**=**
**往生神帝=**Vãng Sinh Thần Đế
2014-09-01=01-09-2014
CEO=Giám đốc điều hành
Ipadmini3=Ipadmini3
[***]=Lục Hợp
[***]八荒=[***] Bát Hoang
bug=lỗi
《剑卷》=《Kiếm Quyển》
一拜斩仙师=Nhất Bái Trảm Tiên Sư
一百六十尊仙人=Một Trăm Sáu Mươi Tôn Tiên Nhân
一绝杀=Nhất Tuyệt Sát
一鸣仙盗=Nhất Minh Tiên Đạo
一鸣妖仙=Nhất Minh yêu tiên
一鸣殿=Nhất Minh Điện
丁卓=Đinh Trác
丁洋=Đinh Dương
丁灵=Đinh Linh
丁灵教主=Đinh Linh Giáo Chủ
丁灵道君=Đinh Linh Đạo Quân
丁灵道母=Đinh Linh Đạo Mẫu
丁灵道母教主=Đinh Linh Đạo Mẫu Giáo Chủ
七=Thất
七佛图=Thất Phật Đồ
七公=Thất Công
七凶旗=Thất Hung Kỳ
七十二地煞=Thất Thập Nhị Địa Sát
七只青鸟=Bảy con chim xanh
七叶=Thất Diệp
七圣=Thất Thánh
七圣王=Thất Thánh Vương
七大圣王=Thất Đại Thánh Vương
七大宇宙=Thất Đại vũ trụ
七头帝皇树=Thất Đầu Đế Hoàng Thụ
七宝=Thất Bảo
七宝华盖=Thất Bảo Hoa Cái
七宝台=Thất Bảo Đài
七宝台境=Thất Bảo Đài Cảnh
七宝帝车=Thất Bảo Đế Xa
七宝林=Thất Bảo Lâm
七尊=Thất Tôn
七帝=Thất Đế
七彩仙凰=Thất Thải Tiên Hoàng
七彩琉璃=Thất Thải Lưu Ly
七星七曜大军=Thất Tinh Thất Diệu Đại Quân
七星青衣王佛=Thất Tinh Thanh Y Vương Phật
七曜=Thất Diệu
七曜天=Thất Diệu Thiên
七曜天宫=Thất Diệu Thiên Cung
七曜天的老鬼=Lão quỷ của Thất Diệu Thiên
七曜天神魔=Thần Ma Thất Diệu Thiên
七杀葫芦=Thất Sát Hồ Lô
七杀魔王=Thất Sát Ma Vương
七都魔火=Thất Đô Ma Hỏa
七魄夺魂钩=Thất Phách Đoạt Hồn Câu
七魄精英=Tinh Anh Thất Phách
万佛之主=Vạn Phật Chi Chủ
万佛之地=Vạn Phật Chi Địa
万佛之宗=Vạn Phật Chi Tông
万佛之祖=Vạn Phật Chi Tổ
万佛塔=Vạn Phật tháp
万兽之王=Vạn Thú Chi Vương
万劫之身=Vạn Kiếp Chi Thân
万古=Vạn Cổ
万古大业=Vạn Cổ Đại Nghiệp
万咒=Vạn Chú
万咒万象=Vạn Chú Vạn Tượng
万咒仙王=Vạn Chú Tiên Vương
万咒大老爷=Vạn Chú Đại Lão Gia
万咒天钟=Vạn Chú Thiên Chung
万咒教主=Vạn Chú giáo chủ
万咒道君=Vạn Chú Đạo Quân
万咒道祖=Vạn Chú Đạo Tổ
万圣=Vạn Thánh
万圣宝殿=Vạn Thánh Bảo Điện
万圣魔帝=Vạn Thánh Ma Đế
万天仙王=Vạn Thiên Tiên Vương
万头先天神魔=vạn đầu tiên thiên thần ma
万宝=Vạn Bảo
万寿丹=Vạn Thọ Đan
万尸路=Vạn Thi Lộ
万恶深渊=Vạn Ác Thâm Uyên
万朵红莲圣佛=Vạn Đóa Hồng Liên Thánh Phật
万法融合=Vạn Pháp Dung Hợp
万灵炼宝劫阵=Vạn Linh Luyện Bảo Kiếp Trận
万灵炼宝大阵=Vạn Linh Luyện Bảo Đại Trận
万物道=Vạn vật đạo
万狱印=Vạn Ngục Ấn
万狱天轮=Vạn Ngục Thiên Luân
万狱洪炉=Vạn Ngục Hồng Lô
万狱洪炉神体=Vạn Ngục Hồng Lô Thần Thể
万狱洪炉经=Vạn Ngục Hồng Lô Kinh
万界=Vạn Giới
万界妖族=Vạn Giới Yêu Tộc
万界宙石=Vạn Giới Trụ Thạch
万界浩劫=Vạn Giới Hạo Kiếp
万界狱图=Vạn Giới Ngục Đồ
万界生灵=Vạn Giới Sinh Linh
万界诸天图=Vạn Giới Chư Thiên Đồ
万神之主=Vạn Thần Chi Chủ
万神之母=Vạn Thần Chi Mẫu
万神化仙池=Vạn Thần Hóa Tiên Trì
万神蜂巢=Vạn Thần Phong Sào
万花楼=Vạn Hoa Lâu
万象=Vạn Tượng
万象圣教=Vạn Tượng Thánh Giáo
万象教主=Vạn Tượng giáo chủ
万象祖师=Vạn Tượng Tổ Sư
万象虚空=Vạn Tượng Hư Không
万象道友=Vạn Tượng đạo hữu
万象道君=Vạn Tượng Đạo Quân
万象道祖=Vạn Tượng Đạo Tổ
万道=Vạn Đạo
万道源流，回归元始=Vạn Đạo Nguyên Lưu, Hồi Quy Nguyên Thủy
万魔谷=Vạn Ma Cốc
万黑虎=Vạn Hắc Hổ
万龙巢=Vạn Long Sào
丈八之身=Trượng Bát Chi Thân
丈六之身=Trượng Lục Chi Thân
丈六之躯=trượng lục chi khu
丈六金身=Trượng Lục Kim Thân
三世真身=Tam Thế Chân Thân
三世身=Tam Thế Thân
三仙王印=Tam Tiên Vương Ấn
三件仙器=Ba Kiện Tiên Khí
三位一体=Tam Vị Nhất Thể
三位转世道君=Ba vị Đạo Quân chuyển thế
三元=Tam Nguyên
三元一击=Tam Nguyên Nhất Kích
三元先天=Tam Nguyên Tiên Thiên
三元先天道境=Tam Nguyên Tiên Thiên Đạo Cảnh
三元合一=Tam Nguyên Hợp Nhất
三元圣教=Tam Nguyên Thánh Giáo
三元天=Tam Nguyên Thiên
三元天尊=Tam Nguyên Thiên Tôn
三元太一先天=Tam Nguyên Thái Nhất Tiên Thiên
三十三天=Ba Mươi Ba Tầng Trời
三十三天仙界=Tam Thập Tam Thiên Tiên Giới
三十三重天元塔=Tam Thập Tam Trọng Thiên Nguyên Tháp
三十三重天宝塔=Tam Thập Tam Trọng Thiên bảo tháp
三十三重天玄黄塔=Tam Thập Tam Trùng Thiên Huyền Hoàng Tháp
三十三重天玄黄宝塔=Tam Thập Tam Trọng Thiên Huyền Hoàng Bảo Tháp
三十六天罡=Tam Thập Lục Thiên Cương
三十六重天神禁=Tam Thập Lục Trọng Thiên Thần Cấm
三千仙体=Tam Thiên Tiên Thể
三千仙山=Tam Thiên Tiên Sơn
三千仙州=Tam Thiên Tiên Châu
三千仙道=Tam Thiên Tiên Đạo
三千口杀气森森的剑光=Tam Thiên Khẩu Sát Khí Sâm Sâm Kiếm Quang
三千大道=Tam Thiên Đại Đạo
三千宇宙=Ba ngàn vũ trụ
三千杀道图=Tam Thiên Sát Đạo đồ
三千极乐大世界=Tam Thiên Cực Lạc Đại Thế Giới
三千造化大道=Tam Thiên Tạo Hóa Đại Đạo
三叉戟=Tam xoa kích
三台阵部=Tam Đài Trận Bộ
三君子=Tam Quân Tử
三哥=Tam ca
三圣棺=Tam Thánh quan
三大仙王=Tam Đại Tiên Vương
三大先天灵宝=Tam Đại Tiên Thiên Linh Bảo
三大劫波=Tam Đại Kiếp Ba
三大圣地=Tam Đại Thánh Địa
三大天君=Tam Đại Thiên Quân
三大时代的劫波=Ba đại thời đại kiếp ba
三大殿主=Tam Đại Điện Chủ
三大灵宝=Tam Đại Linh Bảo
三大真神=Ba Đại Chân Thần
三大真身=Ba Đại Chân Thân
三大禁制=Tam Đại Cấm Chế
三太子=Tam Thái Tử
三宫战部=Tam Cung Chiến Bộ
三尊仙王=Ba vị Tiên Vương
三尻金乌=Tam Kiều Kim Ô
三师=Tam Sư
三帝=Tam Đế
三德=Tam Đức
三德佛君=Tam Đức Phật Quân
三德佛祖=Tam Đức Phật Tổ
三德古佛=Tam Đức Cổ Phật
三德大世尊=Tam Đức Đại Thế Tôn
三德师兄=Tam Đức Sư huynh
三德道人=Tam Đức đạo nhân
三才=Tam Tài
三才大阵=Tam Tài Đại Trận
三把天意诛仙剑=Tam Bả Thiên Ý Tru Tiên Kiếm
三昧真火=Tam Muội Chân Hỏa
三生花=Tam Sinh Hoa
三界=Tam Giới
三界大道=Tam Giới Đại Đạo
三界诸神=Tam Giới Chư Thần
三百五十卷天道宝卷=Ba trăm năm mươi quyển Thiên Đạo Bảo Quyển
三百五十天道宝卷=Ba trăm năm mươi cuốn Thiên Đạo Bảo Quyển
三百五十道天道=Ba Trăm Năm Mươi Đạo Thiên Đạo
三皇=Tam Hoàng
三皇五帝=Tam Hoàng Ngũ Đế
三眼=Tam Nhãn
三眼狼神=Tam Nhãn Lang Thần
三纪元=Tam Kỷ Nguyên
三绝杀=Tam Tuyệt Sát
三缺=Tam Khuyết
三缺 giáo chủ=Tam Khuyết giáo chủ
三缺佛祖=Tam Khuyết Phật Tổ
三缺佛陀=Tam Khuyết Phật Đà
三缺古佛=Tam Khuyết cổ phật
三缺和尚=Tam Khuyết hòa thượng
三缺大佛=Tam Khuyết Đại Phật
三缺教主=Tam Khuyết Giáo Chủ
三缺道人=Tam Khuyết đạo nhân
三缺道友=Tam Khuyết đạo hữu
三花聚顶=Tam hoa tụ đỉnh
三足怪人=Tam Túc Quái Nhân
三足金乌=Tam Túc Kim Ô
三足鸡仔=gà con ba chân
三身=Tam Thân
三途河=Tam Đồ Hà
三阳炼狱=Tam Dương Luyện Ngục
三面八臂孔雀明王化身=Tam Diện Bát Tý Khổng Tước Minh Vương Hóa Thân
三首蛇身的神人=Thần nhân đầu người thân rắn ba đầu
三魂精英=Tinh Anh Tam Hồn
上乘天界=Thượng Thừa Thiên Giới
上使=Thượng sử
上古符咒=Thượng Cổ Phù Chú
上古龙神诀=Thượng Cổ Long Thần Quyết
上品灵石=Thượng phẩm linh thạch
上官煞=Thượng Quan Sát
上官至尊=Thượng Quan Chí Tôn
上尊=Thượng Tôn
上海=Thượng Hải
上清神光=Thượng Thanh Thần Quang
上界=Thượng Giới
上神=Thượng Thần
下界=hạ giới
不动明王=Bất Động Minh Vương
不动明王真身=Bất Động Minh Vương Chân Thân
不动明王诀=Bất Động Minh Vương Quyết
不坏=Bất Hoại
不坏之躯=Bất Hoại Chi Khu
不死之身=Bất Tử Chi Thân
不死冥王=Bất Tử Minh Vương
不死意志=Bất Tử Ý Chí
不死文明之主=Bất Tử Văn Minh Chi Chủ
不灭大道=Đại đạo Bất Diệt
不灭灵光=Bất Diệt Linh Quang
不灭道威=Bất Diệt Đạo Uy
不灭道液=Đạo dịch Bất Diệt
不空=Bất Không
不空印=Bất Không Ấn
不空大道=Bất Không Đại Đạo
不空宝船=Bất Không Bảo Thuyền
不空殿=Bất Không Điện
不空的跟屁虫=kẻ bám đuôi của Bất Không
不空神殿=Bất Không Thần Điện
不空精血=Bất Không Tinh Huyết
不空脚印=Bất Không cước ấn
不空通天桥=Bất Không Thông Thiên Kiều
不空道人=Bất Không Đạo Nhân
不空道兄=Bất Không Đạo Huynh
不空道果=Bất Không đạo quả
不舍天功=Bất Xả Thiên Công
世尊=Thế Tôn
世界境=Thế Giới Cảnh
世界树=Thế Giới Thụ
世界桥=Cầu Thế Giới
丘妗儿=Khâu Cấm Nhi
业力=Nghiệp lực
业念=Nghiệp niệm
业火=Nghiệp Hỏa
业火万雷山=Nghiệp Hỏa Vạn Lôi Sơn
业火红莲=Nghiệp Hỏa Hồng Liên
东云=Đông Vân
东云仙君=Đông Vân Tiên Quân
东云仙王=Đông Vân Tiên Vương
东云十四州=Đông Vân Thập Tứ Châu
东关=Đông Quan
东华国=Đông Hoa Quốc
东宫=Đông Cung
东应情=Đông Ứng Tình
东方妖=Đông Phương Yêu
东方普宇=Đông Phương Phổ Vũ
东方青莲镇道鼎=Đông Phương Thanh Liên Trấn Đạo Đỉnh
东来佛帝=Đông Lai Phật Đế
东来佛祖=Đông Lai Phật Tổ
东极=Đông Cực
东极仙王=Đông Cực Tiên Vương
东极元君=Đông Cực Nguyên Quân
东极兵部=Đông Cực Binh Bộ
东极圣君=Đông Cực Thánh Quân
东极圣城=Đông Cực Thánh Thành
东极圣城东闫城主=Đông Cực Thánh Thành Đông Diễm Thành chủ
东极圣境=Đông Cực Thánh Cảnh
东极大帝=Đông Cực Đại Đế
东极大帝的派系=phe phái Đông Cực Đại Đế
东极大荒=Đông Cực Đại Hoang
东极大荒圣君分舵=Đông Cực Đại Hoang Thánh Quân phân đà
东极天君=Đông Cực Thiên Quân
东极妖仙=Đông Cực Yêu Tiên
东极妖狐=Đông Cực yêu hồ
东极姐姐=Đông Cực tỷ tỷ
东极娘娘=Đông Cực nương nương
东极神君=Đông Cực Thần Quân
东极神帝=Đông Cực Thần Đế
东极神庭=Đông Cực Thần Đình
东极神朝=Đông Cực Thần Triều
东极道友=Đông Cực đạo hữu
东极陛下=Đông Cực bệ hạ
东流=Đông Lưu
东海=Đông Hải
东海王=Đông Hải Vương
东王玉玺=Đông Vương Ngọc Tỉ
东边不亮西边亮=Đông biên bất lượng, tây biên lượng
东野至尊=Đông Dã Chí Tôn
东野良=Đông Dã Lương
东闫城主=Đông Diêm thành chủ
东闫夫人=Đông Diêm phu nhân
东闫神主=Đông Diêm Thần Chủ
东阿=Đông A
东阿道人=Đông A đạo nhân
东龙=Đông Long
丝带=Tơ lụa
两仪=Lưỡng Nghi
两位师尊=Nhị vị sư tôn
两卫=Lưỡng Vệ
两大先天灵宝=Lưỡng Đại Tiên Thiên Linh Bảo
两大宇宙=Hai Đại Vũ Trụ
两大教主=hai đại giáo chủ
两大道宫=Lưỡng Đại Đạo Cung
两宫=Lưỡng Cung
两宫仙君=Lưỡng Cung Tiên Quân
丧门星牌=Tang Môn Tinh Bài
丫头= nha đầu
中千世界=Trung thiên thế giới
中品灵石=trung phẩm linh thạch
中土=Trung Thổ
中土江府=Trung Thổ Giang phủ
中圣皇=Trung Thánh Hoàng
中天=Trung Thiên
中天世界=Trung Thiên Thế Giới
中天东极大荒=Trung Thiên Đông Cực Đại Hoang
中天双棍=Song côn Trung Thiên
中天大世界=Trung Thiên Đại Thế Giới
中天大战=Trung Thiên Đại Chiến
中天罗天镜=Trung Thiên La Thiên Kính
中天群雄=Trung Thiên Quần Hùng
中央八州=Trung Ương Bát Châu
中央天朝=Trung Ương Thiên Triều
中州=Trung Châu
中年仙尊=Trung Niên Tiên Tôn
中年神尊=Thần Tôn trung niên
中洲=Trung Châu
中洲圣皇=Trung Châu Thánh Hoàng
中洲皇主=Trung Châu Hoàng Chủ
中洲皇城=Trung Châu Hoàng Thành
中洲皇朝=Trung Châu Hoàng Triều
中洲社稷图=Trung Châu Xã Tắc Đồ
中洲神朝=Trung Châu Thần Triều
中线紫垣道友=Trung Tuyến Tử Viên Đạo Hữu
丹凤眼=Đan Phượng Nhãn
丹崖=Đan Nhai
丹崖神主=Đan Nhai thần chủ
丹田=Đan điền
丹田道台=Đan Điền Đạo Đài
丹阳=Đan Dương
丹阳仙王=Đan Dương Tiên Vương
丹霞镜=Đan Hà Kính
主上=Chủ Thượng
主公=Chủ công
主大陆=Chủ Đại Lục
主帅=chủ soái
主旗=Chủ kỳ
主星=Chủ Tinh
主母陛下=Chủ mẫu bệ hạ
举霞飞仙=Cử Hà Phi Tiên
义女=Nghĩa Nữ
乌作=Ô Tác
乐的=Nhạc Đích
乐霜=Nhạc Sương
乔乔=Kiều Kiều
九世=Cửu Thế
九世劫波=Cửu Thế Kiếp Ba
九九皇道=Cửu Cửu Hoàng Đạo
九凤=Cửu Phượng
九凤妖君=Cửu Phượng Yêu Quân
九凤妖尊=Cửu Phượng Yêu Tôn
九凤妖帝=Cửu Phượng Yêu Đế
九凤道人=Cửu Phượng Đạo Nhân
九劫=Cửu Kiếp
九十九重寂灭诸天=Cửu Thập Cửu Trọng Tịch Diệt Chư Thiên
九叔=Cửu thúc
九圣佛=Cửu Thánh Phật
九大世界=Cửu đại thế giới
九大天道至宝=Cửu Đại Thiên Đạo Chí Bảo
九大虚空=Cửu Đại Hư Không
九大补天神人=Cửu Đại Bổ Thiên Thần Nhân
九天=Cửu Thiên
九头凤=Cửu Đầu Phượng
九头圣龙=Cửu Đầu Thánh Long
九头大鹏雕=Cửu Đầu Đại Bằng Điêu
九头彩凤=Cửu Đầu Thải Phượng
九头金凤妖尊=Cửu Đầu Kim Phượng Yêu Tôn
九头龙=Cửu Đầu Long
九宫=Cửu Cung
九尊真仙=Cửu Tôn Chân Tiên
九尊补天神人=Cửu Tôn Bổ Thiên Thần Nhân
九尾=Cửu Vĩ
九尾妖狐=Cửu Vĩ Yêu Hồ
九尾狐=Cửu Vĩ Hồ
九嶷棺=Cửu Nghi Quan
九嶷皇君=Cửu Nghi Hoàng quân
九帝=Cửu Đế
九幽冥界=Cửu U Minh Giới
九幽玄关=Cửu U Huyền Quan
九幽魔皇=Cửu U Ma Hoàng
九斗阳芒大军=Cửu Đấu Dương Mang Đại Quân
九斗阳芒天宫=Cửu Đấu Dương Mang Thiên Cung
九星连珠=Cửu Tinh Liên Châu
九曲十八关=Cửu Khúc Thập Bát Quan
九月=Tháng Chín
九朵白莲世界=Chín đóa Bạch Liên Thế Giới
九极阆苑=Cửu Cực Lãng Uyển
九泉=Cửu Tuyền
九灵圣皇=Cửu Linh Thánh Hoàng
九片莲叶世界=Chín phiến Liên Diệp Thế Giới
九环锡杖=Cửu Hoàn Tích Trượng
九百步的彼岸金桥=Kim Kiều Bỉ Ngạn chín trăm bước
九禁=Cửu Cấm
九窍神石=Thần thạch Cửu Khiếu
九绝杀=Cửu Tuyệt Sát
九老仙人=Cửu Lão Tiên Nhân
九胥=Cửu Xu
九胥道尊=Cửu Tư Đạo Tôn
九路大军=Cửu Lộ Đại Quân
九转天轮=Cửu Chuyển Thiên Luân
九转天轮印=Cửu Chuyển Thiên Luân Ấn
九转战体=Cửu Chuyển Chiến Thể
九转金龙大法=Cửu Chuyển Kim Long Đại Pháp
九道三千大道=Cửu đạo tam thiên đại đạo
九重天=Cửu Trọng Thiên
九重天宫=Cửu Trọng Thiên Cung
九阳剑意=Cửu Dương Kiếm Ý
九阳圣龙=Cửu Dương Thánh Long
九阳圣龙老皇=Cửu Dương Thánh Long lão hoàng
九阳灵气=Cửu Dương Linh Khí
九阳谷=Cửu Dương Cốc
九阴九阳=Cửu Âm Cửu Dương
九阴剑意=Cửu Âm Kiếm Ý
九阴圣龙=Cửu Âm Thánh Long
九阴灵气=Cửu Âm Linh Khí
九阴神水=Cửu Âm Thần Thủy
九霄=Cửu Tiêu
九霄大帝=Cửu Tiêu Đại Đế
九霄神帝=Cửu Tiêu Thần Đế
九霄罗天殿=Cửu Tiêu La Thiên Điện
九面神王旗=Cửu Diện Thần Vương Kỳ
九龙=Cửu Long
九龙天域=Cửu Long Thiên Vực
九龙楼船=Cửu Long Lâu Thuyền
九龙皇祖=Cửu Long Hoàng Tổ
九龙道人=Cửu Long Đạo Nhân
书友=bạn đọc
书阁=Thư các
乱空大阵=Loạn Không Đại Trận
乱空魔域=Loạn Không Ma Vực
乾元=Càn Nguyên
乾元仙君=Càn Nguyên Tiên Quân
乾元仙城=Càn Nguyên tiên thành
乾元仙帝=Càn Nguyên Tiên Đế
乾元仙朝=Càn Nguyên Tiên Triều
乾元伯父=Càn Nguyên bá phụ
乾元天君=Càn Nguyên Thiên Quân
乾元宫=Càn Nguyên Cung
乾元师兄=Càn Nguyên sư huynh
乾元师弟=Càn Nguyên sư đệ
乾元老爷=Càn Nguyên Lão Gia
乾元道君=Càn Nguyên Đạo Quân
乾元道尊=Càn Nguyên Đạo Tôn
乾坤=Càn Khôn
乾坤关=Càn Khôn Quan
乾坤圈=Càn Khôn Quyền
乾坤大世界=Càn Khôn Đại Thế Giới
乾坤大手印=Càn Khôn Đại Thủ Ấn
乾坤宫=Càn Khôn Cung
乾坤小友=Càn Khôn tiểu hữu
乾坤神帝=Càn Khôn Thần Đế
乾坤老祖=Càn Khôn lão tổ
乾坤袋=Càn Khôn Đại
乾坤覆灭=Càn Khôn Phục Diệt
乾坤道人=Càn Khôn Đạo Nhân
乾至=Càn Chí
乾至魔君=Càn Chí Ma Quân
乾至魔帝=Càn Chí Ma Đế
乾至魔皇=Càn Chí Ma Hoàng
二十八宿兵部=Nhị Thập Bát Tú Binh Bộ
二十八诸天=Hai mươi tám Chư Thiên
二十八诸天大帝=Hai mươi tám Chư Thiên Đại Đế
二十八重诸天=Hai mươi tám tầng Chư Thiên
二十四星宿=Nhị Thập Tứ Tinh Tú
二十四重天冰源浮屠=Nhị Thập Tứ Trọng Thiên Băng Nguyên Phù Đồ
二哥=Nhị ca
二法=Nhị Pháp
二法王=Nhị Pháp Vương
二绝杀=Nhị Tuyệt Sát
二阶灵脉=Nhị Giai Linh Mạch
于夺仙符之战=Chiến Tranh Đoạt Tiên Phù
云一鸣=Vân Nhất Minh
云为蓬=Vân Vi Bồng
云之元婴=Vân Nguyên Anh
云城=Vân Thành
云城星陆=Vân Thành Tinh Lục
云天派=Vân Thiên Phái
云家=Vân Gia
云层=Vân Tầng
云山仙城=Vân Sơn Tiên Thành
云州=Vân Châu
云泽大墟天=Vân Trạch Đại Khư Thiên
云班魔君=Vân Ban Ma Quân
云系灵兽=Linh thú hệ Vân
云莲=Vân Liên
云莲仙朝=Vân Liên Tiên Triều
云莲女帝=Vân Liên Nữ Đế
云锦=Vân Cẩm
云锦天神=Vân Cẩm Thiên Thần
云间世界=Vân Gian Thế Giới
云阳=Vân Dương
云阳元君=Vân Dương Nguyên Quân
云阳夫人=Vân Dương phu nhân
云雀=Vân Tước
云雨化龙大法=Vân Vũ Hóa Long Đại Pháp
云香=Vân Hương
云香仙王=Vân Hương Tiên Vương
云鹏=Vân Bằng
云龙=Vân Long
云龙十变=Vân Long Thập Biến
云龙心法=Vân Long Tâm Pháp
云龙道人=Vân Long đạo nhân
五一=Mùng 1 tháng 5
五云=Ngũ Vân
五云皇祖=Ngũ Vân Hoàng Tổ
五位叔父=năm vị thúc phụ
五位圣王=Ngũ Vị Thánh Vương
五凤=Ngũ Phượng
五凤车=Ngũ Phượng Xa
五劫印=Ngũ Kiếp Ấn
五劫钟=Ngũ Kiếp Chung
五十弦先天瑶琴=Ngũ Thập Huyền Tiên Thiên Dao Cầm
五千万年第一帝=Ngũ Thiên Vạn Niên Đệ Nhất Đế
五口神剑=Ngũ Khẩu Thần Kiếm
五口镇道鼎=Ngũ Khẩu Trấn Đạo Đỉnh
五大圣城=Ngũ Đại Thánh Thành
五大圣王=Ngũ Đại Thánh Vương
五大尊=Ngũ Đại Tôn
五大时代=Ngũ Đại Thời Đại
五大神君=Ngũ Đại Thần Quân
五大道祖=Ngũ Đại Đạo Tổ
五大道统=Năm Đại Đạo Thống
五尊=Ngũ Tôn
五尊神魔=Năm vị Thần Ma
五帝=Ngũ Đế
五帝五师=Ngũ Đế Ngũ Sư
五帝五皇轮回剑道=Ngũ Đế Ngũ Hoàng Luân Hồi Kiếm Đạo
五帝内座=Ngũ Đế Nội Tọa
五帝座=Ngũ Đế Tọa
五座剑山=Ngũ Tọa Kiếm Sơn
五指山=Ngũ Chỉ Sơn
五方偈帝=Ngũ Phương Kệ Đế
五方圣王佛=Ngũ Phương Thánh Vương Phật
五月=Tháng Năm
五毒四城两后宫=Ngũ Độc Tứ Thành Lưỡng Hậu Cung
五灵石水军=Ngũ Linh Thạch Thủy Quân
五百万神魔=Năm Triệu Thần Ma
五祖=Ngũ Tổ
五福寿桃=Ngũ Phúc Thọ Đào
五绝天=Ngũ Tuyệt Thiên
五绝天神主=Ngũ Tuyệt Thiên Thần chủ
五绝杀=Ngũ Tuyệt Sát
五老=Ngũ Lão
五脏六腑=Ngũ Tạng Lục Phủ
五色仙芝=Ngũ Sắc Tiên Chi
五色剑山=Ngũ Sắc Kiếm Sơn
五色大锤=Ngũ Sắc Đại Chùy
五色莲=Ngũ Sắc Liên
五色金=Ngũ Sắc Kim
五色钟=Ngũ Sắc Chung
五行=Ngũ Hành
五行兵部=Ngũ Hành Binh Bộ
五行剑山=Ngũ Hành Kiếm Sơn
五行大尊=Ngũ Hành Đại Tôn
五行大旗=Ngũ Hành đại kỳ
五行天宫=Ngũ Hành Thiên Cung
五行旗五部大军=Ngũ Hành Kỳ Ngũ Bộ Đại Quân
五行旗军=Ngũ Hành Kỳ Quân
五行灭绝剑阵=Ngũ Hành Diệt Tuyệt Kiếm Trận
五行灭绝神光=Ngũ Hành Diệt Tuyệt Thần Quang
五行神体=Ngũ Hành Thần Thể
五行神尊=Ngũ Hành Thần Tôn
五车兵部=Ngũ Xa Binh Bộ
五车营=Ngũ Xa Doanh
五都四城两后宫=Ngũ Đô Tứ Thành Lưỡng Hậu Cung
五魂幡=Ngũ Hồn Phiên
五魔林佐鸣=Ngũ Ma Lâm Tá Minh
京南=Kinh Nam
亭=tình
亭台楼榭=đình đài lầu gác
亭昊=Đình Hạo
亭昊神主=Đình Hạo thần chủ
亭昊道兄=Đình Hạo đạo huynh
人=Nhân
人仙界=Nhân Tiên Giới
人仙道=Nhân Tiên Đạo
人劫=Nhân Kiếp
人形生物=sinh vật hình người
人形的圣药=Thánh dược hình người
人教=Nhân Giáo
人道=Nhân Đạo
人道圣教=Nhân Đạo Thánh Giáo
人道天堂=Nhân Đạo thiên đường
人道时代=Nhân Đạo Thời Đại
人道皇极经=Nhân Đạo Hoàng Cực Kinh
人间界=Nhân Gian Giới
人首蛇身=Người đầu rắn thân
仁宗=Nhân Tông
仁宗仙王=Nhân Tông Tiên Vương
今曰=Kim Nhật
今生花=Kim Sinh Hoa
仙之锁链=Tiên Chi Tỏa Liên
仙书=Tiên Thư
仙人=Tiên Nhân
仙人**体系=Hệ thống Tiên Nhân
仙人道身=Tiên Nhân Đạo Thân
仙体=Tiên Thể
仙体少虚=Tiên Thể Thiếu Hư
仙体证道=Tiên Thể Chứng Đạo
仙侠=tiên hiệp
仙光=tiên quang
仙光仙道=Tiên Quang Tiên Đạo
仙兽=Tiên thú
仙凰=Tiên Hoàng
仙劫=Tiên Kiếp
仙印=Tiên Ấn
仙古文明=Văn minh Tiên Cổ
仙后圣母=Tiên Hậu Thánh Mẫu
仙后娘娘=Tiên Hậu Nương Nương
仙君=Tiên Quân
仙君级=Tiên Quân cấp
仙器=Tiên khí
仙图=Tiên Đồ
仙垒衣=Tiên Lũy Y
仙域=Tiên Vực
仙境=Tiên Cảnh
仙宫=Tiên Cung
仙宫圣地=Tiên Cung Thánh Địa
仙宫太子=Tiên Cung Thái Tử
仙家之宝=Tiên Gia Chi Bảo
仙尊=Tiên Tôn
仙尊宝船=Tiên Tôn Bảo Thuyền
仙尊宫=Tiên Tôn Cung
仙山=Tiên Sơn
仙州=Tiên Châu
仙帝=Tiên Đế
仙帝叶麟=Tiên Đế Diệp Lân
仙帝宝船=Tiên Đế Bảo Thuyền
仙帝宫=Tiên Đế Cung
仙帝权杖=Tiên Đế Quyền Trượng
仙庭=Tiên Đình
仙弓=Tiên Cung
仙文宝书=Tiên Văn Bảo Thư
仙料=Tiên Liệu
仙旗=Tiên Kỳ
仙朝=Tiên Triều
仙树=Tiên Thụ
仙武库=Tiên Võ Khố
仙殿=Tiên Điện
仙气=Tiên Khí
仙池=Tiên Trì
仙海=Tiên Hải
仙海冰魄=Tiên Hải Băng Phách
仙海十九州=Tiên Hải Thập Cửu Châu
仙海龙王=Tiên Hải Long Vương
仙液=Tiên Dịch
仙火绝地=Tiên Hỏa Tuyệt Địa
仙灵之气=Tiên Linh Chi Khí
仙物=Tiên Vật
仙王=Tiên Vương
仙王级=Tiên Vương cấp
仙琴=Tiên Cầm
仙界=Tiên giới
仙界壁垒=vách ngăn Tiên Giới
仙界大师兄=Hoa sư huynh
仙界始源之地=Tiên Giới Thủy Nguyên Chi Địa
仙界帝尊=Tiên Giới Đế Tôn
仙界源始之地=Tiên Giới Nguyên Thủy Chi Địa
仙眼=Tiên Nhãn
仙矿=Tiên Khoáng
仙碟=Tiên Điệp
仙祖钧道尊=Tiên Tổ Quân Đạo Tôn
仙童=Tiên đồng
仙笔=Tiên Bút
仙符=Tiên Phù
仙缘九关=Tiên Duyên Cửu Quan
仙罚=Tiên Phạt
仙翁=Tiên Ông
仙胎=Tiên thai
仙葫=Tiên Hồ
仙藤=Tiên Đằng
仙蜈=Tiên Ngô
仙血=Tiên Huyết
仙衣=Tiên y
仙貘=Tiên Mịch
仙迹=Tiên Tích
仙道=Tiên Đạo
仙道五祖=Tiên Đạo Ngũ Tổ
仙道元始=Tiên Đạo Nguyên Thủy
仙道四大天君=Tiên Đạo Tứ Đại Thiên Quân
仙道因果=Tiên Đạo Nhân Quả
仙道宇宙=Tiên Đạo Vũ Trụ
仙道寂灭劫=Tiên Đạo Tịch Diệt Kiếp
仙道帝江=Tiên Đạo Đế Giang
仙道时代=Thời đại Tiên Đạo
仙道江南=Tiên Đạo Giang Nam
仙道灵根=Tiên Đạo Linh Căn
仙道神通=Tiên Đạo Thần Thông
仙道符文=Tiên Đạo Phù Văn
仙道至宝=Tiên đạo chí bảo
仙道霞光=Tiên Đạo Hà Quang
仙都=Tiên Đô
仙都上尊=Tiên Đô Thượng Tôn
仙都神尊=Tiên Đô Thần Tôn
仙酿=Tiên Nương
仙金=Tiên Kim
仙锤=Tiên chùy
仙锻=Tiên Đoàn
仙阁=Tiên Các
仙阙=Tiên Khuyết
仙雷=Tiên Lôi
仙魔=Tiên Ma
仙魔二界=Tiên Ma Nhị Giới
仙鸿佩=Tiên Hồng Bội
仙鼎=Tiên Đỉnh
仙鼎之足=Chân Tiên Đỉnh
仙鼎令=Tiên Đỉnh Lệnh
仙鼎碎片=Tiên Đỉnh Toái Phiến
仙鼎碎片空间=Tiên Đỉnh Toái Phiến Không Gian
以宝证道=dùng bảo vật chứng đạo
以神证道=dùng thần chứng đạo
以身证道=dùng thân chứng đạo
以道证道=dùng đạo chứng đạo
任先天=Nhậm Tiên Thiên
任功青=Nhậm Công Thanh
任道友=Nhậm đạo hữu
伏兵=Phục binh
伏咜=Phục Đà
伏咜教主=Phục Đà giáo chủ
伏咜道君=Phục Đà Đạo Quân
伏显=Phục Hiển
众妙之门=Chúng Diệu Chi Môn
众生=Chúng sinh
众生道=Chúng sinh đạo
众神之城=Chúng Thần Chi Thành
会主=Hội Chủ
会造化老祖=Hội Tạo Hóa Lão Tổ
传教=truyền giáo
传法之地=Truyền Pháp Chi Địa
传道图=Truyền Đạo Đồ
伪仙体=Ngụy Tiên Thể
伪元磁神体=Ngụy Nguyên Từ Thần Thể
伪帝皇神体=Ngụy Đế Hoàng Thần Thể
伪神体=Ngụy Thần Thể
伯母=bá mẫu
伯父=bác
伯符=Bá Phù
伯符神帝=Bá Phù Thần Đế
伽摩圣尊=Già Ma Thánh Tôn
伽逯魔仙=Già Lục Ma Tiên
伽酉真魔=Già Dậu Chân Ma
佘文举=Xa Văn Cử
佘老弟=Xa lão đệ
佘老怪=Xa Lão Quái
佛=Phật
佛主=Phật chủ
佛主佛尊=Phật Chủ Phật Tôn
佛仙=Phật Tiên
佛光城=Phật Quang Thành
佛光寺=Phật Quang Tự
佛古文明=Văn minh Phật Cổ
佛君=Phật Quân
佛尊=Phật Tôn
佛帝=Phật Đế
佛帝舍利=Phật Đế Xá Lợi
佛母玉菩萨=Phật Mẫu Ngọc Bồ Tát
佛海=Phật Hải
佛爷=Phật gia
佛珠=Phật Châu
佛界=Phật Giới
佛皇=Phật Hoàng
佛眼=Phật nhãn
佛祖=Phật Tổ
佛门=Phật môn
佛陀=Phật Đà
佞臣=Nịnh thần
佳人=Giai nhân
侯府=Hầu Phủ
保底月票=Phiếu bầu tháng bảo đảm
修士=Tu sĩ
修罗仙道=Tu La Tiên Đạo
修罗界=Tu La Giới
倒三角眼=Đảo Tam Giác Nhãn
倬州=Trác Châu
假不空道果=Giả Bất Không Đạo Quả
偷天换日=Thâu Thiên Hoán Nhật
傀儡=Khôi Lỗi
傅冲=Phó Xung
傅延宗=Phó Duyên Tông
儒门=Nho Môn
元=Nguyên
元会=Nguyên Hội
元会大尊=Nguyên Hội Đại Tôn
元会大老爷=Nguyên Hội Đại Lão Gia
元化=Nguyên Hóa
元化魔仙=Nguyên Hóa Ma Tiên
元君=Nguyên Quân
元君女帝=Nguyên Quân Nữ Đế
元君娘娘=Nguyên Quân nương nương
元塔=Nguyên Tháp
元塔元鼎元钟=Nguyên Tháp, Nguyên Đỉnh, Nguyên Chung
元塔大阵=Nguyên Tháp Đại Trận
元塔阵图=Nguyên Tháp Trận Đồ
元天=Nguyên Thiên
元天时代=Nguyên Thiên thời đại
元太时代=Thời đại Nguyên Thái
元始=Nguyên Thủy
元始三印=Nguyên Thủy Tam Ấn
元始不灭灵光=Nguyên Thủy Bất Diệt Linh Quang
元始不空印=Nguyên Thủy Bất Không Ấn
元始之地=Nguyên Thủy Chi Địa
元始之宝=Nguyên Thủy Chi Bảo
元始之气=Nguyên Thủy Chi Khí
元始仙朝=Nguyên Thủy Tiên Triều
元始元神=Nguyên Thủy Nguyên Thần
元始先天=Nguyên Thủy Tiên Thiên
元始印=Nguyên Thủy Ấn
元始古神=Nguyên Thủy Cổ Thần
元始大罗印=Nguyên Thủy Đại La Ấn
元始大罗天=Nguyên Thủy Đại La Thiên
元始大罗天印=Nguyên Thủy Đại La Thiên Ấn
元始大罗宝剑=Nguyên Thủy Đại La Bảo Kiếm
元始大罗经=Nguyên Thủy Đại La Kinh
元始大老爷=Nguyên Thủy Đại Lão Gia
元始大道=Nguyên Thủy Đại Đạo
元始天君=Nguyên Thủy Thiên Quân
元始天尊=Nguyên Thủy Thiên Tôn
元始天王=Nguyên Thủy Thiên Vương
元始宝剑=Nguyên Thủy bảo kiếm
元始寂灭印=Nguyên Thủy Tịch Diệt Ấn
元始师兄=Nguyên Thủy sư huynh
元始感应篇=Nguyên Thủy Cảm Ứng Thiên
元始母拳=Nguyên Thủy Mẫu Quyền
元始灵光=Nguyên Thủy Linh Quang
元始玄天雷劫=Nguyên Thủy Huyền Thiên Lôi Kiếp
元始真仙道果=Nguyên Thủy Chân Tiên Đạo Quả
元始神君=Nguyên Thủy Thần Quân
元始神王=Nguyên Thủy Thần Vương
元始神道=Nguyên Thủy Thần Đạo
元始神魂=Nguyên Thủy Thần Hồn
元始苍茫，唯我不空=Nguyên Thủy Thương Mang, Duy Ngã Bất Không
元始证道剑=Nguyên Thủy Chứng Đạo Kiếm
元始道君=Nguyên Thủy Đạo Quân
元始道果=Nguyên Thủy Đạo Quả
元始金丹=Nguyên Thủy Kim Đan
元婴=Nguyên Anh
元婴主宰=Nguyên Anh Chủ Tể
元婴控符丹=Nguyên Anh Khống Phù Đan
元婴期=Nguyên Anh kỳ
元尊=Nguyên Tôn
元尊大帝=Nguyên Tôn Đại Đế
元尊法王=Nguyên Tôn Pháp Vương
元尊真仙=Nguyên Tôn Chân Tiên
元尊神帝=Nguyên Tôn Thần Đế
元尊道友=Nguyên Tôn đạo hữu
元尚道人=Nguyên Thượng đạo nhân
元朗=Nguyên Lãng
元枢=Nguyên Xu
元桩=Nguyên Trang
元梵=Nguyên Phạn
元梵佛帝=Nguyên Phạn Phật Đế
元母=Nguyên Mẫu
元母天尊=Nguyên Mẫu Thiên Tôn
元母殿主=Nguyên Mẫu Điện Chủ
元母道殿=Nguyên Mẫu Đạo Điện
元气=Nguyên Khí
元气大殿=Nguyên Khí Đại Điện
元水=Nguyên Thủy
元水仙域=Nguyên Thủy Tiên Vực
元水玉瓶=Nguyên Thủy Ngọc Bình
元清=Nguyên Thanh
元清道母=Nguyên Thanh Đạo Mẫu
元渔女尊=Nguyên Ngư Nữ Tôn
元灭=Nguyên Diệt
元灭时代=Nguyên Diệt Thời Đại
元界=Nguyên Giới
元界主星=Nguyên Giới Chủ Tinh
元界圣宗=Nguyên Giới Thánh Tông
元界金船=Nguyên Giới Kim Thuyền
元白=Nguyên Bạch
元白仙人=Nguyên Bạch Tiên Nhân
元碧君=Nguyên Bích Quân
元磁宙界=Nguyên Từ Trụ Giới
元磁神体=Nguyên Từ Thần Thể
元祉=Nguyên Chỉ
元祉大尊=Nguyên Chỉ Đại Tôn
元祉魔君=Nguyên Chỉ Ma Quân
元祖=Nguyên Tổ
元神=Nguyên Thần
元神世界树=Nguyên Thần Thế Giới Thụ
元神先天=Nguyên Thần Tiên Thiên
元育=Nguyên Dục
元育仙君=Nguyên Dục Tiên Quân
元育仙帝=Nguyên Dục Tiên Đế
元育仙庭=Nguyên Dục Tiên Đình
元育仙朝=Nguyên Dục Tiên Triều
元育仙王=Nguyên Dục Tiên Vương
元育圣境=Nguyên Dục Thánh Cảnh
元育天君=Nguyên Dục Thiên Quân
元育太极=Nguyên Dục Thái Cực
元育太极图=Nguyên Dục Thái Cực Đồ
元育太极天=Nguyên Dục Thái Cực Thiên
元育道兄=Nguyên Dục đạo huynh
元起=Nguyên Khởi
元起时代=Nguyên Khởi thời đại
元道=Nguyên Đạo
元道时代=Thời đại Nguyên Đạo
元钟=Nguyên Chung
元钟城=Nguyên Chung Thành
元钟阵图=Nguyên Chung Trận Đồ
元钰=Nguyên Ngọc
元钰旗主=Nguyên Ngọc Kỳ Chủ
元阳炉=Nguyên Dương Lô
元魔=Nguyên Ma
元魔圣母=Nguyên Ma Thánh Mẫu
元魔魔帝=Nguyên Ma Ma Đế
元魔魔皇=Nguyên Ma Ma Hoàng
元鼎=Nguyên Đỉnh
元鼎元塔元钟=Nguyên Đỉnh, Nguyên Tháp, Nguyên Chung
元鼎阵图=Nguyên Đỉnh Trận Đồ
先天=Tiên Thiên
先天一族=Tiên Thiên Nhất Tộc
先天不明灵光=Tiên Thiên Bất Minh Linh Quang
先天不灭之心=Tiên Thiên Bất Diệt Chi Tâm
先天不灭之躯=Tiên Thiên Bất Diệt Chi Khu
先天不灭大道=Đại đạo Tiên Thiên Bất Diệt
先天不灭灵光=Tiên Thiên Bất Diệt Linh Quang
先天不灭灵根=Tiên thiên Bất Diệt Linh Căn
先天不灭道威=Tiên Thiên Bất Diệt Đạo Uy
先天不败之地=Tiên Thiên Bất Bại Chi Địa
先天之体=Tiên thiên chi thể
先天之力=Tiên Thiên Chi Lực
先天之物=Tiên Thiên Chi Vật
先天五色莲=Tiên Thiên Ngũ Sắc Liên
先天仙域=Tiên Thiên Tiên Vực
先天仙金=Tiên thiên Tiên Kim
先天元水=Tiên Thiên Nguyên Thủy
先天元水仙域=Tiên Thiên Nguyên Thủy Tiên Vực
先天元水大河=Tiên Thiên Nguyên Thủy Đại Hà
先天元水神灵=Tiên Thiên Nguyên Thủy Thần Linh
先天八卦=Tiên Thiên Bát Quái
先天八景=Tiên Thiên Bát Cảnh
先天八景图=Tiên Thiên Bát Cảnh Đồ
先天八景玄功=Tiên Thiên Bát Cảnh Huyền Công
先天八景神帝=Tiên Thiên Bát Cảnh Thần Đế
先天厌魔枪=Tiên Thiên Yếm Ma Thương
先天古琴=Tiên Thiên Cổ Cầm
先天大帝=Tiên Thiên Đại Đế
先天大帝七叶=Tiên Thiên Đại Đế Thất Diệp
先天太极阴阳图=Tiên Thiên Thái Cực Âm Dương Đồ
先天妖帝=Tiên Thiên Yêu Đế
先天妖帝任先天=Tiên Thiên Yêu Đế Nhậm Tiên Thiên
先天妖魔=Tiên Thiên Yêu Ma
先天寂灭灵光=Tiên thiên Tịch Diệt Linh quang
先天师=Tiên Thiên Sư
先天战部=Tiên Thiên Chiến Bộ
先天无为道境=Tiên Thiên Vô Vi Đạo Cảnh
先天本初之气=Tiên Thiên Bản Sơ Chi Khí
先天权杖=Tiên Thiên Quyền Trượng
先天梦镜=Tiên Thiên Mộng Kính
先天法宝=Tiên Thiên Pháp Bảo
先天法宝万咒天钟=Tiên Thiên Pháp Bảo Vạn Chú Thiên Chung
先天混元=Tiên Thiên Hỗn Nguyên
先天混元珠=Tiên Thiên Hỗn Nguyên Châu
先天混元神通=Tiên Thiên Hỗn Nguyên Thần Thông
先天灵光=Tiên Thiên Linh Quang
先天灵宝=Tiên Thiên Linh Bảo
先天灵根=Tiên Thiên Linh Căn
先天灵根道液=Tiên Thiên Linh Căn Đạo Dịch
先天玄气=Tiên Thiên Huyền Khí
先天瑶琴=Tiên Thiên Dao Cầm
先天生灵=Tiên Thiên Sinh Linh
先天瘟帝棺=Tiên Thiên Ôn Đế Quan
先天瘟帝棺的威能=uy năng của Tiên Thiên Ôn Đế quan
先天神刀=Tiên Thiên Thần Đao
先天神圣=Tiên Thiên Thần Thánh
先天神宗=Tiên Thiên Thần Tông
先天神帝=Tiên Thiên Thần Đế
先天神灯=Tiên Thiên Thần Đăng
先天神灵=Tiên Thiên Thần Linh
先天神炉=Tiên Thiên Thần Lô
先天神算大阵=Tiên Thiên Thần Toán Đại Trận
先天神道=Tiên Thiên Thần Đạo
先天神镜=Tiên Thiên Thần Kính
先天神魔=Tiên Thiên Thần Ma
先天神魔血脉=Tiên Thiên Thần Ma huyết mạch
先天至宝=Tiên Thiên Chí Bảo
先天芦蓬=Tiên Thiên Lô Bồng
先天苦海=Tiên Thiên Khổ Hải
先天苦竹=Tiên Thiên Khổ Trúc
先天血脉=Tiên Thiên Huyết Mạch
先天证道=Tiên Thiên Chứng Đạo
先天造化之门=Tiên Thiên Tạo Hóa Chi Môn
先天道体=Tiên Thiên Đạo Thể
先天道则=Tiên Thiên đạo tắc
先天道境=Tiên Thiên Đạo Cảnh
先天金气=Tiên thiên kim khí
先天金精=Tiên Thiên Kim Tinh
先天金龙锏=Tiên Thiên Kim Long Giản
先天雷海=Tiên Thiên Lôi Hải
先天雷海仙域=Tiên Thiên Lôi Hải Tiên Vực
先天雷珠=Tiên Thiên Lôi Châu
先天青莲经=Tiên Thiên Thanh Liên Kinh
先天龙凤=Tiên Thiên Long Phượng
先天龙蛟=Tiên Thiên Long Giao
先天龙蛟马=Tiên Thiên Long Giao Mã
先夫=Tiên phu
先民=Tiên Dân
先贤殿=Tiên Hiền Điện
光之剑意=Quang Chi Kiếm Ý
光光=Quang Quang
光头大汉=đại hán đầu trọc
光武=Quang Võ
光武佛帝=Quang Vũ Phật Đế
光武大帝=Quang Võ Đại Đế
光武帝=Quang Võ Đế
光武帝躯=Quang Võ Đế Khu
光武朝廷=Quang Vũ triều đình
光武神帝=Quang Võ Thần Đế
光武神庭=Quang Vũ Thần Đình
光武神朝=Quang Vũ Thần Triều
光武纪=Quang Võ Kỷ
光武纪劫=Quang Vũ Kỷ Kiếp
光武纪年=Quang Vũ Kỷ Niên
光武道兄=Quang Võ đạo huynh
兜率神火=Đâu Suất Thần Hỏa
入梦镜=Nhập Mộng Kính
八亿年=Tám ức năm
八仙君=Bát Tiên Quân
八仙宫=Bát Tiên Cung
八仙王=Bát Tiên Vương
八休丧门阵=Bát Hưu Tang Môn Trận
八卦=Bát Quái
八卦炼丹炉=Bát Quái Luyện Đan Lô
八口神王剑=Bát Khẩu Thần Vương Kiếm
八圣仙=Bát Thánh Tiên
八境=Bát Cảnh
八大仙道=Bát Đại Tiên Đạo
八大先天法宝=Bát Đại Tiên Thiên Pháp Bảo
八大宇宙=Bát Đại Vũ Trụ
八大明王经=Bát Đại Minh Vương Kinh
八大法宝=Bát Đại Pháp Bảo
八大玉珠=Bát Đại Ngọc Châu
八大真仙=Bát Đại Chân Tiên
八大神国=Bát Đại Thần Quốc
八宝琉璃塔=Bát Bảo Lưu Ly Tháp
八宝莲台=Bát Bảo Liên Đài
八尊仙王=Bát Tôn Tiên Vương
八尊魔皇=Bát Tôn Ma Hoàng
八把神王剑=Bát Bả Thần Vương Kiếm
八景云霄殿=Bát Cảnh Vân Tiêu Điện
八景神帝=Bát Cảnh Thần Đế
八景神帝化身=Bát Cảnh Thần Đế hóa thân
八景神皇=Bát Cảnh Thần Hoàng
八极诛神大阵=Bát Cực Tru Thần đại trận
八瓣锤=Bát Biện Chùy
八神祖=Bát Thần Tổ
八荒=Bát Hoang
八荒九宫=Bát Hoang Cửu Cung
八荒大神通=Bát Hoang Đại Thần Thông
八荒大阵=Bát Hoang Đại Trận
八荒神兵=Bát Hoang Thần Binh
八阵图=Bát Trận Đồ
八魔=Bát Ma
公众薇信=Vi công chúng
公冶=Công Dã
公冶乾=Công Dã Càn
公冶先生=Công Dã tiên sinh
公冶老兔子=Công Dã lão thỏ tử
公子=Công tử
公正严明=Công Chính Nghiêm Minh
公羊毫=Công Dương Hào
公羊至尊=Công Dương Chí Tôn
六位道友=Lục vị đạo hữu
六合八荒=Lục Hợp Bát Hoang
六大化身=Lục Đại Hóa Thân
六大天尊=Lục Đại Thiên Tôn
六大宇宙=Lục Đại Vũ Trụ
六大神明之宝=Lục Đại Thần Minh Chi Bảo
六宝=Lục Bảo
六尊皇祖=Lục Tôn Hoàng Tổ
六尊皇道极境的分身=sáu phân thân Hoàng Đạo Cực Cảnh
六尊魔君=sáu Ma Quân
六极=Lục Cực
六柱天=Lục Trụ Thiên
六柱天世界=Thế giới Lục Trụ Thiên
六爻经=Lục Hào Kinh
六甲=Lục Giáp
六皇=Lục Hoàng
六道世界=Lục Đạo Thế Giới
六道仙界=Lục Đạo Tiên Giới
六道仙轮=Lục Đạo Tiên Luân
六道仙轮天仙界=Lục Đạo Tiên Luân Thiên Tiên Giới
六道剑=Lục Đạo Kiếm
六道化身=Lục Đạo hóa thân
六道大神通=Lục Đạo Đại Thần Thông
六道天轮=Lục Đạo Thiên Luân
六道天轮圣典=Lục Đạo Thiên Luân Thánh Điển
六魂幡=Lục Hồn Phiên
兰姐=Lan tỷ
兰陵=Lan Lăng
兰陵公子=Lan Lăng công tử
兰陵大帝=Lan Lăng Đại Đế
兰陵烈=Lan Lăng Liệt
兰陵神皇=Lan Lăng Thần Hoàng
兰陵魔帝=Lan Lăng Ma Đế
关旭=Quan Húc
关旭真神=Quan Húc Chân Thần
关青山=Quan Thanh Sơn
兵家常事=việc thường của binh gia
兵祖=Binh Tổ
兵祖仙王=Binh Tổ Tiên Vương
兵符=Binh phù
养吾剑灵=Dưỡng Ngô Kiếm Linh
养吾灵剑=Dưỡng Ngô Linh Kiếm
兽之剑意=Thú chi kiếm ý
兽皮古卷=Thú bì cổ quyển
兽道=Thú đạo
兽道时代=Thú Đạo Thời Đại
兽骨=thú cốt
内子=Nội Tử
册封神印=Sách phong Thần ấn
冒牌=Giả mạo
军师=quân sư
军师潜龙=Quân sư Tiềm Long
军荼利明王=Quân Trà Lợi Minh Vương
军荼利明王真身=Quân Trà Lợi Minh Vương Chân Thân
冥土=Minh Thổ
冥土世界=Minh Thổ Thế Giới
冥土十八重世界=Minh Thổ Thập Bát Trọng Thế Giới
冥土大帝=Minh Thổ Đại Đế
冥土神帝=Minh Thổ Thần Đế
冥土神朝=Minh Thổ Thần Triều
冥土镇碑=Minh Thổ Trấn Bi
冥域=Minh Vực
冥度师兄=Minh Độ sư huynh
冥河=Minh Hà
冥海=Minh Hải
冥海万狱印=Minh Hải Vạn Ngục Ấn
冥海万界=Minh Hải Vạn Giới
冥海地狱=Minh Hải Địa Ngục
冥海御天镜=Minh Hải Ngự Thiên Kính
冥海水师=Minh Hải Thủy Sư
冥海玉瓶=Minh Hải Ngọc Bình
冥王城=Minh Vương Thành
冥界=Minh Giới
冥界神族=Minh Giới Thần Tộc
冥皇=Minh Hoàng
冥皇红莲=Minh Hoàng Hồng Liên
冥皇魔帝=Minh Hoàng Ma Đế
冬=Đông
冰峰世界=Băng Phong Thế Giới
冰河霜漠心经=Băng Hà Sương Mạc Tâm Kinh
冰涟=Băng Liên
冰涟元君=Băng Liên Nguyên Quân
冰涟女帝=Băng Liên Nữ Đế
冰涟魔君=Băng Liên Ma Quân
冰涟魔皇=Băng Liên Ma Hoàng
冰莲=Băng Liên
冰莲圣母=Băng Liên Thánh mẫu
冰魄=Băng Phách
冰魄世界=Băng Phách Thế Giới
冰魄仙山=Băng Phách Tiên Sơn
冰魄玄女=Băng Phách Huyền Nữ
冰魄花=Băng Phách Hoa
冲霄剑楼=Xung Tiêu Kiếm Lâu
凉亭=lương đình
凌波=Lăng Ba
凌波仙王=Lăng Ba Tiên Vương
凌霄=Lăng Tiêu
凌霄宝殿=Lăng Tiêu Bảo Điện
凌霄殿=Lăng Tiêu Điện
凌霄门=Lăng Tiêu Môn
几十尊天神=vài chục vị thiên thần
凡人=Phàm nhân
凡尘=Phàm Trần
凤=Phượng
凤仪=Phượng Nghi
凤仪仙王=Phượng Nghi Tiên Vương
凤仪天君=Phượng Nghi Thiên quân
凤儿=Phượng Nhi
凤凰=Phượng Hoàng
凤凰石=Phượng Hoàng Thạch
凤凰茧=Phượng Hoàng Kiển
凤凰金身=Phượng Hoàng Kim Thân
凤古文明=Văn minh Phượng Cổ
凤巢=Tổ phượng
凤引弓=Phượng dẫn cung
凤皇=Phượng Hoàng
凤簪=Phượng trâm
凤羽剑=Phượng Vũ Kiếm
凤驾=Phượng Giá
凤鸣轩=Phượng Minh Hiên
凤鸾天岭=Phượng Loan Thiên Lĩnh
凨州=Phong Châu
出云城=Xuất Vân Thành
出云城的天神=Thiên thần Xuất Vân Thành
出云神尊=Xuất Vân Thần Tôn
刀斧天神=Đao Phủ Thiên Thần
刀枪斧钺=Đao Thương Phủ Việt
分散送走=phân tán đưa đi
分身=Phân Thân
分魂=Phân Hồn
列山族=Liệt Sơn Tộc
初代殿主=Sơ đại điện chủ
初元时代=Thời đại Sơ Nguyên
判官笔=Phán Quan Bút
刨祖师坟=đào mộ tổ sư
刹那海=Sát Na Hải
前世真神=Tiền Thế Chân Thần
前世真身=Tiền thế chân thân
前世身=Tiền Thế Thân
前妻=Tiền thê
前生花=Tiền Sinh Hoa
前辈=Tiền bối
剑丸=kiếm hoàn
剑主=Kiếm Chủ
剑之子=Kiếm Chi Tử
剑之星=Kiếm Chi Tinh
剑侠亡魂=Kiếm Hiệp Vong Hồn
剑侯=Kiếm Hầu
剑古=Kiếm Cổ
剑圣=Kiếm Thánh
剑意=Kiếm ý
剑意怪物=Kiếm Ý Quái Vật
剑文豪=Kiếm Văn Hào
剑王=Kiếm Vương
剑皇=Kiếm Hoàng
剑纹=Kiếm văn
剑门=Kiếm Môn
剑门诛神阵=Kiếm Môn Tru Thần Trận
剑鞘=Kiếm sao
剧毒蛟龙=Kình Long kịch độc
剧毒蟾蜍=Kịch Độc Thiềm Thừ
副将=Phó Tướng
副帅=Phó Soái
功德=Công Đức
动之剑意=Động Chi Kiếm Ý
劫=Kiếp
劫光=Kiếp quang
劫威=Kiếp Uy
劫数=Kiếp số
劫波=Kiếp ba
劫躯=Kiếp Khu
劫运=kiếp vận
劫运元年=Kiếp Vận Nguyên Niên
劫运苍茫，谁主沉浮=Kiếp Vận Thương Mang, ai chủ trầm phù
劫雨=Kiếp vũ
勾陈=Câu Trần
勾陈仙君=Câu Trần Tiên Quân
勾陈仙宫=Cung Câu Trần
勾陈仙王=Câu Trần Tiên Vương
勾陈古仙=Cú Trần Cổ Tiên
勾陈后土=Câu Trần Hậu Thổ
勾陈大帝=Cú Trần Đại Đế
勾陈大老爷=Câu Trần Đại Lão gia
勾陈天=Cấu Trần Thiên
勾陈天宫=Câu Trần Thiên Cung
勾陈天神都=Câu Trần Thiên Thần Đô
勾陈妖帝=Câu Trần Yêu Đế
勾陈宫=Câu Trần Cung
化仙=Hóa Tiên
化仙印=Hóa Tiên Ấn
化仙玉瓶=Hóa Tiên Ngọc Bình
化仙瓶=Hóa Tiên Bình
化仙神光=Hóa Tiên Thần Quang
化仙飞虹=Hóa Tiên Phi Hồng
化尸神光=Hóa Thi Thần Quang
化神毒霞=Hóa Thần Độc Hà
化神池=Hóa Thần Trì
化身=Hóa Thân
化魔谷=Hóa Ma Cốc
北京=Bắc Kinh
北元君=Bắc Nguyên Quân
北斗=Bắc Đẩu
北斗星部=Bắc Đẩu Tinh Bộ
北方仙海十九州=Bắc Phương Tiên Hải Thập Cửu Châu
北方玄关=Bắc Phương Huyền Quan
北极冰原=Bắc Cực Băng Nguyên
北极冰洋=Bắc Cực Băng Dương
北河=Bắc Hà
北河水师=Bắc Hà Thủy Sư
北漠=Bắc Mạc
北漠媞家=Bắc Mạc Đề Gia
北落师门=Bắc Lạc Sư Môn
北都泉=Bắc Đô Tuyền
北都道友=Bắc Đô đạo hữu
北阳山=Bắc Dương Sơn
十七位少年高手=Mười bảy vị thiếu niên cao thủ
十七机缘=Mười bảy cơ duyên
十万魔山=Thập Vạn Ma Sơn
十三人=Thập Tam Nhân
十三人之战=Thập Tam Nhân Chi Chiến
十三修=Thập Tam Tu
十三尊神帝魔帝分身=Thập Tam Tôn Thần Đế Ma Đế phân thân
十三真人=Thập Tam Chân Nhân
十二位=mười hai vị
十二元辰=Thập Nhị Nguyên Thần
十二品莲台=Liên đài mười hai phẩm
十二天罗大阵=Thập Nhị Thiên La Đại Trận
十二宫仙王=Thập Nhị Cung Tiên Vương
十二宫仙王大阵=Đại trận Thập Nhị Cung Tiên Vương
十二宫仙王阵=Thập Nhị Cung Tiên Vương Trận
十二尊化身=Thập Nhị Tôn Hóa Thân
十二尊地狱魔皇=Mười Hai Tôn Địa Ngục Ma Hoàng
十二尊者=Thập Nhị Tôn Giả
十二座大陆=mười hai đại lục
十二旗主=Thập Nhị Kỳ Chủ
十二根华表=Thập Nhị Căn Hoa Biểu
十二真仙=Thập Nhị Chân Tiên
十二神殿=Thập nhị Thần Điện
十二魔皇=Thập Nhị Ma Hoàng
十位天宫强者=Thập vị Thiên Cung cường giả
十全之道=Thập Toàn Chi Đạo
十全大道=Thập Toàn Đại Đạo
十八尊化身=Mười tám Tôn Hóa Thân
十八层地狱=Mười Tám Tầng Địa Ngục
十八罗汉=Thập Bát La Hán
十八诸天=Thập Bát Chư Thiên
十八重神禁=Thập Bát Trọng Thần Cấm
十六尊真仙=Thập Lục Tôn Chân Tiên
十六转世道君=Thập Lục Chuyển Thế Đạo Quân
十几个世界=Mười mấy thế giới
十四亿年=mười bốn ức năm
十四关=Mười Bốn ải
十圣=Thập Thánh
十大仙道=Thập Đại Tiên Đạo
十大仙道法宝=Thập Đại Tiên Đạo Pháp Bảo
十大仙道至宝=Thập Đại Tiên Đạo Chí Bảo
十大佛皇=Thập Đại Phật Hoàng
十大天君道果=Thập Đại Thiên Quân Đạo Quả
十大天道至宝=Thập Đại Thiên Đạo Chí Bảo
十派八天七世家=Thập Phái Bát Thiên Thất Thế Gia
十派八天七世家五都四城=Thập Phái Bát Thiên Thất Thế Gia Ngũ Đô Tứ Thành
十龙合一大法=Thập Long Hợp Nhất Đại Pháp
千劫佛眼=Thiên Kiếp Phật Nhãn
千山迭翠神禁=Thiên Sơn Điệp Thúy Thần Cấm
千棺大阵=Thiên Quan Đại Trận
千相劫躯=Thiên Tướng Kiếp Khu
千翼仙凰=Thiên Dực Tiên Hoàng
千翼神舟=Thiên Dực Thần Chu
千翼魔神=Thiên Dực Ma Thần
千翼魔神大神通=Thiên Dực Ma Thần Đại Thần Thông
千里营=Thiên Lý Doanh
千首魔神=Thiên Thủ Ma Thần
半仙=Bán Tiên
半园=Bán Viên
半园道人=Bán Viên Đạo Nhân
半月斧=Bán Nguyệt Phủ
半步仙王=Bán Bộ Tiên Vương
半道劫光=bán đạo kiếp quang
华=Hoa
华严圣宗=Hoa Nghiêm Thánh Tông
华仪=Hoa Nghi
华倩云=Hoa Thiến Vân
华天仙人=Hoa Thiên Tiên Nhân
华山=Hoa Sơn
华山居=Hoa Sơn Cư
华师侄=Hoa sư điệt
华师兄=Hoa sư huynh
华教主=Hoa giáo chủ
华盖=Hoa Cái
华胥神族=Hoa Từ Thần Tộc
华诞=Hoa Đán
卓伯=Trác bá
单云山=Đơn Vân Sơn
单云山神主=Đan Vân Sơn Thần Chủ
南京=Nam Kinh
南关=Nam Quan
南天门=Nam Thiên Môn
南宫离=Nam Cung Ly
南宫至尊=Nam Cung Chí Tôn
南斗=Nam Đấu
南斗兵部=Nam Đấu Binh Bộ
南斗兵部琅琊水师=Nam Đấu Binh Bộ Lang Gia Thủy Sư
南斗星部=Nam Đấu Tinh Bộ
南旜=Nam Tẫn
南旜九州=Nam Chiêm Cửu Châu
南旜仙州=Nam Chấn tiên châu
南旜仙王=Nam Thân Tiên Vương
南无神陀=Nam Mô Thần Đà
南明=Nam Minh
南明兵部=Nam Minh Binh Bộ
南明兵部火德圣师=Nam Minh Binh Bộ Hỏa Đức Thánh Sư
南明太=Nam Minh Thái
南明太子=Nam Minh Thái Tử
南明离火剑=Nam Minh Ly Hỏa kiếm
南极仙翁=Nam Cực Tiên Ông
南河=Nam Hà
南海=Nam Hải
南海商盟=Nam Hải Thương Minh
南海祖师=Nam Hải Tổ Sư
南竹神翁=Nam Trúc Thần Ông
南荒祖=Nam Hoang Tổ
南部荒城=Nam Bộ Hoang Thành
南郭=Nam Quách
南郭仙翁=Nam Quách Tiên Ông
南郭铭=Nam Quách Minh
博山道人=Bác Sơn đạo nhân
卢云天=Lư Vân Thiên
卢峰法尊=Lư Phong Pháp Tôn
卧龙星域=Ngọa Long Tinh Vực
卿王阁=Khanh Vương Các
厉阳=Lệ Dương
厌魔枪=Yếm Ma Thương
原始祖龙=Nguyên Thủy Tổ Long
双剑=Song Kiếm
双旗=Song Kỳ
双生神魂=Song Sinh Thần Hồn
双锏=Song Giản
反调盟主=Phản Điệu Minh Chủ
古仙=Cổ Tiên
古仙心脏=Cổ Tiên Tâm Tạng
古仙浩劫=Cổ Tiên Hạo Kiếp
古仙界=Cổ Tiên Giới
古仙蒲团=Cổ Tiên Bồ Đoàn
古伽魔尊=Cổ Gia Ma Tôn
古佛=Cổ Phật
古怪的神液=Thần Dịch kỳ quái
古桦=Cổ Hoa
古桦道人=Cổ Hoa Đạo Nhân
古神=Cổ Thần
古神一族=Cổ Thần nhất tộc
古神大军=Cổ Thần Đại Quân
古神大道=Cổ Thần Đại Đạo
古神时代=Thời đại Cổ Thần
古神阁=Cổ Thần Các
古神阁主=Cổ Thần Các Chủ
古籍=cổ tịch
古老存在=Cổ lão tồn tại
古老的家族=Cổ lão gia tộc
古老神尊=Cổ Lão Thần Tôn
古轩=Cổ Hiên
古轩道人=Cổ Hiên đạo nhân
古道热肠=cổ đạo nhiệt tràng
史前=Sử Tiền
史前二十二场寂灭劫=22 kiếp diệt vong thời tiền sử
史前力量=Lực lượng Tiền Sử
史前十七个时代=Mười bảy thời đại tiền sử
史前古老存在=Tồn tại cổ xưa tiền sử
史前圣药=Thánh dược tiền sử
史前大道=Đại Đạo thời tiền sử
史前天君=Thiên Quân Tiền Sử
史前妖族=Thủy Tiên Yêu Tộc
史前存在=tồn tại thời tiền sử
史前巨灵大道=Đại đạo Cự Linh thời tiền sử
史前巨灵武道图=Thạch Tiền Cự Linh Võ Đạo Đồ
史前巨灵神族=Sử Tiền Cự Linh Thần Tộc
史前强者=Sử Tiền Cường Giả
史前怪蛤=Quái Cáp Tiền Sử
史前时代=Thời đại Tiền Sử
史前神道=Thần đạo Tiền Sử
史前神道时代=Thời đại Thần Đạo Tiền Sử
史前道君=Đạo Quân thời tiền sử
史前魔怪=Ma quái thời tiền sử
史前黑尸=Sử Tiền Hắc Thi
右上卫=Hữu Thượng Vệ
右天侯=Hữu Thiên Hầu
右少卫=Hữu Thiếu Vệ
右旗=Hữu Kỳ
叶书秋=Diệp Thư Thu
叶圆=Diệp Viên
叶寒风=Diệp Hàn Phong
叶麟=Diệp Lân
叶麟仙帝=Diệp Lân Tiên Đế
司南=Ti Nam
司寇=Tư Khấu
司寇仙君=Tư Khấu Tiên Quân
司怪=Ty Quái
司盘=Ti Tư Bàn
司马世家=Tư Mã Thế Gia
司马圣帝=Tư Mã Thánh Đế
司马家=Tư Mã Gia
司马端明=Tư Mã Đoan Minh
吃里扒外=ăn cây táo rào cây sung
各位道兄=Chư vị đạo huynh
各大教门=các giáo môn lớn
合道期=Hợp Đạo kỳ
吊车尾=Kẻ đội sổ
同生冰魄花=Đồng Sinh Băng Phách Hoa
后土=Hậu Thổ
后土仙君=Hậu Thổ Tiên Quân
后土仙宫=Hậu Thổ tiên cung
后土仙宫太子=Hậu Thổ Tiên Cung Thái Tử
后土仙王=Hậu Thổ Tiên Vương
后土古仙=Hậu Thổ Cổ Tiên
后土圣帝=Hậu Thổ Thánh Đế
后土大帝=Hậu Thổ Đại Đế
后土大老爷=Hậu Thổ Đại Lão gia
后土天=Hậu Thổ Thiên
后土天宫=Hậu Thổ Thiên Cung
后土天狱法天王=Hậu Thổ Thiên Ngục Pháp Thiên Vương
后土娘娘=Hậu Thổ Nương Nương
后土宫=Hậu Thổ Cung
后土舫=Hậu Thổ Phảng
后土舫魔帝=Hậu Thổ Phỏng Ma Đế
后土道友=Hậu Thổ đạo hữu
后土魔仙=Hậu Thổ Ma Tiên
后天生灵=Hậu thiên sinh linh
后宫佳丽=Hậu cung giai lệ
君临天下=Quân Lâm Thiên Hạ
君天=Quân Thiên
君天大帝=Quân Thiên Đại Đế
君天大殿=Quân Thiên Đại Điện
君天神帝=Quân Thiên Thần Đế
君天纪劫=Quân Thiên Kỷ Kiếp
君天道人=Quân Thiên đạo nhân
君山=Quân Sơn
君山神主=Quân Sơn Thần Chủ
君崖城=Quân Nhai Thành
君崖老祖=Quân Nhai Lão Tổ
君思邪=Quân Tư Tà
君房道母=Quân Phòng Đạo Mẫu
君无道=Quân Vô Đạo
君梦忧=Quân Mộng Ưu
君臣=quân thần
君芳道母=Quân Phương Đạo Mẫu
君阳=Quân Dương
君阳仙王=Quân Dương Tiên Vương
吞噬之龙=Thôn Phệ Chi Long
吞土之龙=Thôn Thổ Chi Long
吞天巨兽=Thôn Thiên Cự Thú
吞天神龙罩=Thôn Thiên Thần Long Tráo
吞木之龙=Thôn Mộc Chi Long
吞水之龙=Thôn Thủy Chi Long
吞火之龙=Thôn Hỏa Chi Long
吞金之龙=Thôn Kim Chi Long
吠陀大教=Phệ Đà Đại Giáo
吧友=Ba Hữu
听月仙王=Thính Nguyệt Tiên Vương
启光=Khải Quang
启光神帝=Khải Quang Thần Đế
吻颙神主=Vẫn Ngung Thần Chủ
吾身即塔=Ngô Thân Tức Tháp
周一=Thứ Hai
周天星力=Chu Thiên Tinh Lực
周天星斗=Chu Thiên Tinh Đấu
周天星斗大军=Chu Thiên Tinh Đấu Đại Quân
周天鼎=Chu Thiên Đỉnh
周怒池=Chu Nộ Trì
周清玄=Chu Thanh Huyền
咒=Chú
咒剑斩天罡=Chú Kiếm Trảm Thiên Cương
咒解=Chú Giải
咒道=Chú Đạo
咒道天坛=Chú Đạo Thiên Đàn
咒道寂灭劫=Chú Đạo Tịch Diệt Kiếp
咒道寂灭劫波=Chú Đạo Tịch Diệt Kiếp Ba
咒道时代=Chú Đạo thời đại
咒道神通=Chú Đạo Thần Thông
咒道血河=Chú Đạo Huyết Hà
咒道铜镜=Chú Đạo Đồng Kính
咒门=Chú Môn
哈兰家=Hà Lan gia
哈兰生=Cáp Lan Sinh
哲儿=Triết Nhi
哲儿钧儿=Triết Nhi Quân Nhi
唯吾不空=Duy Ngô Bất Không
唯我不空=Duy Ngã Bất Không
唯我不空印=Duy Ngã Bất Không Ấn
商洛=Thương Lạc
商洛道人=Thương Lạc Đạo Nhân
商道=Thương Đạo
商道友=Thương đạo hữu
商道尊者=Thương Đạo Tôn Giả
啸邙=Khiếu Mang
啸邙天=Khiếu Mang Thiên
啸邙天元会大尊=Khiếu Mang Thiên Nguyên Hội Đại Tôn
善之剑意=Thiện Chi Kiếm Ý
善哉=Thiện tai
嘲风=Trào Phong
噬血枪=Thệ Huyết thương
囚牛=Tù Ngưu
四不像=Tứ Bất Tượng
四口鼎=Tứ Khẩu Đỉnh
四哥=Tứ ca
四圣王=Tứ Thánh Vương
四大仙王=Tứ Đại Tiên Vương
四大化身=Tứ đại hóa thân
四大圣王=Tứ Đại Thánh Vương
四大天君=Tứ Đại Thiên Quân
四大天尊=Tứ Đại Thiên Tôn
四大皆空=Tứ Đại Giai Không
四大神主=Tứ Đại Thần Chủ
四大绝色=Tứ Đại Tuyệt Sắc
四大身外化身=Tứ Đại Thân Ngoại Hóa Thân
四大转世道君=Tứ Đại Chuyển Thế Đạo Quân
四大道祖=Tứ Đại Đạo Tổ
四天=Tứ Thiên
四天王=Tứ Thiên Vương
四娘=Tứ Nương
四尊魔皇=Bốn Tôn Ma Hoàng
四极四象=Tứ Cực Tứ Tượng
四极四象通天柱=Tứ Cực Tứ Tượng Thông Thiên Trụ
四根撑天巨柱=Tứ Căn Xứng Thiên Cự Trụ
四渎=Tứ Độc
四皇子苏晃=Tứ hoàng tử Tô Hoảng
四绝杀=Tứ Tuyệt Sát
四象=Tứ Tượng
四象之力=Tứ Tượng Chi Lực
四象五行=Tứ Tượng Ngũ Hành
四象劫阵=Tứ Tượng Kiếp Trận
四象山=Tứ Tượng Sơn
四象战部=Tứ Tượng Chiến Bộ
四象通天=Tứ Tượng Thông Thiên
四象通天大神通=Tứ Tượng Thông Thiên Đại Thần Thông
四象通天大阵=Tứ Tượng Thông Thiên Đại Trận
四象通天柱=Tứ Tượng Thông Thiên Trụ
四象阵=Tứ Tượng Trận
四辅座旗=Tứ Phụ Tọa Kỳ
四首牛龙=Tứ Thủ Ngưu Long
因晖玄育天=Nhân Huy Huyền Dục Thiên
因晖玄育天乾元仙帝=Nhân Huy Huyền Dục Thiên Càn Nguyên Tiên Đế
因果=Nhân Quả
因果先天=Nhân Quả Tiên Thiên
因果大道=Nhân Quả Đại Đạo
因果报应=nhân quả báo ứng
因果玄胎先天=Nhân Quả Huyền Thai Tiên Thiên
因果环=Nhân Quả Hoàn
因陀=Nhân Đà
因陀神主=Nhân Đà Thần Chủ
困龙关=Khốn Long Quan
圆空=Viên Không
圆空仙君=Viên Không Tiên Quân
圜太=Viên Thái
圜太老人=Hoàn Thái Lão Nhân
圜太老祖=Hoàn Thái lão tổ
圜太老者=Hoàn Thái lão giả
圜太道君=Hoàn Thái đạo quân
土=Thổ
土匪=thổ phỉ
土著=thổ trước
土豪格百万=Thổ Hào Cách Bách Vạn
土鳖江=Giang thổ bỉ
圣佛=Thánh Phật
圣佛无意中=Thánh Phật vô ý
圣光佛陀=Thánh Quang Phật Đà
圣化革凡=Thánh hóa cách phàm
圣后=Thánh Hậu
圣君=Thánh Quân
圣君古尸=Thi hài Thánh quân
圣君尸神=Thánh Quân Thi Thần
圣君洞府=Thánh Quân Động Phủ
圣君神树=Thánh Quân Thần Thụ
圣君神禁大典=Thánh Quân Thần Cấm Đại Điển
圣地=Thánh địa
圣城=Thánh Thành
圣天=Thánh Thiên
圣天城=Thánh Thiên Thành
圣天大尊=Thánh Thiên Đại Tôn
圣天子哲=Thánh Thiên Tử Triết
圣天子钧=Thánh Thiên Tử Quân
圣天王母=Thánh Thiên Vương mẫu
圣天神朝=Thánh Thiên Thần Triều
圣女=Thánh Nữ
圣宗=Thánh Tông
圣宗分舵=Phân đà Thánh Tông
圣山=Thánh Sơn
圣帝摩天印=Thánh Đế Ma Thiên Ấn
圣母元君=Thánh Mẫu Nguyên Quân
圣母媞轩薇=Thánh Mẫu Đề Hiên Vy
圣治神尊=Thánh Trị Thần Tôn
圣火佛陀=Thánh Hỏa Phật Đà
圣火教=Thánh Hỏa Giáo
圣火教主=Thánh Hỏa Giáo Chủ
圣灵=Thánh Linh
圣灵丹=Thánh Linh Đan
圣王=Thánh Vương
圣皇=Thánh Hoàng
圣皇神帝=Thánh Hoàng Thần Đế
圣药=Thánh dược
圣药宝树=Thánh Dược Bảo Thụ
圣道=Thánh Đạo
圣道时代=Thời đại Thánh Đạo
圣魔=Thánh Ma
圣魔大老爷=Thánh Ma Đại Lão Gia
圣魔天尊=Thánh Ma Thiên Tôn
圣魔教主=Thánh Ma giáo chủ
圣魔道兄=Thánh Ma đạo huynh
圣魔道君=Thánh Ma Đạo Quân
地之剑意=Địa Chi Kiếm Ý
地仙道=Địa Tiên Đạo
地奴=Địa Nô
地宫=Địa Cung
地支=Địa Chi
地极元磁神通=Địa Cực Nguyên Từ Thần Thông
地水风火=Địa Thủy Phong Hỏa
地煞七十二部=Địa Sát Thất Thập Nhị Bộ
地煞星斗天宫=Địa Sát Tinh Đấu Thiên Cung
地煞星部=Địa Sát Tinh Bộ
地狱=Địa Ngục
地狱万界=Địa Ngục Vạn Giới
地狱三大魔皇=Địa Ngục Tam Đại Ma Hoàng
地狱冥海=Địa Ngục Minh Hải
地狱右路先锋=Địa Ngục Hữu Lộ Tiên Phong
地狱大军=Đại Quân Địa Ngục
地狱大衍皇道=Địa Ngục Đại Diễn Hoàng Đạo
地狱天道=Địa Ngục Thiên Đạo
地狱天顶=Địa Ngục Thiên Đỉnh
地狱妖族=Địa Ngục Yêu Tộc
地狱帝使=Địa Ngục Đế Sứ
地狱帝使天玑=Địa Ngục Đế Sử Thiên Cơ
地狱真神=Địa ngục Chân Thần
地狱神主=Địa Ngục Thần Chủ
地狱神君=Địa Ngục Thần Quân
地狱神界=Địa Ngục Thần Giới
地狱神魔=Địa Ngục Thần Ma
地狱种族=Địa ngục chủng tộc
地狱第一杀伐之宝=Đệ Nhất Sát Phạt Chi Bảo Địa Ngục
地狱诸皇=Địa Ngục Chư Hoàng
地狱道人=Địa Ngục Đạo Nhân
地狱阿鼻魔朝=Địa Ngục A Tỳ Ma Triều
地狱魔仙=Địa Ngục Ma Tiên
地狱魔关=Địa Ngục Ma Quan
地狱魔军=Địa Ngục Ma Quân
地狱魔君=Địa Ngục Ma Quân
地狱魔尊=Địa Ngục Ma Tôn
地狱魔帝=Địa Ngục Ma Đế
地狱魔族=Địa Ngục Ma tộc
地狱魔火=Địa Ngục Ma Hỏa
地狱魔皇=Địa Ngục Ma Hoàng
地狱魔神=Địa Ngục Ma Thần
地狱魔神锁链=Địa ngục ma thần tỏa liên
地狱魔舰=Địa Ngục Ma Hạm
地理仪=Địa Lý Nghi
地皇=Địa Hoàng
地皇帝陵=Địa Hoàng Đế Lăng
地皇樽=Địa Hoàng Tôn
地皇樽仙酿=Địa Hoàng Tôn Tiên Lộ
地皇神帝=Địa Hoàng Thần Đế
地磁元力=Địa Từ Nguyên Lực
地磁元斧=Địa Từ Nguyên Phủ
地磁元珠=Địa Từ Nguyên Châu
地龙=Địa Long
坐佛=Tọa Phật
坐骑=tọa kỵ
垂暮灵剑=Thùy Mộ Linh Kiếm
垒壁=Lũy Bích
垒壁道甲=Lũy Bích Đạo Giáp
垒壁阵=Lũy Bích Trận
垒壁阵大军=Lũy Bích Trận Đại Quân
垒生=Lũy Sinh
垒生老祖=Lũy Sinh Lão Tổ
垕尊=Hậu Tôn
垕尊大教=Hậu Tôn Đại Giáo
垕尊天尊=Hậu Tôn Thiên Tôn
垕尊道君=Hậu Tôn Đạo Quân
垣皇=Viên Hoàng
城门失火殃及池鱼=thành môn thất hỏa ương cập trì ngư
域外=Vực Ngoại
域外神魔=Vực ngoại Thần Ma
堕神岭=Đọa Thần Lĩnh
堡主=Bảo chủ
塔儿=Tháp Nhi
墨犴=Mặc Hãn
壮士=Tráng sĩ
壶天=Hồ Thiên
壶天圣山=Hồ Thiên Thánh Sơn
壶天圣祖=Hồ Thiên Thánh Tổ
壶天大世界=Hồ Thiên Đại Thế Giới
壶天小奶娃=Hồ Thiên tiểu nãi oa
壶天小娃娃=Tiểu oa oa Hồ Thiên
壶天帝师=Hồ Thiên Đế Sư
壶天神帝=Hồ Thiên Thần Đế
壶天老师=Hồ Thiên lão sư
壶天老祖=Hồ Thiên Lão Tổ
壶天道人=Hồ Thiên Đạo Nhân
壶天道兄=Hồ Thiên đạo huynh
夏侯伤=Hạ Hầu Thương
夏侯忧=Hạ Hầu Ưu
夏侯至尊=Hạ Hầu Chí Tôn
夔氏=Quỳ Thị
夔牛=Kỳ Ngưu
夔牛神鼓=Quỳ Ngưu Thần Cổ
夔牛鼓=Kỳ Ngưu Cổ
夔王神=Quỳ Vương Thần
外域=Ngoại Vực
外门门生=ngoại môn môn sinh
多叶佛陀=Đa Diệp Phật Đà
多心莲=Đa Tâm Liên
多情环=Đa Tình Hoàn
多旬佛祖=Đa Tuần Phật Tổ
多闻=Đa Văn
多闻圣人=Đa Văn Thánh Nhân
夜壶=Bình đi tiểu
夜放=Dạ Phóng
夜魔皇=Dạ Ma Hoàng
大丞相=Đại Thừa Tướng
大个子=Đại cá nhân
大乘佛门=Đại Thừa Phật Môn
大五行剑气=Đại Ngũ Hành Kiếm Khí
大五行灭绝=Đại Ngũ Hành Diệt Tuyệt
大五行灭绝剑=Đại Ngũ Hành Diệt Tuyệt Kiếm
大五行灭绝剑阵=Đại Ngũ Hành Diệt Tuyệt Kiếm Trận
大五行灭绝大神通=Đại Ngũ Hành Diệt Tuyệt Đại Thần Thông
大五行破灭=Đại Ngũ Hành Phá Diệt
大人物=Đại nhân vật
大佛=Đại Phật
大军=Đại quân
大千世界=Đại thiên thế giới
大千时空=Đại Thiên Thời Không
大千罗天仪=Đại Thiên La Thiên Nghi
大周天星部=Đại Chu Thiên Tinh Bộ
大周天阵势=Đại Chu Thiên Trận Thế
大哥=Đại ca
大圆智镜=Đại Viên Trí Kính
大圆满=Đại Viên Mãn
大圆满仙君=Đại Viên Mãn Tiên Quân
大圆满神君=Thần Quân viên mãn
大圆满魔君=Đại Viên Mãn Ma Quân
大圣印=Đại Thánh Ấn
大圣王=Đại Thánh Vương
大圩宝地=Đại Khư Bảo Địa
大天尊=Đại Thiên Tôn
大天魔=Đại Thiên Ma
大妖=Đại Yêu
大姐=Đại tỷ
大威德明王真身=Đại Uy Đức Minh Vương Chân Thân
大威德明王经=Đại Uy Đức Minh Vương Kinh
大宇宙=Đại vũ trụ
大宗师=Đại Tông Sư
大寂寞=Đại Tịch Mịch
大寂灭=Đại Tịch Diệt
大尊=Đại Tôn
大师兄=Đại sư huynh
大帝=Đại Đế
大帝神通=Đại Đế Thần Thông
大旗=đại kỳ
大曰佛祖=Đại Nhật Phật Tổ
大曰如来佛母=Đại Viết Như Lai Phật Mẫu
大泽=Đại Trạch
大海鳅=Đại Hải Cừu
大渊灵王=Đại Uyên Linh Vương
大爷=Đại gia
大痴=Đại si
大痴道君=Đại Si Đạo Quân
大白幡=Đại Bạch Phiên
大盾=Đại thuẫn
大祭=Đại tế
大祭酒=Đại tế tửu
大罗天=Đại La Thiên
大罗天军=Đại La Thiên quân
大罗天印=Đại La Thiên Ấn
大罗天大军=Đại quân Đại La Thiên
大罗天玄天金阙=Đại La Thiên Huyền Thiên Kim Khuyết
大罗宝剑=Đại La Bảo Kiếm
大罗金仙=Đại La Kim Tiên
大老爷=Đại Lão Gia
大自在天=Đại Tự Tại Thiên
大自在无相劫阵=Đại Tự Tại Vô Tướng Kiếp Trận
大荒=Đại Hoang
大荒凉=Đại Hoang Lương
大菩萨地藏真解=Đại Bồ Tát Địa Tạng Chân Giải
大蛇佘老怪=Đại Xà Xa Lão Quái
大蛇蚺公=Đại Xà Đầm Công
大衍=Đại Diễn
大衍古神=Đại Diễn Cổ Thần
大衍天=Đại Diễn Thiên
大衍天君=Đại Diễn Thiên Quân
大衍皇道=Đại Diễn Hoàng Đạo
大衍神族=Đại Diễn Thần tộc
大衍道君=Đại Diễn Đạo Quân
大衍首领=Đại Diễn thủ lĩnh
大西天=Đại Tây Thiên
大西天佛帝=Đại Tây Thiên Phật Đế
大西天佛界=Đại Tây Thiên Phật Giới
大觉金仙=Đại Giác Kim Tiên
大赤天=Đại Xích Thiên
大赤天神主=Đại Xích Thiên Thần Chủ
大赤天魔尊=Đại Xích Thiên Ma Tôn
大辂宝辇=Đại Lộ bảo liễn
大道=Đại Đạo
大道境=Đại Đạo Cảnh
大道尽头=Đại Đạo Tận Đầu
大道源池=Đại Đạo Nguyên Trì
大道源液=Đại Đạo Nguyên Dịch
大道祖=Đại Đạo Tổ
大道道则=Đại Đạo Đạo Tắc
大金钹=kim bạt lớn
大钟=Đại Chung
大阵=Đại Trận
大风元界=Đại Phong Nguyên Giới
大魔王=Đại Ma Vương
大鸟=Đại điểu
大黑天=Đại Hắc Thiên
大黑锅=Đại Hắc Oa
大鼓=Đại Cổ
大龙=Đại Long
大龙阵图=Đại Long Trận Đồ
天=Thiên
天下大狱=Thiên Hạ Đại Ngục
天下贼=Thiên Hạ Tặc
天下道君=Thiên Hạ Đạo Quân
天丞=Thiên Thừa
天丞夫人=Thiên Thừa phu nhân
天之剑意=Thiên Chi Kiếm Ý
天书天神=Thiên Thư Thiên Thần
天人万象=Thiên Nhân Vạn Tượng
天人五衰=Thiên Nhân Ngũ Suy
天仙道=Thiên Tiên Đạo
天仙道果=Thiên Tiên Đạo Quả
天伞华盖=Thiên Tán Hoa Cái
天佛檀香=Thiên Phật Đàn Hương
天侯溯还白=Thiên Hầu Tố Hoàn Bạch
天元=Thiên Nguyên
天元大阵=Thiên Nguyên Đại Trận
天元天琉璃神君=Thiên Nguyên Thiên Lưu Ly Thần Quân
天元神祖=Thiên Nguyên Thần Tổ
天兵营=Thiên Binh Doanh
天凤妖后=Thiên Phượng Yêu Hậu
天凰魔皇=Thiên Hoàng Ma Hoàng
天刀=Thiên Đao
天刀夫人=Thiên Đao Phu Nhân
天刀神帝=Thiên Đao Thần Đế
天刀老祖=Thiên Đao Lão Tổ
天刀道人=Thiên Đao Đạo Nhân
天初=Thiên Sơ
天初道君=Thiên Sơ Đạo Quân
天劫=Thiên Kiếp
天后=Thiên Hậu
天后娘娘=Thiên Hậu Nương Nương
天后娘娘媞轩薇=Thiên Hậu Nương Nương Đề Hiên Vi
天君=Thiên quân
天君之宝=Thiên Quân Chi Bảo
天君之门=Thiên Quân Chi Môn
天君妖行经=Thiên Quân Yêu Hành Kinh
天君道君=Thiên Quân Đạo Quân
天地主=Thiên Địa Chủ
天地交徴=Thiên Địa Giao Trưng
天地交徵=Thiên Địa Giao Trưng
天地交徵大神通=Thiên Địa Giao Chinh Đại Thần Thông
天地交徵阵图=Thiên Địa Giao Trưng Trận Đồ
天地玄黄=Thiên Địa Huyền Hoàng
天堑=Thiên Hạp
天墓=Thiên Mộ
天外邪魔=Thiên Ngoại Tà Ma
天女=Thiên Nữ
天奴=Thiên Nô
天妃=Thiên Phi
天妃道尊=Thiên Phi Đạo Tôn
天妖圣女=Thiên Yêu Thánh Nữ
天妖宫=Thiên Yêu Cung
天子=Thiên Tử
天宇国=Thiên Vũ Quốc
天宝=Thiên Bảo
天宝圣人=Thiên Bảo Thánh Nhân
天宝尊王=Thiên Bảo Tôn Vương
天宫=Thiên Cung
天宫三重=Thiên Cung Tam Trọng
天宫之宝=Thiên Cung Chi Bảo
天宫八境=Thiên Cung Bát Cảnh
天寿王=Thiên Thọ Vương
天尊=Thiên Tôn
天尊大老爷=Thiên Tôn Đại Lão Gia
天州=Thiên Châu
天帝=Thiên Đế
天干=Thiên Can
天府=Thiên Phủ
天府之主=Thiên Phủ Chi Chủ
天府八叟=Thiên Phủ Bát Tẩu
天府十叟=Thiên Phủ Thập Tẩu
天府少主=Thiên Phủ Thiếu Chủ
天府重楼=Thiên Phủ Trọng Lâu
天庭=Thiên Đình
天庭山人=Thiên Đình Sơn Nhân
天心=Thiên Tâm
天悟石=Thiên Ngộ Thạch
天意=Thiên Ý
天意三剑=Thiên Ý Tam Kiếm
天意大世界=Thiên Ý Đại Thế Giới
天意斩三生=Thiên Ý Trảm Tam Sinh
天意老爷=Thiên Ý lão gia
天意老祖=Thiên Ý Lão Tổ
天意诛仙三剑=Thiên Ý Tru Tiên Tam Kiếm
天意诛仙剑=Thiên Ý Tru Tiên Kiếm
天意诛仙大阵=Thiên Ý Tru Tiên Đại Trận
天意道人=Thiên Ý Đạo Nhân
天才神体花镇元=Thiên tài Thần thể Hoa Trấn Nguyên
天方=Thiên Phương
天方神帝=Thiên Phương Thần Đế
天族=Thiên Tộc
天旗=Thiên Kỳ
天旬大魔主=Thiên Tuần Đại Ma Chủ
天旬魔主=Thiên Tuần Ma Chủ
天昊仙王=Thiên Hạo Tiên Vương
天月神主=Thiên Nguyệt Thần Chủ
天机=Thiên Cơ
天机太子=Thiên Cơ Thái Tử
天机秀士=Thiên Cơ Tú Sĩ
天机营=Thiên Cơ Doanh
天机道君=Thiên Cơ Đạo Quân
天机道藏=Thiên Cơ Đạo Tàng
天材地宝=Thiên tài địa bảo
天极魔帝=Thiên Cực Ma Đế
天枢=Thiên Xu
天柩法王=Thiên Cữu Pháp Vương
天柱=Thiên Trụ
天梯=Thiên Thê
天樽=Thiên Tôn
天歌=Thiên Ca
天母圣后=Thiên Mẫu Thánh Hậu
天氓尊者=Thiên Manh tôn giả
天河=Thiên Hà
天河古道=Thiên Hà Cổ Đạo
天河垒壁阵=Thiên Hà Lũy Bích Trận
天河水军=Thiên Hà Thủy Quân
天河水师=Thiên Hà Thủy Sư
天河神主=Thiên Hà Thần Chủ
天海=Thiên Hải
天涯=Thiên Nhai
天涯公子=Thiên Nhai công tử
天清=Thiên Thanh
天清圣境=Thiên Thanh Thánh Cảnh
天渊魔部=Thiên Uyên Ma Bộ
天火=Thiên Hỏa
天火神胎=Thiên Hỏa Thần Thai
天灵=Thiên Linh
天灵女君=Thiên Linh Nữ Quân
天灵道母=Thiên Linh Đạo Mẫu
天狱=Thiên Ngục
天狱之主=Thiên Ngục Chi Chủ
天狱大军=Thiên Ngục Đại Quân
天狱法天王=Thiên Ngục Pháp Thiên Vương
天狼骑部=Thiên Lang Kỵ Bộ
天王=Thiên Vương
天王城=Thiên Vương Thành
天王大陆=Thiên Vương Đại Lục
天王往生经=Thiên Vương Vãng Sinh Kinh
天王老子=Thiên Vương Lão Tử
天玑=Thiên Cơ
天玑魔帝狱主=Thiên Cơ Ma Đế Ngục Chủ
天球=Thiên Cầu
天界=Thiên Giới
天界封神榜=Thiên Giới Phong Thần Bảng
天界斗部=Thiên Giới Đấu Bộ
天皇=Thiên Hoàng
天皇仙帝=Thiên Hoàng Tiên Đế
天皇星斗=Thiên Hoàng Tinh Đấu
天眼=Thiên Nhãn
天眼仙宫=Thiên Nhãn Tiên Cung
天眼天君=Thiên Nhãn Thiên Quân
天眼神君=Thiên Nhãn Thần Quân
天眼神尊=Thiên Nhãn Thần Tôn
天眼神帝=Thiên Nhãn Thần Đế
天社=Thiên Xã
天神=Thiên Thần
天神之宝=Thiên Thần Chi Bảo
天神之眼=Thiên Thần Chi Nhãn
天秀=Thiên Tú
天秀圣女=Thiên Tú Thánh Nữ
天空之城=Thiên Không Chi Thành
天罗=Thiên La
天罗地=Thiên La Địa Võng
天罗地网=Thiên La Địa Võng
天罗神主=Thiên La Thần Chủ
天罡三十六部=Thiên Cương Tam Thập Lục Bộ
天罡八荒兵阵=Thiên Cương Bát Hoang Binh Trận
天罡星斗天宫=Thiên Cương Tinh Đấu Thiên Cung
天罡星部=Thiên Cương Tinh Bộ
天罡神兵=Thiên Cương Thần Binh
天羲=Thiên Hy
天羲圣人=Thiên Hy Thánh Nhân
天羲宫=Thiên Hy Cung
天羲老人=Thiên Hy lão nhân
天羲道人=Thiên Hi đạo nhân
天翁=Thiên Ông
天翁仙王=Thiên Ông Tiên Vương
天翻地覆=thiên phiên địa phúc
天船=Thiên Thuyền
天荒=Thiên Hoang
天荒大老爷=Thiên Hoang Đại Lão Gia
天荒教主=Thiên Hoang giáo chủ
天荒无邪=Thiên Hoang Vô Tà
天荒道兄=Thiên Hoang đạo huynh
天荒道友=Thiên Hoang đạo hữu
天荒道君=Thiên Hoang đạo quân
天药阁=Thiên Dược Các
天莲感应篇=Thiên Liên Cảm Ứng Thiên
天虹=Thiên Hồng
天虹仙子=Thiên Hồng Tiên Tử
天虹神主=Thiên Hồng Thần Chủ
天蚕结茧=Thiên Tằm Kết Kiển
天衢道君=Thiên Cù Đạo Quân
天谕道尊=Thiên Dụ Đạo Tôn
天谴=Thiên Khiển
天象=Thiên Tượng
天道=Thiên Đạo
天道不足畏=Thiên Đạo bất túc úy
天道之体=Thiên Đạo Chi Thể
天道之劫=Thiên Đạo Chi Kiếp
天道传人=Thiên Đạo truyền nhân
天道化身=Thiên Đạo hóa thân
天道大劫=Thiên Đạo Đại Kiếp
天道宝卷=Thiên Đạo Bảo Quyển
天道宝钟=Thiên Đạo Bảo Chung
天道时代=Thiên Đạo Thời Đại
天道碎片=Thiên Đạo mảnh vỡ
天道神人=Thiên Đạo Thần Nhân
天道神通=Thiên Đạo Thần Thông
天道至宝=Thiên Đạo Chí Bảo
天道造化大神通=Thiên Đạo Tạo Hóa Đại Thần Thông
天都=Thiên Đô
天都上尊=Thiên Đô Thượng Tôn
天都灵雪上尊=Thiên Đô Linh Tuyết Thượng Tôn
天都灵雪女仙帝=Thiên Đô Linh Tuyết Nữ Tiên Đế
天钩=Thiên Câu
天门=Thiên Môn
天门仙君=Thiên Môn Tiên Quân
天门大帝=Thiên Môn Đại Đế
天门大老爷=Thiên Môn Đại Lão Gia
天门妖帝=Thiên Môn Yêu Đế
天门师弟=Thiên Môn sư đệ
天门的江门主=Thiên Môn, Giang Môn Chủ
天门神府=Thiên Môn Thần Phủ
天门门主=Thiên Môn Môn Chủ
天阳子=Thiên Dương Tử
天阳道人=Thiên Dương đạo nhân
天阴圣水=Thiên Âm Thánh Thủy
天雷战鼓=Thiên Lôi Chiến Cổ
天颐殿=Thiên Di Điện
天风书院=Thiên Phong Thư Viện
天香圣果=Thiên Hương Thánh Quả
天香夫人=Thiên Hương phu nhân
天马司=Thiên Mã Tư
天驭=Thiên Ngự
天驭仙君=Thiên Ngự Tiên Quân
天驭道君=Thiên Ngự đạo quân
天魔=Thiên Ma
天魔堡=Thiên Ma Bảo
天魔堡主=Thiên Ma Bảo Chủ
天魔宗=Thiên Ma Tông
天魔宗主=Thiên Ma Tông Chủ
天魔教=Thiên Ma giáo
天魔王=Thiên Ma Vương
天魔琴=Thiên Ma Cầm
天魔真身=Thiên Ma Chân Thân
天魔葬神曲=Thiên Ma Táng Thần Khúc
天龙=Thiên Long
天龙丝=Thiên Long Ti
天龙八荒兵部=Thiên Long Bát Hoang Binh Bộ
天龙八音钟=Thiên Long Bát Âm Chung
天龙族=Thiên Long tộc
天龙脊骨=Thiên Long Tích Cốt
太一=Thái Nhất
太一仙君=Thái Nhất Tiên Quân
太一先天=Thái Nhất Tiên Thiên
太一先天道境=Thái Nhất Tiên Thiên Đạo Cảnh
太一境=Thái Nhất Cảnh
太一境三元天=Thái Nhất Cảnh Tam Nguyên Thiên
太一天君=Thái Nhất Thiên Quân
太一天圣法神主=Thái Nhất Thiên Thánh Pháp Thần Chủ
太一天皇仙帝=Thái Nhất Thiên Hoàng Tiên Đế
太一教主=Thái Nhất Giáo Chủ
太一神教=Thái Nhất Thần Giáo
太一道友=Thái Nhất đạo hữu
太一道君=Thái Nhất Đạo quân
太一道尊=Thái Nhất đạo tôn
太上时代=Thời đại Thái Thượng
太上皇=Thái Thượng Hoàng
太上长老=Thái Thượng Trưởng Lão
太乙=Thái Ất
太乙金仙=Thái Ất Kim Tiên
太元=Thái Nguyên
太元大帝=Thái Nguyên Đại Đế
太公=Thái công
太公府=Thái Công Phủ
太初=Thái Sơ
太初先天=Thái Sơ Tiên Thiên
太初大道=Thái Sơ Đại Đạo
太初天印=Thái Sơ Thiên Ấn
太初天尊=Thái Sơ Thiên Tôn
太史空=Thái Sử Không
太史至尊=Thái Sử Chí Tôn
太墟=Thái Khư
太墟境道会=Thái Khư Cảnh Đạo Hội
太墟天=Thái Khư Thiên
太墟证道图=Thái Khư Chứng Đạo Đồ
太奶奶=Bà nội
太始时代=Thời đại Thái Thủy
太子=Thái Tử
太子太师=Thái Tử Thái Sư
太子封地=Thái Tử Phong Địa
太子殿下=Thái Tử Điện Hạ
太子玄=Thái Tử Huyền
太子虚=Thái Tử Hư
太师=Thái Sư
太微=Thái Vi
太息**=Thái tức **
太极仙道=Thái Cực Tiên Đạo
太极先天=Thái Cực Tiên Thiên
太极印=Thái Cực Ấn
太极图=Thái Cực Đồ
太极大帝=Thái Cực Đại Đế
太极大帝化身=Thái Cực Đại Đế hóa thân
太极神帝=Thái Cực Thần Đế
太极神帝化身=Thái Cực Thần Đế hóa thân
太极神禁=Thái Cực Thần Cấm
太极神禁大典=Thái Cực Thần Cấm Đại Điển
太极道袍=Thái Cực Đạo Bào
太极阴阳图=Thái Cực Âm Dương Đồ
太玄=Thái Huyền
太玄圣宗=Thái Huyền Thánh Tông
太玄大阵=Thái Huyền Đại Trận
太玄心经=Thái Huyền Tâm Kinh
太皇=Thái Hoàng
太皇师兄=Thái Hoàng sư huynh
太皇老祖=Thái Hoàng Lão Tổ
太皇老贼=Lão tặc Thái Hoàng
太真=Thái Chân
太真仙君=Thái Chân Tiên Quân
太真大老爷=Thái Chân Đại Lão Gia
太真天君=Thái Chân Thiên Quân
太真道君=Thái Chân Đạo Quân
太真飞桥=Thái Chân Phi Kiều
太罗=Thái La
太罗道君=Thái La Đạo Quân
太罗道尊=Thái La Đạo Tôn
太育=Thái Dục
太虚苍穹无上真解=Thái Hư Thương Khung Vô Thượng Chân Giải
太阳=Thái Dương
太阳化身=Thái Dương hóa thân
太阳印=Thái Dương Ấn
太阳太阴=Thái Dương Thái Âm
太阳太阴六玄经=Thái Dương Thái Âm Lục Huyền Kinh
太阳战车=Thái Dương Chiến Xa
太阳曰珥=Nhật Nhĩ Thái Dương
太阳真火=Thái Dương Chân Hỏa
太阳真经=Thái Dương Chân Kinh
太阳神=Thái Dương Thần
太阳神化身=Thái Dương Thần Hóa Thân
太阳神殿=Thái Dương Thần Điện
太阳神金=Thái Dương Thần Kim
太阳神钟=Thái Dương Thần Chung
太阳边缘=bên rìa Thái Dương
太阳金帆=Thái Dương Kim Phàm
太阴=Thái Âm
太阴化身=Thái Âm hóa thân
太阴太阳=Thái Âm Thái Dương
太阴星=Thái Âm Tinh
太阴真经=Thái Âm Chân Kinh
太阴神=Thái Âm Thần
夫人= phu nhân
央八州=Ngân Bát châu
头顶庆云=Đỉnh Đầu Khánh Vân
夺仙符=Đoạt Tiên Phù
夺渡=Đoạt Độ
奈何=Nại Hà
奈何桥=Nại Hà Kiều
奈河=Nại Hà
奈河桥=Nại Hà Kiều
奉夏=Phụng Hạ
奉夏大帝=Phụng Hạ Đại Đế
奉天承运=Phụng Thiên Thừa Vận
女丑=Nữ Sửu
女丑道尊=Nữ Sửu Đạo Tôn
女仙=Nữ Tiên
女儿=con gái
女冠=Nữ quan
女妖尊=Nữ Yêu Tôn
女子=Nữ tử
女希=Nữ Hi
女希古神=Nữ Hi Cổ Thần
女帝=Nữ Đế
女帝洛花音=Nữ Đế Lạc Hoa Âm
女神主=Nữ Thần Chủ
女神官=Nữ thần quan
女菩萨=Nữ Bồ Tát
女萝=Nữ La
女萝元君=Nữ La Nguyên Quân
女萝道君=Nữ La Đạo Quân
女魔头=nữ ma đầu
奴隶=Nô lệ
奸夫=gian phu
奸臣=Gian thần
如意丹=Như Ý Đan
如意棒=Như Ý Bổng
如是=Như Thị
如来=Như Lai
妍婼宗主=Nghiên Nhược tông chủ
妖=Yêu
妖仙=Yêu Tiên
妖仙云一鸣=Yêu Tiên Vân Nhất Minh
妖光=yêu quang
妖兽狂潮=Yêu Thú Cuồng Triều
妖君=Yêu Quân
妖孽=Yêu Nghiệt
妖尊=Yêu Tôn
妖巢天师=Yêu Sào Thiên Sư
妖帝=Yêu Đế
妖族=Yêu tộc
妖族大道=Yêu Tộc Đại Đạo
妖族时代=Thời Đại Yêu Tộc
妖族真仙=Yêu Tộc Chân Tiên
妖狐=Yêu Hồ
妖王=Yêu Vương
妖界=Yêu Giới
妖皇=Yêu Hoàng
妖神=Yêu Thần
妖神宗=Yêu Thần Tông
妖神宫=Yêu Thần Cung
妖神犬=Yêu Thần Khuyển
妖神酒=Yêu Thần Tửu
妖神金乌=Yêu Thần Kim Ô
妖神金帝=Yêu Thần Kim Đế
妖莲=Yêu Liên
妖莲海=Yêu Liên Hải
妖道=Yêu Đạo
妖道时代=Yêu Đạo Thời Đại
妖道灵根=Yêu đạo linh căn
妖门=Yêu Môn
妖门大教=Yêu Môn Đại Giáo
妖魔=Yêu Ma
妙元=Diệu Nguyên
妙元上人=Diệu Nguyên Thượng Nhân
妙善=Diệu Thiện
妙慧=Diệu Tuệ
妙慧师兄=Diệu Tuệ sư huynh
妙慧道兄=Diệu Tuệ đạo huynh
妙成天佛祖=Diệu Thành Thiên Phật Tổ
妙谛=Diệu Đế
妙谛佛陀=Diệu Đế Phật Đà
妙谛和尚=Diệu Đế hòa thượng
妙谛圣僧=Diệu Đế Thánh Tăng
妙谛小和尚=Diệu Đế Tiểu Hòa Thượng
妙谛师兄=Diệu Đế Sư huynh
妙谛师弟=Diệu Đế sư đệ
妣母=Bỉ mẫu
妼母=Bức Mẫu
妼母女道人=Bức Mẫu nữ đạo nhân
妼母道君=Bức Mẫu Đạo Quân
妾室=Thiếp thất
妾身=Thiếp thân
始=Thủy
始皇=Thủy Hoàng
始皇乾元=Thủy Hoàng Càn Nguyên
始祖=Thủy Tổ
始祖妖神=Thủy Tổ Yêu Thần
始祖血脉=Thủy Tổ Huyết Mạch
姐姐=Tỷ tỷ
姑言仙子=Cô Ngôn Tiên Tử
姑言女仙=Cô Ngôn Nữ Tiên
姜柔=Khương Nhu
姜神主=Khương Thần Chủ
姜维=Khương Duy
姹女[***]**=Xá Nữ [***]**
威能=uy năng
娄勋=Lâu Huân
娄勋道人=Lâu Huân đạo nhân
娘=Nương
娘亲=Nương thân
娘娘=Nương Nương
婆娑天多旬佛祖=Bà Sa Thiên Đa Tuần Phật Tổ
婆娑宝树=Bà Sa Bảo Thụ
婆罗神葫=Bà La thần hồ
婆罗重水=Bà La Trọng Thủy
婉君=Uyển Quân
婴孩=anh hài
婴孩巨人=Cự nhân hài nhi
媚月=Mị Nguyệt
媚月楼主=Mị Nguyệt Lâu Chủ
媞=Thi
媞姓=Đề
媞家=Thì gia
媞家太奶奶=Thị gia thái nãi nãi
媞家神主=Thị gia Thần chủ
媞战神=Đề Chiến Thần
媞漠山=Đề Mạc Sơn
媞玄公=Thì Huyền Công
媞玄公夫妇=Phu phụ Đề Huyền Công
媞玉=Đề Ngọc
媞老头=Lão đầu Đế
媞轩薇=Đề Hiên Vi
嫁妆=của hồi môn
嫂夫人=Tẩu phu nhân
嫂嫂=Tẩu tẩu
嫔妃=Tần Phi
子安=Tử An
子安道人=Tử An đạo nhân
子川=Tử Xuyên
子归=Tử Quy
子归大帝=Tử Quy Đại Đế
子房=Tử Phòng
子房道人=Tử Phòng Đạo Nhân
子玉=Tử Ngọc
子玉道人=Tử Ngọc Đạo Nhân
子虚上人=Tử Hư Thượng Nhân
孔圣=Khổng Thánh
孔圣大将军=Khổng Thánh đại tướng quân
孔圣道人=Khổng Thánh Đạo Nhân
孔圣飞熊=Khổng Thánh Phi Hùng
孔子=Khổng Tử
孔雀=Khổng Tước
孔雀大佛=Khổng Tước Đại Phật
孔雀大明王=Khổng Tước Đại Minh Vương
孔雀明王=Khổng Tước Minh Vương
孔雀明王印=Khổng Tước Minh Vương Ấn
孔雀明王真身=Khổng Tước Minh Vương Chân Thân
孔雀明王经=Khổng Tước Minh Vương Kinh
孔雀王=Khổng Tước Vương
孔鹤仙王=Khổng Hạc Tiên Vương
季君子=Quý Quân Tử
季庄公子=Quý Trang công tử
季风=Quý Phong
孤月世界=Cô Nguyệt Thế Giới
孤阳尊者=Cô Dương Tôn Giả
学宫=Học Cung
学宫三圣=Học Cung tam thánh
孽畜=Nhiệt súc
宁死=thà chết
宁缺神尊=Ninh Khuyết Thần Tôn
宅猪=Trạch Trư
宇=Vũ
宇宙=Vũ Trụ
宇宙之眼=Vũ Trụ Chi Nhãn
宇宙乾坤=Vũ Trụ Càn Khôn
宇宙交融之地=Vũ Trụ Giao Dung Chi Địa
宇宙洪荒=Vũ trụ hồng hoang
宇宙膜胎=Vũ Trụ Mô Thai
宇宙虚空=Vũ trụ hư không
宇宙融合=Vũ Trụ Dung Hợp
宇文世家=Vũ Văn thế gia
宇文光=Vũ Văn Quang
宇文大阀=Vũ Văn Đại Phạt
宇青石=Vũ Thanh Thạch
宇青金=Vũ Thanh Kim
守=Thủ
守护神=Thủ hộ thần
安僧=An Tăng
安四娘=An Tứ Nương
安灵=An Linh
安青=An Thanh
安青仙君=An Thanh Tiên Quân
安青仙王=An Thanh Tiên Vương
安青大老爷=An Thanh Đại Lão Gia
宗主峰=Tông Chủ Phong
宗会道人=Tông Hội đạo nhân
宗师=Tông Sư
宗让=Tông Nhượng
宗阳魔帝=Tông Dương Ma Đế
宙光=Trụ Quang
宙光钟=Trụ Quang Chung
宙荒石碑=Trụ Hoang Thạch Bi
宙荒神水=Trụ Hoang Thần Thủy
宙荒神石=Trụ Hoang Thần Thạch
宙荒门=Chư Hoang Môn
定位神柱=Định vị thần trụ
定光=Định Quang
定光魔帝=Định Quang Ma Đế
定天元桩=Định Thiên Nguyên Trang
定定=Định Định
定海枪=Định Hải Thương
定海神珠=Định Hải Thần Châu
宝书=bảo thư
宝塔=Bảo Tháp
宝座=bảo tọa
宝日王佛祖=Bảo Nhật Vương Phật Tổ
宝曰王佛祖=Bảo Viết Vương Phật Tổ
宝树神体=Bảo Thụ Thần Thể
宝皇=Bảo Hoàng
宝皇道君=Bảo Hoàng Đạo Quân
宝相庄严=Bảo Tướng Trang Nghiêm
宝蓝袈裟=Bảo Lam Ca Sa
宝贝儿=bảo bối
宝辇=Bảo Liễn
宝音=Bảo Âm
宝音尊者=Bảo Âm Tôn Giả
宣夜=Tuyên Dạ
宣无邪=Tuyên Vô Tà
宣无邪传=Tuyên Vô Tà Truyện
宣无邪化身=Tuyên Vô Tà hóa thân
宣楼=Tuyên Lâu
宣楼仙王=Tuyên Lâu Tiên Vương
宫倩倩=Cung Thiến Thiến
宫天缺=Cung Thiên Khuyết
宫常青=Cung Thường Thanh
宫殿=cung điện
宫道兄=Cung đạo huynh
宫道友=Cung đạo hữu
家祖=Gia Tổ
寂灭=Tịch Diệt
寂灭之气=Tịch Diệt Chi Khí
寂灭之法=Tịch Diệt Chi Pháp
寂灭仙道=Tịch Diệt Tiên Đạo
寂灭元始=Tịch Diệt Nguyên Thủy
寂灭先天=Tịch Diệt Tiên Thiên
寂灭兽=Tịch Diệt Thú
寂灭剑式=Tịch Diệt Kiếm Thức
寂灭劫=Kiếp Diệt Tịch
寂灭劫波=Tịch Diệt Kiếp Ba
寂灭区=Tịch Diệt Khu
寂灭圣境=Tịch Diệt Thánh Cảnh
寂灭大人=Tịch Diệt Đại Nhân
寂灭大帝=Tịch Diệt Đại Đế
寂灭大罗天=Tịch Diệt Đại La Thiên
寂灭大道=Tịch Diệt Đại Đạo
寂灭天君=Tịch Diệt Thiên Quân
寂灭天尊=Tịch Diệt Thiên Tôn
寂灭天星=Tịch Diệt Thiên Tinh
寂灭天火=Tịch Diệt Thiên Hỏa
寂灭天眼=Tịch Diệt Thiên Nhãn
寂灭天轮=Tịch Diệt Thiên Luân
寂灭天门=Tịch Diệt Thiên Môn
寂灭灵光=Tịch Diệt Linh Quang
寂灭绝境=Tịch Diệt tuyệt cảnh
寂灭花=Tịch Diệt Hoa
寂灭血针=Tịch Diệt huyết châm
寂灭道人=Tịch Diệt Đạo Nhân
寂灭道友=Tịch Diệt đạo hữu
寂灭道君=Tịch Diệt Đạo Quân
寂灭魔气=Tịch Diệt Ma Khí
寂灭魔眼=Ma nhãn tịch diệt
寂灭魔鼓=Tịch Diệt Ma Cổ
寇嘉=Khấu Gia
寇嘉尊者=Khấu Gia Tôn Giả
寒之剑意=Hàn chi kiếm ý
寒月纪劫=Hàn Nguyệt Kỷ Kiếp
寰太=Hoàn Thái
寰宇乾坤=Hoàn Vũ Càn Khôn
寸草不生=Thốn thảo bất sinh
寿佛=Thọ Phật
寿元=Thọ Nguyên
寿字=chữ Thọ
封天大阵=Phong Thiên Đại Trận
封灵阵=Phong Linh Trận
封神榜=Phong Thần Bảng
封神道旗=Phong Thần Đạo Kỳ
封禁大阵=Phong Cấm Đại Trận
封越仙王=Phong Việt Tiên Vương
封魔古城=Phong Ma Cổ Thành
射天弓=Xạ Thiên Cung
将岸=Tướng Ngạn
将岸大帝=Tướng Ngạn Đại Đế
将岸狱主=Ngục chủ Tương Ngạn
将岸神主=Tương Ngạn Thần Chủ
将岸神尊=Tương Ngạn Thần Tôn
将岸神庙=Thần miếu Tương Ngạn
尉迟道君=Uất Trì Đạo Quân
尊=Tôn
尊严=Tôn Nghiêm
尊月=Tôn Nguyệt
尊月真人=Tôn Nguyệt Chân Nhân
尊月道人=Tôn Nguyệt Đạo Nhân
尊殿=Tôn Điện
尊炎=Tôn Viêm
尊炎大帝=Tôn Viêm Đại Đế
尊炎神帝=Tôn Viêm Thần Đế
尊炎神炉=Tôn Viêm Thần Lô
尊王=Tôn Vương
尊王神印=Tôn Vương thần ấn
尊王鼎=Tôn Vương Đỉnh
尊者=Tôn Giả
尊莲=Tôn Liên
尊身=Tôn Thân
小丫头=Tiểu nha đầu
小主公=Tiểu chủ công
小乘佛门=Tiểu Thừa Phật Môn
小云莲=Tiểu Vân Liên
小佛陀=Tiểu Phật Đà
小元元=Tiểu Nguyên Nguyên
小元君=Tiểu Nguyên Quân
小元君薇雪主=Tiểu Nguyên Quân Vi Tuyết Chủ
小光明界=Tiểu Quang Minh Giới
小千世界=Tiểu thiên thế giới
小千世界残破大荒剑卷=Tiểu Thiên Thế Giới Tàn Phá Đại Hoang Kiếm Quyển
小周天星部=Tiểu Chu Thiên Tinh Bộ
小和尚=tiểu hòa thượng
小天星元界=Tiểu Thiên Tinh Nguyên Giới
小天星界=Tiểu Thiên Tinh Giới
小奶娃=tiểu nãi oa
小妹=Tiểu muội
小娘子=Tiểu nương tử
小客人=tiểu khách nhân
小师侄=Tiểu sư điệt
小幼蛟=Tiểu Ấu Giao
小庙=Tiểu miếu
小江子=Tiểu Giang Tử
小江教主=Tiểu Giang giáo chủ
小灰灰=Tiểu Hôi Hôi
小狐狸=Tiểu Hồ Ly
小结界丹=Tiểu Kết Giới Đan
小赤都元界=Tiểu Xích Đô Nguyên Giới
小道友=Tiểu đạo hữu
小道耳=Tiểu đạo nhĩ
小邪王=Tiểu Tà Vương
小钻风=Tiểu Toàn Phong
小门主=Tiểu môn chủ
小青=Tiểu Thanh
小鬼=tiểu quỷ
小鬼头=Tiểu Quỷ Đầu
小鸟儿=Tiểu điểu nhi
小鸳鸯=Tiểu uyên ương
少主=Thiếu Chủ
少君=Thiếu Quân
少君大帝=Thiếu Quân Đại Đế
少帅=Thiếu Soái
少帅蒲昭=Thiếu Soái Bồ Chiêu
少帅蒲昭和魔帅燕公戬=Thiếu Soái Bồ Chiêu và Ma Soái Yến Công Tiễn
少帅魔帅=Thiếu Soái Ma Soái
少年书生江南=Thiếu niên thư sinh Giang Nam
少年仙尊=Thiếu Niên Tiên Tôn
少年神帝=Thiếu Niên Thần Đế
少年神明=Thiếu Niên Thần Minh
少年紫垣魔帝=Thiếu niên Tử Viên Ma Đế
少教主=Thiếu Giáo Chủ
少虚=Thiếu Hư
少虚大帝=Thiếu Hư Đại Đế
少虚昊少君=Thiếu Hư Hạo Thiếu Quân
少虚道友=Thiếu Hư đạo hữu
尸神=Thi thần
尸骨=Thi cốt
屠岸=Đồ Ngạn
屠岸真仙=Đồ Ngạn Chân Tiên
屠道人=Đồ Đạo Nhân
山=Sơn
山岚=Sơn Lam
山岚道人=Sơn Lam đạo nhân
山水珠=Sơn Thủy Châu
山水神珠=Sơn Thủy Thần Châu
山海鼎=Sơn Hải Đỉnh
山门=Sơn môn
岁星=Tuế Tinh
岁星神主=Tuế Tinh Thần Chủ
岳=Nhạc
岳世庭=Nhạc Thế Đình
岳幼娘=Nhạc Ấu Nương
岳幼娘神主=Nhạc Ấu Nương Thần Chủ
岳灵儿=Nhạc Linh Nhi
岳父=Nhạc phụ
岸神主=Ngạn Thần Chủ
崇阳真仙=Sùng Dương Chân Tiên
崖思邪=Nha Tư Tà
巡察使=Tuần Sát Sứ
左上卫=Tả Thượng Vệ
左丘道友=Tả Khâu đạo hữu
左伯仁=Tả Bá Nhân
左天丞=Tả Thiên Thừa
左天侯=Tả Thiên Hầu
左少卫=Tả Thiếu Vệ
左岸=Tả Ngạn
左岸仙王=Tả Ngạn Tiên Vương
左旗=Tả Kỳ
左线乾至魔君=Tả Tuyến Càn Chí Ma Quân
左线大军=Tả Tuyến Đại Quân
巨头=Cự đầu
巨婴=Cự Anh
巨灵=Cự Linh
巨灵不灭印=Cự Linh Bất Diệt Ấn
巨灵关=Cự Linh quan
巨灵古神=Cự Linh Cổ Thần
巨灵大道=Cự Linh Đại Đạo
巨灵时代=Cự Linh Thời Đại
巨灵武道图=Cự Linh Võ Đạo Đồ
巨灵神=Cự Linh Thần
巨灵神族=Cự Linh Thần Tộc
巨灵神通=Cự Linh Thần Thông
巨灵禁区=Cự Linh Cấm Khu
巨灵道友=Cự Linh đạo hữu
巨灵道君=Cự Linh đạo quân
巨灵霸体=Cự Linh Bá Thể
巨虫尸巫=Cự Trùng Thi Vu
巫=Vu
巫墓=Vu Mộ
巫门=Vu Môn
巴扈=Ba Hộ
巴扈古神=Ba Hộ Cổ Thần
巴楚道人=Ba Sở Đạo Nhân
巴音=Ba Âm
巴音仙王=Ba Âm Tiên Vương
巾帼不让须眉=kẻ mày râu không thua gì
布臣魔皇=Bố Thần Ma Hoàng
布袋=bố túi
师兄=Sư huynh
师兄师弟=sư huynh, sư đệ
师叔=Sư thúc
师妃仙=Sư Phi Tiên
师姐=Sư tỷ
师尊=Sư Tôn
师弟=Sư đệ
师恩印=Sư Ân Ấn
师祖=Sư Tổ
帛书=Bạch Thư
帝=Đế
帝与灵宝道主=Đế và Linh Bảo Đạo Chủ
帝位=Ngai vị
帝使=Đế Sử
帝使天枢=Đế Sử Thiên Khu
帝使天玑=Đế Sử Thiên Cơ
帝兵=Đế Binh
帝冠=Đế quan
帝劫=Đế Kiếp
帝后=Đế Hậu
帝君=Đế Quân
帝和尊=Đế và Tôn
帝境=Đế cảnh
帝墓=Đế mộ
帝天=Đế Thiên
帝天法王=Đế Thiên Pháp Vương
帝威=Đế Uy
帝宝=Đế bảo
帝宝之印=Đế Bảo Chi Ấn
帝宝混元天罗伞=Đế Bảo Hỗn Nguyên Thiên La Tán
帝宫=Đế Cung
帝尊=Đế Tôn
帝尊☆无相煌=Đế Tôn Vô Tương Hoàng
帝尊仙印=Đế Tôn Tiên Ấn
帝尊传法之地=Đế Tôn Truyền Pháp Chi Địa
帝尊印=Đế Tôn Ấn
帝尊道场=Đế Tôn đạo tràng
帝尸=Đế Thi
帝尸虫=Đế Thi Trùng
帝师=Đế Sư
帝座=Đế Tọa
帝战之地=Đế Chiến Chi Địa
帝斩灵宝=Đế Trảm Linh Bảo
帝星=Đế tinh
帝棺=Đế quan
帝殿=Đế Điện
帝江=Đế Giang
帝江道友=Đế Giang đạo hữu
帝玄=Đế Huyền
帝玄子=Đế Huyền Tử
帝玄神朝=Đế Huyền Thần Triều
帝玄陛下=Đế Huyền bệ hạ
帝皇=Đế Hoàng
帝皇之道=Đế Hoàng Chi Đạo
帝皇树=Đế Hoàng Thụ
帝皇神体=Đế Hoàng Thần Thể
帝皇神体昊少君=Đế Hoàng Thần Thể Hạo Thiếu Quân
帝皇神帝昊少君=Đế Hoàng Thần Đế Hạo Thiếu Quân
帝碑=Đế Bi
帝级=Đế Cấp
帝级**=Đế cấp
帝级功法=Đế Cấp Công Pháp
帝级大道=Đế Cấp Đại Đạo
帝级大阵=Đế Cấp Đại Trận
帝虚=Đế Hư
帝资=Đế tư
帝身=Đế Thân
帝躯=Đế Khu
帝车=Đế Xa
帝都=Đế Đô
帝陵=Đế Lăng
帝驾=Đế Giá
帝骨金船=Đế Cốt Kim Thuyền
帝麟=Đế Lân
帝麟道兄=Đế Lân đạo huynh
席=Tịch
席大哥=Tịch đại ca
席天君=Tịch Thiên Quân
席天王=Tịch Thiên vương
席子归=Tịch Tử Quy
席山=Tịch Sơn
席师兄=Tịch sư huynh
席应情=Tịch Ứng Tình
席掌教=Tịch chưởng giáo
席月清=Tịch Nguyệt Thanh
席道友=Tịch đạo hữu
席重=Tịch Trọng
席重岳=Tịch Trọng Nhạc
席重神主=Tịch Trọng Thần Chủ
席风=Tịch Phong
干娘=mẹ nuôi
干爹=ba nuôi
平天=Bình Thiên
平天大帝=Bình Thiên Đại Đế
平天妖君=Bình Thiên Yêu Quân
平天妖尊=Bình Thiên Yêu Tôn
平天妖祖=Bình Thiên Yêu Tổ
年轻真仙=Chân Tiên trẻ tuổi
幸存的真仙和仙人=Chân Tiên và Tiên Nhân còn sống sót
幻月双瞳=Huyễn Nguyệt song đồng
幼娘=Ấu Nương
幼娘子=Ấu Nương Tử
幼蛟=Ấu Giao
幼蛟龙=ấu Giao Long
幽兰圣女=U Lan Thánh Nữ
幽兰师姐=U Lan sư tỷ
幽冥大魔王=U Minh Đại Ma Vương
幽冥神水=U Minh Thần Thủy
幽冥鬼部=U Minh Quỷ Bộ
幽冥魔王=U Minh Ma Vương
幽天神族=U Thiên Thần Tộc
幽天魔尊=U Thiên Ma Tôn
幽帝=U Đế
幽帝鬼船=U Đế Quỷ Thuyền
幽暗魔尊=U Ám Ma Tôn
幽泉=U Tuyền
幽泉道人=U Tuyền Đạo Nhân
广寒纪劫=Quảng Hàn Kỷ Kiếp
广法禅师=Quảng Pháp Thiền Sư
广都=Quảng Đô
广都天尊=Quảng Đô Thiên Tôn
广都殿主=Quảng Đô Điện Chủ
庄严世尊=Trang Nghiêm Thế Tôn
庄严神祖=Trang Nghiêm Thần Tổ
庄州=Trang Châu
庆云=Khánh Vân
庆云世界=Thế giới Khánh Vân
庆辉=Khánh Huy
应元=Ứng Nguyên
应元皇祖=Ứng Nguyên Hoàng Tổ
应元道人=Ứng Nguyên đạo nhân
应劫=Ứng kiếp
应无双=Ứng Vô Song
应浞=Ứng Trác
应神侯=Ứng Thần Hầu
应裳=Ứng Thường
应龙=Ứng Long
应龙一族=Ứng Long nhất tộc
应龙世界=Thế giới Ứng Long
应龙大世界=Ứng Long Đại Thế Giới
应龙家=Ứng Long gia
应龙族=Ứng Long Tộc
应龙殿=Ứng Long Điện
应龙神帝=Ứng Long Thần Đế
应龙神庭=Ứng Long Thần Đình
应龙老祖=Ứng Long Lão Tổ
应龙道人=Ứng Long Đạo Nhân
庖丁解牛=Bào Đinh Giải Ngưu
庞斑=Bàng Ban
庞飞=Bàng Phi
废弃之地=Phế Khí Chi Địa
度牒=Độ Điệp
座山龙王=Tọa Sơn Long Vương
庵主=Am chủ
康寅=Khang Dần
康寅神主=Khang Dần Thần Chủ
廉琮=Liêm Tông
廉琮天神=Liêm Tông Thiên Thần
建武国=Kiến Vũ Quốc
建武神君=Kiến Vũ Thần Quân
建武神尊=Kiến Võ Thần Tôn
开元=Khai Nguyên
开元一剑=Khai Nguyên Nhất Kiếm
开元一式=Khai Nguyên Nhất Thức
开元剑式=Khai Nguyên Kiếm Thức
开元大神通=Khai Nguyên đại thần thông
开元式=Khai Nguyên Thức
开坛[***]=khai đàn thuyết pháp
开坛讲道=Khai đàn giảng đạo
开天=Khai Thiên
开天功德=Khai thiên công đức
开天功德气运=Khai Thiên Công Đức Khí Vận
开天印=Khai Thiên Ấn
开天斧=Khai Thiên Phủ
开天气运=Khai Thiên Khí Vận
开天气运功德=khai thiên khí vận công đức
开天法宝=Khai Thiên Pháp Bảo
开山老祖=Khai Sơn Lão Tổ
异火=Dị Hỏa
异种水蛭=đỉa dị chủng
异象=Dị tượng
弑神谷=Thí Thần Cốc
弑神谷六魔=Thí Thần Cốc Lục Ma
弑神谷玉佩=Ngọc bội Thí Thần Cốc
弓=Cung
弘祖=Hoằng Tổ
弘祖神帝=Hoằng Tổ Thần Đế
弘祖神皇=Hoằng Tổ Thần Hoàng
弟子=đệ tử
张掌柜=Trương chưởng quỹ
弥罗天盛会=Di La Thiên Thịnh Hội
弥罗山=Di La Sơn
弧矢=Hồ Thỉ
归千愁=Quy Thiên Sầu
彩凤=Thải Phượng
彩凤为脚力=Thải Phượng Vi Cước Lực
彩翼=Thải Dực
彼岸=Bỉ Ngạn
彼岸世界=Thế giới Bỉ Ngạn
彼岸仙庭=Tiên Đình Bỉ Ngạn
彼岸女帝=Bỉ Ngạn Nữ Đế
彼岸娘娘=Bỉ Ngạn nương nương
彼岸小贱人=Tiểu tiện nhân Bỉ Ngạn
彼岸帝陵=Bỉ Ngạn Đế Lăng
彼岸神帝=Bỉ Ngạn Thần Đế
彼岸神舟=Bỉ Ngạn Thần Chu
彼岸花=Bỉ Ngạn Hoa
彼岸道祖=Bỉ Ngạn Đạo Tổ
彼岸金桥=Bỉ Ngạn Kim Kiều
往生=Vãng Sinh
往生帝=Vãng Sinh Đế
往生帝陵=Vãng Sinh Đế lăng
往生神帝=Vãng Sinh Thần Đế
往生经=Vãng Sinh Kinh
往生金钟=Vãng Sinh Kim Chung
御历含真=Ngự Lịch Hàm Chân
御天道钟=Ngự Thiên Đạo Chung
御星舟=Ngự Tinh Chu
御神官=Ngự Thần quan
御花园=Ngự Hoa Viên
心境=Tâm cảnh
心眼长歪=Tâm nhãn trưởng oai
心魔天尊=Tâm Ma Thiên Tôn
怒=Nộ
怜香=Liên Hương
怜香圣女=Liên Hương Thánh Nữ
思=Tư
思川国=Tư Xuyên Quốc
总坛教主=Tổng Đàn Giáo Chủ
恒古=Hằng Cổ
恒古剑式=Hằng Cổ Kiếm Thức
恒古剑意=Hằng Cổ Kiếm Ý
恒河星砂=Hằng Hà Tinh Sa
恩师=Ân Sư
恩怨=ân oán
恭阳天=Cung Dương Thiên
恶之剑意=Ác Chi Kiếm Ý
悟道仙脂=Ngộ Đạo Tiên Chi
情丝=Tình ty
惊天动地=kinh thiên động địa
惠元宗=Huệ Nguyên Tông
意罗仙君=Ý La Tiên Quân
慕太皇=Mộ Thái Hoàng
慕晚晴=Mộ Vãn Tình
慕烟儿=Mộ Yên Nhi
慕道友=Mộ đạo hữu
懈慎=Giải Thận
懈慎神主=Giải Thận Thần Chủ
懈慎道人=Giải Thận đạo nhân
懈慎道兄=Giải Thận đạo huynh
懈慎道友=Giải Thận đạo hữu
懿旨=Ý chỉ
成仙二法=Thành Tiên nhị pháp
我佛=Ta Phật
战争巨兽=Chiến Tranh Cự Thú
战天虫潮=Chiến Thiên Trùng Triều
战天魔君=Chiến Thiên Ma Quân
战天魔尊=Chiến Thiên Ma Tôn
战戟=chiến kích
战王神主=Chiến Vương Thần Chủ
战神=Chiến Thần
战神殿=Chiến Thần Điện
截教=Tiệt Giáo
戮天=Lục Thiên
戮天魔君=Lục Thiên Ma Quân
戴寅=Đái Dần
戴英=Đái Anh
戴震=Đái Chấn
扇星云界=Phiến Tinh Vân Giới
手环=Vòng tay
打神鞭=Đả Thần Tiên
托塔天神=Thác Tháp Thiên Thần
执法圣尊=Chấp Pháp Thánh Tôn
执法天王=Chấp Pháp Thiên Vương
护法=Hộ pháp
拂尘=Phất Trần
拓余=Thác Dư
拓余真仙=Thác Dư Chân Tiên
拓峪国=Thác Dục Quốc
拓跋=Thác Bạt
拓跋兰芸=Thác Bạt Lan Vân
拓跋夫妇=Thác Bạt phu phụ
拓跋弘=Thác Bạt Hoằng
拓跋流照=Thác Bạt Lưu Chiếu
招魂幡=Chiêu Hồn Phiên
招魂营=Chiêu Hồn Doanh
拜月宗=Bái Nguyệt Tông
拜月教=Bái Nguyệt Giáo
拜月教主=Bái Nguyệt Giáo Chủ
持法=Trì Pháp
持法天王=Trì Pháp Thiên Vương
振东=Chấn Đông
振东道友=Chấn Đông đạo hữu
振川=Chấn Xuyên
捆神索=Khổn Thần Tác
掌中宝楼=Chưởng Trung Bảo Lâu
掌教=Chưởng Giáo
掌教师兄=Giáo chủ sư huynh
掌教至尊=Chưởng giáo chí tôn
推荐票=Phiếu đề cử
揽月手=Lãm Nguyệt Thủ
揽鹊桥=Lãm Thước Kiều
搅屎棍子=Kẻ phá đám
搜魂幡=Sưu Hồn Phiên
摄云浑天瓶=Nhiếp Vân Hồn Thiên Bình
摄招=Nhiếp Chiêu
摩元天=Ma Nguyên Thiên
摩天=Ma Thiên
摩天仙君=Ma Thiên Tiên Quân
摩天仙王=Ma Thiên Tiên Vương
摩天大魔头=Ma Thiên Đại Ma Đầu
摩天天君=Ma Thiên Thiên Quân
摩天师兄=Ma Thiên sư huynh
摩天道兄=Ma Thiên đạo huynh
摩崖天=Ma Nhai Thiên
摩罗=Ma La
摩罗什=Ma La Thập
摩罗前辈=Ma La tiền bối
摩罗大哥=Ma La đại ca
摩罗师叔=Ma La sư thúc
摩罗神族=Ma La Thần tộc
摩罗魔神=Ma La Ma Thần
摩诃=Ma Ha
摩诃仙君=Ma Ha Tiên Quân
摩诃古神=Ma Ha Cổ Thần
摩诃大神=Ma Ha Đại Thần
摩诃天君=Ma Kha Thiên Quân
撞击=va chạm
放牧人=Phóng Mục Nhân
救兵=cứu binh
敕令=Sắc lệnh
敕令符文=Sắc Lệnh Phù Văn
教主=Giáo Chủ
教主夫人=Giáo Chủ Phu Nhân
教尊=Giáo Tôn
散仙=Tán Tiên
散景=Tản Cảnh
散景真仙=Tản Cảnh Chân Tiên
散辉=Tán Huy
敬=Kính
文书=Văn Thư
文朱氏=Văn Chu thị
文焕神尊=Văn Hoán Thần Tôn
文臣=Văn thần
斐皇=Phỉ Hoàng
斑卢超=Ban Lư Siêu
斗姆=Đấu Mẫu
斗姆女君=Đấu Mẫu Nữ Quân
斗战部=Đấu Chiến Bộ
斗战金公旗=Đấu Chiến Kim Công kỳ
斗法神典=Đấu Pháp Thần Điển
斗罗=Đấu La
斗罗神主=Đấu La Thần Chủ
斩字营=Trảm Tự Doanh
斩神台=Trảm Thần Đài
斩神灭域大阵=Trảm Thần Diệt Vực Đại Trận
斩虚皇仙王=Trảm Hư Hoàng tiên vương
斩道=Trảm Đạo
断剑=đoạn kiếm
断狱=Đoạn Ngục
断狱大神通=Đoạn Ngục Đại Thần Thông
断狱神通=Đoạn Ngục Thần Thông
斯文败类=kẻ bại hoại văn nhã
新仙道=Tân Tiên Đạo
新生代=Thế hệ mới
新魔道=Tân Ma Đạo
方天画戟=Phương Thiên Họa Kích
方天道君=Phương Thiên Đạo Quân
方宇真神=Phương Vũ Chân Thần
方师弟=Phương sư đệ
方颙=Phương Ngung
方颙魔尊=Phương Vọng Ma Tôn
旃焕魔尊=Chiên Hoán Ma Tôn
旌旗=tinh kỳ
族老=Tộc lão
旗坛=Kỳ đàn
旗营=Kỳ Doanh
无上至尊往生神帝=Vô Thượng Chí Tôn Vãng Sinh Thần Đế
无上魔境=Vô Thượng Ma Cảnh
无为先天=Vô Vi Tiên Thiên
无为至道天=Vô Vi Chí Đạo Thiên
无为至道天仙帝=Vô Vi Chí Đạo Thiên Tiên Đế
无人区=Vô Nhân Khu
无人禁区=Vô Nhân Cấm Khu
无伤天甲=Vô Thương Thiên Giáp
无双大蛇=Đại xà vô song
无双郡主=Vô Song quận chúa
无双青蛇=Thanh Xà Vô Song
无尘=Vô Trần
无尘道人=Vô Trần Đạo Nhân
无底魔渊=Vô Để Ma Uyên
无形剑气诛魔剑=Vô Hình Kiếm Khí Tru Ma Kiếm
无忧八神国=Vô Ưu Bát Thần Quốc
无忧魔皇=Vô Ưu Ma Hoàng
无极=Vô Cực
无极书童=Vô Cực Thư Đồng
无极圣地=Vô Cực Thánh Địa
无极天尊=Vô Cực Thiên Tôn
无极殿主=Vô Cực điện chủ
无极神宗=Vô Cực Thần Tông
无极道书=Vô Cực Đạo Thư
无极道兄=Vô Cực đạo huynh
无极道琢=Vô Cực Đạo Trác
无源无始=Vô Nguyên Vô Thủy
无源魔帝=Vô Nguyên Ma Đế
无漏先天=Vô Lậu Tiên Thiên
无生老死=Vô Sinh Lão Tử
无畏三印=Vô Úy Tam Ấn
无畏印=Vô Úy Ấn
无相之龙=Vô Tướng Chi Long
无相劫经=Vô Tướng Kiếp Kinh
无相吞噬诀=Vô Tướng Thôn Phệ Quyết
无相大禅师=Vô Tướng Đại Thiền Sư
无相煌=Vô Tướng Hoàng
无相禅师=Vô Tướng Thiền Sư
无相自在劫经=Vô Tướng Tự Tại Kiếp Kinh
无衣=Vô Y
无道公子=Vô Đạo công tử
无道深渊=Vô Đạo Thâm Uyên
无邪=Vô Tà
无邪大老爷=Vô Tà Đại Lão Gia
无邪教主=Vô Tà giáo chủ
无邪神母=Vô Tà Thần Mẫu
无邪道友=Vô Tà đạo hữu
无邪道君=Vô Tà đạo quân
无量=Vô Lượng
无量光=Vô Lượng Quang
无量光音=Vô Lượng Quang Âm
无量劫=Vô Lượng Kiếp
无量寿=Vô Lượng Thọ
无量寿佛=Vô Lượng Thọ Phật
无量智慧=Vô Lượng Trí Huệ
无量杀劫=Vô Lượng Sát Kiếp
无间地狱魔帝兰陵烈=Vô Gian Địa Ngục Ma Đế Lan Lăng Liệt
日之剑意=Nhật Chi Kiếm Ý
日月星辰=Nhật Nguyệt Tinh Thần
旦星=Đán Tinh
早教主=Tảo giáo chủ
旱魃=Hạn Bạt
时之剑法=Thời Chi Kiếm Pháp
时之剑道=Thời Chi Kiếm Đạo
时之铁则=Thời Chi Thiết Tắc
时光长河=Thời Quang Trường Hà
时空=Thời Không
时空黑洞=hố đen thời không
旷世的精品=tuyệt phẩm
昆仑=Côn Luân
昆仑仙君=Côn Luân Tiên Quân
昆仑境=Côn Luân Cảnh
昆仑神府=Côn Luân Thần Phủ
昊=Hạo
昊兄=Hạo huynh
昊天上尊=Hạo Thiên Thượng Tôn
昊天圣宗=Hạo Thiên Thánh Tông
昊天帝=Hạo Thiên Đế
昊天神君=Hạo Thiên Thần Quân
昊天镜=Hạo Thiên Kính
昊少君=Hạo Thiếu Quân
昊师兄=Hạo sư huynh
昊道友=Hạo đạo hữu
昌端=Xương Đoan
昌端神主=Xương Đoan Thần Chủ
明堂=Minh Đường
明堂仙君=Minh Đường Tiên Quân
明堂神府=Minh Đường Thần Phủ
明月=Minh Nguyệt
明月定海印=Minh Nguyệt Định Hải Ấn
明月金蟾=Minh Nguyệt Kim Thiềm
明梵=Minh Phạn
明梵仙君=Minh Phạn Tiên Quân
明梵仙城=Minh Phạn tiên thành
明珠=minh châu
明界魔皇=Minh Giới Ma Hoàng
明皇=Minh Hoàng
明皇宫=Minh Hoàng Cung
明皇宫主=Minh Hoàng Cung Chủ
明耀神灵天=Minh Diệu Thần Linh Thiên
明耀神灵天仙帝=Minh Diệu Thần Linh Thiên Tiên Đế
明觉上人=Minh Giác Thượng Nhân
明觉佛尊=Minh Giác Phật Tôn
明觉老祖=Minh Giác lão tổ
明镜=Minh Kính
明镜宝鉴=Minh Kính Bảo Giám
易冰少主=Dịch Băng Thiếu Chủ
昙摩魔仙=Đàm Ma Ma Tiên
昙智=Đàm Trí
昙智和尚=Đàm Trí hòa thượng
昙智圣僧=Đàm Trí Thánh Tăng
星=Tinh
星云=Tinh Vân
星光=Tinh Quang
星光世家=Tinh Quang thế gia
星光大帝=Tinh Quang Đại Đế
星光大帝世家=Tinh Quang Đại Đế Thế Gia
星光大帝家族=Tinh Quang Đại Đế gia tộc
星光帝=Tinh Quang Đế
星光帝家=Tinh Quang Đế Gia
星光帝陵=Tinh Quang Đế Lăng
星光真仙=Tinh Quang Chân Tiên
星光神帝=Tinh Quang Thần Đế
星光神帝化身=Tinh Quang Thần Đế hóa thân
星光纪=Tinh Quang Kỷ
星光纪劫=Tinh Quang Kỷ Kiếp
星光遁法=Tinh Quang Độn Pháp
星光道人=Tinh Quang Đạo Nhân
星力=tinh lực
星宿海=Tinh Tú Hải
星帝=Tinh Đế
星斗=Tinh Đấu
星斗神通=Tinh Đấu Thần Thông
星月圣女=Tinh Nguyệt Thánh Nữ
星月巨人=Tinh Nguyệt Cự Nhân
星月神体=Tinh Nguyệt thần thể
星月神宗=Tinh Nguyệt Thần Tông
星月魔宗=Tinh Nguyệt Ma Tông
星核=Tinh Hạch
星河=Tinh Hà
星河印=Tinh Hà Ấn
星河圆盘=Tinh Hà Viên Bàn
星河宙光=Tinh Hà Trụ Quang
星河宙光印=Tinh Hà Trụ Quang Ấn
星河宙光心经=Tinh Hà Trụ Quang Tâm Kinh
星河宙光盘=Tinh Hà Trụ Quang Bàn
星湖圣典=Tinh Hồ Thánh Điển
星湖玉家=Tinh Hồ Ngọc gia
星空=tinh không
星辰剑法=Tinh Thần Kiếm Pháp
星辰剑道=Tinh Thần Kiếm Đạo
星门=Tinh Môn
星霜剑法=Tinh Sương Kiếm Pháp
春=Xuân
春来江水绿如蓝=Xuân lai giang thủy lục như lam
春江花朝宝帕=Bảo Tháp Xuân Giang Hoa Triều
春江花朝经=Xuân Giang Hoa Triều Kinh
春节=Tết Nguyên Đán
昴天=Mão Thiên
昴天旗主=Mão Thiên Kỳ Chủ
昴日=Mão Nhật
晋国=nước Tấn
晚晴=Vãn Tình
晨光神界=Thần Giới Thần Quang
晨星=Thần Tinh
晨钟暮鼓=Chuông sớm trống chiều
普宇仙枪=Phổ Vũ Tiên Thương
普尊=Phổ Tôn
普法世界=Thế giới Phổ Pháp
普通仙人=Phổ Thông Tiên Nhân
普陀=Phổ Đà
普陀真人=Phổ Đà chân nhân
景天=Cảnh Thiên
景天大帝=Cảnh Thiên Đại Đế
景天真仙=Cảnh Thiên Chân Tiên
景天碧玉玺=Cảnh Thiên Bích Ngọc Tỷ
景天神帝=Cảnh Thiên Thần Đế
景天道人=Cảnh Thiên Đạo Nhân
晴儿=Tình Nhi
晴川女魔主=Tình Xuyên Nữ Ma Chủ
暗之剑意=Ám Chi Kiếm Ý
暗月大陆=Ám Nguyệt Đại Lục
暹罗妖尊=Xiêm La Yêu Tôn
曰出江花红胜火=Nhật xuất giang hoa hồng thắng hỏa
曰曜神主=Nhật Diệu Thần Chủ
曲昌旗主=Khúc Xương Kỳ Chủ
曲泉真仙=Khúc Tuyền Chân Tiên
曼罗媞香=Mạn La Thị Hương
替命神虫=Th thế Thần Trùng
最终寂灭劫=Tối Chung Tịch Diệt Kiếp
月=Nguyệt
月华宝轮=Nguyệt Hoa Bảo Luân
月姓=Nguyệt tính
月孛=Nguyệt Bột
月孛女君=Nguyệt Bột Nữ Quân
月孛女帝=Nguyệt Bột Nữ Đế
月明珠=Nguyệt Minh Châu
月曜=Nguyệt Diệu
月曜星君=Nguyệt Diệu Tinh Quân
月桂仙树=Nguyệt Quế Tiên Thụ
月桂神树=Nguyệt Quế Thần Thụ
月琉璃=Nguyệt Lưu Ly
月生=Nguyệt Sinh
月票=phiếu tháng
月票榜=Bảng nguyệt phiếu
月轮=Nguyệt Luân
月金轮=Nguyệt Kim Luân
朔月=Sóc Nguyệt
朔月回天镜=Sóc Nguyệt Hồi Thiên Kính
朕=Trẫm
望乡台=Vọng Hương Đài
望仙台=Vọng Tiên Đài
望帝道尊=Vọng Đế Đạo Tôn
望月夫人=Vọng Nguyệt phu nhân
望月楼=Vọng Nguyệt Lâu
望江峰=Vọng Giang Phong
朝圣宗=Triều Thánh Tông
朝天圣地=Triều Thiên Thánh Địa
木=Mộc
木德阵师=Mộc Đức Trận Sư
木灵珠=Mộc Linh Châu
未央=Vị Ương
未央公子=Vị Ương công tử
未央太子=Vị Ương Thái Tử
未央女帝=Vị Ương Nữ Đế
未央女燕京=Vị Ương Nữ Yến Kinh
未央娘娘=Vị Ương Nương Nương
未央宫=Vị Ương Cung
未央宫主=Vị Ương Cung Chủ
末日劫=Kiếp Mạt Nhật
末日劫雨=Mạt Nhật Kiếp Vũ
末日劫音=Kiếp âm ngày tận thế
末日教=Giáo chủ Mạt Nhật
末日教主=Mạt Nhật Giáo Chủ
末日童子=Mạt Nhật Đồng Tử
末法时代=Thời đại mạt pháp
本体=Bản Thể
本初灵气=Bản Sơ Linh Khí
本初灵液=Bản Sơ Linh Dịch
本殿=bản điện
朱十三=Chu Thập Tam
朱厌=Chu Yếm
朱砂=Chu Sa
朱道友=Chu đạo hữu
朱雀=Chu Tước
机缘障=Cơ Duyên Chướng
杀帝=Sát Đế
杀道图=Sát Đạo Đồ
杀鸡焉用牛刀=Sát kê yên dụng ngưu đao
杂驼州=Tạp Đà Châu
杂驼州人=Tạp Đà Châu nhân
权天印=Quyền Thiên Ấn
李元白=Lý Nguyên Bạch
李原空=Lý Nguyên Không
束带=Thúc đới
来世真身=Lai Thế Chân Thân
来世花=Lai Thế Hoa
来生真身=Lai Sinh Chân Thân
来生身=Lai Sinh Thân
松元=Tùng Nguyên
松元仙人=Tùng Nguyên Tiên Nhân
松元仙王=Tùng Nguyên Tiên Vương
松元大老爷=Tùng Nguyên Đại Lão Gia
松元真仙=Tùng Nguyên Chân Tiên
松元神帝=Tùng Nguyên Thần Đế
松元道人=Tùng Nguyên Đạo Nhân
极乐=Cực Lạc
极乐仙帝=Cực Lạc Tiên Đế
极乐佛主=Cực Lạc Phật Chủ
极乐佛祖=Cực Lạc Phật Tổ
极乐先天=Cực Lạc Tiên Thiên
极乐圣境=Cực Lạc Thánh Cảnh
极乐大世界=Cực Lạc Đại Thế Giới
极乐天国=Cực Lạc Thiên Quốc
极乐天堂=Cực Lạc Thiên Đường
极乐天境苦行教主=Cực Lạc Thiên Cảnh Khổ Hành Giáo Chủ
极乐经咒=Cực Lạc kinh chú
极乐老佛=Cực Lạc Lão Phật
极乐老祖=Cực Lạc Lão Tổ
极乐道人=Cực Lạc Đạo Nhân
极乐道兄=Cực Lạc đạo huynh
极乐道友=Cực Lạc đạo hữu
林佐鸣=Lâm Tá Minh
林端尊者=Lâm Đoan Tôn Giả
果=Quả
果妈妈=Quả Ma Ma
果果=Quả Quả (tên riêng)
枪魂淬体心经=Thương Hồn Thối Thể Tâm Kinh
枭龙尊者=Kiêu Long Tôn Giả
柔=Nhu
柳=Liễu (tên gọi, không có bản dịch trực tiếp)
核心弟子=Hạch Tâm đệ tử
桐为轩=Đồng Vi Hiên
梧桐=Ngô Đồng
梧桐树=Cây Ngô Đồng
梧桐神树=Ngô Đồng Thần Thụ
梵隐神尊=Phạn Ẩn Thần Tôn
棋桶=Kỳ Đồng
棋盘=Kỳ Bàn
森罗=Sâm La
森罗万臂法相=Sâm La Vạn Tí Pháp Tướng
森罗万象=Sâm La Vạn Tượng
森罗之手=Sâm La Chi Thủ
森罗之躯=Thiên La Chi Khu
森罗分身=Sâm La phân thân
森罗印=Sâm La Ấn
森罗大圆满魔君=Sâm La Đại Viên Mãn Ma Quân
森罗大帝=Sâm La Đại Đế
森罗大帝化身=Sâm La Đại Đế hóa thân
森罗天庭=Sâm La Thiên Đình
森罗殿=Sâm La Điện
森罗法相=Sâm La Pháp Tướng
森罗狱天=Sâm La Ngục Thiên
森罗魔君=Sâm La Ma Quân
森罗魔尊=Sâm La Ma Tôn
森罗魔帝=Sâm La Ma Đế
森罗魔帝化身=Sâm La Ma Đế hóa thân
森罗魔庭=Sâm La Ma Đình
森罗魔手=Mô-thủ Sâm La
森罗魔皇=Sâm La Ma Hoàng
棱镜督天仪=Lăng Kính Đốc Thiên Nghi
棺椁=quan tài
椒图=Tiêu Đồ
楚断=Sở Đoạn
楚香香=Sở Hương Hương
楼伦神侯=Lâu Luân thần hầu
楼天=Lâu Thiên
楼船=lâu thuyền
楼船营=Lâu Thuyền Doanh
楼阁=lầu các
樊都统=Phàn Đô Thống
樊阕道人=Phàn Khuyết Đạo Nhân
欧振东=Âu Chấn Đông
欧振云=Âu Chấn Vân
欧振川=Âu Chấn Xuyên
欧振殇=Âu Chấn Thương
欧阳靖=Âu Dương Tĩnh
欧随真=Âu Tùy Chân
欧随靖=Âu Tùy Tĩnh
正宫帝后娘娘=Chính Cung Đế Hậu Nương Nương
正月初六=mùng sáu tháng giêng
步兵=Bộ Binh
步兵营=Bộ Binh Doanh
步军营=Bộ Quân Doanh
步姓=Bộ tính
步征=Bộ Chinh
步征步神侯=Bộ Chinh Bộ Thần Hầu
步征神尊=Bộ Chinh Thần Tôn
步神侯=Bộ Thần Hầu
武古文明=Văn minh Võ Cổ
武布天下=Võ Bố Thiên Hạ
武神帝=Võ Thần Đế
武臣=Võ thần
武通师弟=Võ Thông sư đệ
武通道人=Võ Thông đạo nhân
武道=Võ Đạo
死=Tử
死之剑意=Tử Chi Kiếm Ý
歼猾=gian hoạt
残月=Tàn Nguyệt
殿主=Điện chủ
毁灭=Diệt Vong
毁灭咒道=Hủy Diệt Chú Đạo
毁灭魔宫=Diệt Vong Ma Cung
毁灭魔尊=Diệt Vong Ma Tôn
母仪仙界=mẫu nghi tiên giới
母老虎=Mẹ hổ
毒蟾=Độc Thiềm
比丘尼=Tỳ Khưu Ni
比翼天=Bỉ Dực Thiên
毗=Tỳ
毛远公=Mao Viễn Công
气泡=bọt khí
气运=Khí Vận
气运七子=Khí Vận Thất Tử
气运之争=tranh đoạt khí vận
水=Thủy
水位=Thủy Vị
水工=Thủy Công
水工江=Thủy Công Giang
水师圣明旗=Thủy Sư Thánh Minh Kỳ
水师镇远旗副将圣公=Thủy Sư Trấn Viễn Kỳ Phó Tướng Thánh Công
水府=Thủy Phủ
水月宝镜=Thủy Nguyệt Bảo Kính
水月道人=Thủy Nguyệt đạo nhân
水火二旗=Thủy Hỏa Nhị Kỳ
水火双旗=Thủy Hỏa Song Kỳ
水灵珠=Thủy Linh Châu
水烟生=Thủy Yên Sinh
水莲灵根=Thủy Liên Linh Căn
水麒麟=Thủy Kỳ Lân
永恒不灭=Vĩnh Hằng Bất Diệt
永恒不灭的道心=Vĩnh Hằng Bất Diệt Đạo Tâm
永恒神炉=Vĩnh Hằng Thần Lô
永恒葬天炉=Vĩnh Hằng Táng Thiên Lô
永恒葬天炉和冥海玉瓶=Vĩnh Hằng Táng Thiên Lô và Minh Hải Ngọc Bình
永恒道兄=Vĩnh Hằng Đạo Huynh
永恒魔帝=Vĩnh Hằng Ma Đế
永恒魔皇=Vĩnh Hằng Ma Hoàng
江=Giang
江云莲=Giang Vân Liên
江兄=Giang huynh
江南=Giang Nam
江南好=Giang Nam hảo
江哲=Giang Triết
江坏胚=Giang Hại phôi
江大奸臣=Giang Đại Gian Thần
江大当家=Giang đại đương gia
江大教主=Giang Đại giáo chủ
江太墟=Giang Thái Khư
江太师=Giang Thái Sư
江太师夫人=Giang Thái Sư Phu Nhân
江太虚=Giang Thái Hư
江夫人=Giang phu nhân
江姑爷=Giang phò mã
江子川=Giang Tử Xuyên
江家=Giang gia
江家的小公主=Tiểu công chúa nhà họ Giang
江小友=Giang tiểu hữu
江小子=Giang tiểu tử
江山社稷图=Giang Sơn Xã Tắc Đồ
江师侄=Giang sư điệt
江师弟=Giang sư đệ
江府=Giang Phủ
江掌教=Giang chưởng giáo
江教主=Giang giáo chủ
江施主=Giang thí chủ
江无衣=Giang Vô Y
江月破浪诀=Giang Nguyệt Phá Lãng Quyết
江某=Giang mỗ
江某某=Giang mỗ mỗ
江母=Giang Mẫu
江爱琼=Giang Ái Quỳnh
江玄天=Giang Huyền Thiên
江琳=Giang Lâm
江祸水=Giang họa thủy
江老匹夫=Giang lão thất phu
江老弟=Giang lão đệ
江老爷=Giang Lão gia
江贤侄=Giang Hiền chất
江道友=Giang đạo hữu
江邪王=Giang Tà Vương
江雪=Giang Tuyết
江雪姐姐=Giang Tuyết tỷ tỷ
江雪晴=Giang Tuyết Tình
江雪道王=Giang Tuyết Đạo Vương
沈元君=Thẩm Nguyên Quân
沉沦魔城=Trầm Luân Ma Thành
沐琛=Mộc Sâm
沐琛魔尊=Mộc Sâm Ma Tôn
沙=Sa
沙王堡=Sa Vương Bảo
沙罗=Sa La
沙罗剑=Sa La Kiếm
沙罗大帝=Sa La Đại Đế
沙罗道友=Sa La đạo hữu
沙罗魔帝=Sa La Ma Đế
沙罗魔朝=Sa La Ma Triều
沙罗魔皇=Sa La Ma Hoàng
沙门=Sa Môn
沙门劫波=Sa Môn Kiếp Ba
沙门大教=Sa Môn Đại Giáo
沙门时代=Thời đại Sa Môn
沙门诸天=Sa Môn Chư Thiên
沙陀神皇=Sa Đà Thần Hoàng
河魁=Hà Khôi
河魁皇祖=Hà Khôi Hoàng Tổ
河鼓=Hà Cổ
沼泽=Đầm lầy
泉百川=Tuyền Bách Xuyên
泉百川真神=Tuyền Bách Xuyên Chân Thần
法=Pháp
法力=Pháp Lực
法华寺=Pháp Hoa Tự
法华生=Pháp Hoa Sinh
法古文明=Văn minh Pháp Cổ
法坛=Pháp Đàn
法天=Pháp Thiên
法天和尚=Pháp Thiên hòa thượng
法天师兄=Pháp Thiên sư huynh
法天象地=Pháp Thiên Tượng Địa
法宝=Pháp Bảo
法宝宝库=pháp bảo bảo khố
法帖=Pháp Thiếp
法度天=Pháp Độ Thiên
法旨=Pháp chỉ
法王=Pháp Vương
法相=Pháp Tướng
法相和尚=Pháp Tướng
法眼=Pháp Nhãn
法舟仙王=Pháp Chu Tiên Vương
法螺仙王=Pháp Loa Tiên Vương
法言神鼓=Pháp Ngôn Thần Cổ
法身=Pháp thân
法身道果=Pháp thân đạo quả
法身道果四位一体=Pháp Thân Đạo Quả Tứ Vị Nhất Thể
波煜魔尊=Ba Dục Ma Tôn
泥=Nê
泥犁地狱=Địa ngục Ni Lê
泰峰仙人=Thái Phong Tiên Nhân
洗地=Tẩy Địa
洗地的=tẩy địa
洛=Lạc
洛师=Lạc sư
洛师叔=Lạc sư thúc
洛师姐=Lạc sư tỷ
洛花音=Lạc Hoa Âm
洛花音女帝=Lạc Hoa Âm Nữ Đế
洛道友=Lạc đạo hữu
洞天=Động Thiên
洞天之宝=Động Thiên Chi Bảo
洞天境=Động Thiên Cảnh
洞天神府=Động Thiên thần phủ
洞庭=Động Đình
洞渊=Động Uyên
洞渊恶兽=Động Uyên ác thú
洞渊皇祖=Động Uyên Hoàng Tổ
洪儿=Hồng Nhi
洪武=Hồng Vũ
洪武前辈=Tiền bối Hồng Vũ
洪武道人=Hồng Vũ đạo nhân
洪流=hồng lưu
洪炉=Hồng Lô
洪荒=Hồng Hoang
洪荒圣宫=Hồng Hoang Thánh Cung
洪荒大世界=Hồng Hoang Đại Thế Giới
洪荒始龙=Hồng Hoang Thủy Long
洪荒老祖=Hồng Hoang lão tổ
洪钟=Hồng Chung
洪钟大吕=Hồng Chung Đại Lữ
流云神主=Lưu Vân Thần Chủ
流放之地=Lưu Phóng Chi Địa
流觞=Lưu Thương
浑天万象罗盘=Hồn Thiên Vạn Tượng La Bàn
浑天仪=Hồn Thiên Nghi
浑天大阵=Hồn Thiên Đại Trận
浑天神主=Hồn Thiên Thần Chủ
浑天魔尊=Hồn Thiên Ma Tôn
浩劫=Hạo Kiếp
浪屿元界=Lãng Dữ Nguyên Giới
浮白仙人=Phù Bạch Tiên Nhân
浮黎元君=Phù Lê Nguyên Quân
浮黎元君媞轩薇=Phù Lê Nguyên Quân Đề Hiên Vi
浮黎圣母元君=Phù Lê Thánh Mẫu Nguyên Quân
浮黎圣母元君媞轩薇=Phù Lê Thánh Mẫu Nguyên Quân Đề Hiên Vy
浮黎圣父教主=Phù Lê Thánh Phụ Giáo Chủ
海州=Hải Châu
海王=Hải Vương
涅槃圣火=Niết Bàn Thánh Hỏa
淑女=Thục nữ
混乱元君=Hỗn Loạn Nguyên Quân
混乱战神鼓=Hỗn Loạn Chiến Thần Cổ
混元=Hỗn Nguyên
混元一气孔雀明王经=Hỗn Nguyên Nhất Khí Khổng Tước Minh Vương Kinh
混元三千杀道图=Hỗn Nguyên Tam Thiên Sát Đạo Đồ
混元三圣=Hỗn Nguyên Tam Thánh
混元天伞=Hỗn Nguyên Thiên Tán
混元天罗伞=Hỗn Nguyên Thiên La Tán
混元无极圣人=Hỗn Nguyên Vô Cực Thánh Nhân
混元杀道图=Hỗn Nguyên Sát Đạo Đồ
混元玄天圣人=Hỗn Nguyên Huyền Thiên Thánh Nhân
混元珠=Hỗn Nguyên Châu
混元翻天绫=Hỗn Nguyên Phiên Thiên Lăng
混沌=Hỗn Độn
混沌不空经=Hỗn Độn Bất Không Kinh
混沌世界=Hỗn Độn thế giới
混沌之气=Hỗn Độn Chi Khí
混沌五重天=Hỗn Độn Ngũ Trọng Thiên
混沌仙人=Hỗn Độn Tiên Nhân
混沌仙剑=Hỗn Độn Tiên Kiếm
混沌仙君=Hỗn Độn Tiên Quân
混沌仙帝=Hỗn Độn Tiên Đế
混沌仙道=Hỗn Độn Tiên Đạo
混沌仙钟=Hỗn Độn Tiên Chung
混沌元婴=Hỗn Độn Nguyên Anh
混沌元神=Hỗn Độn Nguyên Thần
混沌先天=Hỗn Độn Tiên Thiên
混沌先天异象=Hỗn Độn Tiên Thiên Dị Tượng
混沌八古神=Hỗn Độn Bát Cổ Thần
混沌勾陈雷劫=Hỗn Độn Câu Trần Lôi Kiếp
混沌古气=hỗn độn cổ khí
混沌古神=Hỗn Độn Cổ Thần
混沌古魔=Hỗn Độn Cổ Ma
混沌后土雷劫=Hỗn Độn Hậu Thổ Lôi Kiếp
混沌圣帝钟天=Hỗn Độn Thánh Đế Chung Thiên
混沌大曰符文=Hỗn Độn Đại Nhật Phù Văn
混沌大道=Hỗn Độn Đại Đạo
混沌天元钟=Hỗn Độn Thiên Nguyên Chung
混沌天君=Hỗn Độn Thiên Quân
混沌天国=Hỗn Độn Thiên Quốc
混沌天弓=Hỗn Độn Thiên Cung
混沌天火=Hỗn Độn Thiên Hỏa
混沌天龙=Hỗn Độn Thiên Long
混沌天龙八音钟=Hỗn Độn Thiên Long Bát Âm Chung
混沌天龙大神通=Hỗn Độn Thiên Long đại thần thông
混沌天龙符文=Hỗn Độn Thiên Long Phù Văn
混沌奇兵=Hỗn Độn Kỳ Binh
混沌孔雀=Hỗn Độn Khổng Tước
混沌宇宙=hỗn độn vũ trụ
混沌家乡=Hỗn Độn Gia Hương
混沌小世界=Hỗn Độn tiểu thế giới
混沌巨龙=Hỗn Độn Cự Long
混沌年=Niên Hỗn Độn
混沌异火=Hỗn Độn Dị Hỏa
混沌教主=Hỗn Độn Giáo Chủ
混沌教主大衍=Hỗn Độn Giáo Chủ Đại Diễn
混沌斩仙剑=Hỗn Độn Trảm Tiên Kiếm
混沌时代=Thời đại hỗn độn
混沌月桂神树=Hỗn Độn Nguyệt Quế Thần Thụ
混沌洞天=Hỗn Độn Động Thiên
混沌海=Hỗn Độn Hải
混沌灵帝=Hỗn Độn Linh Đế
混沌灵帝灵女=Hỗn Độn Linh Đế Linh Nữ
混沌灵根=Hỗn Độn Linh Căn
混沌灵珠=Hỗn Độn Linh Châu
混沌玄青雷劫=Hỗn Độn Huyền Thanh Lôi Kiếp
混沌玉柱=Hỗn Độn ngọc trụ
混沌珍奇=Hỗn Độn Trân Kỳ
混沌界=Hỗn Độn Giới
混沌界印=Hỗn Độn Giới Ấn
混沌界域=Hỗn Độn Giới Vực
混沌界域真经=Chân Kinh Giới Vực Hỗn Độn
混沌瘟帝=Hỗn Độn Ôn Đế
混沌真仙=Hỗn Độn Chân Tiên
混沌真仙青玄=Hỗn Độn Chân Tiên Thanh Huyền
混沌神国=Hỗn Độn Thần Quốc
混沌神城=Hỗn Độn Thần Thành
混沌神帝=Hỗn Độn Thần Đế
混沌神族=Hỗn Độn Thần Tộc
混沌神通=Hỗn Độn Thần Thông
混沌神魔=Hỗn Độn Thần Ma
混沌符文=Hỗn Độn Phù Văn
混沌紫竹=Hỗn Độn Tử Trúc
混沌紫金=hỗn độn tử kim
混沌紫霄雷劫=Hỗn Độn Tử Tiêu Lôi Kiếp
混沌肉身=Hỗn Độn Nhục Thân
混沌莲叶灵根=Hỗn Độn Liên Diệp Linh Căn
混沌虹桥=Cầu vồng hỗn độn
混沌誓言=Hỗn Độn Thệ Ngôn
混沌诛仙剑=Hỗn Độn Tru Tiên Kiếm
混沌道君=Hỗn Độn Đạo Quân
混沌道果=Hỗn Độn Đạo Quả
混沌金=Hỗn Độn Kim
混沌金乌=Hỗn Độn Kim Ô
混沌钟=Hỗn Độn Chung
混沌铁=Hỗn Độn Thiết
混沌魔教=Hỗn Độn Ma Giáo
混沌魔神=Hỗn Độn Ma Thần
混沌鸿蒙=Hỗn Độn Hồng Mông
混沌鸿蒙之气=Hỗn Độn Hồng Mông Chi Khí
混沌鸿蒙气=khí hỗn độn hồng mông
混沌鸿蒙空间=Hỗn Độn Hồng Mông Không Gian
混沌龙祖=Hỗn Độn Long Tổ
混洞境=Hỗn Động Cảnh
清幽天=Thanh U Thiên
清心石=Thanh Tâm Thạch
清月上尊=Thanh Nguyệt Thượng Tôn
清虚=Thanh Hư
清虚道人=Thanh Hư Đạo Nhân
清虚道君=Thanh Hư Đạo Quân
清风=Thanh Phong
渊宣=Uyên Tuyên
渊宣大帝=Uyên Tuyên Đại Đế
温青=Ôn Thanh
游长老=Du trưởng lão
游韵神尊=Du Vận Thần Tôn
湮灭=yên diệt
湿婆罗木=Thấp Bà La Mộc
源始之地=Nguyên Thủy Chi Địa
源胎印=Nguyên Thai Ấn
溯天侯=Tố Thiên Hầu
溯天帝=Tố Thiên Đế
溯神侯=Tố Thần Hầu
溯还白=Tố Hoàn Bạch
溯还白溯天侯=Tố Hoàn Bạch Tố Thiên Hầu
滕王仙阁=Đằng Vương Tiên Các
滕道友=Đằng đạo hữu
满朝文武=Mãn Triều Văn Võ
滴水崖石刻=Tích Thủy Nhai thạch khắc
漠山神主=Mạc Sơn Thần Chủ
漠海=Mạc Hải
漠海媞香宝卷=Mạc Hải Đề Hương Bảo Quyển
潘凤=Phan Phụng
潘凤真神=Phan Phụng chân thần
潘帅=Phan Soái
潘庶昌=Phan Thứ Xương
潜龙=Tiềm Long
潜龙军师=Tiềm Long Quân Sư
潜龙勿用=Tiềm Long vật dụng
潜龙遁世无闷=Tiềm Long độn thế vô muộn
潜龙道人=Tiềm Long Đạo Nhân
濯山道人=Trạc Sơn Đạo Nhân
灌老鼠=灌 chuột (Không có bản dịch trực tiếp, thuật ngữ ám chỉ việc dìm chết chuột bằng nước)
火=Hỏa
火云=Hỏa Vân
火云仙珠=Hỏa Vân Tiên Châu
火云祝家=Hỏa Vân Chúc Gia
火云神体=Hỏa Vân Thần Thể
火元力=Hỏa Nguyên Lực
火凤=Hỏa Phượng
火德圣师=Hỏa Đức Thánh Sư
火德圣师旗=Hỏa Đức Thánh Sư kỳ
火德星部=Hỏa Đức Tinh Bộ
火流星=Hỏa Lưu Tinh
火灵珠=Hỏa Linh Châu
火炉=Hỏa Lô
火皇剑道=Hỏa Hoàng Kiếm Đạo
火系仙祖=Hỏa hệ Tiên Tổ
火蟒=Hỏa Mãng
火道人=Hỏa Đạo Nhân
火鸦=Hỏa Nha
火龙枪=Hỏa Long Thương
火龙神国=Hỏa Long Thần Quốc
灭世=Diệt Thế
灭世印=Diệt Thế Ấn
灭世大磨=Diệt Thế Đại Ma
灭元界=Diệt Nguyên Giới
灭天=Diệt Thiên
灭天邪皇=Diệt Thiên Tà Hoàng
灭天飞梭=Diệt Thiên Phi Toa
灭天魔皇=Diệt Thiên Ma Hoàng
灭界之战=Diệt Giới Chi Chiến
灭神母舰=Diệt Thần mẫu hạm
灭神魔光=Diệt Thần Ma Quang
灭神魔光炮=Diệt Thần Ma Quang Pháo
灰色神鹰=Thần Ưng Xám
灵=Linh
灵主=Linh Chủ
灵儿=Linh Nhi
灵光=Linh quang
灵台=Linh Đài
灵图=Linh Đồ
灵女=Linh Nữ
灵女道母=Linh Nữ Đạo mẫu
灵宇大帝=Linh Vũ Đại Đế
灵宗=Linh Tông
灵宝=Linh Bảo
灵宝圣教=Linh Bảo Thánh Giáo
灵宝大道=Linh Bảo Đại Đạo
灵宝时代=Linh Bảo Thời Đại
灵宝道主=Linh Bảo Đạo Chủ
灵宝道君=Linh Bảo Đạo Quân
灵山=Linh Sơn
灵悲佛仙=Linh Bi Phật Tiên
灵感=Linh Cảm
灵根=Linh Căn
灵气=Linh khí
灵河道人=Linh Hà Đạo Nhân
灵河道友=Linh Hà Đạo Hữu
灵泉=Linh Tuyền
灵液=Linh dịch
灵湖=linh hồ
灵灵姐=Linh Linh tỷ
灵王龛=Linh Vương Khám
灵珠=Linh Châu
灵珠子=Linh Châu Tử
灵界=Linh giới
灵石=Linh Thạch
灵石灵液=Linh Thạch Linh Dịch
灵破劲=Linh Phá Kính
灵秀峰=Linh Tú Phong
灵符=Linh Phù
灵肉一体=Linh Nhục Nhất Thể
灵蟾子=Linh Thiềm Tử
灵道=Linh Đạo
灵道子=Linh Đạo Tử
灵道子师兄=Linh Đạo Tử sư huynh
灵道神帝=Linh Đạo Thần Đế
灵郡主=Linh quận chúa
灵雨=Linh Vũ
灵雪=Linh Tuyết
灵雪神主=Linh Tuyết Thần Chủ
灵雪神尊=Linh Tuyết Thần Tôn
灵龟=Linh Quy
炎峰魔尊=Viêm Phong Ma Tôn
炎州=Viêm Châu
炫阳神尊=Huyễn Dương Thần Tôn
炼天兵部=Luyện Thiên Binh Bộ
炼天大旗=Luyện Thiên Đại Kỳ
炼天大阵=Luyện Thiên Đại Trận
炼宙荒神石=luyện Trụ Hoang Thần Thạch
炼狱=Luyện Ngục
炼神大阵=Luyện Thần Đại Trận
烈曰=Liệt Nhật
烈火烹油=Liệt Hỏa Phanh Du (lửa cháy dầu)
烈火谷=Liệt Hỏa Cốc
烛渊=Chúc Uyên
烛陌=Chúc Mạch
烛龙=Chúc Long
烛龙族=Chúc Long tộc
烛龙灵根=Chúc Long Linh Căn
烟儿=Yên Nhi
烟花=pháo hoa
焚世枪=Phần Thế Thương
焱朵朵=Diễm Đóa Đóa
熊千里=Hùng Thiên Lý
熊魔王=Hùng Ma Vương
熊魔王熊千里=Hùng Ma Vương Hùng Thiên Lý
熙儿=Hi Nhi
熙帅=Hi Soái
熙皇=Hi Hoàng
熙皇太子=Hi Hoàng Thái tử
燕京=Bắc Kinh
燕公戬=Yên Công Tiễn
燕师兄=Yến sư huynh
燕祖师=Yến Tổ Sư
燕苍天=Yến Thương Thiên
爱琼=Ái Quỳnh
父皇=Phụ Hoàng
父神=Phụ Thần
爹=Cha
牛斗=Ngưu Đấu
牛斗句芒枪=Ngưu Đấu Cú Mang thương
牛斗大枪=Ngưu Đấu đại thương
牛斗天煞枪=Ngưu Đấu Thiên Sát Thương
牛斗定海枪=Ngưu Đấu Định Hải Thương
牛斗焚世枪=Ngưu Đấu Phần Thế Thương
牛斗神枪=Ngưu Đấu Thần Thương
牛斗载德枪=Ngưu Đấu Tải Đức Thương
牛首人身=ngưu thủ nhân thân
牛龙=Ngưu Long
牛龙神音=Ngưu Long Thần Âm
牧山=Mục Sơn
牧山道人=Mục Sơn đạo nhân
牲畜=súc vật
牵牛=Khiên Ngưu
狂风过境=Cuồng Phong Quá Cảnh
狄云=Địch Vân
狐尊=Hồ Tôn
狐尊仙王=Hồ Tôn Tiên Vương
独步=Độc Bộ
独步天下=Độc Bộ Thiên Hạ
独眼大天魔=Độc Nhãn Đại Thiên Ma
独眼道人=Độc Nhãn Đạo Nhân
狱主=Ngục Chủ
狱守=Ngục Thủ
狱楼=Ngục Lâu
狱法天王=Ngục Pháp Thiên Vương
狱法道友=Ngục Pháp đạo hữu
狱灵=Ngục Linh
狱王=Ngục Vương
狱门=Ngục Môn
狴犴=Tỳ Ngạn
狻猊=Toan Nghê
狻猊妖王=Toan Nghê Yêu Vương
猎户相康=Thợ săn Tương Khang
猪=Trư (Heo)
猪夫人=Chư phu nhân
猪婆=Trư bà
玄之至尊=Huyền Chi Chí Tôn
玄元圣水旗=Huyền Nguyên Thánh Thủy Kỳ
玄元鼎=Huyền Nguyên Đỉnh
玄公=Huyền Công
玄公王府=Huyền Công Vương phủ
玄关=Huyền Quan
玄冥神水=Huyền Minh Thần Thủy
玄冰峰=Huyền Băng Phong
玄功=Huyền Công
玄台=Huyền Đài
玄台境=Huyền Đài Cảnh
玄台金人=Huyền Đài Kim Nhân
玄壶道人=Huyền Hồ Đạo Nhân
玄天=Huyền Thiên
玄天上宫=Huyền Thiên Thượng Cung
玄天世界=Huyền Thiên Thế Giới
玄天书院=Huyền Thiên Thư Viện
玄天仙域=Huyền Thiên Tiên Vực
玄天圣宗=Huyền Thiên Thánh Tông
玄天圣教主=Huyền Thiên Thánh Giáo Chủ
玄天大帝=Huyền Thiên Đại Đế
玄天大老爷=Huyền Thiên Đại Lão Gia
玄天大魔神=Huyền Thiên Đại Ma Thần
玄天宫=Huyền Thiên Cung
玄天小友=Huyền Thiên tiểu hữu
玄天小鬼=Tiểu quỷ Huyền Thiên
玄天师兄=Huyền Thiên sư huynh
玄天师弟=Huyền Thiên sư đệ
玄天教=Huyền Thiên Giáo
玄天教主=Huyền Thiên Giáo Chủ
玄天教主夫人=Huyền Thiên Giáo Chủ phu nhân
玄天旗主=Huyền Thiên kỳ chủ
玄天江=Huyền Thiên Giang
玄天神宫=Huyền Thiên Thần Cung
玄天神帝=Huyền Thiên Thần Đế
玄天神殿=Huyền Thiên Thần Điện
玄天道人=Huyền Thiên Đạo Nhân
玄天道友=Huyền Thiên đạo hữu
玄天部=Huyền Thiên bộ
玄天金阙=Huyền Thiên Kim Khuyết
玄天金阙凌霄宝殿=Huyền Thiên Kim Khuyết Lăng Tiêu Bảo Điện
玄天金阙后宫=Huyền Thiên Kim Khuyết Hậu Cung
玄天门下=Huyền Thiên môn hạ
玄女=Huyền Nữ
玄女仙君=Huyền Nữ Tiên Quân
玄女冰宫=Huyền Nữ Băng Cung
玄女娘娘=Huyền Nữ nương nương
玄州=Huyền Châu
玄州大罗天军=Huyền Châu Đại La Thiên Quân
玄幽=Huyền U
玄幽道人=Huyền U Đạo Nhân
玄幽镇道鼎=Huyền U trấn đạo đỉnh
玄度佛尊=Huyền Độ Phật Tôn
玄度师伯=Huyền Độ Sư Bá
玄恒道人=Huyền Hằng đạo nhân
玄明三界=Huyền Minh Tam Giới
玄明元界=Huyền Minh Nguyên Giới
玄明元界之主=Nguyên Giới Chi Chủ Huyền Minh
玄明大世界=Huyền Minh Đại Thế Giới
玄明大陆=Huyền Minh đại lục
玄明玄关=Huyền Minh Huyền Quan
玄明罗天镜=Huyền Minh La Thiên Kính
玄梵=Huyền Phạn
玄武=Huyền Vũ
玄武仙王=Huyền Vũ Tiên Vương
玄武宫=Huyền Vũ Cung
玄武神主=Huyền Vũ Thần Chủ
玄武营=Huyền Vũ Doanh
玄武道人=Huyền Vũ Đạo Nhân
玄武道君=Huyền Vũ Đạo Quân
玄武重师=Huyền Vũ Trọng Sư
玄武重师大营=Huyền Vũ Trọng Sư Đại Doanh
玄武重师旗=Huyền Vũ Trọng Sư kỳ
玄气青龙=Huyền Khí Thanh Long
玄祖=Huyền Tổ
玄穹九霄=Huyền Khung Cửu Tiêu
玄竹月=Huyền Trúc Nguyệt
玄胎=Huyền Thai
玄胎印=Huyền Thai Ấn
玄胎神人=Huyền Thai Thần Nhân
玄胎证道之法=Huyền Thai Chứng Đạo Chi Pháp
玄胎金人=Huyền Thai Kim Nhân
玄蛇=Huyền Xà
玄贺道人=Huyền Hạ đạo nhân
玄道=Huyền Đạo
玄道时代=Huyền Đạo Thời Đại
玄都=Huyền Đô
玄都**=Huyền Đô
玄都**天书=Huyền Đô Đạo Kinh
玄都七宝林=Huyền Đô Thất Bảo Lâm
玄都仙人=Huyền Đô Tiên Nhân
玄都仙君=Hoa Đô Tiên Quân
玄都仙城=Huyền Đô Tiên Thành
玄都古仙=Huyền Đô Cổ Tiên
玄都圣境=Huyền Đô Thánh Cảnh
玄都圣教=Huyền Đô Thánh Giáo
玄都境=Huyền Đô cảnh
玄都大劫=Huyền Đô Đại Kiếp
玄都天君=Huyền Đô Thiên Quân
玄都师兄=Huyền Đô sư huynh
玄都忘情天书=Huyền Đô Vong Tình Thiên Thư
玄都神府=Huyền Đô Thần Phủ
玄都神识=Huyền Đô thần thức
玄都老爷=Huyền Đô lão gia
玄都造化大教=Huyền Đô Tạo Hóa Đại Giáo
玄都造化天君=Huyền Đô Tạo Hóa Thiên Quân
玄都造化道君=Huyền Đô Tạo Hóa Đạo Quân
玄都造化道尊=Huyền Đô Tạo Hóa Đạo Tôn
玄都道人=Huyền Đô Đạo Nhân
玄都道果=Huyền Đô đạo quả
玄门人仙=Huyền Môn Nhân Tiên
玄隐=Huyền Ẩn
玄隐道人=Huyền Ẩn đạo nhân
玄青=Huyền Thanh
玄青仙君=Huyền Thanh Tiên Quân
玄青仙宫=Huyền Thanh tiên cung
玄青仙王=Huyền Thanh Tiên Vương
玄青十三真人=Huyền Thanh Thập Tam Chân Nhân
玄青大老爷=Huyền Thanh Đại Lão gia
玄青天=Huyền Thanh Thiên
玄青天宫=Huyền Thanh Thiên Cung
玄青宫=Huyền Thanh Cung
玄青老鬼=Huyền Thanh lão quỷ
玄青衣=Huyền Thanh Y
玄青道人=Huyền Thanh Đạo Nhân
玄鸟=Huyền Điểu
玄鸟大尊=Huyền Điểu Đại Tôn
玄黄=Huyền Hoàng
玄黄一气自在经=Huyền Hoàng Nhất Khí Tự Tại Kinh
玄黄之气=Khí Huyền Hoàng
玄黄之躯=Huyền Hoàng chi khu
玄黄二气=Huyền Hoàng Nhị Khí
玄黄圣山=Huyền Hoàng Thánh Sơn
玄黄圣金=Huyền Hoàng Thánh Kim
玄黄大世界=Huyền Hoàng Đại Thế Giới
玄黄太极图=Huyền Hoàng Thái Cực Đồ
玄黄学宫=Huyền Hoàng Học Cung
玄黄宝塔=Huyền Hoàng bảo tháp
玄黄母气=Huyền Hoàng mẫu khí
玄黄派系=Huyền Hoàng phái hệ
玄黄神体=Huyền Hoàng Thần Thể
玄黄神帝=Huyền Hoàng Thần Đế
玄黄老祖=Huyền Hoàng Lão Tổ
玄黄苍茫=Huyền Hoàng Thương Mang
玄黄道人=Huyền Hoàng Đạo Nhân
玄黄道体=Huyền Hoàng Đạo Thể
玄黄镇道鼎=Huyền Hoàng Trấn Đạo Đỉnh
玄黄阴阳=Huyền Hoàng Âm Dương
玄黄阴阳四象五行[***]八荒九宫天干地支=Huyền Hoàng Âm Dương Tứ Tượng Ngũ Hành [***] Bát Hoang Cửu Cung Thiên Can Địa Chi
玄龟=Huyền Quy
玄龟师伯=Huyền Quy sư bá
玄龟师叔=Huyền Quy sư thúc
玉=Ngọc
玉京=Ngọc Kinh
玉京仙君=Ngọc Kinh Tiên Quân
玉京仙城=Ngọc Kinh Tiên Thành
玉京仙王=Ngọc Kinh Tiên Vương
玉京圣教=Ngọc Kinh Thánh Giáo
玉京城=Ngọc Kinh thành
玉京境=Ngọc Kinh Cảnh
玉京天君=Ngọc Kinh Thiên Quân
玉京宝船=Ngọc Kinh Bảo Thuyền
玉京宫=Ngọc Kinh Cung
玉京忘情仙帝=Ngọc Kinh Vong Tình Tiên Đế
玉京忘情先天=Ngọc Kinh Vong Tình Tiên Thiên
玉京感应诀=Ngọc Kinh Cảm Ứng Quyết
玉京教主=Ngọc Kinh Giáo Chủ
玉京楼船=Ngọc Kinh Lâu Thuyền
玉京玄宫天=Ngọc Kinh Huyền Cung Thiên
玉京玄宫天忘情仙帝=Ngọc Kinh Huyền Cung Thiên Vong Tình Tiên Đế
玉京神府=Ngọc Kinh Thần Phủ
玉京神识=Ngọc Kinh thần thức
玉京神识神府=Ngọc Kinh Thần Thức Thần Phủ
玉京老爷=Ngọc Kinh lão gia
玉京道君=Ngọc Kinh Đạo Quân
玉京道尊=Ngọc Kinh Đạo Tôn
玉仙=Ngọc Tiên
玉仙儿=Ngọc Tiên Nhi
玉佩=Ngọc bội
玉夫人=Ngọc phu nhân
玉宫=Ngọc Cung
玉宫仙君=Ngọc Cung Tiên Quân
玉宫境=Ngọc Cung Cảnh
玉宫大老爷=Ngọc Cung Đại Lão Gia
玉宫神府=Ngọc Cung Thần Phủ
玉家=Ngọc gia
玉容=Ngọc Dung
玉容小郡王=Ngọc Dung Tiểu Quận Vương
玉容神主=Ngọc Dung Thần Chủ
玉容郡王=Ngọc Dung Quận Vương
玉林=Ngọc Lâm
玉林仙君=Ngọc Lâm Tiên Quân
玉林子=Ngọc Lâm Tử
玉桶=Ngọc đồng
玉梭=Ngọc Toa
玉清=Ngọc Thanh
玉清圣境=Ngọc Thanh Thánh Cảnh
玉灵芝法王=Ngọc Linh Chi Pháp Vương
玉焕天=Ngọc Hoán Thiên
玉牒=Ngọc Điệp
玉玲仙子=Ngọc Linh Tiên Tử
玉琉璃界=Ngọc Lưu Ly Giới
玉生香=Ngọc Sinh Hương
玉皇=Ngọc Hoàng
玉皇仙君=Ngọc Hoàng Tiên Quân
玉皇仙宫=Ngọc Hoàng Tiên Cung
玉皇仙王=Ngọc Hoàng Tiên Vương
玉皇仙王大阵=Ngọc Hoàng Tiên Vương Đại Trận
玉皇大帝=Ngọc Hoàng Đại Đế
玉皇大老爷=Ngọc Hoàng Đại Lão gia
玉皇天=Ngọc Hoàng Thiên
玉皇天多妍神主=Ngọc Hoàng Thiên Đa Nghiên Thần chủ
玉皇天子=Ngọc Hoàng Thiên Tử
玉皇天宫=Ngọc Hoàng Thiên Cung
玉皇天帝=Ngọc Hoàng Thiên Đế
玉皇天沁钰法王之墓=Mộ của Ngọc Hoàng Thiên Thấm Ngọc Pháp Vương
玉皇天犼天妖尊之墓=Mộ của Ngọc Hoàng Thiên Hống Thiên Yêu Tôn
玉皇天皎月女尊之墓=Mộ của Ngọc Hoàng Thiên Kiểu Nguyệt Nữ Tôn
玉皇太子=Ngọc Hoàng Thái Tử
玉皇宫=Ngọc Hoàng Cung
玉皇席应情=Ngọc Hoàng Tịch Ứng Tình
玉皇殿=Ngọc Hoàng Điện
玉皇神图=Ngọc Hoàng Thần Đồ
玉皇老儿=Ngọc Hoàng lão nhi
玉皇金书=Ngọc Hoàng Kim Thư
玉真=Ngọc Chân
玉真上人=Ngọc Chân Thượng Nhân
玉真大帝=Ngọc Chân Đại Đế
玉真神帝=Ngọc Chân Thần Đế
玉真道衣=Ngọc Chân Đạo Y
玉笙世界=Ngọc Sanh Thế Giới
玉笙元界=Ngọc Sanh Nguyên Giới
玉符=Ngọc Phù
玉菩萨=Ngọc Bồ Tát
玉虚神火=Ngọc Hư Thần Hỏa
玉钰=Ngọc Dụ
玉钰真人=Ngọc Dục chân nhân
王娘=Vương Nương
王道明=Vương Đạo Minh
玲珑=Linh Lung
玲珑仙君=Linh Lung Tiên Quân
玲珑天君= Linh Lung Thiên Quân
玲珑子=Linh Lung Tử
玲珑小道童=Linh Lung tiểu đạo đồng
玲珑道人=Linh Lung Đạo Nhân
玲珑道君=Linh Lung Đạo Quân
玲珑道童=Linh Lung đạo đồng
玲珑镇仙鼎=Linh Lung Trấn Tiên Đỉnh
珈蓝=Già Lam
珈蓝尊者=Già Lam Tôn Giả
珈蓝神殿=Già Lam Thần Điện
珠珠=Châu Châu
珠珠哥=Châu Châu ca
珠花=chu hoa
琅琊=Lang Nha
琅琊水师=Lang Gia Thủy Sư
琅琊水师旗=Lang Gia Thủy Sư kỳ
琅轩=Lang Hiên
琅轩道尊=Lang Hiên Đạo Tôn
琅青丝=Lang Thanh Ti
琉璃塔=Lưu Ly Tháp
琉璃宫=Lưu Ly Cung
琉璃玉如意=Lưu Ly Ngọc Như Ý
琉璃神主=Lưu Ly Thần Chủ
琉璃神君=Lưu Ly Thần Quân
琉璃神尊=Lưu Ly Thần Tôn
琉璃神殿=Lưu Ly Thần Điện
琳儿=Lâm Nhi
琴棋书画=cầm kỳ thư họa
琵琶骨=Tỳ bà cốt
琼华=Quỳnh Hoa
琼华夫人=Quỳnh Hoa phu nhân
琼华娘娘=Quỳnh Hoa Nương Nương
瑶台=Dao Đài
瑶台境=Dao Đài Cảnh
瑶池=Dao Trì
瑶琴=Dao Cầm
瑶瑶=Dao Dao
璟玥=Cảnh Duệ
璟玥女君=Cảnh Nguyệt Nữ Quân
甄婉君=Chân Uyển Quân
甜头=ngọt bùi
生之剑意=Sinh Chi Kiếm Ý
生死万化魔轮=Sinh Tử Vạn Hóa Ma Luân
生死万化魔轮印=Sinh Tử Vạn Hóa Ma Luân Ấn
生死万化魔轮经=Sinh Tử Vạn Hóa Ma Luân Kinh
生死台=Sinh Tử Đài
生死轮回之盘=Sinh tử luân hồi chi bàn
生灵=Sinh Linh
甫嵩天神=Phủ Tung Thiên Thần
田丰=Điền Phong
田丰神主=Điền Phong Thần chủ
电之剑意=Điện Chi Kiếm Ý
画舫=Họa Phỏng
界王图=Giới Vương Đồ
疥癣之患=Giới tiễn chi hoạn
瘟帝=Ôn Đế
瘟帝棺=Ôn Đế Quan
瘟毒神主=Ôn Độc Thần Chủ
瘟疫=Ôn Dịch
瘟疫之气=Ôn dịch chi khí
癫道人=Điên đạo nhân
登仙之地=Đăng Tiên Chi Địa
白云叟=Bạch Vân Tẩu
白使神人=Bạch Sứ Thần Nhân
白发皓首=tóc trắng đầu bạc
白发苍苍的老神尊=Lão thần tôn tóc bạc phơ
白帝剑道=Bạch Đế Kiếm Đạo
白沧海=Bạch Thương Hải
白泽氏=Bạch Trạch thị
白溯神侯=Bạch Tố Thần Hầu
白玉双角神犀=Bạch Ngọc Song Giác Thần Tê
白玉瓶=bình bạch ngọc
白玉金睛麒麟=Bạch Ngọc Kim Tinh Kỳ Lân
白眼狼=bạch nhãn lang
白虎=Bạch Hổ
白虎宫=Bạch Hổ Cung
白虎金精=Bạch Hổ kim tinh
白衣女居士=Bạch Y Nữ Cư Sĩ
白衣女神主=Bạch Y nữ thần chủ
白衣少年=Thiếu niên áo trắng
白衣道空=Bạch Y Đạo Không
白马=Bạch Mã
白马僧人玉真=Bạch Mã tăng nhân Ngọc Chân
白骨之城=Bạch Cốt Chi Thành
白骨大佛=Bạch Cốt Đại Phật
白骨巨人=Bạch Cốt Cự Nhân
白骨狼牙棒=Bạch Cốt Lang Nha Bổng
白鹳关青山=Bạch Quán Quan Thanh Sơn
白龙魄=Bạch Long Phách
百万仙人大军=triệu đại quân tiên nhân
百万大军=triệu đại quân
百万天河水师=Bách Vạn Thiên Hà Thủy Sư
百万恒河星砂佛陀=Bách Vạn Hằng Hà Tinh Sa Phật Đà
百万神魔=Bách Vạn Thần Ma
百分之一的道祖=một phần trăm của Đạo Tổ
百十=hơn một trăm
百十尊神魔=trăm vị thần ma
百国考核=Bách Quốc Khảo Hạch
百度风云榜=Bảng Phong Vân Baidu
百晓楼=Bách Hiểu Lâu
百晓楼主=Bách Hiểu Lâu chủ
百灵山=Bách Linh Sơn
百里冰=Bách Lý Băng
百里至尊=Bách Lý Chí Tôn
皇图=Hoàng Đồ
皇图葬天渊魔=Hoàng Đồ Táng Thiên Uyên Ma
皇图葬天渊魔经=Hoàng Đồ Táng Thiên Uyên Ma Kinh
皇图霸业=Hoàng Đồ Bá Nghiệp
皇图魔渊=Hoàng Đồ Ma Uyên
皇天圣火=Hoàng Thiên Thánh Hỏa
皇天无极=Hoàng Thiên Vô Cực
皇天星斗大阵=Hoàng Thiên Tinh Đấu đại trận
皇太子=Hoàng Thái Tử
皇极道钟=Hoàng Cực Đạo Chung
皇甫=Hoàng Phủ
皇甫仙王=Hoàng Phủ Tiên Vương
皇甫冰焰=Hoàng Phủ Băng Diễm
皇祖=Hoàng Tổ
皇道=Hoàng Đạo
皇道三印=Hoàng Đạo Tam Ấn
皇道大旗=Hoàng Đạo Đại Kỳ
皇道大神通=Hoàng Đạo Đại Thần Thông
皇道极兵=Hoàng Đạo Cực Binh
皇道极境=Hoàng Đạo Cực Cảnh
皇道正统印=Hoàng Đạo Chính Thống Ấn
皇道至尊印=Hoàng Đạo Chí Tôn Ấn
皇道道则=Hoàng Đạo Đạo Tắc
皇道青莲=Hoàng Đạo Thanh Liên
皇陵帝棺=hoàng lăng đế quan
监天司=Giám Thiên Tư
监天司天眼神君=Giám Thiên Tư Thiên Nhãn Thần Quân
监星司=Giám Tinh Tư
盘古=Bàn Cổ
盘古十二天轮=Bàn Cổ Thập Nhị Thiên Luân
盘古十二鸿蒙大阵=Bàn Cổ Thập Nhị Hồng Mông Đại Trận
盘古天轮=Bàn Cổ Thiên Luân
盛德木师旗=Thịnh Đức Mộc Sư kỳ
盟主=Minh Chủ
相康=Tương Khang
相康道人=Tương Khang đạo nhân
眉心=Mi tâm
眉心紫府=Mi tâm Tử phủ
眉心魔狱=Mi tâm Ma ngục
真仙=Chân Tiên
真仙大老爷=Chân Tiên Đại Lão Gia
真仙麒麟=Chân Tiên Kỳ Lân
真传弟子=Chân Truyền đệ tử
真传长老=Chân Truyền trưởng lão
真佛舍利=Chân Phật Xá Lợi
真法=Chân Pháp
真法佛祖=Chân Pháp Phật Tổ
真法佛陀=Chân Pháp Phật Đà
真灵圣女=Chân Linh Thánh Nữ
真灵玄女=Chân Linh Huyền Nữ
真灵魔帝=Chân Linh Ma Đế
真神=Chân Thần
真神之宝=Chân Thần Chi Bảo
真神之眼=Chân Thần Chi Nhãn
真神城主=Chân Thần Thành Chủ
真言天神=Chân Ngôn Thiên Thần
真身=chân thân
真魔=Chân Ma
真龙=Chân Long
真龙双锏=Chân Long Song Kiếm
真龙锏=Chân Long Kiển
睚眦=Nha Tí
督天府=Đốc Thiên Phủ
督天府神主=Đốc Thiên Phủ Thần Chủ
睽翼=Quỳ Dực
睽翼道君=Quỳ Dực Đạo Quân
瞻州=Chiêm Châu
石=Thạch
石咒=Thạch Chú
石敢当=Thạch Cảm Đương
石榴裙=Váy thạch lựu
石皇=Thạch Hoàng
矿山=Mỏ
破旗=Phá Kỳ
破灭之地=Nơi Hủy Diệt
破碗=Phá Bát
碎神闸=Toái Thần Trát
碧月=Bích Nguyệt
碧歆=Bích Khâm
碧游神火=Bích Du Thần Hỏa
碧玺天=Bích Tỉ Thiên
碧眼金蟾=Bích nhãn Kim Thiềm
碧空=Bích Không
碧空金镯=Bích Không Kim Trạc
碧落=Bích Lạc
磨盘大鼓=Ma Bàn Đại Cổ
礼敬玄天=Lễ Kính Huyền Thiên
礼祭=Lễ Tế
社稷图=Xã Tắc Đồ
祖儒=Tổ Nho
祖儒大帝=Tổ Nho Đại Đế
祖千千=Tổ Thiên Thiên
祖圣=Tổ Thánh
祖宗=Tổ tông
祖宗不足法=Tổ Tông bất túc pháp
祖岳=Tổ Nhạc
祖州=Tổ Châu
祖师=Tổ Sư
祖师奶奶=Tổ Sư Nãi Nãi
祖战=Tổ Chiến
祖渠=Tổ Cừ
祖渠大帝=Tổ Cừ Đại Đế
祖火=Tổ Hỏa
祖盛=Tổ Thịnh
祖神=Tổ Thần
祖龙=Tổ Long
祖龙仙塔=Tổ Long Tiên Tháp
祖龙剑=Tổ Long kiếm
祖龙族=Tổ Long tộc
祝元朗=Chúc Nguyên Lãng
祝兄=Chúc huynh
祝妍婷=Chúc Diên Đình
祝家=Chúc gia
祝家主=Chúc Gia Chủ
祝家家主=Chúc gia gia chủ
祝师妹=Chúc sư muội
祝易冰=Chúc Dịch Băng
祝融炼世=Chúc Dung Luyện Thế
神=Thần
神中仙=Thần Trung Tiên
神主=Thần Chủ
神主之宝=Thần Chủ Chi Bảo
神主令牌=Thần chủ lệnh bài
神主分身=Thần Chủ Phân Thân
神主神尊=Thần Chủ Thần Tôn
神主老爷=Thần chủ lão gia
神人=Thần Nhân
神仙界=Thần Tiên Giới
神仙道=Thần Tiên Đạo
神仙醉=Thần Tiên Túy
神体=Thần Thể
神体花镇元=Thần Thể Hoa Trấn Nguyên
神体血脉=Thần Thể huyết mạch
神侯=Thần Hầu
神侯府=Thần Hầu Phủ
神侯溯=Thần Hầu Tố
神像=Thần Tượng
神光=Thần Quang
神兵神将=Thần Binh Thần Tướng
神剑=Thần kiếm
神台=Thần Đài
神台境=Thần Đài Cảnh
神君=Thần Quân
神君圣佛=Thần Quân Thánh Phật
神君级=Thần Quân cấp
神国=Thần Quốc
神垕=Thần Hậu
神城=thần thành
神境=Thần cảnh
神墟=Thần Khư
神墟荒漠=Thần Khư Hoang Mạc
神女=Thần nữ
神姓=Thần Tính
神威=thần uy
神官=Thần Quan
神官神将=Thần Quan Thần Tướng
神宫=Thần Cung
神家=Thần gia
神将=Thần Tướng
神将神官=Thần Tướng Thần Quan
神尊=thần tôn
神尊之宝=Thần Tôn Chi Bảo
神尊古树=Thần Tôn cổ thụ
神尸=Thần thi
神山=Thần Sơn
神帝=Thần Đế
神帝道则=Thần Đế đạo tắc
神庙=Thần miếu
神府=Thần Phủ
神府境界=Thần Phủ Cảnh Giới
神庭=Thần Đình
神异=Thần Dị
神异道君=Thần Dị Đạo Quân
神异道尊=Thần Dị Đạo Tôn
神怡楼=Thần Di Lâu
神性=Thần Tính
神料=Thần liệu
神明=Thần Minh
神明**体系=Hệ thống Thần Minh
神明之宝=Thần Minh Chi Bảo
神明转世身=Thần Minh Chuyển Thế Thân
神曦=thần hi
神朝=Thần Triều
神木令=Thần Mộc Lệnh
神木圣君=Thần Mộc Thánh Quân
神树=Thần Thụ
神桑娘娘=Thần Tang Nương Nương
神桑树=Thần Tang Thụ
神武=Thần Võ
神武大帝=Thần Võ Đại Đế
神武宝匣=Thần Võ Bảo Hạp
神武真仙=Thần Võ Chân Tiên
神武神帝=Thần Vũ Thần Đế
神殿=Thần Điện
神母=Thần Mẫu
神母圣教=Thần Mẫu Thánh Giáo
神母道君=Thần Mẫu Đạo Quân
神液=Thần dịch
神潜=Thần Tiềm
神灯=Thần Đăng
神灵=Thần Linh
神灵道君=Thần Linh Đạo Quân
神狱魔狱=Thần Ngục Ma Ngục
神王=Thần Vương
神王剑=Thần Vương Kiếm
神王旗=Thần Vương Kỳ
神王诸天=Thần Vương Chư Thiên
神珠=Thần Châu
神甲=Thần Giáp
神界=Thần Giới
神界天狱=Thần Giới Thiên Ngục
神界罗天=Thần Giới La Thiên
神皇=Thần Hoàng
神石仙胎=Thần Thạch Tiên Thai
神祖=Thần Tổ
神祖道果=Thần Tổ Đạo Quả
神禁=Thần cấm
神秀=Thần Tú
神秀道人=Thần Tú Đạo Nhân
神算=Thần Toán
神翁=Thần Ông
神舟=Thần Chu
神药=Thần dược
神血=Thần huyết
神识=Thần Thức
神识神府=Thần thức thần phủ
神轮=Thần Luân
神选之子=Thần Tuyển Chi Tử
神通=Thần Thông
神通八境=Thần Thông Bát Cảnh
神通天成=Thần Thông Thiên Thành
神通营=Thần Thông Doanh
神通道法=Thần thông đạo pháp
神道=Thần Đạo
神道敕令符文=Thần Đạo Sắc Lệnh Phù Văn
神道教主=Thần Đạo Giáo Chủ
神道时代=Thần Đạo Thời Đại
神道道祖=Thần Đạo Đạo Tổ
神道道祖玄天教主=Thần Đạo Đạo Tổ Huyền Thiên giáo chủ
神都=Thần Đô
神都上尊=Thần Đô thượng tôn
神都之主=Thần Đô Chi Chủ
神都神君=Thần Đô Thần Quân
神金=Thần Kim
神金神料=Thần Kim Thần Liệu
神门=Thần Môn
神门教主=Thần Môn Giáo Chủ
神阳天眼=Thần Dương Thiên Nhãn
神陆玄功=Thần Lục Huyền Công
神雷磨盘=Thần Lôi Ma Bàn
神霄=Thần Tiêu
神霞=thần hà
神魂=Thần hồn
神魂精气=Thần Hồn Tinh Khí
神魔=thần ma
神魔之躯=Thần Ma chi khu
神魔圣火=Thần Ma Thánh Hỏa
神魔战场=Thần Ma chiến trường
神魔洞天=Thần Ma Động Thiên
神魔试验场=Thần Ma Thí Nghiệm Tràng
神鸦尊者=Thần Nha Tôn Giả
神鸦族=Thần Nha Tộc
神鹫=Thần Thứu
神鹫妖仙=Thần Thứu Yêu Tiên
神鹫妖王=Thần Thứu Yêu Vương
神鹫尊王=Thần Thứu Tôn Vương
神鹰道人=Thần Ưng Đạo Nhân
神鼎=Thần Đỉnh
神龙=Thần Long
祭坛=Tế đàn
祭孤=Tế Cô
祭酒=Tế Tửu
祭阵图=Tế Trận Đồ
禁区=Cấm khu
禅心寺=Thiền Tâm Tự
福海之滨=Phúc Hải Chi Tân
禳天之法=Nhiễu Thiên Chi Pháp
禳天大祭=Tương Thiên Đại Tế
禺圣王=Ngu Thánh Vương
离丑=Ly Sửu
离丑魔帝=Ly Sửu Ma Đế
离丑魔皇=Ly Sửu Ma Hoàng
离丒=Ly Xú
离丒仙祖=Ly Xú Tiên Tổ
离丒魔帝=Ly Sấu Ma Đế
离丒魔皇=Ly Sửu Ma Hoàng
离地=Ly Địa
离地圣光旗=Ly Địa Thánh Quang Kỳ
离地镇道鼎=Ly Địa Trấn Đạo Đỉnh
离岸=Ly Ngạn
离岸仙王=Ly Ngạn Tiên Vương
离火仙域=Ly Hỏa tiên vực
离珠=Ly Châu
离真=Ly Chân
离真仙王=Ly Chân Tiên Vương
禽之剑意=Cầm chi kiếm ý
秀云天女=Tú Vân Thiên Nữ
秃子=Thích tử
秘境=bí cảnh
秣陵别雪=Mạt Lăng Biệt Tuyết
秦兄=Tần huynh
秦家=Tần gia
秦流云=Tần Lưu Vân
秦霜城=Tần Sương Thành
秦非鱼=Tần Phi Ngư
积水潭医院=Bệnh viện Tích Thủy Đàm
移花接木=Di Hoa Tiếp Mộc
程观真神=Trình Quan Chân Thần
穆仙子=Mục Tiên Tử
穆宣神主=Mục Tuyên Thần Chủ
穆宣道人=Mục Tuyên Đạo Nhân
穆宣道兄=Mục Tuyên đạo huynh
空之山=Không Chi Sơn
空之至尊=Không Chi Chí Tôn
空断剑法=Không Đoạn Kiếm Pháp
空相=Không Tướng
空相仙王=Không Tướng Tiên Vương
空间铁则=Không Gian Thiết Tắc
空间长河=Không Gian Trường Hà
窈窕淑女，君子好逑=Yểu điệu thục nữ, quân tử hảo cầu
窗棂=song liễn
章武=Chương Võ
章逸尊王=Chương Dật Tôn Vương
端木丽=Đoan Mộc Lệ
端木从容=Đoan Mộc Tùng Dung
端木响河=Đoan Mộc Hưởng Hà
端木朱=Đoan Mộc Chu
端木至尊=Đoan Mộc Chí Tôn
竹上猪猪=Trúc Thượng Trư Trư
笙阳=Sanh Dương
笠神翁=Lạp Thần Ông
符丹=Phù Đan
符天天神=Phù Thiên Thiên Thần
符文=Phù văn
第一任都天之主=Đệ Nhất Nhậm Đô Thiên Chi Chủ
第一凶阵=Đệ Nhất Hung Trận
第一圣教=Đệ Nhất Thánh Giáo
第一虚空=Hư không thứ nhất
第一重神禁=Thần cấm tầng thứ nhất
第七虚空=Đệ Thất Hư Không
第三虚空=Đệ Tam Hư Không
第九仙道=Đệ Cửu Tiên Đạo
第九位道祖=Đạo Tổ thứ chín
第九十八代玉皇=Đệ Cửu Mươi Bát Đại Ngọc Hoàng
第九天宫=Đệ Cửu Thiên Cung
第九尊神祖=Thần Tổ thứ chín
第九神祖=Đệ Cửu Thần Tổ
第九虚空=Đệ Cửu Hư Không
第九重=cõi thứ chín
第二虚空=Hư Không Thứ Hai
第五卷万界浩劫=Quyển 5: Vạn Giới Hạo Kiếp
第五虚空=Đệ Ngũ Hư Không
第五重=Đệ Ngũ Trọng
第八虚空=Hư Không Thứ Tám
第六化身=Hóa thân thứ sáu
第六虚空=Hư không thứ sáu
第六重=Đệ Lục Trọng
第十大仙道至宝定天元桩=Đệ Thập Đại Tiên Đạo Chí Bảo Định Thiên Nguyên Trang
第四卷奉天承运=Quyển 4: Phụng Thiên Thừa Vận
第四虚空=Hư Không Thứ Tư
第四重=Đệ Tứ Trọng
箫印丹阵=tiêu ấn đan trận
箭=Tiễn
箴酆=Châm Phong
箴酆会主=Châm Phong hội chủ
箴酆真神=Châm Phong chân thần
精气神=Tinh Khí Thần
精神=Tinh thần
精神烙印=Tinh thần lạc ấn
精血=Tinh huyết
紫仙葫=Tử Tiên Hồ
紫发=tóc tím
紫发金瞳=Tử phát Kim Đồng
紫发银瞳=Tử phát Ngân Đồng
紫垣=Tử Viên
紫垣魔帝=Tử Viên Ma Đế
紫垣魔帝化身=Tử Viên Ma Đế hóa thân
紫垣魔皇=Tử Viên Ma Hoàng
紫府=Tử Phủ
紫府空间=Tử Phủ Không Gian
紫庭真人=Tử Đình chân nhân
紫微天宫=Tử Vi Thiên Cung
紫微宫=Tử Vi Cung
紫怡=Tử Di
紫气=Tử Khí
紫气东来=Tử Khí Đông Lai
紫界=Tử Giới
紫竹=Tử Trúc
紫色=tím
紫苑=Tử Viện
紫菡=Tử Hàm
紫菡仙后=Tử Hạm Tiên Hậu
紫菡娘娘=Tử Hạm nương nương
紫菡道母=Tử Hàm đạo mẫu
紫萱=Tử Huyên
紫薇=Tử Vi
紫薇仙君=Tử Vi Tiên Quân
紫薇仙王=Tử Vi Tiên Vương
紫薇兵部=Tử Vi Binh Bộ
紫薇兵部玄武重师=Tử Vi Binh Bộ Huyền Vũ Trọng Sư
紫薇天=Tử Vi Thiên
紫薇天宫=Tử Vi Thiên Cung
紫薇宫=Tử Vi Cung
紫薇神帝=Tử Vi Thần Đế
紫衣少女=Thiếu nữ áo tím
紫袍金绶=Tử bào kim thụ
紫雷叉=Tử Lôi Xoa
紫霄=Tử Tiêu
紫霄三仙=Tử Tiêu Tam Tiên
紫霄仙君=Tử Tiêu Tiên Quân
紫霄仙宫=Tử Tiêu Tiên Cung
紫霄仙王=Tử Tiêu Tiên Vương
紫霄仙道符文=Tử Tiêu Tiên Đạo phù văn
紫霄古仙=Tử Tiêu Cổ Tiên
紫霄大帝=Tử Tiêu Đại Đế
紫霄大老爷=Tử Tiêu Đại Lão Gia
紫霄天=Tử Tiêu Thiên
紫霄天和罗天=Tử Tiêu Thiên và La Thiên
紫霄天宫=Tử Tiêu Thiên Cung
紫霄宫=Tử Tiêu Cung
紫霄殿=Tử Tiêu Điện
紫霄皓庭=Tử Tiêu Hạo Đình
紫霄神帝=Tử Tiêu Thần Đế
紫霄老道=Tử Tiêu Lão Đạo
紫霄道兄=Tử Tiêu đạo huynh
紫霄道身=Tử Tiêu Đạo Thân
紫霄长生=Tử Tiêu Trường Sinh
紫髯公=Tử Nhiêm Công
红丸仙丹=Hồng Hoàn Tiên Đan
红色守宫=Hồng Thủ Cung
红莲大佛=Hồng Liên Đại Phật
红螺紫塔=Hồng Loa Tử Tháp
红鸾=Hồng Loan
红鸾星空=Hồng Loan Tinh Không
约法三章=Ước Pháp Tam Chương
纪劫=Kỷ kiếp
纪绍棠=Kỷ Thiệu Đường
纯粹=Thuần túy
纯阳塔=Thuần Dương Tháp
纯阳大殿=Thuần Dương Đại Điện
纯阳无极剑=Thuần Dương Vô Cực Kiếm
纯阳无极经=Thuần Dương Vô Cực Kinh
纯阳无极钟=Thuần Dương Vô Cực Chung
纯阳殿=Thuần Dương Điện
纯阳神鉴=Thuần Dương Thần Giám
纯阳钟=Thuần Dương Chung
纳兰德=Nạp Lan Đức
细作=nội gián
织锦图=Chức Cẩm Đồ
结界之沙=Kết Giới Chi Sa
绛仙=Giáng Tiên
绛仙奇珍=Giáng Tiên kỳ trân
绝世级=Tuyệt Thế Cấp
绝情上人=Tuyệt Tình Thượng Nhân
绝户坟=Tuyệt Hộ Phần
绝杀=Tuyệt Sát
绝灭之地=Tuyệt Diệt Chi Địa
绝顶的天君=Tuyệt Đỉnh Thiên Quân
绯云老祖=Phi Vân Lão Tổ
绯红=phi hồng
绾绾=Oản Oản
绿叶神树=Thần Thụ Lá Xanh
缁衣僧人=Tỳ Y tăng nhân
编钟=Biên Chung
罗云天尊=La Vân Thiên Tôn
罗云尊王镜=La Vân Tôn Vương Kính
罗儿=La Nhi
罗刹女帝=La Sát Nữ Đế
罗刹女月孛=La Sát Nữ Nguyệt Bột
罗刹魔君=La Sát Ma Quân
罗天=La Thiên
罗天上=La Thượng Thiên
罗天下=La Thiên Hạ
罗天之战=La Thiên Chi Chiến
罗天仪=La Thiên Nghi
罗天大帝=La Thiên Đại Đế
罗天庆云=La Thiên Khánh Vân
罗天星光帝宫=La Thiên Tinh Quang Đế Cung
罗天星盘=La Thiên Tinh Bàn
罗天神庭=La Thiên Thần Đình
罗天绝境=La Thiên Tuyệt Cảnh
罗天雪莲=La Thiên Tuyết Liên
罗天雪莲仙道=La Thiên Tuyết Liên Tiên Đạo
罗天魔尊=La Thiên Ma Tôn
罗宕圣宗=La Đãng Thánh Tông
罗宕宝印=La Đãng Bảo Ấn
罗州=La Châu
罗摩=La Ma
罗摩古神=La Ma Cổ Thần
罗摩大神=La Ma Đại Thần
罗摩天君=La Ma Thiên Quân
罗摩头骨=La Ma đầu cốt
罗摩无量杀阵=La Ma Vô Lượng Sát Trận
罗摩真身=La Ma chân thân
罗摩统帅=La Ma Thống Soái
罗摩骨矛=La Ma Cốt Mâu
罗汉=La Hán
罗睺=La Hầu
罗睺教主=La Hầu giáo chủ
罗睺祖师=La Hầu Tổ Sư
罗睺罗=La Hầu La
罗睺罗祖师=La Hầu La Tổ Sư
罗睺罗魔祖=La Hầu La Ma Tổ
罗睺魔帝=La Hầu Ma Đế
罗睺魔祖=La Hầu Ma Tổ
罗陀=La Đà
罗陀古神=La Đà Cổ Thần
羊脂白玉=Ngọc Dương Chi Trắng
群仙图=Quần Tiên Đồ
群玉山头，冰肌玉容=Đầu núi Quần Ngọc, da băng xương ngọc
羽化天=Vũ Hóa Thiên
羽林军=Vũ Lâm Quân
羽渊=Vũ Uyên
羽渊道君=Vũ Uyên Đạo Quân
羽炎天=Vũ Viêm Thiên
羽王=Vũ Vương
羽王天神=Vũ Vương Thiên Thần
羽王族=Tộc Vũ Vương
羽王神族=Thần tộc Vũ Vương
羽珞道人=Vũ Lạc Đạo Nhân
羽神丹=Vũ Thần Đan
羽神灵丹=Vũ Thần Linh Đan
羽神舟=Vũ Thần Chu
羽辰魔皇=Vũ Thần Ma Hoàng
翠云国=Thúy Vân Quốc
翠云天罗云天尊=Thúy Vân Thiên La Vân Thiên Tôn
翠云宫=Thúy Vân Cung
翠云庵=Thúy Vân Am
翠云界域=Thúy Vân Giới Vực
翻天印=Phiên Thiên Ấn
翼人族=Dực Nhân Tộc
翼人魔族=Dực Nhân Ma Tộc
老兔子=lão thỏ tử
老君=Lão Quân
老君山=Lão Quân Sơn
老太君=lão thái quân
老太爷=Ông nội
老头=lão đầu
老妪=lão ẩu
老婆=vợ
老媞家=nhà họ Đề
老子=Lão Tử
老族长=Lão tộc trưởng
老母=Lão mẫu
老爷=Lão gia
老爷子=Lão gia tử (Ông)
老狐狸=Lão hồ ly
老祖=Lão Tổ
老象=Lão Tượng
老迈仙尊=Lão Mại Tiên Tôn
老道=lão đạo
老鬼=Lão quỷ
老龙王=Lão Long Vương
老龙龟=lão Long Quy
聂长空=Nhiếp Trường Không
聂长空真神=Nhiếp Trường Không chân thần
聘礼=sính lễ
肉身=Nhục thân
肉身神通=Nhục Thân Thần Thông
胜光佛体=Thắng Quang Phật Thể
胜天=Thắng Thiên
胜天大帝=Thắng Thiên Đại Đế
胜天妖君=Thắng Thiên Yêu Quân
胜天妖尊=Thắng Thiên Yêu Tôn
胜天妖祖=Thắng Thiên Yêu Tổ
脚力=cước lực
脚印=Dấu chân
腾昌引=Đằng Xương Dẫn
腾龙大尊=Đằng Long Đại Tôn
膜胎=màng thai
臧道神主=Tang Đạo thần chủ
臧道道人=Tang Đạo đạo nhân
臧道道兄=Tang Đạo đạo huynh
自在道妙=Tự Tại Đạo Diệu
自然=Tự Nhiên
自然仙君=Tự Nhiên tiên quân
自然大老爷=Tự Nhiên Đại Lão Gia
自然老君=Tự Nhiên Lão Quân
自然道书=Tự Nhiên Đạo Thư
自然道君=Tự Nhiên Đạo Quân
至尊=Chí Tôn
至尊黄气=Chí Tôn Hoàng Khí
至清=Chí Thanh
至清圣境=Chí Thanh Thánh Cảnh
至秽之地=Chí Uế Chi Địa
至秽至污=Chí Uế Chí Ô
至高天=Chí Cao Thiên
舍利=Xá Lợi
舍利天球=Xá Lợi Thiên Cầu
舍利天球神算=Xá Lợi Thiên Cầu Thần Toán
舍利天眼=Xá Lợi Thiên Nhãn
舍利子=Xá Lợi Tử
般若仙王=Bát Nhã Tiên Vương
般若阿含经=Bát Nhã A Hàm Kinh
船桅=cột buồm
良辰吉曰=Ngày lành tháng tốt
艹=điều khiển
节操=Tiết Tháo
芦蓬=Lô Bồng
芭蕉扇=Ba Tiêu Phiến
花兄=Hoa huynh
花公子=Hoa công tử
花怜香=Hoa Liên Hương
花某=Hoa mỗ
花清妍=Hoa Thanh Nghiên
花篮=Hoa Lãm
花道友=Hoa đạo hữu
花镇元=Hoa Trấn Nguyên
芳杏天女=Phương Hạnh Thiên Nữ
苍云生=Thương Vân Sinh
苍云生天神=Thương Vân Sinh Thiên Thần
苍天=Thương Thiên
苍生剑=Thương Sinh Kiếm
苍皓魔仙=Thương Hạo Ma Tiên
苍鸿道人=Thương Hồng đạo nhân
苍鹤=Thương Hạc
苏晃=Tô Hoảng
苑主=Uyển chủ
苦海=Khổ Hải
苦海行舟=Khổ Hải Hành Chu
苦竹=Khổ Trúc
苦竹杖=Khổ Trúc Trượng
苦竹道主=Khổ Trúc Đạo chủ
苦舟天尊=Khổ Chu Thiên Tôn
苦舟阁=Khổ Chu Các
苦行=Khổ Hạnh
苦行天尊=Khổ Hành Thiên Tôn
苦行师弟=Khổ Hành sư đệ
苦行教主=Khổ Hành Giáo Chủ
苦道人=Khổ Đạo Nhân
英灵=anh linh
茶博士=Trà Bác Sĩ
荆棘=Kinh Cức
草=Thảo
荒古=Hoang Cổ
荒古圣城=Hoang Cổ Thánh Thành
荒古圣山=Hoang Cổ Thánh Sơn
荒古大帝=Hoang Cổ Đại Đế
荒州=Hoang Châu
荒帅=Hoang Soái
荒璟=Hoang Cảnh
荒璟天神=Hoang Cảnh Thiên Thần
荒璟少尊=Hoang Cảnh Thiếu Tôn
荒祖=Hoang Tổ
荒祖神君=Hoang Tổ Thần Quân
荒祖神帝=Hoang Tổ Thần Đế
荒神=Hoang Thần
荡天幕=Đãng Thiên Mạc
荡魂岭=Đãng Hồn Lĩnh
荡魔剑=Đãng Ma Kiếm
荡魔戟=Đãng Ma Kích
荧惑=Huỳnh Hoặc
荧惑神主=Huỳnh Hoặc Thần Chủ
荧惑辰星=Huỳnh Hoặc Thần Tinh
荧惑魔尊=Huỳnh Hoặc Ma Tôn
药王城=Dược Vương Thành
药王府=Dược Vương Phủ
莫家=Mạc Gia
莫家师兄=Mạc gia sư huynh
莲儿=Liên Nhi
莲台=Liên Đài
莲台境=Liên Đài Cảnh
莲月=Liên Nguyệt
莲月圣女=Liên Nguyệt Thánh Nữ
莲月女帝=Liên Nguyệt Nữ Đế
莲花=Liên Hoa
莲花宝座=Liên Hoa Bảo Tọa
莲花池=Liên Hoa Trì
莲花锤=Liên Hoa Chùy
莲莲=Liên Liên
菡萏妖君=Hàm Đạm Yêu Quân
菡萏妖尊=Hàm Đàm Yêu Tôn
菩仙城=Bồ Tiên thành
菩提仙城=Bồ Đề tiên thành
菩提树=Bồ Đề Thụ
菩楼魔皇=Bồ Lâu Ma Hoàng
菩萨=Bồ Tát
萧峰雄=Tiêu Phong Hùng
萧朔=Tiêu Sóc
萧逸仙=Tiêu Dật Tiên
萨多逻大真魔=Tát Đa La Đại Chân Ma
落曰谷=Lạc Nhật Cốc
落霞山脉=Lạc Hà Sơn Mạch
落魂钟=Lạc Hồn Chung
葛云=Cát Vân
葛云真神=Cát Vân chân thần
葫芦藤=Hồ lô đằng
葬天墟=Táng Thiên Khư
葬神谷=Táng Thần Cốc
蒙城主=Mông thành chủ
蒙天=Mông Thiên
蒙逊=Mông Tốn
蒙逊太子=Mông Tốn Thái Tử
蒙逊道主=Mông Tốn đạo chủ
蒲团=Bồ Đoàn
蒲州=Bồ Châu
蒲昭=Bồ Chiêu
蒲昭和=Bồ Chiêu Hòa
蒲牢=Bồ Lao
蒹葭天=Kiêm Giao Thiên
蓝山=Lam Sơn
蓝山道人=Lam Sơn đạo nhân
蓬莱仙岛=Bồng Lai Tiên Đảo
薇信=WeChat (Wechat)
薇雪主=Vi Tuyết Chủ
薪火=Tân Hỏa
薪火道君=Tân Hỏa đạo quân
藏天仙葫=Tàng Thiên Tiên Hồ
藏天葫芦=Tàng Thiên Hồ Lô
虎叔叔=Hổ thúc thúc
虎榜=Hổ Bảng
虎贲=Hổ Bôn
虚皇=Hư Hoàng
虚皇仙王=Hư Hoàng Tiên Vương
虚空=Hư Không
虚空大蛇=Hư Không Đại Xà
虚空天魔=Hư Không Thiên Ma
虚空天魔蝠王神=Hư Không Thiên Ma Phúc Vương Thần
虚空宝船=Hư Không Bảo Thuyền
虫豸=Trùng trệ
虹=Cầu Vồng
虹桥=Hồng kiều
蚺公=Nhâm Công
蛇皮袋=Túi da rắn
蛊惑大龙=cổ hoặc đại long
蛊王神主=Cổ Vương Thần Chủ
蛊虫=Trùng Cổ
蛟圣王=Giao Thánh Vương
蛟王神=Giao Vương Thần
蛟龙王=Giao Long Vương
蛤兄=Cáp huynh
蛤蟆=Cóc
蛤道人=Cáp Đạo Nhân
蛮夷大帝=Man Di Đại Đế
蛮族=Man tộc
蛮皇=Man Hoàng
蛮红衣=Man Hồng Y
蛮红衣魔尊=Man Hồng Y Ma Tôn
蛮荒世界=Man Hoang thế giới
蛮荒古域=Man Hoang Cổ Vực
蛮荒死城=Man Hoang Tử Thành
蛮龙=Man Long
蜉蝣=Phù du
蝎魔=Hạt Ma
蝠王神=Phúc Vương Thần
蝶衣=Điệp Y
蝶衣妖君=Điệp Y Yêu Quân
蝶衣妖尊=Điệp Y Yêu Tôn
蝶衣姐姐=Điệp Y tỷ tỷ
融合之地=Giao Dung Chi Địa
融合了妖界、天界、佛界、鬼界和混沌界天道的天伞华盖=Thiên Tán Hoa Cái dung hợp Yêu Giới, Thiên Giới, Phật Giới, Quỷ Giới và Thiên Đạo Hỗn Độn Giới
螭吻=Li Vẫn
螭龙=Li Long
蟠龙天尊=Bàn Long Thiên Tôn
蠢龙=con rồng ngu xuẩn
血凰=Huyết Hoàng
血圣道君=Huyết Thánh Đạo Quân
血族=Huyết tộc
血族时代=Thời đại Huyết Tộc
血曈=Huyết Đồng
血池=huyết trì
血河=Huyết Hà
血河大阵=Huyết Hà Đại Trận
血河天诸将=Huyết Hà Thiên Chư Tướng
血河车=Huyết Hà Xa
血海=Huyết Hải
血海魔渊=Huyết Hải Ma Uyên
血眼=Huyết Nhãn
血祖=Huyết Tổ
血祖大道=Huyết Tổ Đại Đạo
血神=Huyết thần
血神剑=Huyết Thần Kiếm
血神尸海大剑气=Huyết Thần Thi Hải Đại Kiếm Khí
血神楼=Huyết Thần Lâu
血神楼主=Huyết Thần Lâu Chủ
血神毛远公=Huyết Thần Mao Viễn Công
血祭大典=Huyết Tế Đại Điển
血纹射魄弓=Huyết Văn Xạ Phách Cung
血纹弓=Huyết văn Cung
血肉=Huyết Nhục
血食=Huyết thực
血魔宗=Huyết Ma Tông
血魔宗主=Huyết Ma Tông Chủ
血魔神主=Huyết Ma Thần Chủ
血龙大法=Huyết Long Đại Pháp
行云大禅师=Hành Vân Đại Thiền Sư
行宫=hành cung
行密=Hành Mật
行密佛陀=Hành Mật Phật Đà
行痴=Hành Si
行痴佛陀=Hành Si Phật Đà
行真佛陀=Hành Chân Phật Đà
行端佛陀=Hành Đoan Phật Đà
衣衫=Y sam
衣裙=Y quần
补天=Bổ Thiên
补天印=Bổ Thiên Ấn
补天大阵=Bổ Thiên Đại Trận
补天神人=Bổ Thiên Thần Nhân
补天老祖=Bổ Thiên Lão Tổ
衮州=Cổn Châu
袁栋神主=Viên Đống Thần Chủ
裂天轮=Liệt Thiên Luân
裂天魔主=Liệt Thiên Ma Chủ
裴头陀大尊=Bồi Đầu Đà Đại Tôn
裴紫衣=Bùi Tử Y
褚灏真神=Chử Hạo Chân Thần
西圣佛=Tây Thánh Phật
西天斗部=Tây Thiên Đấu Bộ
西宫娘娘=Tây Cung Nương Nương
西方偈帝=Tây Phương Kệ Đế
西方极乐圣境=Tây Phương Cực Lạc Thánh Cảnh
西方沙门大教=Tây Phương Sa Môn Đại Giáo
西无邪=Tây Vô Tà
西游=Tây Du
西环=Tây Hoàn
西环十二州=Tây Hoàn Thập Nhị Châu
西荒佛城=Tây Hoang Phật Thành
覃石魔尊=Đàm Thạch Ma Tôn
覆云神尊=Phúc Vân Thần Tôn
覆天=Phục Thiên
覆天大帝=Phúc Thiên Đại Đế
覆天妖君=Phúc Thiên Yêu Quân
覆天妖尊=Phúc Thiên Yêu Tôn
观觉仙王=Quan Giác Tiên Vương
角族=Giác Tộc
角马=Giác mã
解天华盖=Giải Thiên Hoa Cái
计三爷=Kế Tam Gia
计都=Kế Đô
计都罗睺罗=Kế Đô La Hầu La
计都魔帝=Kế Đô Ma Đế
计都魔祖=Kế Đô Ma Tổ
讲道崖=Giảng Đạo Nhai
讳姓=Úy Tính
许文顺=Hứa Văn Thuận
证帝之宝=Chứng Đế Chi Bảo
证道=Chứng Đạo
证道剑=Chứng Đạo Kiếm
证道成帝=Chứng Đạo Thành Đế
诛神阵=Tru Thần Trận
诛魔剑=Tru Ma Kiếm
诡计=mưu kế
诸仙=chư Tiên
诸位=Chư vị
诸位施主=Chư vị thí chủ
诸佛=Chư Phật
诸侯=chư hầu
诸君=Chư Quân
诸圣=chư thánh
诸地魔帝=Chư Địa Ma Đế
诸天=Chư Thiên
诸天万界=Chư Thiên Vạn Giới
诸天兵部=Chư Thiên Binh Bộ
诸天圣境=Chư Thiên Thánh Cảnh
诸天帝=Chư Thiên Đế
诸天府=Chư Thiên Phủ
诸天无漏=Chư Thiên Vô Lậu
诸天无漏道=Chư Thiên Vô Lậu Đạo
诸天易主=Chư Thiên Dịch Chủ
诸天星辰=Chư Thiên tinh thần
诸天星陆=Chư Thiên Tinh Lục
诸天浩劫卷=Chư Thiên Hạo Kiếp Quyển
诸天神朝=Chư Thiên Thần Triều
诸天神朝玄经=Chư Thiên Thần Triều Huyền Kinh
诸天神魔=Chư Thiên Thần Ma
诸将=Chư Tướng
诸帝=chư đế
诸皇=Chư Hoàng
诸皇诸帝=Chư Hoàng Chư Đế
诸神=Chư Thần
诸神殿=Chư Thần Điện
诸神策=Chư Thần Sách
诸神荒神=Chư Thần Hoang Thần
诸神诸帝=chư thần chư đế
诸神诸帝诸皇=Chư Thần, Chư Đế, Chư Hoàng
诸神黄昏=Chư Thần Hoàng Hôn
诸神黄昏劫=Chư Thần Hoàng Hôn Kiếp
诸神黄昏卷=Chư Thần Hoàng Hôn Quyển
读书人=Độc thư nhân
谈正峰=Đàm Chính Phong
象圣王=Tượng Thánh Vương
貔貅=Tỳ Hưu
貔貅圣王=Tỳ Hưu Thánh Vương
貔貅妖王=Tỳ Hưu Yêu Vương
负心人=Kẻ bạc tình
财东=Tài Đông
责天尺=Trách Thiên Xích
贤伉俪=Hiền Khanh Lỵ
贤弟=Hiền đệ
贱内=Tiện nội
贱妇=Tiện phụ
赐罪=tứ tội
赑屃=Tí Hí
赢家=Người thắng
赤=Xích
赤天=Xích Thiên
赤子之心=Xích tử chi tâm
赤渊天=Xích Uyên Thiên
赤炎=Xích Viêm
赤炎丽天大阵=Xích Viêm Lệ Thiên đại trận
赤炎尊王印=Xích Viêm Tôn Vương Ấn
赤炎神庭宝卷=Xích Viêm Thần Đình Bảo Quyển
赤炎神族=Xích Viêm Thần Tộc
赤炎魔神=Xích Viêm Ma Thần
赤炎魔神化身=Xích Viêm Ma Thần hóa thân
赤血战戟=Xích Huyết Chiến Kích
赤血蒲葵=Xích Huyết Bồ Quỳ
赫胥=Hách Hư
赵图=Triệu Đồ
起点=Khởi Điểm
趴蝮=Bá Phục
路=Lộ
路神侯=Lộ Thần Hầu
路风尘=Lộ Phong Trần
路风尘神尊=Lộ Phong Trần Thần Tôn
跳梁小丑=Tiểu sửu nhảy nhót
身=Thân
轩薇=Hiên Vi
轩薇仙子=Hiên Vi Tiên Tử
轩辕=Hiên Viên
轩辕令=Hiên Viên Lệnh
轩辕十二=Hiên Viên Thập Nhị
轩辕台=Hiên Viên Đài
轩辕师兄=Hiên Viên sư huynh
轩辕师叔=Hoa sư thúc
轩辕望=Hiên Viên Vọng
轩辕望至尊=Hiên Viên Vọng Chí Tôn
轩辕淡=Hiên Viên Đạm
轩辕至尊=Hiên Viên Chí Tôn
转世=Chuyển Thế
转世的神=Thần chuyển thế
转世神主皇甫冰焰=Chuyển thế Thần Chủ Hoàng Phủ Băng Diễm
转世道君=Chuyển Thế Đạo Quân
转轮钟=Chuyển Luân Chung
轮回=Luân Hồi
轮回之力=Luân Hồi Chi Lực
轮回剑式=Luân Hồi Kiếm Thức
轮回剑道=Luân Hồi Kiếm Đạo
轮回天尊=Luân Hồi Thiên Tôn
轮回道友=Luân Hồi đạo hữu
轮回道尊=Luân Hồi Đạo Tôn
载德枪=Tải Đức Thương
辅文恭=Phụ Văn Cung
辅朝=Phụ Triều
辅朝法王=Phụ Triều Pháp Vương
辛辛苦苦=Tân tân khổ khổ
辟邪尊者=Tịch Tà tôn giả
辰公子=Thần công tử
辰天神主=Thần Thiên Thần Chủ
辰天神族=Thần Thiên Thần Tộc
辰少商=Thần Thiếu Thương
辰星=Thần Tinh
辰星星君=Thần Tinh Tinh Quân
辰星神主=Thần Tinh Thần Chủ
近仙=Cận Tiên
近神强者=Cận Thần cường giả
还魂草=Hoàn Hồn Thảo
远古=Viễn Cổ
远古先民=Viễn cổ tiên dân
远古时期=Thời kỳ viễn cổ
远古魔舰=Viễn Cổ Ma Hạm
迦楼罗=Ca Lâu La
送掌教=Tống Chưởng Giáo
逆不道=đại nghịch bất đạo
逆贼乱党=nghịch tặc loạn đảng
通仙桥=Thông Tiên Kiều
通仙飞桥=Thông Tiên Phi Kiều
通天之路=Thông Thiên Chi Lộ
通天桥=Thông Thiên Kiều
通天阁=Thông Thiên Các
通幽=Thông U
通幽大帝=Thông U Đại Đế
通幽真仙=Thông U Chân Tiên
通幽神帝=Thông U Thần Đế
通幽节杖=Thông U Tiết Trượng
通幽道人=Thông U Đạo Nhân
通郅=Thông Chất
通郅仙君=Thông Chất Tiên Quân
造化=Tạo Hóa
造化之门=Tạo Hóa Chi Môn
造化仙经=Tạo Hóa Tiên Kinh
造化仙翁=Tạo Hóa Tiên Ông
造化仙鼎=Tạo Hóa Tiên Đỉnh
造化仙鼎之胚=Tạo Hóa Tiên Đỉnh Chi Phôi
造化大世界=Tạo Hóa Đại Thế Giới
造化玄祖=Tạo Hóa Huyền Tổ
造化神力=Tạo Hóa Thần Lực
造化神帝=Tạo Hóa Thần Đế
造化神庭=Tạo Hóa Thần Đình
造化神楼=Tạo Hóa Thần Lâu
造化神秀=Tạo Hóa Thần Tú
造化神藏=Tạo Hóa Thần Tàng
造化老爷=Tạo Hóa Lão Gia
造化老祖=Tạo Hóa Lão Tổ
造化道人=Tạo Hóa Đạo Nhân
造化道友=Tạo Hóa đạo hữu
造化道君=Tạo Hóa Đạo Quân
造化道尊=Tạo Hóa Đạo Tôn
造父=Tạo Phụ
道=Đạo
道主=Đạo Chủ
道乾道君=Đạo Càn Đạo Quân
道人江南=Đạo nhân Giang Nam
道兄=Đạo huynh
道则=Đạo tắc
道友=Đạo hữu
道台=Đạo Đài
道台境=Đạo Đài Cảnh
道君=Đạo quân
道君之宝=Đạo Quân Chi Bảo
道君果位=Đạo Quân Quả Vị
道君果位大殿=Đạo Quân Quả Vị Đại Điện
道君殿=Đạo Quân Điện
道君殿的道尊=Đạo Tôn Đạo Quân Điện
道君的威严=Uy Nghiêm của Đạo Quân
道君石柱=Đạo Quân Thạch Trụ
道境=Đạo Cảnh
道妙=Đạo Diệu
道宗=Đạo Tông
道宗真仙=Đạo Tông Chân Tiên
道宫=Đạo cung
道尊=Đạo Tôn
道度仙人=Đạo Độ Tiên Nhân
道德=đạo đức
道心=Đạo Tâm
道果=Đạo Quả
道母=Đạo mẫu
道王=Đạo Vương
道王大世界=Đạo Vương Đại Thế Giới
道王宫=Đạo Vương Cung
道王的神庭=Thần đình của Đạo Vương
道王的道金玉盘=Đạo Vương Đạo Kim Ngọc Bàn
道王神朝=Đạo Vương Thần Triều
道祖=Đạo Tổ
道祖剑=Đạo Tổ Kiếm
道种=Đạo chủng
道空=Đạo Không
道空天尊=Đạo Không Thiên Tôn
道空道人=Đạo Không đạo nhân
道空道兄=Đạo Không đạo huynh
道空道尊=Đạo Không Đạo Tôn
道童=Đạo đồng
道纹=Đạo văn
道藏=Đạo Tàng
道藏道君=Đạo Tàng Đạo Quân
道金玉盘=Đạo Kim Ngọc Bàn
道音=Đạo Âm
道音喝唱=Đạo Âm Hát Xướng
道音鼓=Đạo Âm Cổ
避水犀=Tị Thủy Tê
邢家=Hình Gia
邢真大尊=Hình Chân Đại Tôn
那位师兄=Vị sư huynh kia
那位老祖=Vị lão tổ kia
邪王=Tà Vương
邪皇=Tà Hoàng
邪魔=Tà Ma
邵天涯=Thiệu Thiên Nhai
邵师侄=Thiệu sư điệt
郁长青=Úc Trường Thanh
郭四娘=Quách Tứ Nương
郭奕=Quách Dịch
郭德纲=Quách Đức Cương
郭氏女帝=Quách Thị Nữ Đế
郭玉容=Quách Ngọc Dung
都天=Đô Thiên
都天之主=Đô Thiên Chi Chủ
都天古神=Đô Thiên Cổ Thần
都天府=Đô Thiên phủ
都天神=Đô Thiên Thần
都天神主=Đô Thiên Thần Chủ
都天神尊=Đô Thiên Thần Tôn
都天神帝=Đô Thiên Thần Đế
都天神帝化身=Đô Thiên Thần Đế hóa thân
都天神照大禁=Đô Thiên Thần Chiếu Đại Cấm
都天神照经=Đô Thiên Thần Chiếu Kinh
都天神界=Đô Thiên Thần Giới
都天道兄=Đô Thiên đạo huynh
都天道友=Đô Thiên đạo hữu
都帝=Đô Đế
都帝道君=Đô Đế Đạo Quân
都门大帝=Đô Môn Đại Đế
都门妖帝=Đô Môn Yêu Đế
酆都=Phong Đô
酆都上尊=Phong Đô Thượng Tôn
酆都玉容尊王=Phong Đô Ngọc Dung Tôn Vương
醉仙魔境=Túy Tiên Ma Cảnh
重光=Trọng Quang
重光仙君=Trọng Quang Tiên Quân
重光天君=Trọng Quang Thiên Quân
重光师兄=Trọng Quang Hoa sư huynh
重和=Trọng Hòa
重和道友=Trọng Hòa đạo hữu
重和道君=Trọng Hòa Đạo Quân
重和道尊=Trọng Hòa Đạo Tôn
重塑金身=Trọng Tố Kim Thân
野蛮=Dã Man
量劫阵图=Lượng Kiếp Trận Đồ
金=Kim
金丹=Kim Đan
金丹大道=Kim Đan Đại Đạo
金丹教主=Kim Đan Giáo Chủ
金乌=Kim Ô
金乌之卵=Kim Ô Chi Noãn
金乌卵=Kim Ô noãn
金乌妖神=Kim Ô Yêu Thần
金乌巢穴=Kim Ô Sào Huyệt
金乌精气=Kim Ô tinh khí
金仙=Kim Tiên
金佛=Kim Phật
金光=Kim Quang
金光镇道鼎=Kim Quang Trấn Đạo Đỉnh
金公=Kim Công
金凤印=Kim Phượng Ấn
金凤阁=Kim Phượng Các
金凤阁梧桐神树=Kim Phượng Các Ngô Đồng Thần Thụ
金刚杵=Kim Cương Xử
金刚法禅宗=Kim Cương Pháp Thiền Tông
金刚般若多心经=Kim Cương Bát Nhã Ba La Mật Đa Tâm Kinh
金刚转轮钟=Kim Cương Chuyển Luân Chung
金帝=Kim Đế
金日=Kim Nhật
金曜=Kim Diệu
金曜星君=Kim Diệu Tinh Quân
金木=Kim Mộc
金木水火土=Kim Mộc Thủy Hỏa Thổ
金棺=Kim Quan
金榜=Kim Bảng
金池=Kim Trì
金池琼液=Kim Trì Quỳnh Dịch
金波=Kim Ba
金灵珠=Kim Linh Châu
金牛玺=Kim Ngưu Tỉ
金牛神族=Kim Ngưu Thần tộc
金甲=Kim Giáp
金甲神人=Kim Giáp Thần Nhân
金瞳=Kim Đồng
金瞳古神=Kim Đồng Cổ Thần
金瞳银瞳=Kim Đồng Ngân Đồng
金瞳银瞳古神=Kim Đồng Ngân Đồng cổ thần
金碧辉煌=kim bích huy hoàng
金符=Kim Phù
金策=Kim Sách
金箍=Kim Cô
金精=Kim Tinh
金精麒麟怪=Kim Tinh Kỳ Lân Quái
金翅大鹏=Kim Sí Đại Bằng
金翅大鹏雕=Kim Sí Đại Bằng Điêu
金船=Kim thuyền
金色令牌=kim sắc lệnh bài
金色大榜=Kim sắc Đại Bảng
金色大蜈蚣=Kim Ngô Công
金色鸟卵=Kim sắc điểu noãn
金萱=Kim Huyên
金萱仙子=Kim Huyên Tiên Tử
金萱女仙王=Kim Huyên Nữ Tiên Vương
金蝉=Kim Thiền
金身=Kim Thân
金身大佛=Kim Thân Đại Phật
金轮=Kim Luân
金銮仙殿=Kim Loan Tiên Điện
金銮殿=Kim Loan Điện
金钩=Kim Câu
金钵=Kim Bát
金钻风=Kim Toàn Phong
金风=Kim Phong
金龙出涧=Kim Long Xuất Giản
金龙锏=Kim Long Giản
銮阙=Loan Khuyết
钟儿=Chung Nhi
钟千军=Chung Thiên Quân
钟墨=Chung Mặc
钟墨道人=Chung Mặc Đạo Nhân
钟声=tiếng chuông
钟天=Chung Thiên
钟天下界=Chung Thiên Hạ Giới
钟天小圣=Chung Thiên Tiểu Thánh
钟天舒=Chung Thiên Thư
钟岳=Chung Nhạc
钟灵=Chung Linh
钟瑞=Chung Thụy
钟瑞真人=Chung Thụy chân nhân
钟秀秀=Chung Tú Tú
钟道兄=Chung đạo huynh
钟鼎=Chung Đỉnh
钟鼓=Chuông Trống
钧=Quân
钧儿= Quân Nhi
钧师兄=Quân Sư Huynh
钧道人=Quân đạo nhân
钧道祖=Quân Đạo Tổ
钽塔族=Tân Tháp tộc
铁柱=Thiết Trụ
铁桶江山=Thiết thông giang sơn
铁箍=Thiết Cô
铁蹄=thiết kỵ
铃郡主=Linh quận chúa
铃铛=chuông gió
铜墙铁壁=Đồng Tường Thiết Bích
铮宗=Tranh Tông
银月=Ngân Nguyệt
银河星系=Ngân Hà Tinh Hệ
银甲大将=Ngân Giáp Đại Tướng
银甲战将=Ngân Giáp Chiến Tướng
银瞳=Ngân Đồng
银瞳古神=Ngân Đồng Cổ Thần
银箍=Ngân Cô
银钻风=Ngân Toàn Phong
锁魂绳=Tỏa Hồn Thằng
锦绣城=Cẩm Tú Thành
锦绣天=Cẩm Tú Thiên
锦绣天南海商盟=Cẩm Tú Thiên Nam Hải thương minh
锦绣盟=Cẩm Tú Minh
锦绣神城=Cẩm Tú Thần Thành
镇仙鼎=Trấn Tiên Đỉnh
镇元仙祖=Trấn Nguyên Tiên Tổ
镇园=Trấn Viên
镇园大仙=Trấn Viên Đại Tiên
镇园大帝=Trấn Viên Đại Đế
镇园神帝=Trấn Viên Thần Đế
镇园老祖=Trấn Viên Lão Tổ
镇天=Trấn Thiên
镇天星域=Trấn Thiên Tinh Vực
镇天神国=Trấn Thiên Thần Quốc
镇天神帝=Trấn Thiên Thần Đế
镇天神朝=Trấn Thiên Thần Triều
镇岳灵剑=Trấn Nhạc Linh Kiếm
镇教=Trấn Giáo
镇教之宝=Trấn Giáo Chi Bảo
镇星=Trấn Tinh
镇星神主=Trấn Tinh Thần Chủ
镇海氏=Trấn Hải Thị
镇狱=Trấn Ngục
镇狱之战=Trấn Ngục Chi Chiến
镇狱界碑=Trấn Ngục Giới Bi
镇狱结界=Trấn Ngục Kết Giới
镇狱鼓=Trấn Ngục Cổ
镇界化凡大阵=Trấn Giới Hóa Phàm Đại Trận
镇碑=Trấn Bi
镇道鼎=Trấn Đạo Đỉnh
镇魂圣音=Trấn Hồn Thánh Âm
镇魔剑=Trấn Ma Kiếm
镇魔殿=Trấn Ma Điện
镔铁棍=Bân Thiết Côn
长乐=Trường Nhạc
长乐公子=Trường Nhạc công tử
长乐女帝=Trường Nhạc Nữ Đế
长乐娘娘=Trường Nhạc Nương Nương
长乐宫=Trường Nhạc Cung
长乐宫主=Trường Lạc Cung Chủ
长乐未央=Trường Lạc Vị Ương
长乐未央两位女帝=Trường Nhạc, Vị Ương hai nữ đế
长乐未央两宫宫主=Trường Lạc Vị Ương Lưỡng Cung Cung Chủ
长乐神庭=Trường Lạc Thần Đình
长孙叔荣=Trưởng Tôn Thúc Vinh
长桑=Trường Tang
长桑皇祖=Trường Tang Hoàng Tổ
长桑道友=Trường Tang đạo hữu
长楼元界=Trường Lâu Nguyên Giới
长生=Trường Sinh
长生仙君=Trường Sinh Tiên Quân
长生仙王=Trường Sinh Tiên Vương
长生大帝=Trường Sinh Đại Đế
长生大老爷=Trường Sinh Đại Lão gia
长生天=Trường Sinh Thiên
长生天宫=Trường Sinh Thiên Cung
长生宫=Trường Sinh Cung
长生果=Trường Sinh Quả
长生神帝=Trường Sinh Thần Đế
长生莲=Trường Sinh Liên
长生轮=Trường Sinh Luân
长老=Trưởng lão
长老院=Trưởng Lão Viện
长青道人=Trường Thanh đạo nhân
门户=môn hộ
问天镜=Vấn Thiên Kính
问心镜=Vấn Tâm Kính
问情=Vấn Tình
闺女=con gái
闻道亭=Văn Đạo Đình
闻道有先后，达者为师=Văn đạo hữu tiên hậu, đạt giả vi sư
阁主=Các chủ
阎尊者=Diêm Tôn Giả
阎浮=Diêm Phù
阎浮提=Diêm Phù Đề
阎浮提魔经=Diêm Phù Đề Ma Kinh
阎王殿=Diêm Vương Điện
阎真=Diêm Chân
阎罗王族=Diêm La Vương tộc
阎肃神尊=Diêm Túc Thần Tôn
阎颉=Diêm Hiệt
阎魔地狱=Diêm Ma Địa Ngục
阐教=Xiển giáo
阐道=Xiển Đạo
阐道时代=Xiển Đạo Thời Đại
阚谷=Hàm Cốc
阳夷=Dương Di
阳夷神族=Dương Di Thần tộc
阳尊=Dương Tôn
阳川河=Dương Xuyên Hà
阳春三月=Dương Xuân tháng Ba
阳炉=Dương Lô
阳逻=Dương La
阴凝四季剑法=Âm Ngưng Tứ Quý Kiếm Pháp
阴炉=Âm Lô
阴阳=Âm Dương
阴阳两仪=Âm Dương Lưỡng Nghi
阴阳二气=Âm Dương Nhị Khí
阴阳天徵大欢赋=Âm Dương Thiên Trưng Đại Hoan Phú
阴阳太极图=Âm Dương Thái Cực Đồ
阴阳昏晓=Âm Dương Hôn Hiểu
阴阳神体=Âm Dương Thần Thể
阴阳鱼=Âm Dương Ngư
阴雷=Âm Lôi
阴魂=Âm Hồn
阴魂噬神幡=Âm Hồn Phệ Thần Phiên
阵兵营=Trận Binh Doanh
阵图=trận đồ
阵旗营=Trận Kỳ Doanh
阵眼=Trận nhãn
阿大=A Đại
阿鼻地狱=A Tỳ Địa Ngục
阿鼻魔朝=A Tỳ Ma Triều
陀丘罗佛皇=Đà Khâu La Phật Hoàng
陀罗育皇=Đà La Dục Hoàng
陆云=Lục Vân
陆元=Lục Nguyên
陆师弟=Lục sư đệ
陆芷苡=Lục Chỉ Ỷ
陈天=Trần Thiên
降三世明王=Giáng Tam Thế Minh Vương
降三世明王真身=Hàng Tam Thế Minh Vương Chân Thân
降魔杵=Hàng Ma Xử
陛下=Bệ hạ
院长=Viện Trưởng
陶长老=Đào trưởng lão
陷阵营=Hãm Trận Doanh
隆歌鬼仙=Long Ca Quỷ Tiên
随云道人=Tùy Vân Đạo Nhân
随真堂兄=Tùy Chân đường huynh
随靖=Tùy Tĩnh
隐之剑术=Ẩn Chi Kiếm Thuật
隗玠=Ngụy Giới
隗玠道人=Nguy Giới đạo nhân
雄关=Hùng Quan
雄鹰搏兔尚用全力=Hùng Ưng bộc thỏ thượng dụng toàn lực
雍和大神=Ung Hòa Đại Thần
雍耀天=Ung Diệu Thiên
雨涵=Vũ Hàm
雨涵仙子=Vũ Hàm Tiên Tử
雪丹女仙王=Tuyết Đan Nữ Tiên Vương
雪主=Tuyết Chủ
雪主小元君=Tuyết Chủ Tiểu Nguyên Quân
雪主小元界=Tuyết Chủ Tiểu Nguyên Giới
雪姐姐=Tuyết tỷ tỷ
雪崖世界=Tuyết Nhai Thế Giới
雪晴=Tuyết Tình
雪晴姐=Tuyết Tình tỷ
雪窦=Tuyết Đậu
雷=Lôi
雷伯=Lôi Bá
雷光=Lôi Quang
雷公=Lôi Công
雷公神主=Lôi Công Thần Chủ
雷公金钹=Lôi Công Kim Bạt
雷兽=Lôi thú
雷劫=Lôi kiếp
雷州=Lôi Châu
雷幕=Lôi Mạc
雷幕山门=Lôi Mạc Sơn Môn
雷池=Lôi Trì
雷海=Lôi Hải
雷海仙兽=Lôi Hải Tiên Thú
雷渊=Lôi Uyên
雷电=Lôi Điện
雷祖=Lôi Tổ
雷霆道纹=Lôi Đình Đạo Văn
雷龙降世神通=Lôi Long Giáng Thế Thần Thông
霄象魔皇=Tiêu Tượng Ma Hoàng
霍一步=Hoắc Nhất Bộ
霜=Sương
霞光=hào quang
霸尊妖帝=Bá Tôn Yêu Đế
霸岳=Bá Nhạc
霹雳=Tích Lịch
青丝=tóc xanh
青云=Thanh Vân
青云宗=Thanh Vân Tông
青光=Ánh sáng xanh
青华=Thanh Hoa
青华仙君=Thanh Hoa Tiên Quân
青华仙王=Thanh Hoa Tiên Vương
青华佛帝=Thanh Hoa Phật Đế
青华国=Thanh Hoa Quốc
青华大老爷=Thanh Hoa Đại Lão gia
青华天=Thanh Hoa Thiên
青华天宫=Thanh Hoa Thiên Cung
青华宫=Thanh Hoa Cung
青山=Thanh Sơn
青牛=Thanh Ngưu
青牛尊者=Thanh Ngưu Tôn Giả
青牛神殿=Thanh Ngưu Thần Điện
青玄=Thanh Huyền
青玄真仙=Thanh Huyền Chân Tiên
青羽神扇=Thanh Vũ Thần Phiến
青色大蛇=Thanh Xà
青莲=Thanh Liên
青莲世界=Thanh Liên thế giới
青莲仙宫=Thanh Liên Tiên Cung
青莲仙尊=Thanh Liên Tiên Tôn
青莲大世界=Thế giới Thanh Liên
青莲宫=Thanh Liên Cung
青莲道人=Thanh Liên đạo nhân
青莲道兄=Thanh Liên đạo huynh
青莲镇道鼎=Thanh Liên Trấn Đạo Đỉnh
青莲鸿蒙世界=Thế giới Thanh Liên Hồng Mông
青萝宫=Thanh La Cung
青虚神主=Thanh Hư Thần Chủ
青衣=Thanh Y
青衣长老=Thanh Y trưởng lão
青衫少年=Thiếu niên áo xanh
青裳=Thanh Thường
青裳仙子=Thanh Thường tiên tử
青裳仙王=Thanh Thường Tiên Vương
青裳女仙=Thanh Thường Nữ Tiên
青裳娘娘=Thanh Thường Nương Nương
青霄=Thanh Tiêu
青鸟=Thanh Điểu
青龙=Thanh Long
青龙桩=Thanh Long thung
靖公子=Tĩnh công tử
靖州=Tĩnh Châu
静之剑意=Tĩnh Chi Kiếm Ý
靳东流=Cận Đông Lưu
靳师兄=Cận sư huynh
靳掌教=Hoa chưởng giáo
鞠躬尽瘁，死而后已=Cúc cung tận tụy, tử hậu dĩ
鞭子=Tiên Tử
韦昌=Vi Xương
韩芳=Hàn Phương
韩长老=Hàn trưởng lão
韭菜馅饺子=bánh sủi cảo nhân hẹ
顶上三花=Đỉnh Thượng Tam Hoa
顶点小说=Đỉnh Điểm tiểu thuyết
顺风营=Thuận Phong Doanh
须弥卧佛=Tu Di Ngọa Phật
须弥山=Tu Di Sơn
须阿=Tu A
须阿仙君=Tu A Tiên Quân
须阿大老爷=Tu A Đại Lão Gia
须阿梦洁=Tu A Mộng Khiết
须阿道心塔=Tu A Đạo Tâm Tháp
领袖峰=Lĩnh Tụ Phong
颚骨=Ngạc cốt
风=Phong
风华=Phong Hoa
风华旗主=Phong Hoa Kỳ Chủ
风华神主=Phong Hoa Thần Chủ
风后=Phong Hậu
风后神主=Phong Hậu Thần Chủ
风尘=Phong Trần
风尘神帝=Phong Trần Thần Đế
风师兄=Phong Sư huynh
风景旧曾谙=Phong cảnh cựu từng am
风月=Phong Nguyệt
风月仙王=Phong Nguyệt Tiên Vương
风满楼=Phong Mãn Lâu
风火连城仙域=Phong Hỏa Liên Thành Tiên Vực
风铃仙子=Phong Linh Tiên Tử
风铃儿=Phong Linh Nhi
风雪晴=Phong Tuyết Tình
飓风=cuồng phong
飘=Phiêu
飘渺=Phiêu Miểu
飞举=Phi Cử
飞举道人=Phi Cử Đạo Nhân
飞仙=Phi Tiên
飞仙屏风=Phi Tiên Bình Phong
飞仙神光=Phi Tiên Thần Quang
飞仙神族=Phi Tiên Thần Tộc
飞升=Phi Thăng
飞升仙界=Phi Thăng Tiên Giới
飞桥=Phi Kiều
飞熊=Phi Hùng
飞熊道人=Phi Hùng Đạo Nhân
飞飞=Phi Phi
飞龙=Phi Long
食粮=Thực Lương
饕餮=Thao Thiết
饕鹄=Thao Cốc
饕鹄尊者=Đao Cúc Tôn Giả
饭饭=Phạn Phạn
饭饭小幼蛟=Phạn Phạn Tiểu Ấu Giao
首席大祭酒=Thủ Tịch Đại Tế Tửu
香云华盖=Hương Vân Hoa Cái
香州=Hương Châu
香橼世界=Hương Viên Thế Giới
香炉=Hương Lô
香车=Hương Xa
香香=Hương Hương
马年=Năm Ngọ
马面魔王=Mã Diện Ma Vương
马面魔王马彭秋=Mã Diện Ma Vương Mã Bành Thu
马面魔王马鹏秋=Mã Diện Ma Vương Mã Bằng Thu
马鹏秋=Mã Bằng Thu
驭兽图=Ngự Thú Đồ
驭兽圈=Ngự Thú Khuyên
驭兽时代=Ngự Thú Thời Đại
驭兽营=Ngự Thú Doanh
驭星大教=Ngự Tinh Đại Giáo
驱神魔皇=Khu Thần Ma Hoàng
骑兵营=Kỵ Binh Doanh
骨帝=Cốt Đế
骨皇=Cốt Hoàng
骨皇魔皇=Cốt Hoàng Ma Hoàng
髋骨=xương hông
高等神界=Cao Đẳng Thần Giới
高铁=tàu cao tốc
鬼=Quỷ
鬼仙=Quỷ tiên
鬼仙界=Quỷ Tiên Giới
鬼仙花清妍=Quỷ Tiên Hoa Thanh Nghiên
鬼仙道=Quỷ Tiên Đạo
鬼婆天=Quỷ Bà Thiên
鬼婆婆=Quỷ bà bà
鬼帝=Quỷ Đế
鬼帝北都泉=Quỷ Đế Bắc Đô Tuyền
鬼怪=Quỷ Quái
鬼戎=Quỷ Nhung
鬼戎道君=Quỷ Nhung Đạo Quân
鬼方=Quỷ Phương
鬼界=Quỷ Giới
鬼脸=quỷ diện
鬼脸面具=mặt nạ mặt quỷ
鬼船=Quỷ Thuyền
鬼道天庭=Quỷ đạo thiên đình
鬼都=Quỷ Đô
鬼门关=Quỷ Môn Quan
鬼门真仙花清妍=Quỷ Môn Chân Tiên Hoa Thanh Nghiên
魁梧大汉=tráng hán khôi ngô
魂=Hồn
魂道=Hồn Đạo
魑魅魍魉=Si Mị Vong Lượng
魔=Ma
魔、咒=Ma, Chú
魔主=Ma Chủ
魔仙=Ma Tiên
魔仙尸身=thi thể Ma Tiên
魔仙殿=Ma Tiên Điện
魔元秘界=Ma Nguyên Bí Giới
魔光=Ma Quang
魔君=Ma Quân
魔天=Ma Thiên
魔天小童=Ma Thiên Tiểu Đồng
魔天道主=Ma Thiên Đạo Chủ
魔天魔君=Ma Thiên Ma Quân
魔字营=Ma Tự Doanh
魔将=Ma Tướng
魔尊=Ma Tôn
魔州=Ma Châu
魔帅=Ma Soái
魔帅燕公戬=Ma Soái Yến Công Tiễn
魔帝=Ma Đế
魔帝神姓=Ma Đế Thần Tính
魔庭=Ma Đình
魔性=Ma Tính
魔怪=Ma quái
魔文敕令=Ma Văn Sắc Lệnh
魔日=Ma Nhật
魔月=Ma Nguyệt
魔月二帝=Ma Nguyệt Nhị Đế
魔极证仙经=Ma Cực Chứng Tiên Kinh
魔殿=Ma Điện
魔气=Ma Khí
魔渊=Ma Uyên
魔渊皇图=Ma Uyên Hoàng Đồ
魔渊葬天=Ma Uyên Táng Thiên
魔火天幢=Ma Hỏa Thiên Tràng
魔灵=Ma Linh
魔灵之气=Ma Linh Chi Khí
魔灵液=Ma Linh Dịch
魔狱=Ma Ngục
魔狱洞天=Ma Ngục Động Thiên
魔狱玄胎=Ma Ngục Huyền Thai
魔狱玄胎经=Ma Ngục Huyền Thai Kinh
魔王=Ma Vương
魔王摩罗什=Ma Vương Ma La Thập
魔界=Ma giới
魔界宇宙=Ma Giới vũ trụ
魔界寂灭劫=Ma Giới Tịch Diệt Kiếp
魔皇=Ma Hoàng
魔祖=Ma Tổ
魔神=Ma Thần
魔神真身=Ma Thần chân thân
魔罗=Ma La
魔罗族=Ma La tộc
魔罗魔神=Ma La Ma Thần
魔罗魔神化身=Ma La Ma Thần hóa thân
魔舰=ma hạm
魔蝎=Ma Hạt
魔道=Ma Đạo
魔道大罗天=Ma Đạo Đại La Thiên
魔道时代=Thời đại Ma Đạo
魔钟霸体=Ma Chung Bá Thể
魔钟霸体神通=Ma Chung Bá Thể Thần Thông
魔镜=Ma Kính
魔门=Ma Môn
魔门大教=Ma Môn Đại Giáo
魔雷=Ma Lôi
魔鼓=Ma Cổ
魔龙尊者=Ma Long Tôn Giả
鲜血化身=Huyết nhục hóa thân
鲜血灵光分身=Tiên Huyết Linh Quang Phân Thân
鲞鱼=Tưởng Ngư
鲞鱼真神=Tưởng Ngư Chân Thần
鲤龙王=Lý Long Vương
鲧王=Cổn Vương
鲧道人=Cổn Đạo Nhân
鲮鲤=Lân Lý
鳄王神=Ngạc Vương Thần
鳄神=Ngạc Thần
鳄鲨魔尊=Ngạc Sa Ma Tôn
鸠驮罗=Cưu Đà La
鸣轩圣子=Minh Hiên Thánh Tử
鸿=Hồng
鸿儿=Hồng Nhi
鸿儿钧儿=Hồng Nhi, Cung Nhi
鸿师兄=Hồng Sư Huynh
鸿蒙=Hồng Mông
鸿蒙三圣=Hồng Mông Tam Thánh
鸿蒙三圣经=Hồng Mông Tam Thánh Kinh
鸿蒙之体=Hồng Mông Chi Thể
鸿蒙之气=Khí Hồng Mông
鸿蒙之身=Hồng Mông Chi Thân
鸿蒙之躯=Hồng Mông chi khu
鸿蒙之骨=Hồng Mông Chi Cốt
鸿蒙仙体=Hồng Mông Tiên Thể
鸿蒙先天=Hồng Mông Tiên Thiên
鸿蒙古气=Hồng Mông Tổ Khí
鸿蒙大道=Hồng Mông Đại Đạo
鸿蒙开天=Hồng Mông Khai Thiên
鸿蒙战神殿=Hồng Mông Chiến Thần Điện
鸿蒙树=Hồng Mông Thụ
鸿蒙气团=Hồng Mông Khí Đoàn
鸿蒙河=Hồng Mông Hà
鸿蒙皇道=Hồng Mông Hoàng Đạo
鸿蒙紫光=Hồng Mông Tử Quang
鸿蒙紫气=Hồng Mông Tử Khí
鸿蒙紫气天=Hồng Mông Tử Khí Thiên
鸿蒙紫气天仙帝=Hồng Mông Tử Khí Thiên Tiên Đế
鸿蒙紫瞳=Hồng Mông Tử Đồng
鸿蒙紫竹=Hồng Mông Tử Trúc
鸿蒙紫金=Hồng Mông Tử Kim
鸿蒙道种=Hồng Mông Đạo Chủng
鸿蒙金幡=Hồng Mông Kim Phiên
鸿蒙长河=Hồng Mông Trường Hà
鸿蒙青莲=Hồng Mông Thanh Liên
鸿蒙青莲经=Hồng Mông Thanh Liên Kinh
鸿道人=Hồng đạo nhân
鸿道祖=Hồng Đạo Tổ
鸿钧=Hồng Quân
鹊山=Thước Sơn
鹊风=Tước Phong
麒麟=Kỳ Lân
麒麟真仙=Kỳ Lân Chân Tiên
麻三寿=Ma Tam Thọ
黄巾剑客=Hoàng Cân Kiếm Khách
黄泉=Hoàng Tuyền
黄泉神水=Hoàng Tuyền Thần Thủy
黄祖=Hoàng Tổ
黄祖伟=Hoàng Tổ Vĩ
黄竹杖=Hoàng Trúc Trượng
黄筮=Hoàng Thệ
黄筮道君=Hoàng Thệ Đạo Quân
黄羊=Hoàng Dương
黄羊神殿=Thần điện Hoàng Dương
黄羊老祖=Hoàng Dương Lão Tổ
黄衫=Hoàng Sam
黄衫人=Hoàng Sam Nhân
黄衫少年=Hoàng Sam Thiếu Niên
黄辛道尊=Hoàng Tân Đạo Tôn
黄金为辕=Hoàng Kim Vi Viên
黄金神体=Hoàng Kim Thần Thể
黄金神族=Hoàng Kim Thần Tộc
黎华=Lê Hoa
黎华圣母=Lê Hoa Thánh Mẫu
黎夷=Lê Di
黑使神人=Hắc Sứ Thần Nhân
黑天魔尊=Hắc Thiên Ma Tôn
黑暗时期=Thời kỳ đen tối
黑水元君=Hắc Thủy Nguyên Quân
黑水元君女帝=Hắc Thủy Nguyên Quân Nữ Đế
黑水元城=Hắc Thủy Nguyên Thành
黑熊=Hắc Hùng
黑白二使=Hắc Bạch Nhị Sử
黑白子=Hắc Bạch Tử
黑色毒蝎=Hắc Độc Hạt
黑虎=Hắc Hổ
黑蝎妖尊=Hắc Hạt Yêu Tôn
黑蝎魔尊=Hắc Hạt Ma Tôn
黑衣=Hắc y
黑衣道空=Hắc Y Đạo Không
黑袍大祭酒=Hắc bào đại tế tửu
黑袍帝使=Hắc Bào Đế Sử
黑袍男子=Hắc Bào Nam Tử
黑迭=Hắc Điệp
黑迭古神=Hắc Điệp Cổ Thần
黑锅=Hắc oa
黑风=Hắc Phong
黑风老妖=Hắc Phong Lão Yêu
黛瑛=Đại Anh
黛瑛神主=Đại Anh Thần Chủ
鼎儿=Đỉnh Nhi
鼎杖=Đỉnh Trượng
鼎瓮樽玺=đỉnh ủng tôn tỷ
鼎足=Đỉnh Túc
齐王府=Tề Vương phủ
齐长老=Tề trưởng lão
齐随云=Tề Tùy Vân
龙=Rồng
龙三太子=Long Tam thái tử
龙主=Long Chủ
龙儿=Long Nhi
龙凤=Long Phượng
龙凤之气=Long phượng chi khí
龙凤开天=Long Phượng Khai Thiên
龙化=Long hóa
龙古文明=Văn minh Long Cổ
龙吟凤鸣=Long Ngâm Phượng Minh
龙吟风=Long Ngâm Phong
龙大爷=Long đại gia
龙女=Long Nữ
龙女仙王=Long Nữ Tiên Vương
龙尊=Long Tôn
龙尾峰=Long Vĩ Phong
龙岸=Long Ngạn
龙岸教主=Long Ngạn Giáo Chủ
龙岸道君=Long Ngạn đạo quân
龙巢=Long sào
龙德而隐者=Long đức nhi ẩn giả
龙戬=Long Tiễn
龙族=Long tộc
龙柱=long trụ
龙榜=Long Bảng
龙汉魔皇=Long Hán Ma Hoàng
龙涎香=Long Tiên Hương
龙皇=Long Hoàng
龙祖三连斩=Long Tổ Tam Liên Trảm
龙祖传承=Long Tổ truyền thừa
龙祖太息**=Long Tổ Thái Tức
龙祖太息**势=Long Tổ Thái Tức ** Thế
龙祖的混沌神兵=Hỗn Độn thần binh của Long Tổ
龙祖菩提仙君=Long Tổ Bồ Đề Tiên Quân
龙祖道果=Long Tổ đạo quả
龙祖鼎=Long Tổ Đỉnh
龙神=Long Thần
龙神烛陌=Long Thần Chúc Mạch
龙系=Long Hệ
龙纹山海衣=Long Văn Sơn Hải Y
龙罗=Long La
龙罗普尊=Long La Phổ Tôn
龙罗菩=Long La Bồ
龙罗菩仙君=Long La Bồ tiên quân
龙罗菩提=Long La Bồ Đề
龙罗菩提仙君=Long La Bồ Đề Tiên Quân
龙虎宗=Long Hổ Tông
龙虎宗主=Long Hổ Tông chủ
龙虎阴阳图=Long Hổ Âm Dương Đồ
龙虎风云榜=Long Hổ Phong Vân Bảng
龙蛇起陆=Long Xà Khởi Lục
龙血菩树=Long Huyết Bồ Thụ
龙逢=Long Phùng
龙逢仙王=Long Phùng Tiên Vương
龙逢道人=Long Phùng đạo nhân
龙野=Long Dã
龙首山=Long Thủ Sơn
龙鳞精铜=Long Lân Tinh Đồng
龙龟=Long quy