一袖碎乾坤=Nhất Tụ Toái Càn Khôn
丁卓=Đinh Trác
七宝台=Thất Bảo Đài
七宝台境=Cảnh giới Thất Bảo Đài
七宝林=Thất Bảo Lâm
七宝道台=Thất Bảo Đạo Đài
七魔寨=Thất Ma Trại
万剑图=Vạn Kiếm Đồ
万剑山庄=Vạn Kiếm Sơn Trang
万剑阵图=Vạn Kiếm Trận Đồ
万妖旗=Vạn Yêu Kỳ
万妖谷=Vạn Yêu Cốc
万尸路=Vạn Thi Lộ
万年天蚕丝=Vạn Niên Thiên Tàm Ti
万花楼=Vạn Hoa Lâu
万龙巢=Vạn Long Sào
三圣宝卷=Tam Thánh Bảo Quyển
三圣经=Tam Thánh Kinh
三昧真火=Tam Muội Chân Hỏa
三殿下=Tam điện hạ
三足金乌=Tam Túc Kim Ô
三魔天机秀士=Tam Ma Thiên Cơ Tú Sĩ
上清神光=Thượng Thanh Thần Quang
不动明王=Bất Động Minh Vương
不死冥王=Bất Tử Minh Vương
不死冥神=Bất Tử Minh Thần
不死山=Bất Tử Sơn
世界桥=Cầu nối thế giới
丘妗儿=Khâu Cấm Nhi
东岳剑气=Đông Nhạc Kiếm Khí
东王=Đông Vương
东王方=Đông Vương Phương
东王神府=Đông Vương Thần Phủ
东王神族=Đông Vương Thần tộc
东王舒=Đông Vương Thư
两[***]=hai mặt trời
中土=Trung Thổ
中土废墟=Trung Thổ Phế Khư
中天世界=Trung Thiên Thế Giới
中岳剑气=Trung Nhạc Kiếm Khí
丹=Đan
丹丘=Đan Khâu
丹族=Đan tộc
丹田=Đan Điền
丹神族=Đan Thần tộc
丹青树=Đan Thanh Thụ
主公=chủ công
主泉=Chủ Tuyền
乐青国=Nhạc Thanh Quốc
乙木之气=Khí Ất Mộc
九夷=Cửu Di
九夷神族=Cửu Di Thần tộc
九幽=Cửu U
九幽之地=Cửu U Chi Địa
九幽冥界=Cửu U Minh Giới
乱空大阵=Đại trận Loạn Không
乱空魔域=Loạn Không Ma Vực
乱空魔教=Loạn Không Ma Giáo
乾元宫=Càn Nguyên Cung
二魔石敢当=Nhị Ma Thạch Cảm Đương
云师兄=Vân sư huynh
云老爷=Vân lão gia
云鹏=Vân Bằng
五劫印=Ngũ Kiếp Ấn
五劫钟=Chuông Ngũ Kiếp
五哥=Ngũ ca
五彩孔雀=Khổng Tước Ngũ Sắc
五毒幡=Ngũ Độc Phiên
五毒炼魂**=Ngũ Độc Luyện Hồn **
五脏=Ngũ Tạng
五色神光=Ngũ Sắc Thần Quang
五色金=Ngũ Sắc Kim
五色钟=Chuông Ngũ Sắc
五行=Ngũ Hành
五行元力=Ngũ Hành Nguyên Lực
五行剑山=Ngũ Hành Kiếm Sơn
五雷印=Ngũ Lôi Ấn
五雷炼神印=Ngũ Lôi Luyện Thần Ấn
五魔=Ngũ Ma
人族=Nhân tộc
人神混血=Nhân Thần Hỗn Huyết
付延生=Phó Duyên Sinh
仙道=Tiên đạo
仙鼎=Tiên Đỉnh
令狐庸=Lệnh Hồ Dung
伍元山=Ngũ Nguyên Sơn
伍师兄=Ngũ sư huynh
众生相=Chúng Sinh Tướng
优婆离=Ưu-ba-ly
佛法=Phật Pháp
佛爷=Phật Gia
佛门=Phật Môn
佛门金刚法禅宗=Phật Môn Kim Cương Pháp Thiền Tông
佛门金身=Phật Môn Kim Thân
佛陀=Phật Đà
作者=Tác giả
修罗=Tu La
傅前辈=Tiền bối Phó
傅师兄=Sư huynh Phó
傅延宗=Phó Diên Tông
傅芸儿=Phó Vân Nhi
元山=Nguyên Sơn
元气大殿=Nguyên Khí Đại Điện
先天神=Tiên Thiên Thần
光明=Quang Minh
兜率神火=Đâu Suất Thần Hỏa
八卦炼丹炉=Bát Quái Luyện Đan Lô
八大佛门明王经典=Bát Đại Phật Môn Minh Vương Kinh Điển
八大神族=Bát Đại Thần Tộc
八百里紫气=Tám trăm dặm Tử Khí
八臂=Bát Tý
八阵金凤天王锤=Bát Trận Kim Phượng Thiên Vương Chùy
六大神通=Lục Đại Thần Thông
六大魔头=Lục Đại Ma Đầu
六欲相=Lục Dục Tướng
六腑=Lục Phủ
六道化身=Lục Đạo Hóa Thân
六道天轮=Lục Đạo Thiên Luân
六道天轮圣典=Lục Đạo Thiên Luân Thánh Điển
六道天轮美少女圣典=Lục Đạo Thiên Luân Mỹ Thiếu Nữ Thánh Điển
六道神念=Lục Đạo Thần Niệm
六道轮回=Lục Đạo Luân Hồi
六魔=Lục Ma
六魔哈兰生=Lục Ma Cáp Lan Sinh
兰芸=Lan Vân
养心宫=Dưỡng Tâm Cung
内罡=Nội Cương (chưa có bản dịch chính thức)
冉冉=rực rỡ
军荼利明王=Quân Trà Lợi Minh Vương
军荼利明王经=Quân Trà Lợi Minh Vương Kinh
冥毒之气=Minh Độc Chi Khí
冥河=Minh Hà
冥河巨兽=Minh Hà cự thú
冥王=Minh Vương
冥王城=Minh Vương Thành
冥王神血=Thần huyết Minh Vương
冥界=Minh Giới
凤翅火羽=Phượng Sí Hỏa Vũ
凤鸣轩=Phượng Minh Hiên
剑气御空=Kiếm Khí Ngự Không
勾陈境=Cú Trần cảnh
化血神功=Hóa Huyết Thần Công
北岳剑气=Bắc Nhạc Kiếm Khí
北极冰洋=Bắc Cực Băng Dương
北行神府=Bắc Hành Thần Phủ
北行神族=Bắc Hành Thần Tộc
北行雪=Bắc Hành Tuyết
十二重楼=Thập Nhị Trọng Lâu
十二重楼斩神经=Thập Nhị Trọng Lâu Trảm Thần Kinh
千丝拂尘=Thiên Ti Phất Trần
千秋阁=Thiên Thu Các
千翼=Thiên Dực
千翼神舟=Thiên Dực Thần Chu
千翼神遁**=Thiên Dực Thần Độn
千翼魔神=Thiên Dực Ma Thần
千翼魔神大神通=Thiên Dực Ma Thần Đại Thần Thông
千足蜈蚣=Thiên Túc Ngô Công (Con rết nghìn chân)
华严圣宗=Hoa Nghiêm Thánh Tông
华秀芳=Hoa Tú Phương
华胥氏=Hoa Tư Thị
华胥神族=Hoa Tư Thần tộc
南岳剑气=Nam Nhạc Kiếm Khí
南明离火=Nam Minh Ly Hỏa
南海=Nam Hải
南海万花楼=Nam Hải Vạn Hoa Lâu
南海盛宴=Nam Hải Thịnh Yến
卿王阁=Khanh Vương Các
古惑神族=Cổ Hoặc Thần Tộc
古昙元界=Cổ Đàm Nguyên Giới
古神阁=Cổ Thần Các
句山=Cú Sơn
句山氓=Cú Sơn Manh
句山神族=Cú Sơn Thần tộc
右旗使=Hữu Kỳ Sử
右旗使寮金斗=Hữu kỳ sứ Liêu Kim Đấu
后土境=Hậu Thổ cảnh
后土天宫=Hậu Thổ Thiên Cung
后土娘娘=Hậu Thổ Nương Nương
向云天=Hướng Vân Thiên
向天南=Hướng Thiên Nam
君兄=Quân huynh
君师姐=Quân sư tỷ
君思邪=Quân Tư Tà
君无道=Quân Vô Đạo
君梦忧=Quân Mộng Ưu
员丘山=Viên Khâu Sơn
周纯孝=Chu Thuần Hiếu
哈兰生=Ha Lan Sinh
商洛师兄=Thương Lạc sư huynh
商洛道人=Thương Lạc đạo nhân
啸邙=Khiếu Mang
喻涛=Dụ Đào
四哥=Tứ ca
四极炎阳**=Tứ Cực Viêm Dương **
四极炎阳大阵=Tứ Cực Viêm Dương Đại Trận
四极炎阳珠=Tứ Cực Viêm Dương Châu
四极炎阳诀=Tứ Cực Viêm Dương Quyết
四魔=Tứ Ma
图雨田=Đồ Vũ Điền
圣宗=Thánh Tông
地极元磁神通=Địa Cực Nguyên Từ Thần Thông
地母皇道经=Địa mẫu Hoàng Đạo Kinh
地狱神火=Địa Ngục Thần Hỏa
地狱魔火=Địa Ngục Ma Hỏa
地眼通=Địa Nhãn Thông
地磁元力=Địa Từ Nguyên Lực
地磁元力神通=Địa Từ Nguyên Lực Thần Thông
地磁元斧=Địa Từ Nguyên Phủ
地魔族=Địa Ma Tộc
墨师叔=Mặc sư thúc
外罡=Ngoại Cương
多择=Đa Trạch
夜摩神=Dạ Ma Thần
大五行剑气=Đại Ngũ Hành Kiếm Khí
大五行剑阵=Đại Ngũ Hành Kiếm Trận
大千楼船=Đại Thiên Lâu Thuyền
大千罗天仪=Đại Thiên La Thiên Nghi
大千遁法=Đại Thiên Độn Pháp
大哥=Đại ca
大妖=Đại yêu
大师兄=Đại sư huynh
大师兄神潜=Đại sư huynh Thần Tiềm
大明王神印=Đại Minh Vương Thần Ấn
大曰=Đại Nhật (Mặt Trời lớn)
大曰道纹=Đại Viết Đạo Văn
大欢喜禅经=Đại Hoan Hỷ Thiền Kinh
大渊=Đại Uyên
大荒圣宗=Đại Hoang Thánh Tông
大荒山印=Đại Hoang Sơn Ấn
大金刚轮=Đại Kim Cương Luân
大魔=Đại Ma
大魔鬼面男子=Đại Ma Quỷ Diện Nam Tử
大鹏=Đại Bàng
大鹏明王法身=Đại Bàng Minh Vương Pháp Thân
大鹏明王真身=Đại Bằng Minh Vương Chân Thân
大鹏明王经=Đại Bằng Minh Vương Kinh
大鹏金翅=Đại Bằng Kim Sí
天妖圣女=Thiên Yêu Thánh Nữ
天妖圣女花怜香=Thiên Yêu Thánh Nữ Hoa Liên Hương
天宫=Thiên Cung
天宫之宝=Thiên Cung Chi Bảo
天宫级经典=Thiên Cung Cấp Kinh Điển
天府=Thiên Phủ
天府重楼=Thiên Phủ Trọng Lâu
天府重楼大神通=Thiên Phủ Trọng Lâu Đại Thần Thông
天府重楼神通=Thiên Phủ Trọng Lâu Thần Thông
天庭=Thiên Đình
天意钩=Thiên Ý Câu
天族=Thiên tộc
天机秀士=Thiên Cơ Tú Sĩ
天王炼神圣法=Thiên Vương Luyện Thần Thánh Pháp
天眼通=Thiên Nhãn Thông
天神=Thiên Thần
天神下凡=Thiên Thần Hạ Phàm
天神魔神=Thiên Thần Ma Thần
天罡斩妖剑=Thiên Cương Trảm Yêu Kiếm
天道=Thiên đạo
天金丝=Thiên Kim Ti
天门=Thiên Môn
天门神府=Thiên Môn thần phủ
天霄精铜=Thiên Tiêu Tinh Đồng
天魔堡=Thiên Ma Bảo
天魔宗=Thiên Ma Tông
天魔楼船=Thiên Ma Lâu Thuyền
天魔琴=Thiên Ma Cầm
天魔葬神曲=Thiên Ma Táng Thần Khúc
天魔霓裳大阵=Thiên Ma Nghê Thường Đại Trận
天魔霓裳舞=Thiên Ma Nghê Thường Vũ
天鹏羽化=Thiên Bằng Vũ Hóa
天鹏羽化**=Thiên Bằng Vũ Hóa **
天鹤王族=Thiên Hạc Vương Tộc
天龙=Thiên Long
天龙业火=Thiên Long Nghiệp Hỏa
天龙八音=Thiên Long Bát Âm
天龙八音钟=Chuông Thiên Long Bát Âm
天龙叱咤真经=Thiên Long Sích Trá Chân Kinh
太上长老=Thái Thượng Trưởng Lão
太公府=Thái Công Phủ
太炎金精=Thái Viêm Kim Tinh
太玄圣女=Thánh nữ Thái Huyền
太玄圣宗=Thái Huyền Thánh Tông
太玄圣宗的神刀归千愁=Thần đao Quy Thiên Sầu của Thái Huyền Thánh Tông
太玄大阵=Đại Trận Thái Huyền
太玄心经=Thái Huyền Tâm Kinh
太皇=Thái Hoàng
太皇峰=Thái Hoàng Phong
太皇统一=Thái Hoàng Thống Nhất
太皇老祖=Tổ sư Thái Hoàng
太阳=Thái Dương
太阳元气=Thái Dương nguyên khí
太阳印=Thái Dương Ấn
太阳战车=Thái Dương Chiến Xa
太阳真火=Thái Dương Chân Hỏa
太阳真经=Thái Dương Chân Kinh
太阳神化身=Hóa thân Thần Thái Dương
太阴=Thái Âm
太阴魔火=Thái Âm Ma Hỏa
夷=Di
奇珍异果=Kỳ trân dị quả
奈何珠=Nại Hà Châu
奥秘=奥秘
女施主=nữ thí chủ
妖族=Yêu tộc
妖王=Yêu Vương
妖神宗=Yêu Thần Tông
妖神宫=Yêu Thần Cung
妖道=Yêu Đạo
妖风扇=Yêu Phong Phiến
妗儿=Cấm Nhi
姓江的小子=thằng nhóc họ Giang
姜少书=Khương Thiếu Thư
姜柔=Khương Nhu
姜氏=Khương Thị
姜氏神族=Khương thị Thần tộc
姜法王=Khương Pháp Vương
姜神通=Khương Thần Thông
姜维=Khương Duy
媚月=Mị Nguyệt
媚月楼主=Mị Nguyệt Lâu Chủ
子川=Tử Xuyên
孔雀大佛=Khổng Tước Đại Phật
孔雀大明王法身=Khổng Tước Đại Minh Vương Pháp Thân
孔雀彩翼=Khổng Tước Thải Dực
孔雀明王=Khổng Tước Minh Vương
孔雀明王印=Khổng Tước Minh Vương Ấn
孔雀明王法身=Khổng Tước Minh Vương Pháp Thân
孔雀明王真身=Khổng Tước Minh Vương Chân Thân
孔雀明王经=Khổng Tước Minh Vương Kinh
孔雀翎=Khổng Tước Linh
孙婆婆=Tôn bà bà
孟洛川=Mạnh Lạc Xuyên
宅猪=Trạch Trư
宇清宙光玄经=Vũ Thanh Trụ Quang Huyền Kinh
宗主大殿=Tông Chủ Đại Điện
宗主峰=Tông Chủ Phong
宝瓶=Bảo Bình
宝瓶印=Bảo Bình Ấn
宝辇=Bảo Niễn
宣无邪=Tuyên Vô Tà
宫商角徵=Cung Thương Giác Chủy
宵金窟=Tiêu Kim Quật
寒师弟=Hàn sư đệ
寒褚=Hàn Chử
寒褚师兄=Hàn Chử sư huynh
寒褚道人=Hàn Chử đạo nhân
寒霜世界=Hàn Sương Thế Giới
寒鹊=Hàn Thước
寮金斗=Liêu Kim Đấu
小圣尊=Tiểu Thánh Tôn
小灰灰=Tiểu Hôi Hôi
小邪王=Tiểu Tà Vương
小邪王江子川=Tiểu Tà Vương Giang Tử Xuyên
少商=Thiếu Thương
屠师伯=Đồ sư bá
屠师叔=Đồ sư thúc
屠道人=Đồ Đạo Nhân
屠魔大会=Đồ Ma Đại Hội
山形大印=Đại ấn hình núi
山海鼎=Đỉnh Sơn Hải
山石=sơn thạch
岳父=Nhạc phụ
左丘尚=Tả Khâu Thượng
左伯仁=Tả Bá Nhân
左旗=Tả Kỳ
左旗使图雨田=Tả Kỳ Sử Đồ Vũ Điền
巴楚道人=Ba Sở Đạo Nhân
巽风=Tốn Phong (gió Tốn)
帅仲商=Soái Trọng Thương
师尊=Sư Tôn
席应情=Tịch Ứng Tình
席掌教=Tịch Chưởng Giáo
幽冥神水=U Minh Thần Thủy
幽暗魔土=U Ám Ma Thổ
幽暗魔土之气=Khí U Ám Ma Thổ
幽深的洞府=động phủ u tĩnh
应情=Ứng Tình
庚金=Canh Kim
庚金之气=Khí Canh Kim
廖师兄=Liaooo Sư huynh
建武国=Kiến Vũ quốc
弑神谷=Thích Thần Cốc
弑神谷主=Thí Thần Cốc Chủ
弱水地狱=Nhược Thủy Địa Ngục
归前辈=Tiền bối Quy
归千愁=Quy Thiên Sầu
归师兄=Quy sư huynh
归真丹=Quy Chân Đan
彩凤=Thải Phượng
彩翼=Thải Dực
御宝斋=Ngự Bảo Trai
怜香=Liên Hương
怜香公主=Công chúa Liên Hương
思思=Tư Tư
恒宇神金=Hằng Vũ Thần Kim
恒宇神金锁链=Hằng Vũ Thần Kim Tỏa Liên
慕师叔=Mộ sư thúc
慕晚晴=Mộ Vãn Tình
慕烟儿=Mộ Yên Nhi
慕青=Mộ Thanh
战争巨兽=Chiến Tranh Cự Thú
战神=Chiến Thần
战神体=Chiến Thần Thể
战神墓=Chiến Thần Mộ
战骑部=Chiến Kỵ Bộ
战魂部=Chiến Hồn Bộ
执法堂=Chấp Pháp Đường
护法金刚=Hộ pháp Kim Cương
拓跋=Thác Bạt
拓跋兰芸=Thác Bạt Lan Vân
拓跋流照=Thác Bạt Lưu Chiếu
招贤令=Chiêu Hiền Lệnh
拜月楼=Bái Nguyệt Lâu
持斧大汉=Đại hán cầm rìu
掌教=Chưởng giáo
掌教至尊=Chưởng giáo Chí Tôn
掌教辅文恭=Chưởng giáo Phụ Văn Cung
接引使=Tiếp Dẫn Sứ
揽月手神通=Lãm Nguyệt Thủ Thần Thông
摩罗什=Ma La Thập
摩罗南=Ma La Nam
摩罗族=Ma La tộc
摩罗昆吾=Ma La Côn Ngô
摩罗神族=Ma La Thần tộc
摩罗老祖=Ma La Lão Tổ
摩羅神族=Ma La Thần Tộc
摩诃摩瑜利佛母明王大陀罗尼=Ma Ha Ma Duệ Lợi Phật mẫu Minh Vương Đại Đà La Ni
擒龙手=Cầm Long Thủ
文师兄=Văn sư huynh
斑斓锤=Ban Lan Chuy
斗法神典=Đấu Pháp Thần Điển
无定寺=Vô Định Tự
无心=Vô Tâm
无心和尚=Vô Tâm Hòa Thượng
无相=Vô Tướng
无相劫经=Vô Tướng Kiếp Kinh
无相大禅师=Vô Tướng Đại Thiền Sư
无相神僧=Vô Tướng Thần Tăng
无相禅师=Vô Tướng Thiền Sư
无相银僧=Vô Tướng Ngân Tăng
无量镜=Vô Lượng Kính
昆仑=Côn Luân
昆仑神府=Thần Phủ Côn Lôn
昆吾=Côn Ngô
明堂神府=Minh Đường Thần Phủ
明月=Minh Nguyệt
明王神印=Minh Vương Thần Ấn
星光甲=Tinh Quang Giáp
星月之法=Tinh Nguyệt Chi Pháp
星月神体=Tinh Nguyệt Thần Thể
星月神体魔典=Tinh Nguyệt Thần Thể Ma Điển
星月神宗=Tinh Nguyệt Thần Tông
星月魔宗=Tinh Nguyệt Ma Tông
星泪神金=Tinh Lệ Thần Kim
晓月=Hiểu Nguyệt
晓月师叔=Tiểu Nguyệt sư thúc
晓月道人=Hiểu Nguyệt Đạo Nhân
晚晴=Vãn Tình
普度往生经=Phổ Độ Vãng Sinh Kinh
智珠在握=Trí châu tại ác
曰光=ánh nắng mặt trời
曹青山=Tào Thanh Sơn
月亮=Mặt Trăng
月桂树=Nguyệt Quế Thụ
月桂神树=Nguyệt Quế Thần Thụ
月轩皇帝=Nguyệt Hiên Hoàng Đế
有熊=Hữu Hùng
有熊氏=Hữu Hùng thị
望江峰=Vọng Giang Phong
朝圣宗=Triều Thánh Tông
朱煜=Chu Dục
朱雀=Chu Tước
李原空=Lý Nguyên Không
极乐世界=Cực Lạc Thế Giới
极乐神宫=Cực Lạc Thần Cung
枭雄=Kiêu hùng
枯骨=khô cốt
柔公主=Nhu công chúa
柔宫主=Nhu cung chủ
梦蝶**=Mộng Điệp **
椒盐味=Vị tiêu muối
楚香香=Sở Hương Hương
欧阳羽=Âu Dương Vũ
武圣阁=Võ Thánh Các
气血=Khí huyết
水烟生=Thủy Yên Sinh
水精之气=Thủy Tinh Chi Khí
汉沣=Hán Phong
江南=Giang Nam
江南江雪=Giang Nam Giang Tuyết
江子川=Giang Tử Xuyên
江师侄=Giang sư điệt
江师兄=Giang sư huynh
江师弟=Giang sư đệ
江施主=Giang thí chủ
江某=Giang mỗ
江某某=Giang mỗ mỗ
江琳=Giang Lâm
江道友=Giang đạo hữu
江雪=Giang Tuyết
汪峰=Uông Phong
沧海明月心经=Thương Hải Minh Nguyệt Tâm Kinh
沧海桑田=Thương Hải Tang Điền
沧海桑田**=Thương Hải Tang Điền
法力=Pháp lực
法华生=Pháp Hoa Sinh
法天=Pháp Thiên
法天和尚=Pháp Thiên Hòa Thượng
法天象地=Pháp Thiên Tượng Địa
法宝战魂枪=Pháp Bảo Chiến Hồn Thương
法由心生=Pháp do tâm sinh
法相=Pháp Tướng
法相和尚=Pháp Tướng Hòa Thượng
法禅宗=Pháp Thiền Tông
法身=Pháp Thân
洛姐姐=Lạc tỷ tỷ
洛师伯=Sư bá Lạc
洛师叔=Lạc sư thúc
洛师姐=Lạc sư tỷ
洛花音=Lạc Hoa Âm
洞天=Động Thiên
洪钟大吕=Hồng Chung Đại Lữ
浑天万象罗盘=Hồn Thiên Vạn Tượng La Bàn (tạm dịch)
浑天空动仪=Hồn Không Động Nghi
浒山=Hổ Sơn
浣清池=Hoàn Thanh Trì
涂云山=Đồ Vân Sơn
混元一气孔雀明王经=Hỗn Nguyên Nhất Khí Khổng Tước Minh Vương Kinh
混沌鸿蒙=Hỗn Độn Hồng Mông
溺战羽神族=Nịch Chiến Vũ Thần Tộc
火云峰=Hỏa Vân Phong
火圣=Hỏa Thánh
火山印=Hỏa Sơn Ấn
火灵果=Hỏa Linh Quả
火龙果=Hỏa Long Quả
灵乾峰=Linh Càn Phong
灵台=Linh Đài
灵台境=Linh Đài Cảnh
灵泉=Linh tuyền
灵液=Linh dịch
灵珠=Linh Châu
灵秀峰=Linh Tú Phong
炎阳珠=Viêm Dương Châu
烈曰骄阳=Liệt Nhật Kiêu Dương (Mặt trời rực lửa)
焦虺=Tiêu Hủy
焦虺妖王=Tiêu Hủy Yêu Vương
熊=Hùng
熊千里=Hùng Thiên Lý
熊道友=Hùng đạo hữu
燕师兄=Yên sư huynh
牛头虎面=Ngưu Đầu Hổ Diện
狮子=Sư Tử
狮子印=Sư Tử Ấn
狱神舟=Ngục Thần Chu
狸猫十三扑=Lì Miêu Thập Tam phốc
玄台=Huyền Đài
玄天圣宗=Huyền Thiên Thánh Tông
玄幽老道=Huyền U Lão Đạo
玄幽道人=Huyền U Đạo Nhân
玄明元界=Huyền Minh Nguyên Giới
玄武=Huyền Vũ
玄武王族=Huyền Vũ Vương Tộc
玄胎=Huyền Thai
玄胎印=Huyền Thai Ấn
玄胎金人=Huyền Thai Kim Nhân
玄贺=Huyền Hạ
玄都=Huyền Đô
玄都七宝林=Huyền Đô Thất Bảo Lâm
玄都忘情天书=Huyền Đô Vong Tình Thiên Thư
玄铁精英=Huyền Thiết Tinh Anh
玄门=Huyền Môn
玄门圣体=Huyền Môn Thánh Thể
玄门金身=Huyền Môn Kim Thân
玄门金身圣典=Huyền Môn Kim Thân Thánh Điển
玄阴魔水=Huyền Âm Ma Thủy
玄隐=Huyền Ẩn
玄隐道人=Huyền Ẩn Đạo Nhân
玄鸟青翼=Huyền Điểu Thanh Dực
玄黄二气=Huyền Hoàng Nhị Khí
玉京=Ngọc Kinh
玉台=Ngọc Đài
玉宫=Ngọc Cung
玉池香园=Ngọc Trì Hương Viên
玉琉璃界=Ngọc Lưu Ly Giới
玉生香=Ngọc Sinh Hương
玉皇=Ngọc Hoàng
玉皇天宫=Ngọc Hoàng Thiên Cung
玲珑护神金缕衣=Linh Lung Hộ Thần Kim Lũ Y
珈蓝袈裟=Già Lam Già Sa
珍宝宫=Trân Bảo Cung
琳儿=Lâm Nhi
琳师妹=Lâm sư muội
琴仙子=Cầm Tiên Tử
琴弦=Cầm huyền
琴道=Cầm Đạo
琼宇高楼=Quỳnh Vũ Cao Lâu
瑶台=Dao Đài
瑶台境=Dao Đài Cảnh
瑶玉=Dao Ngọc
生死万化魔轮=Sinh Tử Vạn Hóa Ma Luân
生死万化魔轮经=Sinh Tử Vạn Hóa Ma Luân Kinh
生死台=Sinh Tử Đài
生死台境=Sinh Tử Đài Cảnh
畎戎=Khuyển Nhung
畎氏神族=Khuyển Thị Thần Tộc
白沧海=Bạch Thương Hải
白泽氏=Bạch Trạch Thị
白熊=Bạch Hùng
白虎金精=Tinh Kim Bạch Hổ
白隆=Bạch Long
白骨化魔**=Bạch Cốt Hóa Ma **
白骨葫芦=Bạch Cốt Hồ Lô
百子鬼母大神通=Bách Tử Quỷ Mẫu Đại Thần Thông
百晓楼=Bách Hiểu Lâu
百晓楼主=Bách Hiểu Lâu Chủ
百欲弑神谷=Thung lũng Bách Dục Thí Thần
百欲弑神谷的大魔=Đại Ma của Bách Dục Thí Thần Cốc
百汇=Bách Hội
百色王族=Bách Sắc Vương Tộc
百色魔族=Bách Sắc Ma Tộc
百魔窟=Bách Ma Quật
相空=Tương Không
真身=Chân thân
真魔大会=Đại hội Chân Ma
矮瘦魔族=Ma tộc gầy gò
石君述=Thạch Quân Thuật
石敢当=Thạch Cảm Đương
石族=Thạch tộc
石族太子=Thái tử Thạch Tộc
石生花=Thạch Sinh Hoa
石碑=bia đá
石龙道人=Thạch Long Đạo Nhân
石龙长老=Thạch Long trưởng lão
矿山架子=khung mỏ
破军戟=Phá Quân Kích
祖圣=Tổ Thánh
祖天=Tổ Thiên
祖阳=Tổ Dương
祖阳公子=Công tử Tổ Dương
祖阳太子=Tổ Dương Thái tử
神=Thần
神人=Thần nhân
神仙窝=Thần Tiên Oa
神兽=Thần thú
神台=Thần Đài
神台境=Thần Đài Cảnh
神垕=Thần Hậu
神墟=Thần Khư
神女遗蜕=Thiên nữ di thể
神宗=Thần Tông
神宫=Thần Cung
神尸=Thần Thi
神府=Thần Phủ
神府之宝=Thần Phủ Chi Bảo
神念=Thần Niệm
神族=Thần tộc
神明=Thần Minh
神潜=Thần Tiềm
神秀=Thần Tú
神秀道人=Thần Tú đạo nhân
神藏古地域=Thần Tàng Cổ Vực
神血=Thần huyết
神识=Thần thức
神识化身=Thần thức hóa thân
神轮=Thần Luân
神轮圣丹=Thần Luân Thánh Đan
神通=Thần thông
神通天府重楼=Thần Thông Thiên Phủ Trọng Lâu
神霄宗=Thần Tiêu Tông
神驼王族=Thần Đà Vương Tộc
神骨=Thần Cốt
神魔结界=Thần Ma Kết Giới
神鹫=Thần Thứu
神鹫妖王=Thần Thứu Yêu Vương
神鼎=Thần đỉnh
神龙木=Thần Long Mộc
禅心寺=Thiền Tâm Tự
禅心岛=Thiền Tâm Đảo
秀士=Tú sĩ
秦非鱼=Tần Phi Ngư
穆仙子=Mục tiên tử
穆师兄=Mục sư huynh
空明镜=Không Minh Kính
空青草=Không Thanh Thảo
竹筒=Ống trúc
第七魔=Đệ Thất Ma
第二百四十一章=Chương 241
第五重神火=Thần Hỏa tầng thứ năm
第六秘境=Đệ lục bí cảnh
紫府=Tử Phủ
紫微天宫=Tử Vi Thiên Cung
紫月=Tử Nguyệt
紫河车=Tử Hà Xa
紫霄宫=Tử Tiêu Cung
紫霄宫境=Tử Tiêu Cung Cảnh
纯阳宫=Thuần Dương Cung
纯阳无极分神剑=Thuần Dương Vô Cực Phân Thần Kiếm
纯阳无极钟=Thuần Dương Vô Cực Chung
纯阳殿=Thuần Dương Điện
绿莲魔珠=Lục Liên Ma Châu
罗天仪=La Thiên Nghi
罗天法相=La Thiên Pháp Tướng
罗汉=La Hán
罗王族=La Vương Tộc
罗长老=La trưởng lão
罗青=La Thanh
罡气=Cương khí
群山=quần sơn
羽=Vũ
羽化功=Vũ Hóa Công
羽族=Vũ tộc
羽神族=Vũ Thần tộc
羽蛇之翼=Vũ Xà Chi Dực
翠云宫=Thúy Vân Cung
翠翠=Thúy Thúy
翻天印=Phiên Thiên Ấn
翻天印法=Phiên Thiên Ấn Pháp
翻天印神通=Phiên Thiên Ấn Thần Thông
老七=Lão Thất
聚贤峰=Tụ Hiền Phong
胡阎山=Hồ Diêm Sơn
舍利=Xá Lợi
舒师兄=Thư sư huynh
舒望月=Thư Vọng Nguyệt
舞仙子=Vũ Tiên Tử
花怜香=Hoa Liên Hương
花音=Hoa Âm
芸儿=Vân Nhi
苍云术=Thương Vân Thuật
苏晃=Tô Hoảng
苏陌川=Tô Mạch Xuyên
苗=Miêu
苗素素=Miêu Tố Tố
苦舟阁=Khổ Chu Các
范文公=Phạm Văn Công
荒古圣山=Hoang Cổ Thánh Sơn
荒神铁=Hoang Thần Thiết
药王府=Dược Vương Phủ
莫师兄=Mạc sư huynh
莲台=Liên Đài
莲台境=Liên Đài Cảnh
莲花=Liên Hoa
菩萨=Bồ Tát
菩萨大士=Bồ Tát Đại Sĩ
萧师姐=Tiêu sư tỷ
萧无极=Tiêu Vô Cực
萧长歌=Tiêu Trường Ca
葬神谷=Táng Thần Cốc
葵水=Quý Thủy
蒋师兄=Tưởng sư huynh
蓝山师伯=Sư bá Lam Sơn
蓝山道人=Lam Sơn Đạo Nhân
薪火=Tân Hỏa
藏经楼=Tàng Kinh Lâu
虎榜=Hổ Bảng
虬龙=Cầu Long
虬龙魔体=Cầu Long Ma Thể
蛮荒元界=Man Hoang Nguyên Giới
蝙蝠膜翅=Biên Bức Mạc Sí
螣蛇之翼=Đằng Xà Chi Dực
螣蛇鞭=Đằng Xà Tiên
血凰=Huyết Hoàng
血魔化生**=Huyết Ma Hóa Sinh Đại Pháp
行云大禅师=Hành Vân Đại Thiền Sư
行痴和尚=Hành Si Hoà Thượng
补天之物=Bổ Thiên Chi Vật
补天印=Bổ Thiên Ấn
西岳剑气=Tây Nhạc Kiếm Khí
角族=Giác tộc
诸天星辰=Chư Thiên Tinh Thần
谈师兄=Đàm sư huynh
谢天佑=Tạ Thiên Hữu
谭师弟=Đàm sư đệ
谷主=Cốc chủ
赤火流金=Xích Hỏa Lưu Kim
赤龙=Xích Long
赤龙老鬼=Xích Long lão quỷ
轻罗云纱=Khinh La Vân Sa
辅文恭=Phụ Văn Cung
辛龙子=Tân Long Tử
辰山=Thần Sơn
追风舟=Truy Phong Chu
逐流=Trục Lưu
通道=kênh, đường hầm
造化之名=danh hiệu Tạo Hóa
造化仙经=Tạo Hóa Tiên Kinh
造化仙翁=Tạo Hóa Tiên Ông
造化仙鼎=Tạo Hóa Tiên Đỉnh
遁火流光=Độn Hỏa Lưu Quang
遁火流光神通=Độn Hỏa Lưu Quang Thần Thông
道侣=Đạo lữ
道台=Đạo Đài
道台八境=Đạo Đài Bát Cảnh
道神=Đạo Thần
道金炼骨镇魔经=Đạo Kim Luyện Cốt Trấn Ma Kinh
道音=Đạo âm
道音喝唱=Đạo Âm Hát Xướng
道音鼓=Cổ Đạo Âm
郭师叔=Quách sư thúc
郭玉珍=Quách Ngọc Trân
都天神照经=Đô Thiên Thần Chiếu Kinh
释若龙=Thích Nhược Long
野狗道人=Dã Cẩu Đạo Nhân
量劫阵图=Lượng Kiếp Trận Đồ
金乌=Kim Ô
金乌火翅=Kim Ô Hỏa Sí
金佛=Kim Phật
金凤阁=Kim Phượng Các
金刚圈=Kim Cương Quyền
金刚法禅宗=Kim Cương Pháp Thiền Tông
金刚法身=Kim Cương Pháp Thân
金察=Kim Sát
金桥=Kim Kiều
金牛=Kim Ngưu
金牛丘山=Kim Ngưu Khâu Sơn
金牛圣尊=Kim Ngưu Thánh Tôn
金牛大魔王=Kim Ngưu Đại Ma Vương
金牛尊者=Kim Ngưu Tôn Giả
金牛族=Kim Ngưu tộc
金牛玺=Kim Ngưu Tỉ
金牛神族=Kim Ngưu Thần Tộc
金牛紫月=Kim Ngưu Tử Nguyệt
金牛魔王=Kim Ngưu Ma Vương
金翅大鹏=Kim Sí Đại Bằng
金身=Kim Thân
金身法相=Kim Thân Pháp Tướng
金身霸体=Kim Thân Bá Thể
金风=Kim Phong
金龙=Kim Long
钟岳=Chung Nhạc
钱师弟=Tiền sư đệ
铁壁山神盾=Thiết Bích Sơn Thần Thuẫn
铁柱=Thiết Trụ
银僧=Ngân Tăng
银蛟剑=Ngân Giao Kiếm
镇教之宝=Trấn Giáo Chi Bảo
长弓=Trường Cung
长生天宫=Trường Sinh Thiên Cung
阎山=Diêm Sơn
阎战=Diêm Chiến
阎浮=Diêm Phù
阎浮提魔经=Diêm Phù Đề Ma Kinh
阎王城=Diêm Vương Thành
阎罗王族=Diêm La Vương Tộc
阙阳宫=Khuyết Dương Cung
阳夷神族=Dương Di Thần tộc
阳逻=Dương La
阴沟里翻船=lật thuyền trong mương
阴阳二仙斩=Âm Dương Nhị Tiên Trảm
阴阳二气=Âm Dương Nhị Khí
阵旗部=Trận Kỳ Bộ
阿修罗魔经=A Tu La Ma Kinh
陆天=Lục Thiên
陆生巨兽=Lục Sinh Cự Thú
陈师弟=Trần sư đệ
陈越=Trần Việt
陈道子=Trần Đạo Tử
降三世明王=Hàng Tam Thế Minh Vương
陶长老=Đào trưởng lão
雁门宗=Nhạn Môn Tông
雪鹄=Tuyết Hộc
雷泽大漠神通=Lôi Trạch Đại Mạc Thần Thông
雷霆=Lôi Đình
霍师兄=Hoắc sư huynh
霹雳无敌雷光电闪美少女=Bích Lịch Vô Địch Lôi Quang Điện Thiểm Mỹ Thiếu Nữ
青云宗=Thanh Vân Tông
青云宗的掌教=Chưởng giáo Thanh Vân Tông
青云战体=Thanh Vân Chiến Thể
青云道人=Thanh Vân Đạo Nhân
青华天宫=Thanh Hoa Thiên Cung
青山道人=Thanh Sơn đạo nhân
青莲=Thanh Liên
青龙桩=Trụ Thanh Long
靳东流=Cận Đông Lưu
靳师侄=Cận sư điệt
韩师叔=Hàn sư thúc
韩芳=Hàn Phương
韩长老=Hàn trưởng lão
音波神通=Âm ba Thần thông
领袖峰=Lãnh Tụ Phong
风夷神族=Phong Di Thần Tộc
风满楼=Phong Mãn Lâu
风火九龙扇=Phong Hỏa Cửu Long Phiến
风臣秀=Phong Thần Tú
风阳=Phong Dương
风阳少商=Phong Dương Thiếu Thương
风魔王族=Phong Ma Vương Tộc
飞天=Phi Thiên
香车=Hương xa
骆空明=Lạc Không Minh
骊龙=Ly Long
骨=cốt (tham gia)
鬼佛=Quỷ Phật
鬼佛城=Quỷ Phật Thành
鬼脸面具=Mặt nạ quỷ
鬼面男子=Người đàn ông mặt nạ quỷ
魏皓=Ngụy Hạo
魔=Ma
魔使=Ma sứ
魔域=Ma Vực
魔域大泽=Ma Vực Đại Trạch
魔头=Ma đầu
魔将=Ma tướng
魔尊=Ma Tôn
魔族=Ma Tộc
魔气=Ma khí
魔海=Ma Hải
魔火=Ma Hỏa
魔火焚世=Ma Hỏa Phần Thế
魔狱=Ma Ngục
魔狱万象轮=Ma Ngục Vạn Tượng Luân
魔狱玄胎=Ma Ngục Huyền Thai
魔狱玄胎经=Ma Ngục Huyền Thai Kinh
魔猿大力神通=Ma Viên Đại Lực Thần Thông
魔王墓=Mộ Ma Vương
魔王府=Ma Vương Phủ
魔神=Ma Thần
魔神之躯=Ma Thần Chi Khu
魔神真身=Ma Thần Chân Thân
魔神肉翅=Ma Thần Nhục Sí
魔道=Ma Đạo
魔钟=Ma Chung
魔钟霸体=Ma Chung Bá Thể
魔钟霸体神通=Ma Chung Bá Thể Thần Thông
魔魂堡=Ma Hồn Bảo
魔龙神族=Ma Long Thần Tộc
魔龙驹=Ma Long Cừu
鲧=Cổn
鲧氏=Cổn Thị
鲧鳐=Cổn Dao
鲲溟=Côn Minh
鸣轩圣子=Minh Hiên Thánh Tử
鸿蒙=Hồng Mông
鹊狐族=Thước Hồ Tộc
麻三寿=Ma Tam Thọ
黄泉圣水=Hoàng Tuyền Thánh Thủy
黄泉路=Hoàng Tuyền Lộ
黄衫=Hoàng Sam
黄衫少年=Thiếu niên áo vàng
黄轩=Hoàng Hiên
黄金神族=Hoàng Kim Thần Tộc
黄金车=Hoàng Kim Xa
黎放=Lê Phóng
黑水=Hắc Thủy
齐长老=Tề trưởng lão
齑粉=tề phấn
龙三太子=Long Tam Thái Tử
龙兰大会=Long Lan Đại Hội
龙凤=Long Phụng
龙凤纹鼎=Long Phượng Văn Đỉnh
龙吟风=Long Ngâm Phong
龙山=Long Sơn
龙山真人=Long Sơn Chân Nhân
龙族=Long tộc
龙皇=Long Hoàng
龙纹山海衣=Long Văn Sơn Hải Y
龙肉=Long nhục
龙虎宗=Long Hổ Tông
龙虎风云榜=Long Hổ Phong Vân Bảng
龙血骨杖=Long Huyết Cốt Trượng
龙象=Long Tượng
龙霄真人=Long Tiêu Chân Nhân