李广远=Lý Quảng Viễn
赵杰飞=Triệu Kiệt Phi
王桃桃=Vương Đào Đào
孟公子=Mạnh công tử
太白拳法=Thái Bạch quyền pháp
张先生=Trương tiên sinh
黄府=Hoàng Phủ
驭鬼术=Ngự Quỷ Thuật
百炼内甲=Bách Luyện Nội Giáp
狗尾巴草=Cẩu Vĩ Ba Thảo
王维=Vương Duy
何师兄=Hà sư huynh
夜叉观想法=Dạ Xoa Quan Tưởng Pháp
鸡血石=Kê Huyết Thạch
小栀子子=Tiểu Chi Tử Tử
山河万里伏=Sơn Hà Vạn Lý Phục
小翠=Tiểu Thúy
山神龙君=Sơn Thần Long Quân
方丈=Phương Trượng
能法=Năng Pháp
云山寺=Vân Sơn Tự
纳月术=Nạp Nguyệt Thuật
护神香=Hộ Thần Hương
梅超风=Mai Siêu Phong
能无=Năng Vô
黑玄蛇=Hắc Huyền Xà
鹰喙枪=Ưng Chủy Thương
魁梧男人=Người đàn ông vạm vỡ
飞燕逐月=Phi Yến Trục Nguyệt
回风落雁=Hồi Phong Lạc Nhạn
仙树=Tiên Thụ
定神香=Định Thần Hương
清心玉佩=Thanh Tâm Ngọc Bội
高村长=Cao thôn trưởng
小余abc=Tiểu Dư abc
起点写手开玩笑=Khởi Điểm Tác Giả Nói Đùa
黄李=Hoàng Lý
观气符=Quan Khí Phù
中李=Trung Lý
好坏不定菇=Hảo Hoại Bất Định Cô
洗魂之风=Tẩy Hồn Chi Phong
黑底白条鸡血石=Hắc Để Bạch Điều Kê Huyết Thạch
八珍鸡=Bát Trân Kê
夜叉=Dạ Xoa
欢喜仙=Hoan Hỉ Tiên
虎血草=Hổ Huyết Thảo
阳元花=Dương Nguyên Hoa
赤血参=Xích Huyết Sâm
犀角木=Tê Giác Mộc
大力果=Đại Lực Quả
高家庄=Cao Gia Trang
寻鬼盘=Tầm Quỷ Bàn
唐家堡=Đường Gia Bảo
炼魂幡=Luyện Hồn Phiên
大雷寺=Đại Lôi Tự
元气归一法=Nguyên Khí Quy Nhất Pháp
熊胆大力丸=Hùng Đảm Đại Lực Hoàn
神誓符=Thần Thệ Phù
夜睡咒=Dạ Thụy Chú
净天地神咒=Tịnh Thiên Địa Thần Chú
入定石=Nhập Định Thạch
追风靴=Truy Phong Ngoa
金刚醍醐酥=Kim Cương Đề Hồ Tô
王大=Vương Đại
王二=Vương Nhị
白天深=Bạch Thiên Thâm
杨兴=Dương Hưng
夏莫=Hạ Mạc
虎力丹=Hổ Lực Đan
皮肉境=Bì Nhục Cảnh
遇宝嗡嗡石=Ngộ Bảo Ông Ông Thạch
香火符钱=Hương Hỏa Phù Tiền
人品灵酒=Nhân Phẩm Linh Tửu
斗战法酒=Đấu Chiến Pháp Tửu
下品魂植=Hạ Phẩm Hồn Thực
忘尘草=Vong Trần Thảo
法器=Pháp Khí
避水珠=Tị Thủy Châu
炽金精=Sí Kim Tinh
法符=Pháp Phù
兵器符=Binh Khí Phù
道法=Đạo Pháp
明光符=Minh Quang Phù
特殊物品=Vật phẩm đặc biệt
一级惩恶令=Nhất Cấp Trừng Ác Lệnh
阴气领域=Âm Khí Lĩnh Vực
阴阳石=Âm Dương Thạch
天月诸县=Thiên Nguyệt Chư Huyện
黑云镇鬼神都管司=Hắc Vân Trấn Quỷ Thần Đô Quản Tư
黑云镇定武司=Hắc Vân Trấn Định Võ Tư
齐律=Tề Luật
李折=Lý Chiết
白化县=huyện Bạch Hóa
神女=Thần Nữ
高都管=Cao Đô quản
洪都管=Hồng Đô quản
张老板=Trương lão bản
李执=Lý Chấp
平天牛魔炼形=Bình Thiên Ngưu Ma luyện hình
覆海蛟魔真劲=Phúc Hải Giao Ma chân kình
火焰刀=Hỏa Diệm đao
万均锤=Vạn Quân chùy
狼力丹=Lang Lực Đan
惑心丹=Hoặc Tâm Đan
贾兄=Giả huynh
城南=Thành Nam
钱都管=Tiền Đô Quản
县令=Huyện Lệnh
洪副都管=Hồng Phó Đô quản
高问=Cao Vấn
高副都管=Cao phó đô quản
邪魔天女=Tà ma thiên nữ
彭府=Bành phủ
王浩=Vương Hạo
素儿=Tố Nhi
夜游=Dạ Du
贾上使=Giả Thượng sứ
黑云桃林=Hắc Vân Đào Lâm
倒悬山=Đảo Huyền Sơn
书友20221203084919876=Thư hữu 20221203084919876
彭刘铭=Bành Lưu Minh
天母=Thiên Mẫu
千风=Thiên Phong
方天戟法=Phương Thiên Kích Pháp
郡鬼神都管司=Quận Quỷ Thần Đô Quản Tư
太白袋=Thái Bạch Đại
银精=Ngân Tinh
天青金液=Thiên Thanh Kim Dịch
鬼神都管司=Quỷ Thần Đô Quản Tư
州道观=Châu Đạo Quán
陆都=Lục Đô
千里掠影=Thiên Lý Lược Ảnh
秦始皇=Tần Thủy Hoàng
姆士=Mỗ Sĩ
江畔=Giang Bạn
陈博=Trần Bác
赵谢=Triệu Tạ
高路=Cao Lộ
沈大哥=Thẩm đại ca
甲壳蚁=Giáp Xác Kiến
葆星=Bảo Tinh
裴屠狗=Bùi Đồ Cẩu
江河载月=Giang Hà Tái Nguyệt
白特慢啊=Bạch Đặc Mạn A
白若=Bạch Nhược
云呆呆=Vân Ngốc Ngốc
斜月三星洞=Tà Nguyệt Tam Tinh Động
云岚宗=Vân Lam Tông
云山=Vân Sơn
赵光=Triệu Quang
紫雷玉=Tử Lôi Ngọc
派大星=Phái Đại Tinh
龙脉草=Long Mạch Thảo
震骨丹=Chấn Cốt Đan
清泉兄=Thanh Tuyền Huynh
凯申兄=Khải Thân Huynh
红缘楼=Hồng Duyên Lâu
藏宝石=Tàng Bảo Thạch
耳听八方石=Nhĩ Thính Bát Phương Thạch
紫霄=Tử Tiêu
玉京凌家=Ngọc Kinh Lăng Gia
周老爷=Chu Lão Gia
太阴之力=Thái Âm chi lực
虾兵=Hà Binh
蟹将=Giải Tướng
血煞珠=Huyết Sát Châu
血兽=Huyết Thú
明视=Minh Thị
蚌女=Bạng Nữ
虾兵蟹将=Hà binh Giải tướng
云家人=Vân Gia Nhân
磨骨花=Ma Cốt Hoa
真元果=Chân Nguyên Quả
倪震刚=Nghê Chấn Cương
太白金星=Thái Bạch Kim Tinh
真否=Chân Phủ
高风=Cao Phong
高木=Cao Mộc
高火=Cao Hỏa
高宏=Cao Hoành
玄空子=Huyền Không Tử
翼蛇争寿图=Dực Xà Tranh Thọ Đồ
长安=Trường An
朱丈亭=Chu Trượng Đình
血鬼子=Huyết Quỷ Tử
朱亭丈=Chu Đình Trượng
方儿=Phương Nhi
苍穹弓=Cung Thương Khung
魏三=Ngụy Tam
追风紫雷靴=Truy Phong Tử Lôi Ngoa
郡城定武司=Quận Thành Định Võ Tư
朱都管=Chu Đô Quản
小云朵=Tiểu Vân Đóa
小雪山=Tiểu Tuyết Sơn
周天君=Chu Thiên Quân
铁一=Thiết Nhất
风华县=Phong Hoa Huyện
九洞龙君=Cửu Động Long Quân
熔岩鲶鱼=Dung Nham Niêm Ngư
灵阳湖龙宫三太子=Linh Dương Hồ Long Cung Tam Thái Tử
泥鳅精=Cá Chạch Tinh
灵阳花=Linh Dương Hoa
大日煌煌，余者皆黯=Đại Nhật Huy Hoàng, Dư Giả Giai Ảm
水元妙境=Thủy Nguyên Diệu Cảnh
天海水元盛会=Thiên Hải Thủy Nguyên Thịnh Hội
蛟珠=Giao Châu
幻龙果=Huyễn Long Quả
水元之试=Thủy Nguyên Chi Thí
跃龙门=Dược Long Môn
灵阳阳腾=Linh Dương Dương Đằng
玄薇=Huyền Vi
九洞湖龙君大人=Cửu Động Hồ Long Quân đại nhân
九洞湖龙君=Cửu Động Hồ Long Quân
灵阳湖三太子=Linh Dương Hồ Tam Thái Tử
阴空河=Âm Không Hà
阴空水主=Âm Không Thủy Chủ
蛟大将=Giao Đại Tướng
妙境之源=Diệu Cảnh Chi Nguyên
杜甫=Đỗ Phủ
江南东=Giang Nam Đông
林冲=Lâm Xung
紫衣青年=Thanh niên áo tím
大齐朝廷=Đại Tề triều đình
地尸门=Địa Thi Môn
煞尸珠=Sát Thi Châu
祭龙王=Tế Long Vương
牛家村=Ngưu Gia Thôn
三江推荐=Tam Giang đề cử
夜的旅途=Dạ đích lữ đồ
诸葛夜华=Gia Cát Dạ Hoa
阳光的白鸽=Dương Quang đích Bạch Cát
我见青山万里=Ngã kiến Thanh Sơn Vạn Lí
好名字全重复了=Hảo danh tự toàn trùng phục liễu
若世间有神明=Nhược thế gian hữu thần minh
风花雪月=Phong Hoa Tuyết Nguyệt
帝壹=Đế Nhất
暗月天明=Ám Nguyệt Thiên Minh
沉迷书中世界=Trầm Mê Thư Trung Thế Giới
温驯的折耳猫=Ôn Thuần Đích Chiết Nhĩ Miêu
阿政128=A Chính 128
落花有道=Lạc Hoa Hữu Đạo
最后的小吉=Tối Hậu Đích Tiểu Cát
善E=Thiện E
allGOD梦=allGOD Mộng
最后的落落=Tối Hậu Đích Lạc Lạc
黎丘=Lê Khâu
山鬼=Sơn Quỷ
阴阳石灯=Âm Dương Thạch Đăng
连城=Liên Thành
大楚=Đại Sở
陈胜=Trần Thắng
龙王=Long Vương
铁石村=Thiết Thạch Thôn
张伟=Trương Vĩ
李长老=Lý trưởng lão
姜望远=Khương Vọng Viễn
齐周晋=Tề Chu Tấn
闭眼姐=Bế Nhãn Tỷ
天骄之试=Thiên Kiêu Chi Thí
仙种之试=Tiên Chủng Chi Thí
黑白哥=Hắc Bạch Ca
云家家主=Vân Gia Gia Chủ
登仙池=Đăng Tiên Trì
元魂之核=Nguyên Hồn Chi Hạch
生灵圣水=Sinh Linh Thánh Thủy
生命之潭=Sinh Mệnh Chi Đàm
牛魔=Ngưu Ma
蛟魔=Giao Ma
黄泉阴露=Hoàng Tuyền Âm Lộ
阴华=Âm Hoa
青山武馆=Thanh Sơn Võ Quán
阿莲=A Liên
无命之面=Vô Mệnh Chi Diện
甄明=Chân Minh
黄天霸=Hoàng Thiên Bá
南宣=Nam Tuyên
云龙卫=Vân Long Vệ
混天鹏骨=Hỗn Thiên Bằng Cốt
高元=Cao Nguyên
罗会=La Hội
孙通=Tôn Thông
海心甲=Hải Tâm Giáp
齐朝=Tề triều
小石=Tiểu Thạch
林主管=Lâm chủ quản
大师姐=Đại sư tỷ
商主=Thương chủ
北边草原=Bắc Biên thảo nguyên
三国=Tam quốc
蛮族大祭司=Man tộc Đại tế tư
兽神=Thú Thần
天月酒楼=Thiên Nguyệt Tửu Lâu
方雪=Phương Tuyết
袁梅=Viên Mai
袁黄二家=Viên Hoàng nhị gia
落雨=Lạc Vũ
圆月=Viên Nguyệt
寒石=Hàn Thạch
金龙=Kim Long
风鸣=Phong Minh
灵玄=Linh Huyền
郡道观=Quận Đạo Quan
武道大宗=Võ Đạo Đại Tông
天地奇珍=Thiên Địa Kỳ Trân
梦境=Mộng Cảnh
禺狨石=Ngu Nhung Thạch
五脏六腑神丹=Ngũ Tạng Lục Phủ Thần Đan
中皇城=Trung Hoàng Thành
天北域=Thiên Bắc Vực
瑶莀=Dao Trân
谢狂=Tạ Cuồng
林路飞=Lâm Lộ Phi
苏何=Tô Hà
三光福灵镜=Tam Quang Phúc Linh Kính
阎罗=Diêm La
鬼长老=Quỷ trưởng lão
夜游境=Dạ Du cảnh
日游境=Nhật Du cảnh
交州=Giao Châu
安仙王=An Tiên Vương
金光咒=Kim Quang Chú
元气屏障=Nguyên Khí Bình Chướng
幻梦术=Huyễn Mộng Thuật
脱衣咒=Thoát Y Chú
江文武=Giang Văn Võ
陇天俯=Lũng Thiên Phủ
黑云武卫=Hắc Vân Võ Vệ
张远涛=Trương Viễn Đào
萧卿绾=Tiêu Khanh Oản
洛妙妙=Lạc Diệu Diệu
天武侯府=Thiên Vũ Hầu Phủ
大乾=Đại Càn
西山=Tây Sơn
福伯=Phúc Bá
梦依允=Mộng Y Doãn
气经=Khí Kinh
气圣=Khí Thánh
铁矿场=Mỏ Sắt
铜矿=Mỏ Đồng
戴流=Đới Lưu
方圆=Phương Viên
云家姐妹=Vân Gia tỷ muội
覆海大圣=Phúc Hải Đại Thánh
覆海蛟龙=Phúc Hải Giao Long
天海法会=Thiên Hải Pháp Hội
九洞=Cửu Động
灵阳=Linh Dương
仙器哥=Tiên Khí Ca
九阳湖=Hồ Cửu Dương
天海水族=Thuỷ tộc Thiên Hải
三太子=Tam Thái Tử
天海长公主=Thiên Hải Trưởng Công Chúa
天药鱼=Thiên Dược Ngư
鳄鱼精=Ngạc Ngư Tinh
冰蛟=Băng Giao
金缕衣=Kim Lũ Y
天海龙君=Thiên Hải Long Quân
英吉利=Anh Cát Lợi
奂英=Hoán Anh
氿古=Cửu Cổ
小桃=Tiểu Đào
焚诀=Phần Quyết
冰灵寒魂焰=Băng Linh Hàn Hồn Diễm
无名阴火=Vô Danh Âm Hỏa
日游=Nhật Du
阴地火印=Âm Địa Hỏa Ấn
阴华县=Âm Hoa Huyện
阳地火印=Dương Địa Hỏa Ấn
黑云校场=Hắc Vân Giáo Trường
狂刀馆=Cuồng Đao Quán
张元=Trương Nguyên
灵犀棋局=Linh Tê Kỳ Cục
齐武经=Tề Võ Kinh
齐道经=Tề Đạo Kinh
灵心篇=Linh Tâm Thiên
段金=Đoạn Kim
敖殿下=Ngao điện hạ
云峰=Vân Phong
临阳县=Lâm Dương huyện
加库玛=Gia Khố Mã
天阳=Thiên Dương
承山石=Thừa Sơn Thạch
轩师兄=Hiên sư huynh
云宗主=Vân Tông chủ
日月石林=Nhật Nguyệt Thạch Lâm
紫气蕴焰蛇=Tử Khí Uẩn Diệm Xà
天行道=Thiên Hành Đạo
方家=Phương gia
大夏太祖=Đại Hạ Thái Tổ
大夏=Đại Hạ
天行道节度使=Tiết độ sứ Thiên Hành Đạo
三生三世轮回经=Tam Sinh Tam Thế Luân Hồi Kinh
不坏天功=Bất Hoại Thiên Công
南山行者=Nam Sơn Hành Giả
从搜山降魔开始=Từ Sưu Sơn Hàng Ma Bắt Đầu
老山海域=Lão Sơn Hải Vực
青阳真人=Thanh Dương chân nhân
三阴村=Tam Âm Thôn
三阴湖=Tam Âm Hồ
三阴山=Tam Âm Sơn
水帘洞=Thủy Liêm Động
九阴丹=Cửu Âm Đan
阴灵入圣丹=Âm Linh Nhập Thánh Đan
圣心丹=Thánh Tâm Đan
天魔丹=Thiên Ma Đan
天魔虎=Thiên Ma Hổ
古娜拉黑暗之神=Cổ Na Lạp Hắc Ám Chi Thần
太阳太阴真神丹=Thái Dương Thái Âm Chân Thần Đan
三阴幡=Tam Âm Phiên
紫灵玉=Tử Linh Ngọc
紫焰宗=Tử Diễm Tông
水域=Thủy Vực
玄龙果=Huyền Long Quả
玄蛇果=Huyền Xà Quả
莲心丹=Liên Tâm Đan
夏花=Hạ Hoa
十一天神丹=Thập Nhất Thiên Thần Đan
载意郡=Tái Ý Quận
白氏=Bạch Thị
齐白=Tề Bạch
周武=Chu Vũ
晋司马=Tấn Tư Mã
武氏=Võ Thị
慕婉=Mộ Uyển
慕冬山=Mộ Đông Sơn
八部天龙经=Bát Bộ Thiên Long Kinh
天龙不朽身=Thiên Long Bất Hủ Thân
八部天龙=Bát Bộ Thiên Long
天龙变=Thiên Long Biến
云江龙女=Vân Giang Long Nữ
A级推荐=Đề xuất cấp A
源气=Nguyên khí
源石=Nguyên thạch
天龙内门=Thiên Long nội môn
发惹=Phát Nhạ
顾左=Cố Tả
方师兄=Phương sư huynh
李师兄=Lý sư huynh
于师兄=Vu sư huynh
太上道=Thái Thượng Đạo
缺月大师=Khuyết Nguyệt đại sư
四海龙族=Tứ Hải Long Tộc
青天神君=Thanh Thiên Thần Quân
轮转法王=Luân Chuyển Pháp Vương
李奶奶=Lý nãi nãi
十方天光=Thập Phương Thiên Quang
刘臣=Lưu Thần
陛下=Bệ Hạ
国师大人=Quốc Sư đại nhân
天阴定命草=Thiên Âm Định Mệnh Thảo
天灵金果=Thiên Linh Kim Quả
玄武灵丹=Huyền Vũ Linh Đan
卫州卫家=Vệ Châu Vệ Gia
皇室=Hoàng Thất
聚火壶=Tụ Hỏa Hồ
纯质阳炎=Thuần Chất Dương Viêm
凤凰之火=Phượng Hoàng Chi Hỏa
龙鳞=Long Lân
袁华=Viên Hoa
黄明年=Hoàng Minh Niên
灵玄武馆=Linh Huyền Võ Quán
曹曲=Tào Khúc
灵玄观=Linh Huyền Quán
高通=Cao Thông
望月山=Vọng Nguyệt Sơn
四海=Tứ Hải
郡城=Quận Thành
李师姐=Lý sư tỷ
张师兄=Trương sư huynh
大雷雨寺=Đại Lôi Vũ Tự
万道殿=Vạn Đạo Điện
天命仙种=Thiên Mệnh Tiên Chủng
青铜门=Thanh Đồng Môn
真传弟子=Chân Truyền Đệ Tử
州城董家=Châu Thành Đổng Gia
鼎鳞尊者=Đỉnh Lân Tôn Giả
冤刀武尊=Oan Đao Võ Tôn
博灵真人=Bác Linh Chân Nhân
天启之石=Thiên Khải Chi Thạch
天命之月计划=Thiên Mệnh Chi Nguyệt Kế Hoạch
天武学天龙变=Thiên Vũ Học Thiên Long Biến
天圆地方枪法=Thiên Viên Địa Phương Thương Pháp
丁六灵=Đinh Lục Linh
黄明日=Hoàng Minh Nhật
太白馆=Thái Bạch Quán
肖执=Tiêu Chấp
金水=Kim Thủy
黄风话=Hoàng Phong Thoại
袁丽=Viên Lệ
于刃=Vu Nhận
李海=Lý Hải
七宝妙树=Thất Bảo Diệu Thụ
天辰之金=Thiên Thần Chi Kim
大地神石=Đại Địa Thần Thạch
金龙武馆=Kim Long Võ Quán
韵儿=Vận Nhi
凤凰岁帝=Phượng Hoàng Tuế Đế
地窟=Địa quật
地兽遗命=Địa thú di mệnh
洛神扇=Lạc Thần Phiến
静若室=Tĩnh Nhược Thất
舍生开道法=Xả Sinh Khai Đạo Pháp
养命器=Dưỡng Mệnh Khí
司马氏=Tư Mã thị
丁六=Đinh Lục
九凤汤=Cửu Phượng Thang
青玉灵皇笋=Thanh Ngọc Linh Hoàng Măng
十二彩鸡=Thập Nhị Thải Kê
赤焰酒=Xích Diễm Tửu
乘龙快婿=Thừa long khoái tế
显圣境=Hiển Thánh Cảnh
六腑神丹=Lục Phủ Thần Đan
五脏神丹=Ngũ Tạng Thần Đan
申家=Thân Gia
黄枫谷=Hoàng Phong Cốc
卫州=Vệ Châu
望峰县=Vọng Phong Huyện
望月峰=Vọng Nguyệt Phong
方振远=Phương Chấn Viễn
闵行=Mẫn Hành
闵长老=Mẫn trưởng lão
丁六地兽场=Đinh Lục Địa Thú Tràng
太白门=Thái Bạch Môn
镇守府=Trấn Thủ Phủ
翻海霸刀=Phiên Hải Bá Đao
燕嫣然=Yến Yên Nhiên
真极宗=Chân Cực Tông
小圣寺=Tiểu Thánh Tự
李师=Lý Sư
楚师=Sở Sư
木伯=Mộc Bá
孟家废物少爷=Mạnh gia phế vật thiếu gia
方振兴=Phương Chấn Hưng
海侦=Hải Trinh
卫家=Vệ Gia
池瑶天女=Trì Dao Thiên Nữ
江南东家=Giang Nam Đông Gia
东圣天=Đông Thánh Thiên
东王镜=Đông Vương Kính
东王御仙道阵=Đông Vương Ngự Tiên Đạo Trận
天母教教主=Giáo chủ Thiên Mẫu Giáo
赵都管=Triệu Đô Quản
九邪鬼婴=Cửu Tà Quỷ Anh
无常阎罗域=Vô Thường Diêm La Vực
大河村=Đại Hà thôn
小草河=Tiểu Thảo hà
贾明=Giả Minh
太白密室=Thái Bạch Mật Thất
承命符=Thừa Mệnh Phù
麒麟=Kỳ Lân
光狐=Quang Hồ
追月狼=Truy Nguyệt Lang
狼后=Lang Hậu
角光狐=Giác Quang Hồ
天地双虎=Thiên Địa Song Hổ
胡英俊=Hồ Anh Tuấn
合灵法=Hợp Linh Pháp
金刚镯=Kim Cương Trạc
追月狼谷=Truy Nguyệt Lang Cốc
狼行=Lang Hành
黑山妖族=Hắc Sơn Yêu tộc
月神果=Nguyệt Thần Quả
接月圣泉=Tiếp Nguyệt Thánh Tuyền
狐谷=Hồ Cốc
月神树=Nguyệt Thần Thụ
阿列=A Liệt
神山=Thần Sơn
承天镇世经=Thừa Thiên Trấn Thế Kinh
天子神拳=Thiên Tử Thần Quyền
狼虹=Lang Hồng
阎王=Diêm Vương
黑云卫=Hắc Vân Vệ
陆姐姐=Lục tỷ tỷ
云家主=Vân Gia Chủ
无名宝花=Vô Danh Bảo Hoa
怪蜂蜂蜜=Quái Phong Mật Ong
熔岩墟金=Dung Nham Khư Kim
玄藤=Huyền Đằng
玄藤木珠=Huyền Đằng Mộc Châu
御石=Ngự Thạch
光明草=Quang Minh Thảo
天蛇藤花=Thiên Xà Đằng Hoa
玄藤甲=Huyền Đằng Giáp
天仙壶=Thiên Tiên Hồ
紫气幡=Tử Khí Phan
清元观=Thanh Nguyên Quan
天音谷=Thiên Âm Cốc
太素玄真上仙=Thái Tố Huyền Chân Thượng Tiên
天子学宫=Thiên Tử Học Cung
金公子=Kim Công Tử
大齐皇室=Đại Tề Hoàng thất
金展=Kim Triển
杨统领=Dương Thống lĩnh
千师=Thiên Sư
南晋司马氏=Nam Tấn Tư Mã Thị
胡列列=Hồ Liệt Liệt
清河郡=Thanh Hà Quận
蒋英宇=Tưởng Anh Vũ
娑仙=Sa Tiên
周公子=Chu công tử
周兄=Chu huynh
红尘仙经=Hồng Trần Tiên Kinh
寒州蒋家=Hàn Châu Tưởng Gia
栖凤花=Tê Phượng Hoa
白老=Bạch lão
真血大魔=Chân Huyết Đại Ma
原始海域=Nguyên Thủy Hải Vực
血魔=Huyết Ma
日魔=Nhật Ma
月神印记=Nguyệt Thần Ấn Ký
飞云剑法=Phi Vân Kiếm Pháp
暴雨术=Bạo Vũ Thuật
崔献=Thôi Hiến
起点=Khởi Điểm
主编力荐=Chủ biên lực tiến
夸克2021=Quark2021
狼谷=Lang Cốc
白馆主=Bạch Quán Chủ
圣女=Thánh nữ
炼骨境=Luyện Cốt Cảnh
林歌=Lâm Ca
宫主=Cung chủ
真传=Chân Truyền
仙器太素元真图=Tiên khí Thái Tố Nguyên Chân Đồ
清河=Thanh Hà
太阴真火=Thái Âm Chân Hỏa
玄木心=Huyền Mộc Tâm
落云石=Lạc Vân Thạch
绝真老祖=Tuyệt Chân Lão Tổ
陈晓=Trần Hiểu
黑云高家=Hắc Vân Cao Gia
道州=Đạo Châu
姜姐姐=Khương tỷ tỷ
混天鹏魔密式=Hỗn Thiên Bằng Ma Mật Thức
一宝妙树=Nhất Bảo Diệu Thụ
莫家=Mạc Gia
神华宗=Thần Hoa Tông
地级武馆=Địa Cấp Võ Quán
人级武馆=Nhân Cấp Võ Quán
娑仙道子=Sa Tiên Đạo Tử
食寿鬼=Thực Thọ Quỷ
大千仙树观想图=Đại Thiên Tiên Thụ Quan Tưởng Đồ
炼丹术=Luyện Đan Thuật
三阴丹道传承=Tam Âm Đan Đạo Truyền Thừa
制符术=Chế Phù Thuật
基础法符传承=Cơ Sở Pháp Phù Truyền Thừa
三阴鼎=Tam Âm Đỉnh
逆命丹=Nghịch Mệnh Đan
回血丹=Hồi Huyết Đan
太阴炼神法=Thái Âm Luyện Thần Pháp
葵花宝典=Quỳ Hoa Bảo Điển
太阳炼神法=Thái Dương Luyện Thần Pháp
观想图=Quán Tưởng Đồ
太阳炼神=Thái Dương Luyện Thần
太阴炼神=Thái Âm Luyện Thần
胡图图=Hồ Đồ Đồ
小晕=Tiểu Vựng
追月狼族=Truy Nguyệt Lang Tộc
追月狼王=Truy Nguyệt Lang Vương
月神之光=Nguyệt Thần Chi Quang
夜叉观想图=Dạ Xoa Quán Tưởng Đồ
追月狼爪=Truy Nguyệt Lang Trảo
天海升龙法会=Thiên Hải Thăng Long Pháp Hội
宁采臣=Ninh Thái Thần
光狐族=Quang Hồ Tộc
太白馆主=Thái Bạch Quán Chủ
花果山=Hoa Quả Sơn
休命武道=Hưu Mệnh Võ Đạo
幽冥杀剑=U Minh Sát Kiếm
翻江倒海=Phiên Giang Đảo Hải
造化灵液=Tạo Hóa Linh Dịch
白姑娘=Bạch cô nương
本源神池=Bản Nguyên Thần Trì
太上仙经=Thái Thượng Tiên Kinh
蜗牛=Ốc Sên
圣心咒=Thánh Tâm Chú
形神俱灭=Hình Thần Câu Diệt
启灵养神法=Khải Linh Dưỡng Thần Pháp
餐霞食气=Xan Hà Thực Khí
缺月阁主=Khuyết Nguyệt Các chủ
州城=Châu Thành
天青郡=Thiên Thanh Quận
心眼秘术=Tâm Nhãn Bí Thuật
秦尊者=Tần Tôn Giả
李武=Lý Vũ
归真宝船=Quy Chân Bảo Thuyền
元涛=Nguyên Đào
苏师兄=Tô sư huynh
平康坊=Bình Khang Phường
安定坊=An Định Phường
圣灵液=Thánh Linh Dịch
驱神禺狨=Khu Thần Ngu Nhung
混天鹏魔=Hỗn Thiên Bằng Ma
州鬼神司=Châu Quỷ Thần Tư
黄泉之门=Hoàng Tuyền Chi Môn
玉真=Ngọc Chân
斩光刀=Trảm Quang Đao
神心果=Thần Tâm Quả
地肺果=Địa Phế Quả
六腑灵水=Lục Phủ Linh Thủy
搬山神躯=Bàn Sơn Thần Khu
禺狨=Ngu Nhung
吕华=Lữ Hoa
花果山水帘洞者行孙=Hoa Quả Sơn Thủy Liêm Động Giả Hành Tôn
山水武馆=Sơn Thủy Võ Quán
天山郡=Thiên Sơn Quận
中天商会=Trung Thiên Thương Hội
崔曜=Thôi Diệu
中天=Trung Thiên
甲申=Giáp Thân
甲午=Giáp Ngọ
甲辰=Giáp Thìn
大齐钱庄=Đại Tề Tiền Trang
甲辰包厢=Giáp Thìn Bao Sương
掩天机=Yểm Thiên Cơ
道术=Đạo Thuật
都管=Đô Quản
山海关=Sơn Hải Quan
凤凰族=Phượng Hoàng Tộc
小花=Tiểu Hoa
沈师弟=Thẩm sư đệ
小草=Tiểu Thảo
龚家=Cung gia
四海龙皇=Tứ Hải Long Hoàng
董伟宇=Đổng Vĩ Vũ
极光武馆=Cực Quang võ quán
素恩武馆=Tố Ân Võ Quán
天归城=Thiên Quy Thành
素真山=Tố Chân Sơn
星罗武馆=Tinh La Võ Quán
神鹰武馆=Thần Ưng Võ Quán
天蟒武馆=Thiên Mãng Võ Quán
天斗武馆=Thiên Đấu Võ Quán
天西郡=Thiên Tây Quận
天北武馆=Thiên Bắc Võ Quán
九阳武馆=Cửu Dương Võ Quán
巩留=Củng Lưu
太白剑法=Thái Bạch Kiếm Pháp
杨阳=Dương Dương
震雷锤=Chấn Lôi Chùy
飞檐溅雪=Phi Diêm Tiễn Tuyết
天龙武馆=Thiên Long Võ Quán
武王霸剑=Võ Vương Bá Kiếm
武王武馆=Võ Vương Võ Quán
天灵武馆=Thiên Linh Võ Quán
吴英雄=Ngô Anh Hùng
叶副会长=Diệp Phó hội trưởng
白启=Bạch Khải
秦都=Tần Đô
裂星=Liệt Tinh
天圆地方=Thiên Viên Địa Phương
绝命刀=Tuyệt Mệnh Đao
上阳真力=Thượng Dương Chân Lực
尸堂=Thi Đường
斗堂=Đấu Đường
技堂=Kỹ Đường
王大山=Vương Đại Sơn
戴林=Đái Lâm
天延郡=Thiên Duyên Quận
孟家=Mạnh Gia
北原=Bắc Nguyên
东海=Đông Hải
南海=Nam Hải
无序之境=Vô Tự Chi Cảnh
灵兽袋=Linh Thú Đại
养尸袋=Dưỡng Thi Đại
周古进=Chu Cổ Tiến
斗堂堂主=Đấu Đường Đường Chủ
紫僵=Tử Cương
插翅紫僵=Sáp Sí Tử Cương
尸堂堂主=Thi Đường Đường Chủ
天妄郡城=Thiên Vọng Quận Thành
灵尸子=Linh Thi Tử
地尸道人=Địa Thi Đạo Nhân
技堂堂主=Kỹ Đường Đường Chủ
叶叔叔=Diệp thúc thúc
天妄山脉=Thiên Vọng Sơn Mạch
地尸山脉=Địa Thi Sơn Mạch
神器山海珠=Thần khí Sơn Hải Châu
万山之精=Vạn Sơn chi Tinh
海洋之心=Hải Dương chi Tâm
齐人=Tề Nhân
小王庄=Tiểu Vương Trang
王根正=Vương Căn Chính
小草姐妹=Tiểu Thảo tỷ muội
王定蛮=Vương Định Man
腾空武馆=Đằng Không Võ Quán
钱多多=Tiền Đa Đa
天妄郡=Thiên Vọng quận
山海珠=Sơn Hải Châu
三星剑=Tam Tinh Kiếm
裂星弓=Liệt Tinh Cung
中天郡=Trung Thiên Quận
陇云=Lũng Vân
谢雷=Tạ Lôi
驱神禺狨图录=Khu Thần Ngu Nhung Đồ Lục
天蛇藤=Thiên Xà Đằng
林凡=Lâm Phàm
清明上河图=Thanh Minh Thượng Hà Đồ
黑云镇鬼神司=Hắc Vân Trấn Quỷ Thần Tư
万寿道果=Vạn Thọ Đạo Quả
三阴传承=Tam Âm Truyền Thừa
天妄古墓=Thiên Vọng Cổ Mộ
紫金宝箱=Rương báu Tử Kim
龙女=Long Nữ
幽冥劫=U Minh Kiếp
生死劫=Sinh Tử Kiếp
龟丞相=Quy Thừa Tướng
林影=Lâm Ảnh
黑熊=Hắc Hùng
宁菀可=Ninh Uyển Khả
魂墨=Hồn Mặc
中天联合交易会=Trung Thiên Liên Hợp Giao Dịch Hội
龙皇=Long Hoàng
黑火尊者=Hắc Hỏa Tôn Giả
黑火蚁族=Hắc Hỏa Kiến Tộc
天女神=Thiên Nữ Thần
蛮族大草原=Đại thảo nguyên Man tộc
余家=Dư gia
百骨丹=Bách Cốt Đan
吞神功=Thôn Thần Công
余宾=Dư Tân
阿宾=A Tân
袁一寒=Viên Nhất Hàn
疤脸老汉=Ông Lão Mặt Sẹo
袁副都管=Viên Phó Đô Quản
刘进=Lưu Tiến
晨光鬼神司=Thần Tư Ánh Sáng Buổi Sáng
刘府=Lưu phủ
袁通=Viên Thông
晨光县=Thần Quang huyện
刘家=Lưu gia
脏毒鬼手=Tạng Độc Quỷ Thủ
万田县=Vạn Điền huyện
青华=Thanh Hoa
风晓县=Phong Hiểu huyện
长河县=Trường Hà huyện
黑云镇外=ngoài Hắc Vân trấn
天女=Thiên Nữ
魂魔=Hồn Ma
云云江龙宫=Vân Vân Giang Long Cung
天州鬼神司=Thiên Châu Quỷ Thần Tư
齐皇=Tề Hoàng
三阴遗藏=Tam Âm Di Tàng
凌竹=Lăng Trúc
狂刀=Cuồng Đao
腾龙=Đằng Long
死孽冥尸=Tử Nghiệt Minh Thi
武神花=Võ Thần Hoa
灵植益骨草=Linh Thực Ích Cốt Thảo
真元宝液=Chân Nguyên Bảo Dịch
千兵坊=Thiên Binh Phường
混湖=Hỗn Hồ
袁大师=Viên đại sư
日游长老=Nhật Du trưởng lão
黄文=Hoàng Văn
青城派=Thanh Thành Phái
窝迭=Oa Điệt
太白周清=Thái Bạch Chu Thanh
余沧海=Dư Thương Hải
黄亥=Hoàng Hợi
黄石仁=Hoàng Thạch Nhân
绛云船=Giáng Vân Thuyền
苍天殿=Thương Thiên Điện
方振宇=Phương Chấn Vũ
三龙辇=Tam Long Liễn
古龙峰=Cổ Long Phong
圣龙峰峰主=Phong chủ Thánh Long Phong
西海龙宫=Tây Hải Long Cung
西海龙君=Tây Hải Long Quân
黑山洞天福地=Hắc Sơn Động Thiên Phúc Địa
仙姑=Tiên Cô
星之传承=Tinh Chi Truyền Thừa
宁麟=Ninh Lân
慕道友=Mộ Đạo hữu
龙宫龙后=Long Cung Long Hậu
青霄殿主=Thanh Tiêu Điện Chủ
玄光王=Huyền Quang Vương
慕星主=Mộ Tinh Chủ
宁会长=Ninh Hội Trưởng
慕云萝=Mộ Vân La
天归郡城=Thiên Quy Quận Thành
山河苍生榜=Sơn Hà Thương Sinh Bảng
圣龙峰=Thánh Long Phong
黑山大阵=Hắc Sơn Đại Trận
三阴山谷=Tam Âm Sơn Cốc
八卦真炉=Bát Quái Chân Lô
天龙域=Thiên Long Vực
海州=Hải Châu
古龙峰主=Cổ Long Phong Chủ
天龙峰=Thiên Long Phong
天龙门主=Thiên Long Môn Chủ
龙后=Long Hậu
绛云仙姑=Giáng Vân Tiên Cô
云绝真=Vân Tuyệt Chân
天龙老儿=Thiên Long Lão Nhi
天龙=Thiên Long
圣龙峰主=Thánh Long Phong Chủ
陆师妹=Lục sư muội
若月=Nhược Nguyệt
远南=Viễn Nam
苏长安=Tô Trường An
小风=Tiểu Phong
黑云周清=Hắc Vân Chu Thanh
小鱼儿=Tiểu Ngư Nhi
清月甲=Thanh Nguyệt Giáp
大草原=Đại Thảo Nguyên
叶都管=Diệp Đô Quản
叶老=Diệp lão
凌月=Lăng Nguyệt
郡鬼神司=Quận Quỷ Thần Tư
黑云=Hắc Vân
蒋前辈=Tưởng tiền bối
凌家=Lăng Gia
魂魔上人=Hồn Ma Thượng Nhân
彩云仙子=Thải Vân Tiên Tử
三念真王=Tam Niệm Chân Vương
黄泉雏丹=Hoàng Tuyền Sồ Đan
龙珠=Long Châu
天月各县=Thiên Nguyệt Các Huyện
州定武司=Châu Định Võ Tư
袁方=Viên Phương
天月五灵玄光阵=Thiên Nguyệt Ngũ Linh Huyền Quang Trận
天成=Thiên Thành
陆都管=Lục Đô Quản
黑山福地=Hắc Sơn Phúc Địa
青华县=Thanh Hoa Huyện
血魂上人=Huyết Hồn Thượng Nhân
缺月丹阁=Khuyết Nguyệt Đan Các
慕大师=Mộ đại sư
阴天小尊=Âm Thiên Tiểu Tôn
阴神尊者=Âm Thần Tôn Giả
天月五灵玄光大阵=Thiên Nguyệt Ngũ Linh Huyền Quang Đại Trận
陈郡=Trần Quận
灵玄道观=Linh Huyền Đạo Quán
圆月武馆=Viên Nguyệt Võ Quán
周巡游=Chu Tuần Du
陈郡守=Trần Quận Thủ
袁家家主=Viên Gia Gia Chủ
黄腾=Hoàng Đằng
天州道观=Thiên Châu Đạo Quán
齐皇后=Tề Hoàng Hậu
袁家=Viên Gia
落雨武馆=Lạc Vũ Võ Quán
风鸣道观=Phong Minh Đạo Quán
浩然大手印=Hạo Nhiên Đại Thủ Ấn
鬼神巡游=Quỷ Thần Tuần Du
武馆=Võ quán
张元涛=Trương Nguyên Đào
何风=Hà Phong
高顶天=Cao Đỉnh Thiên
林家=Lâm gia
狂刀武馆=Cuồng Đao Võ Quán
陇天牙=Lũng Thiên Nha
陇天冲=Lũng Thiên Xung
两司=Lưỡng Tư
官府=Quan Phủ
山神=Sơn Thần
白姓皇室=Bạch Tính Hoàng Thất
白氏尊者=Bạch Thị Tôn Giả
左天正=Tả Thiên Chính
朝廷=Triều Đình
云天河=Vân Thiên Hà
江都管=Giang Đô Quản
天河尊者=Thiên Hà Tôn Giả
高真雄=Cao Chân Hùng
云龙湖=Hồ Vân Long
蚌精=Bạng Tinh
云龙阁=Vân Long Các
天火=Thiên Hỏa
元武宝树=Nguyên Võ Bảo Thụ
圣血树=Thánh Huyết Thụ
灵魂树=Linh Hồn Thụ
小真武神金=Tiểu Chân Võ Thần Kim
真武仙金=Chân Võ Tiên Kim
化神莲=Hóa Thần Liên
水元门=Thủy Nguyên Môn
天地钱庄=Thiên Địa Tiền Trang
神秘宝像=Thần Bí Bảo Tượng
阳武县=Dương Võ huyện
阳地县=Dương Địa huyện
云远南=Vân Viễn Nam
天月=Thiên Nguyệt
安府=An phủ
安愉=An Du
宋秋=Tống Thu
明空公主=Minh Không công chúa
青阳区域=Khu vực Thanh Dương
紫阳石=Tử Dương Thạch
紫阳墟=Tử Dương Khư
白阳区=Bạch Dương Khu
青阳区=Thanh Dương Khu
炽火道人=Sí Hỏa Đạo Nhân
青阳神火=Thanh Dương Thần Hỏa
纯白之森=Thuần Bạch Chi Sâm
白炽火=Bạch Sí Hỏa
九阳潮=Cửu Dương Triều
碧落=Bích Lạc
暗阳湖=Ám Dương Hồ
离骚=Ly Tao
李管事=Lý quản sự
阿大=A Đại
阿二=A Nhị
天城鬼王=Thiên Thành Quỷ Vương
墟蛮兽=Khư Man Thú
墟灵=Khư Linh
阳鬼=Dương Quỷ
阴天尊者=Âm Thiên Tôn Giả
地冥兽尊=Địa Minh Thú Tôn
天海=Thiên Hải
九洞湖=Cửu Động Hồ
阳绪=Dương Tự
阳唯=Dương Duy
金火兽尊=Kim Hỏa Thú Tôn
厌冰=Yếm Băng
焚风尊者=焚 Phong Tôn Giả
天墟=Thiên Khư
玄光大阵=Huyền Quang Đại Trận
黄泉液=Hoàng Tuyền Dịch
周郎=Chu Lang
九阳百科=Cửu Dương Bách Khoa
白阳墟=Bạch Dương Khư
鱼师姐=Ngư Sư Tỷ
赤阳区=Xích Dương Khu
赤阳墟=Xích Dương Khư
青阳墟=Thanh Dương Khư
九阳=Cửu Dương
郡定武司=Quận Định Võ Tư
史都管=Sử Đô Quản
万浪神金=Vạn Lãng Thần Kim
复神丹=Phục Thần Đan
灵阳圣果=Linh Dương Thánh Quả
深海银母=Thâm Hải Ngân Mẫu
神血丹=Thần Huyết Đan
灵阳湖龙君=Linh Dương Hồ Long Quân
傲阳甲=Ngạo Dương Giáp
地兽场=Địa Thú Tràng
乙十三号=Ất Thập Tam Hào
香字=Hương Tự
闻字=Văn Tự
赤阳尊者=Xích Dương Tôn Giả
闻字令牌=Văn Tự Lệnh Bài
真血兽尊=Chân Huyết Thú Tôn
焚天宗=Phần Thiên Tông
暗阳墟=Ám Dương Khư
鬼宝=Quỷ Bảo
地熔妖=Địa Dung Yêu
地鳞=Địa Lân
彻地=Triệt Địa
十道殿=Thập Đạo Điện
鲲分身=Khôn Phân Thân
高家=Cao Gia
腾龙武馆=Đằng Long Võ Quán
许仙=Hứa Tiên
覆海蛟=Phúc Hải Giao
灵鬼道人=Linh Quỷ Đạo Nhân
百阳鬼花=Bách Dương Quỷ Hoa
铜锤=Đồng Chuy
九阳城=Cửu Dương Thành
元丰县=Nguyên Phong Huyện
梁海=Lương Hải
天阳城=Thiên Dương Thành
沧元县=Thương Nguyên Huyện
天海郡=Thiên Hải Quận
天北郡=Thiên Bắc Quận
西晋=Tây Tấn
素真=Tố Chân
素真府=Tố Chân Phủ
素真城=Tố Chân Thành
林执事=Lâm chấp sự
天归郡=Thiên Quy Quận
姚欢欢=Diêu Hoan Hoan
崔曜之=Thôi Diệu Chi
飞仙道=Phi Tiên Đạo
朱姑娘=Cô Chu
圣女峰=Thánh Nữ Phong
幽灵尸火=U Linh Thi Hỏa
天火封印=Thiên Hỏa Phong Ấn
真阳天火=Chân Dương Thiên Hỏa
陨星石焰=Vẫn Tinh Thạch Diệm
暗天坑=Ám Thiên Hố
陀舍古帝=Đà Xá Cổ Đế
芙蓉尊者=Phù Dung Tôn Giả
阴地火=Âm Địa Hỏa
雍州=Ung Châu
天墟郡=Thiên Khư Quận
紫薇下凡=Tử Vi Hạ Phàm
崔曜河=Thôi Diệu Hà
显圣=Hiển Thánh
大岩山=Đại Nham Sơn
雪满人间=Tuyết Mãn Nhân Gian
张启灵=Trương Khải Linh
雷刀狂僧=Lôi Đao Cuồng Tăng
莽金刚=Mãng Kim Cương
泰和郡=Thái Hòa Quận
泰保郡城=Thái Bảo Quận Thành
雪龙=Tuyết Long
雪凤凰=Tuyết Phượng Hoàng
崔洞=Thôi Động
李元杰=Lý Nguyên Kiệt
沧澜之域=Thương Lan Chi Vực
沧澜千刃=Thương Lan Thiên Nhận
沧澜万剑=Thương Lan Vạn Kiếm
崔氏=Thôi thị
崔老=Thôi lão
沧澜宗=Thương Lan Tông
青州州城=Thanh Châu Châu Thành
祝融=Chúc Dung
清河崔氏=Thanh Hà Thôi Thị
青州=Thanh Châu
元州=Nguyên Châu
元灵族=Nguyên Linh Tộc
古民=Cổ Dân
江南=Giang Nam
暖石=Noãn Thạch
玄都七十二外峰=Huyền Đô Thất Thập Nhị Ngoại Phong
黄家=Hoàng Gia
怀远峰=Hoài Viễn Phong
林师弟=Lâm Sư Đệ
韩姓=Hàn Tính
林师姐=Lâm Sư Tỷ
冷面丹君=Lãnh Diện Đan Quân
王媛=Vương Viện
云韵=Vân Vận
仙境=Tiên Cảnh
忘忧殿=Vong Ưu Điện
药峰=Dược Phong
琉璃峰=Lưu Li Phong
于雪=Vu Tuyết
归元峰=Quy Nguyên Phong
传道峰=Truyền Đạo Phong
玄法小市=Huyền Pháp Tiểu Thị
齐师兄=Tề sư huynh
诸葛=Gia Cát
天律殿=Thiên Luật Điện
李文=Lý Văn
李家=Lý Gia
海藏峰=Hải Tàng Phong
方成=Phương Thành
黑白楼=Hắc Bạch Lâu
绝真神君=Tuyệt Chân Thần Quân
第九峰=Đệ Cửu Phong
第二十一峰=Đệ Nhị Thập Nhất Phong
第三十六峰=Đệ Tam Thập Lục Phong
海老=Hải Lão
江副殿主=Giang Phó Điện Chủ
唐峰主=Đường Phong Chủ
云家=Vân Gia
二宝妙树=Nhị Bảo Diệu Thụ
诸葛副观主=Gia Cát Phó Quán Chủ
天母教主=Thiên Mẫu Giáo Chủ
通古海=Thông Cổ Hải
临雪郡=Lâm Tuyết Quận
摘星峰=Trích Tinh Phong
文道友=Văn đạo hữu
姬道友=Cơ đạo hữu
孟道友=Mạnh đạo hữu
离山海域=Ly Sơn Hải Vực
韩兴荣=Hàn Hưng Vinh
韩兴商=Hàn Hưng Thương
银河=Ngân Hà
替心石=Thế Tâm Thạch
封印粉尘=Phong Ấn Phấn Trần
狂暴之晶=Cuồng Bạo Chi Tinh
禁空之羽=Cấm Không Chi Vũ
天雷子=Thiên Lôi Tử
微挪移符=Vi Nọa Di Phù
蛊惑之瞳=Cổ Hoặc Chi Đồng
器物融合之光=Khí Vật Dung Hợp Chi Quang
小回天丹=Tiểu Hồi Thiên Đan
寒原郡城=Hàn Nguyên Quận Thành
草原=Thảo Nguyên
韩德言=Hàn Đức Ngôn
张白=Trương Bạch
张岩=Trương Nham
韩德为=Hàn Đức Vi
张威=Trương Uy
折山枪=Chiết Sơn Thương
万川掌=Vạn Xuyên Chưởng
动地步=Động Địa Bộ
万川势=Vạn Xuyên Thế
空山枪=Không Sơn Thương
极光飞舟=Cực Quang Phi Chu
黑原郡=Hắc Nguyên Quận
蛮族部落=Man Tộc Bộ Lạc
天客楼=Thiên Khách Lâu
天坑=Thiên Hố
韩姑娘=Hàn cô nương
韩州=Hàn Châu
张波=Trương Ba
定武司=Định Võ Tư
杜都管=Đỗ Đô Quản
苏都管=Tô Đô Quản
横川县=Hoành Xuyên Huyện
万川真经=Vạn Xuyên Chân Kinh
董家=Đổng Gia
寒原城=Hàn Nguyên Thành
水月周清=Thủy Nguyệt Chu Thanh
江长老=Giang trưởng lão
丹花=Đan Hoa
神农玉册=Thần Nông Ngọc Sách
功德殿殿主=Điện chủ Công Đức Điện
纪副观主=Kỷ phó quan chủ
韩家家主=Hàn gia gia chủ
张信理=Trương Tín Lý
三线峡=Tam Tuyến Hạp
江景若=Giang Cảnh Nhược
玄念道人=Huyền Niệm Đạo Nhân
忘尘殿主=Điện chủ Vong Trần Điện
玄都金册=Huyền Đô Kim Sách
玄都大阵=Huyền Đô Đại Trận
十大真传=Thập Đại Chân Truyền
大齐国=Đại Tề Quốc
尔木=Nhĩ Mộc
珠穆朗玛峰=Đỉnh Everest
真传令=Chân Truyền Lệnh
武丹=Võ Đan
道丹=Đạo Đan
天级=Thiên Cấp
真宫=Chân Cung
鬼神传承=Quỷ Thần Truyền Thừa
天佑之光=Thiên Hữu Chi Quang
玄都仙阵=Huyền Đô Tiên Trận
漂流愿瓶=Phiêu Lưu Nguyện Bình
半妖岁=Bán Yêu Tuế
蜕凡之种=Thoái Phàm Chi Chủng
鸿天剑录=Hồng Thiên Kiếm Lục
归真剑典=Quy Chân Kiếm Điển
惊世古功=Kinh Thế Cổ Công
朝暮剑法=Triêu Mộ Kiếm Pháp
承道楼=Thừa Đạo Lâu
雷瀑神剑=Lôi Bộc Thần Kiếm
阴阳道剑=Âm Dương Đạo Kiếm
七窍玲珑心=Thất Khiếu Linh Lung Tâm
仙鹤峰=Tiên Hạc Phong
龚长老=Cung Trưởng Lão
小七=Tiểu Thất
紫电峰=Tử Điện Phong
金足道=Kim Túc Đạo
紫电宫=Tử Điện Cung
冥云=Minh Vân
郭家=Quách Gia
神农老人=Thần Nông Lão Nhân
玄都真丹=Huyền Đô Chân Đan
玄都传承=Huyền Đô Truyền Thừa
玄都真传=Huyền Đô Chân Truyền
尊者=Tôn Giả
立道池=Lập Đạo Trì
玄都根法=Huyền Đô Căn Pháp
密武=Mật Võ
真传峰=Chân Truyền Phong
混元火=Hỗn Nguyên Hỏa
仙鹤峰主=Tiên Hạc Phong Chủ
玄法河山=Huyền Pháp Hà Sơn
灵兽牌=Linh Thú Bài
唐天=Đường Thiên
通玄峰=Thông Huyền Phong
九阳联盟=Cửu Dương Liên Minh
玄法南域=Huyền Pháp Nam Vực
洛丹君=Lạc Đan Quân
齐氏兄弟=Tề Thị huynh đệ
郭义=Quách Nghĩa
谢东流=Tạ Đông Lưu
古尽=Cổ Tẫn
倪轮光=Nghê Luân Quang
王明阳=Vương Minh Dương
牧野=Mục Dã
季行秋=Quý Hành Thu
火龙=Hỏa Long
宝光境=Bảo Quang Cảnh
大师兄=Đại Sư Huynh
真圣魔教=Chân Thánh Ma Giáo
林怡=Lâm Di
玄都小市=Huyền Đô Tiểu Thị
百鬼噬心花=Bách Quỷ Phệ Tâm Hoa
忘尘殿=Vong Trần Điện
玄都净土=Huyền Đô Tịnh Thổ
幽鬼祖=U Quỷ Tổ
玄鬼祖=Huyền Quỷ Tổ
决明鬼祖=Quyết Minh Quỷ Tổ
天冬鬼祖=Thiên Đông Quỷ Tổ
魂域神树=Hồn Vực Thần Thụ
剑魂草=Kiếm Hồn Thảo
万浪血珊瑚=Vạn Lãng Huyết San Hô
神魂丹=Thần Hồn Đan
无神丹=Vô Thần Đan
鬼神之息=Quỷ Thần Chi Tức
元灵液=Nguyên Linh Dịch
白玉盘=Bạch Ngọc Bàn
三千幻叶藤=Tam Thiên Huyễn Diệp Đằng
青白双生蛇=Thanh Bạch Song Sinh Xà
圆觉峰=Viên Giác Phong
杜金宁=Đỗ Kim Ninh
米芽鬼尊=Mễ Nha Quỷ Tôn
灵鬼祖=Linh Quỷ Tổ
青黛=Thanh Đại
玄都鬼神陵=Huyền Đô Quỷ Thần Lăng
三阴山神=Tam Âm Sơn Thần
逆乱阴阳宝香=Nghịch Loạn Âm Dương Bảo Hương
青囊阴阳经=Thanh Nang Âm Dương Kinh
逆阴乱阳道光=Nghịch Âm Loạn Dương Đạo Quang
血鬼祖=Huyết Quỷ Tổ
至阳血果=Chí Dương Huyết Quả
北寒郡=Bắc Hàn Quận
落神沼泽=Lạc Thần Chiểu Trạch
神魂门=Thần Hồn Môn
韩复=Hàn Phục
黑白鸡=Hắc Bạch Kê
福龟=Phúc Quy
南道郡=Nam Đạo quận
朔望郡=Sóc Vọng quận
万魂小店=Vạn Hồn Tiểu Điếm
付店主=Phó Điếm Chủ
林间=Trong rừng
郑重=Trịnh Trọng
朱兄=Chu huynh
道友=Đạo hữu
朱姓武者=Võ giả họ Chu
五大鬼神=Ngũ Đại Quỷ Thần
步姓=Họ Bộ
朱大叔=Chu đại thúc
朱三=Chu Tam
步津=Bộ Tân
步家=Bộ Gia
万魂镇=Vạn Hồn Trấn
青白蛇妖=Thanh Bạch Xà Yêu
天罡神拳=Thiên Cương Thần Quyền
十八天剑=Thập Bát Thiên Kiếm
古殿主=Cổ Điện Chủ
天罡星=Thiên Cương Tinh
天剑星=Thiên Kiếm Tinh
紫薇星=Tử Vi Tinh
太阴星=Thái Âm Tinh
太阴=Thái Âm
江北=Giang Bắc
方师弟=Phương sư đệ
树哥=Thụ ca
星峰=Tinh Phong
紫薇=Tử Vi
王家=Vương Gia
黑云鬼神司=Hắc Vân Quỷ Thần Tư
蒋横川=Tưởng Hoành Xuyên
阴阳两极神丹=Âm Dương Lưỡng Cực Thần Đan
独孤师兄=Độc Cô sư huynh
三凝三散=Tam Ngưng Tam Tán
崔家=Thôi Gia
东家=Đông Gia
万魔塔=Vạn Ma Tháp
天龙钟=Thiên Long Chung
冰雪巨人符=Băng Tuyết Cự Nhân Phù
阴阳合和丹=Âm Dương Hợp Hòa Đan
灵台丹=Linh Đài Đan
衍丹书=Diễn Đan Thư
冰雪薇甜=Băng Tuyết Vi Điềm
天寒神木=Thiên Hàn Thần Mộc
冰极神晶=Băng Cực Thần Tinh
碧幽蛇=Bích U Xà
寒冰巨鳄=Hàn Băng Cự Ngạc
谢年=Tạ Niên
天级武馆=Thiên Cấp Võ Quán
冰原郡的霸主=Bá chủ của Băng Nguyên Quận
极冰神典=Cực Băng Thần Điển
冰天冻地寒霜道气=Băng Thiên Đống Địa Hàn Sương Đạo Khí
冰熊=Băng Hùng
蓝霜果=Lam Sương Quả
昆仑山主=Côn Lôn Sơn Chủ
十万大山=Thập Vạn Đại Sơn
北方大草原=Bắc Phương Đại Thảo Nguyên
东周诸圣书院=Đông Chu Chư Thánh Thư Viện
天璇圣山=Thiên Toàn Thánh Sơn
冰原=Băng Nguyên
妖族=Yêu tộc
天图王=Thiên Đồ Vương
天图祭祀=Thiên Đồ Tế Tự
胡腓=Hồ Phỉ
谢家=Tạ gia
万相魔经=Vạn Tướng Ma Kinh
万相圣经=Vạn Tướng Thánh Kinh
仇师兄=Cừu sư huynh
付师弟=Phó sư đệ
獛师弟=Điền sư đệ
仇姓=Cừu Tính
付姓=Phó Tính
獛姓=Điền Tính
灭蝶=Diệt Điệp
哑蝶=Ách Điệp
天阳郡=Thiên Dương Quận
渡世道=Độ Thế Đạo
姜烟瑶=Khương Yên Dao
张家=Trương Gia
蒋家=Tưởng gia
上古魔君=Thượng Cổ Ma Quân
功德殿=Công Đức Điện
隐空虚蚕=Ẩn Không Hư Tằm
人族三国=Nhân Tộc Tam Quốc
蛮妖=Man Yêu
古与今=Cổ Dữ Kim
无边天墟=Vô Biên Thiên Khư
隐空虚蚕丝=Ẩn Không Hư Tằm Tơ
显灵水=Hiển Linh Thủy
显圣洗髓=Hiển Thánh Tẩy Tủy
无相魔经=Vô Tướng Ma Kinh
蒋灵=Tưởng Linh
麟羽=Lân Vũ
天璇神山=Thiên Toàn Thần Sơn
天图部落=Thiên Đồ Bộ Lạc
黑山大战=Hắc Sơn Đại Chiến
云江龙后=Vân Giang Long Hậu
拉嘎=Lạp Già
第一功德殿=Đệ Nhất Công Đức Điện
唐长老=Đường Trưởng Lão
第二功德殿=Đệ Nhị Công Đức Điện
筑基丹=Trúc Cơ Đan
华玉丹=Hoa Ngọc Đan
血莲丹=Huyết Liên Đan
灭生丹=Diệt Sinh Đan
普照灯=Phổ Chiếu Đăng
禁法符=Cấm Pháp Phù
化影液=Hóa Ảnh Dịch
重影珠=Trùng Ảnh Châu
朝天椒=Triều Thiên Tiêu
冥河水=Minh Hà Thủy
雨打芭蕉=Vũ Đả Ba Tiêu
仇凛=Cừu Lẫm
付横=Phó Hoành
獛甲=Bồ Giáp
玄都除魔榜=Huyền Đô Trừ Ma Bảng
端长老=Đoan trưởng lão
虎榜=Hổ Bảng
道榜=Đạo Bảng
清风拂尘=Thanh Phong Phất Trần
驭妖环=Ngự Yêu Hoàn
仙梦丹=Tiên Mộng Đan
金刚发=Kim Cương Phát
六耳风=Lục Nhĩ Phong
金睛光=Kim Tình Quang
万兽鼎=Vạn Thú Đỉnh
忘尘殿主尔木=Vong Trần Điện Chủ Nhĩ Mộc
第六内峰=Đệ Lục Nội Phong
万魂林=Vạn Hồn Lâm
春秋峰=Xuân Thu Phong
方远=Phương Viễn
古风=Cổ Phong
韩束=Hàn Thúc
五光峰=Ngũ Quang Phong
吕师姐=Lữ sư tỷ
蒋师兄=Tưởng sư huynh
齐师弟=Tề sư đệ
韩雅=Hàn Nhã
云江君=Vân Giang Quân
碧霞峰=Bích Hà Phong
清辉山=Thanh Huy Sơn
万窟峰=Vạn Quật Phong
九阳拍卖会=Cửu Dương Phách Mại Hội
西海=Tây Hải
和娣=Hòa Đệ
武神果=Võ Thần Quả
龙凤和鸣玉璧=Long Phượng Hòa Minh Ngọc Bích
圣龙=Thánh Long
神凤=Thần Phượng
龙魂=Long Hồn
凤魂=Phượng Hồn
龙血=Long Huyết
凤血=Phượng Huyết
神圣龙凰=Thần Thánh Long Hoàng
九窍金丹=Cửu Khiếu Kim Đan
真龙血魂石=Chân Long Huyết Hồn Thạch
飞星丹=Phi Tinh Đan
紫薇星力=Tử Vi Tinh Lực
太阴星力=Thái Âm Tinh Lực
阵道之灵=Trận Đạo Chi Linh
仙树秘境=Tiên Thụ Bí Cảnh
大地神脉=Đại Địa Thần Mạch
大地武神树=Đại Địa Võ Thần Thụ
阴阳之源=Âm Dương Chi Nguyên
玄法洞天福地=Huyền Pháp Động Thiên Phúc Địa
阴阳法光=Âm Dương Pháp Quang
洛师姐=Lạc Sư Tỷ
桃林=Đào Lâm
秦都管=Tần Đô Quản
圣灵=Thánh Linh
通幽花=Thông U Hoa
吴都管=Ngô Đô Quản
五灵玄光大阵=Ngũ Linh Huyền Quang Đại Trận
阴阳不灭真经=Âm Dương Bất Diệt Chân Kinh
阴阳万劫真经=Âm Dương Vạn Kiếp Chân Kinh
补天藤=Bổ Thiên Đằng
羽化峰=Vũ Hóa Phong
渊峰=Uyên Phong
圣光镜=Thánh Quang Kính
白虎煞魂=Bạch Hổ Sát Hồn
天雷印=Thiên Lôi Ấn
白虎踏月=Bạch Hổ Đạp Nguyệt
太阴星神=Thái Âm Tinh Thần
紫薇星神=Tử Vi Tinh Thần
王载=Vương Tái
金古桥=Kim Cổ Kiều
苏玉=Tô Ngọc
龙榜=Long Bảng
龙虎榜=Long Hổ Bảng
苏家族峰=Tô Gia Tộc Phong
齐氏三兄弟=Tề Thị Tam Huynh Đệ
丹君=Đan Quân
通天花=Thông Thiên Hoa
天圣还魂液=Thiên Thánh Hoàn Hồn Dịch
战神血脉=Chiến Thần Huyết Mạch
气血丹=Khí Huyết Đan
元气晶=Nguyên Khí Tinh
玄法命符=Huyền Pháp Mệnh Phù
塑命丹=Tố Mệnh Đan
阴阳两极返命神丹=Âm Dương Lưỡng Cực Phản Mệnh Thần Đan
冰原郡=Băng Nguyên Quận
冰神宫=Băng Thần Cung
玄法洗礼=Huyền Pháp Tẩy Lễ
四灵天=Tứ Linh Thiên
生灭气=Sinh Diệt Khí
无神无我=Vô Thần Vô Ngã
渡宇步=Độ Vũ Bộ
天转地翻=Thiên Chuyển Địa Phiên
原始古地=Nguyên Thủy Cổ Địa
古州=Cổ Châu
不动金刚=Bất Động Kim Cang
天源道人=Thiên Nguyên Đạo Nhân
天源阵经=Thiên Nguyên Trận Kinh
天霞雪泉=Thiên Hà Tuyết Tuyền
玄法=Huyền Pháp
寒原郡=Hàn Nguyên Quận
真血尊者=Chân Huyết Tôn Giả
韩家=Hàn Gia
敖寒=Ngao Hàn
薇薇=Vi Vy
龙宫=Long Cung
冰原郡蒋家=Băng Nguyên Quận Tưởng Gia
极冰门=Cực Băng Môn
素天女=Tố Thiên Nữ
道魔子=Đạo Ma Tử
宋师叔=Tống sư thúc
傀神之力=Khôi Thần Chi Lực
净焰峰=Tịnh Diệm Phong
化神池=Hóa Thần Trì
守陵老人=Thủ Lăng Lão Nhân
玄都宝山=Huyền Đô Bảo Sơn
戮仙剑=Lục Tiên Kiếm
阴阳地火=Âm Dương Địa Hỏa
真血境=Chân Huyết Cảnh
宝山=Bảo Sơn
龙命草=Long Mệnh Thảo
净浊莲=Tịnh Trược Liên
圣火石=Thánh Hỏa Thạch
地神丹=Địa Thần Đan
黄泉=Hoàng Tuyền
金刚果=Kim Cương Quả
伏笝花=Phục Nạp Hoa
地鬼=Địa Quỷ
阵元石=Trận Nguyên Thạch
天律殿主=Điện chủ Thiên Luật Điện
古神宫=Cổ Thần Cung
凰翼=Hoàng Dực
北海=Bắc Hải
苍梧=Thương Ngô
韩具=Hàn Cụ
仙客峰=Tiên Khách Phong
沈鱼=Thẩm Ngư
雪山=Tuyết Sơn
龙君=Long Quân
冷辉仙子=Lãnh Huy Tiên Tử
云龙市=Vân Long Thị
龙君宴=Long Quân Yến
西海龙族=Tây Hải Long Tộc
白卒路=Bạch Tốt Lộ
承望郡=Thừa Vọng Quận
庆家=Khánh Gia
九阳墟=Cửu Dương Khư
雪人族=Tuyết Nhân Tộc
虚空之鲲=Hư Không Chi Côn
杨道友=Dương đạo hữu
真龙门=Chân Long Môn
白虎门=Bạch Hổ Môn
九五前殿=Cửu Ngũ Tiền Điện
双头犬=Song Đầu Khuyển
天尸宗=Thiên Thi Tông
地尸宗=Địa Thi Tông
六极神光=Lục Cực Thần Quang
云虹果=Vân Hồng Quả
庆阳=Khánh Dương
北圣派=Bắc Thánh Phái
纳风尊者=Nạp Phong Tôn Giả
白卒小市=Bạch Tốt Tiểu Thị
冥古神殿=Đền Minh Cổ
五圣诛邪大阵=Ngũ Thánh Tru Tà Đại Trận
冰泉尊者=Băng Tuyền Tôn Giả
玉池圣山=Ngọc Trì Thánh Sơn
五圣=Ngũ Thánh
冰泉兽尊=Băng Tuyền Thú Tôn
李缘=Lý Duyên
俗佛=Tục Phật
弥渡=Di Độ
恶山=Ác Sơn
真龙=Chân Long
白虎=Bạch Hổ
玄龟=Huyền Quy
金甲=Kim Giáp
五灵=Ngũ Linh
古傀路=Cổ Khôi Lộ
北江郡=Bắc Giang Quận
大力金刚寺=Đại Lực Kim Cương Tự
金圣道树=Kim Thánh Đạo Thụ
石家=Thạch Gia
冥古郡=Minh Cổ Quận
无常殿=Vô Thường Điện
双头犬兽尊=Song Đầu Khuyển Thú Tôn
苏望=Tô Vọng
金阳神傀=Kim Dương Thần Khôi
宋师弟=Tống sư đệ
尹幸=Doãn Hạnh
天图王部=Thiên Đồ Vương Bộ
器阁=Khí Các
周皇室=Chu Hoàng Thất
黄泉之龙=Hoàng Tuyền Chi Long
黄泉宝丹=Hoàng Tuyền Bảo Đan
乙玄神船=Ất Huyền Thần Thuyền
丙玄神船=Bính Huyền Thần Thuyền
宁菀=Ninh Uyển
曹伏=Tào Phục
雪山城=Tuyết Sơn Thành
万星交易会=Vạn Tinh Giao Dịch Hội
易宝阁=Dịch Bảo Các
中天城=Trung Thiên Thành
吕师妹=Lữ sư muội
曹家=Tào Gia
葬古大沙漠=Táng Cổ Đại Sa Mạc
晋司马氏=Tấn Tư Mã Thị
晋世家宗门=Tấn Thế Gia Tông Môn
齐土=Tề Thổ
石曦=Thạch Hi
蛮王=Man Vương
甲辰号=Giáp Thìn hiệu
甲卯号=Giáp Mão hiệu
云伯伯=Vân bá bá
玉液丹=Ngọc Dịch Đan
山灵液=Sơn Linh Dịch
通元尊者=Thông Nguyên Tôn Giả
慕容师姐=Mộ Dung sư tỷ
甲卯包厢=Bao sương Giáp Mão
万星城=Vạn Tinh Thành
浩然长明灯=Hạo Nhiên Trường Minh Đăng
雪桂=Tuyết Quế
阴阳洞=Âm Dương Động
趋吉避凶=Khu Cát Tị Hung
雪族=Tuyết Tộc
天赐秘力=Thiên Tứ Bí Lực
天赐谷=Thiên Tứ Cốc
风雪谷=Phong Tuyết Cốc
三尺飘雪辰宁=Tam Xích Phiêu Tuyết Thần Ninh
萧腾=Tiêu Đằng
天圣派=Thiên Thánh Phái
烈焰星神周清=Liệt Diễm Tinh Thần Chu Thanh
辰宁=Thần Ninh
雪山派=Tuyết Sơn Phái
吉星高照=Cát Tinh Cao Chiếu
福星高照=Phúc Tinh Cao Chiếu
人族=Nhân Tộc
阴现云=Âm Hiện Vân
风无己=Phong Vô Kỷ
叶功=Diệp Công
墨姨=Mặc Di
沈副观主=Thẩm phó quan chủ
万煞炼魂术=Vạn Sát Luyện Hồn thuật
青黛珠=Thanh Đại Châu
功德峰=Công Đức phong
第八真传=Đệ Bát Chân Truyền
甲玄神船=Giáp Huyền Thần Thuyền
大齐国教=Đại Tề Quốc Giáo
萧战=Tiêu Chiến
戴劲=Đái Kính
白大人=Bạch đại nhân
江道友=Giang đạo hữu
吴将军=Ngô tướng quân
灰骨山脉=Hôi Cốt Sơn Mạch
大齐天鹰军=Đại Tề Thiên Ưng Quân
焚寂=焚 Tịch
大千仙树=Đại Thiên Tiên Thụ
寒雪盛会=Hàn Tuyết Thịnh Hội
定光鹰=Định Quang Ưng
定灵之光=Định Linh Chi Quang
蛮鹫=Man Thứu
七杀剑=Thất Sát Kiếm
玄藤神甲=Huyền Đằng Thần Giáp
焚寂弓=Phần Tịch Cung
蛮鹫军=Man Thứu Quân
玉门关=Ngọc Môn Quan
文圣=Văn Thánh
魏长老=Ngụy trưởng lão
高长老=Cao trưởng lão
大千仙树观想法=Đại Thiên Tiên Thụ Quan Tưởng Pháp
天地冰湖=Thiên Địa Băng Hồ
古挞=Cổ Thát
小青湖=Tiểu Thanh Hồ
钟馗=Chung Quỳ
终南山=Chung Nam Sơn
摩云洞=Ma Vân Động
积雷山=Tích Lôi Sơn
呼克=Hô Khắc
凛寒=Lẫm Hàn
月敕=Nguyệt Sắc
张信空=Trương Tín Không
韩铁林=Hàn Thiết Lâm
周智深=Chu Trí Thâm
昆仑=Côn Lôn
四海龙宫=Tứ Hải Long Cung
龙族=Long tộc
漠古将部=Mạc Cổ Tướng Bộ
兽尊=Thú Tôn
天子山河剑=Thiên Tử Sơn Hà Kiếm
大周=Đại Chu
武明空=Võ Minh Không
武周=Võ Chu
高将军=Cao tướng quân
西齐=Tây Tề
曦姐姐=Hy tỷ tỷ
神都=Thần Đô
须卜阿提拉=Tu Bặc A Đề Lạp
漠古部落=Mạc Cổ Bộ Lạc
曼吥=Mạn Phả
漠古祭祀=Mạc Cổ Tế Tự
北原郡=Bắc Nguyên Quận
阴神=Âm Thần
横宇船=Hoành Vũ Thuyền
明空=Minh Không
无上星神三叩首=Vô Thượng Tinh Thần Tam Khấu Thủ
童长老=Đồng trưởng lão
万河养魂液=Vạn Hà Dưỡng Hồn Dịch
小天武丹=Tiểu Thiên Vũ Đan
阴灵土=Âm Linh Thổ
血煞神晶=Huyết Sát Thần Tinh
天杀仙石=Thiên Sát Tiên Thạch
落霞冰原=Lạc Hà Băng Nguyên
天星液=Thiên Tinh Dịch
天星碎片=Thiên Tinh Toái Phiến
重苍=Trọng Thương
脱胎丹=Thoát Thai Đan
六极战船=Lục Cực Chiến Thuyền
东周亚圣=Đông Chu Á Thánh
万星商主=Vạn Tinh Thương Chủ
紫霄天君=Tử Tiêu Thiên Quân
苍胤王=Thương Dận Vương
漠古=Mạc Cổ
血牙=Huyết Nha
赵利=Triệu Lợi
定远将军=Định Viễn Tướng Quân
韩珊珊=Hàn San San
黄泉境=Hoàng Tuyền Cảnh
造化壶=Hồ Tạo Hóa
安息古棺=Quan tài cổ An Tức
异兽分身=Dị Thú Phân Thân
紫霄城=Tử Tiêu Thành
傀宗=Khôi Tông
玄都丹君=Huyền Đô Đan Quân
涅槃骨=Niết Bàn Cốt
神农谷=Thần Nông Cốc
山海域=Sơn Hải Vực
乱妖界=Loạn Yêu Giới
凤凰一族=Phượng Hoàng Nhất Tộc
岁帝=Tuế Đế
天神道体=Thiên Thần Đạo Thể
天武学原始战体=Thiên Võ Học Nguyên Thủy Chiến Thể
十万雪山=Thập Vạn Tuyết Sơn
通风猕猴髓法=Thông Phong Mị Hầu Tủy Pháp
山水寺=Sơn Thủy Tự
天母教=Thiên Mẫu Giáo
灵育大师=Linh Dục đại sư
灵惠首座=Linh Huệ thủ tọa
圆法师伯=Viên Pháp sư bá
那剋觉明佛=Na Khắc Giác Minh Phật
寒风老道=Hàn Phong Lão Đạo
月神=Nguyệt Thần
叶重=Diệp Trọng
天月城=Thiên Nguyệt Thành
龙境神域=Long Cảnh Thần Vực
玉应=Ngọc Ứng
玉某=Ngọc mỗ
玄法郡=Huyền Pháp Quận
冥古神山=Minh Cổ Thần Sơn
凤凰=Phượng Hoàng
法真=Pháp Chân
寒风道人=Hàn Phong Đạo Nhân
龙境山神=Long Cảnh Sơn Thần
龙境山=Long Cảnh Sơn
月魔=Nguyệt Ma
元气魔=Nguyên Khí Ma
真魔=Chân Ma
远山郡=Viễn Sơn Quận
灵育方丈=Linh Dục Phương Trượng
龙境县=Long Cảnh Huyện
圆法=Viên Pháp
水源道观=Thủy Nguyên Đạo Quán
那剋寺=Na Khắc Tự
甘霖符=Cam Lâm Phù
诸圣书院=Chư Thánh Thư Viện
太上三化=Thái Thượng Tam Hóa
摘星拿月=Trích Tinh Nã Nguyệt
心界=Tâm Giới
承道峰=Thừa Đạo Phong
尊者境=Tôn Giả Cảnh
幽冥地府=U Minh Địa Phủ
放置栏=Phóng Trí Lan
云江龙君=Vân Giang Long Quân
阳腾=Dương Đằng
灵阳湖=Linh Dương Hồ
万血灵花=Vạn Huyết Linh Hoa
境海三龙=Cảnh Hải Tam Long
梦中证道=Mộng Trung Chứng Đạo
青蛇=Thanh Xà
小青小白=Tiểu Thanh Tiểu Bạch
雪龙族=Tuyết Long Tộc
水元盛会=Thủy Nguyên Thịnh Hội
龟勉=Quy Miễn
雷峰塔=Lôi Phong Tháp
缙媃=Tấn Nhu
觉远=Giác Viễn
缙雎=Tấn Tư
境海龙宫=Cảnh Hải Long Cung
李灵秀=Lý Linh Tú
蛟孤=Giao Cô
蛟河=Giao Hà
镜我=Kính Ngã
云江龙宫=Vân Giang Long Cung
寒云别府=Hàn Vân Biệt Phủ
云江=Vân Giang
白天=Bạch Thiên
秦明=Tần Minh
王寨主=Vương Trại Chủ
周老头=Chu Lão Đầu
回元商会=Hồi Nguyên Thương Hội
双星镜=Song Tinh Kính
齐白氏=Tề Bạch Thị
蒋密=Tưởng Mật
天断台=Thiên Đoạn Đài
星河峰=Tinh Hà Phong
齐云霄=Tề Vân Tiêu
曹茵茵=Tào Nhân Nhân
齐云渊=Tề Vân Uyên
齐云海=Tề Vân Hải
大梦心经=Đại Mộng Tâm Kinh
先天剑体=Tiên Thiên Kiếm Thể
斩妖除魔=Trảm Yêu Trừ Ma
仙衍天杀石=Tiên Diễn Thiên Sát Thạch
素真宫=Tố Chân Cung
太素玄真图=Thái Tố Huyền Chân Đồ
素真圣女=Tố Chân Thánh Nữ
剑君=Kiếm Quân
六合仙莲印=Lục Hợp Tiên Liên Ấn
六极仙莲印=Lục Cực Tiên Liên Ấn
紫气东来=Tử Khí Đông Lai
祖师=Tổ Sư
诸葛祖师=Gia Cát Tổ Sư
玄玄子祖师=Huyền Huyền Tử Tổ Sư
观主=Quan Chủ
戮仙剑经=Lục Tiên Kiếm Kinh
小祈=Tiểu Kỳ
境海流光域=Cảnh Hải Lưu Quang Vực
化神峰=Hóa Thần Phong
炼血窟=Luyện Huyết Quật
一气化三清=Nhất Khí Hóa Tam Thanh
寒州龙虎榜=Hàn Châu Long Hổ Bảng
天杀剑=Thiên Sát Kiếm
元磁精石=Nguyên Từ Tinh Thạch
五灵铁=Ngũ Linh Thiết
天神=Thiên Thần
妙树=Diệu Thụ
星辰砂=Tinh Thần Sa
原血期=Nguyên Huyết Kỳ
平天牛魔=Bình Thiên Ngưu Ma
覆海蛟魔=Phúc Hải Giao Ma
孟浩=Mạnh Hạo
承道殿=Thừa Đạo Điện
六道轮回功=Lục Đạo Luân Hồi Công
龙凤大化=Long Phượng Đại Hóa
尘光剑=Trần Quang Kiếm
玄玉甲=Huyền Ngọc Giáp
定天弓=Định Thiên Cung
天灵法剑=Thiên Linh Pháp Kiếm
不动神钟=Bất Động Thần Chung
太极图=Thái Cực Đồ
云朵=Vân Đóa
清虚殿=Thanh Hư Điện
天命宗=Thiên Mệnh Tông
登仙殿=Đăng Tiên Điện
白若月=Bạch Nhược Nguyệt
天州=Thiên Châu
太白武馆=Thái Bạch Võ Quán
沈龙=Thẩm Long
黑山圣地=Hắc Sơn Thánh Địa
天龙门=Thiên Long Môn
小青=Tiểu Thanh
小白=Tiểu Bạch
玄都祖师=Huyền Đô Tổ sư
黑山山神=Hắc Sơn Sơn Thần
天武学=Thiên Vũ Học
上帝视角=Góc nhìn của Thượng Đế
先天法体=Tiên Thiên Pháp Thể
真血武者=Chân Huyết Võ Giả
彻地境=Triệt Địa Cảnh
玄法净土=Huyền Pháp Tịnh Thổ
黄金树=Hoàng Kim Thụ
黄金叶=Hoàng Kim Diệp
黄金古叶=Hoàng Kim Cổ Diệp
原始战体=Nguyên Thủy Chiến Thể
净土=Tịnh Thổ
福地=Phúc Địa
黄泉彻地=Hoàng Tuyền Triệt Địa
碧落通天=Bích Lạc Thông Thiên
天门关=Thiên Môn Quan
静虚祖师=Tĩnh Hư Tổ Sư
南晋=Nam Tấn
葬古沙漠=Táng Cổ Sa Mạc
恒心=Hằng Tâm
心圣=Tâm Thánh
水月峰主=Thủy Nguyệt Phong chủ
琉璃=Lưu Ly
玄都=Huyền Đô
龟尊者=Quy Tôn Giả
圣命莲=Thánh Mệnh Liên
玄法群山=Huyền Pháp Quần Sơn
阴神真血境=Âm Thần Chân Huyết Cảnh
碧落通天境=Bích Lạc Thông Thiên Cảnh
同尘石=Đồng Trần Thạch
十地心乳=Thập Địa Tâm Nhũ
十地宝液=Thập Địa Bảo Dịch
福地之血=Phúc Địa Chi Huyết
恒心道人=Hằng Tâm Đạo Nhân
静虚山=Tĩnh Hư Sơn
静虚山主=Tĩnh Hư Sơn Chủ
琉璃心力=Lưu Ly Tâm Lực
西湖=Tây Hồ
真传宫=Chân Truyền Cung
大罗天境=Đại La Thiên Cảnh
玄都观主=Huyền Đô Quan Chủ
千老=Thiên lão
燕师姐=Yến sư tỷ
阴神境=Âm Thần Cảnh
鬼神司=Quỷ Thần Tư
蛮族=Man Tộc
蛮族王庭=Man Tộc Vương Đình
万法峰=Vạn Pháp Phong
周师弟=Chu sư đệ
昆仑山=Côn Lôn Sơn
鬼居=Quỷ Cư
水月峰=Thủy Nguyệt Phong
宋东辰=Tống Đông Thần
玄法山=Huyền Pháp Sơn
苏家=Tô Gia
诸葛通达=Gia Cát Thông Đạt
沈愿宁=Thẩm Nguyện Ninh
长留道人=Trường Lưu Đạo Nhân
碧落境=Bích Lạc Cảnh
扶风真君=Phù Phong Chân Quân
通天境=Thông Thiên Cảnh
江家=Giang Gia
诸葛英月=Gia Cát Anh Nguyệt
慕容嫣然=Mộ Dung Yên Nhiên
寒州=Hàn Châu
青黛鬼祖=Thanh Đại Quỷ Tổ
石易=Thạch Dịch
吕圆圆=Lữ Viên Viên
独孤=Độc Cô
寒苦城=Hàn Khổ Thành
万星商会=Vạn Tinh Thương Hội
寒苦集=Hàn Khổ Tập
三主市=Tam Chủ Thị
洛琉璃=Lạc Lưu Li
通州=Thông Châu
玉京=Ngọc Kinh
剑一派=Kiếm Nhất Phái
东周=Đông Chu
天杀剑器图=Thiên Sát Kiếm Khí Đồ
天月郡=Thiên Nguyệt Quận
黑山=Hắc Sơn
辽州=Liêu Châu
驭剑道人=Ngự Kiếm Đạo Nhân
地火印=Địa Hỏa Ấn
鬼神陵=Quỷ Thần Lăng
九幽神火=Cửu U Thần Hỏa
敖玄薇=Ngao Huyền Vi
陆清墨=Lục Thanh Mặc
黑云镇=Hắc Vân Trấn
境海=Cảnh Hải
齐境=Tề Cảnh
太白剑=Thái Bạch Kiếm
六灵傀=Lục Linh Khôi
八龙佛火=Bát Long Phật Hỏa
睡佛山=Thụy Phật Sơn
阴阳而火=Âm Dương Nhi Hỏa
戮仙剑域=Lục Tiên Kiếm Vực
五行珠=Ngũ Hành Châu
五行法界=Ngũ Hành Pháp Giới
紫红玉符=Tử Hồng Ngọc Phù
天雷地火印=Thiên Lôi Địa Hỏa Ấn
觉闻=Giác Văn
古境宗=Cổ Cảnh Tông
阎浮圣界=Diêm Phù Thánh Giới
三灵之阵=Tam Linh Chi Trận
天地浩然剑=Thiên Địa Hạo Nhiên Kiếm
太白=Thái Bạch
阙境郡=Khuyết Cảnh Quận
胡家=Hồ Gia
天极凰翼=Thiên Cực Hoàng Dực
六道轮回=Lục Đạo Luân Hồi
阴阳生死轮=Âm Dương Sinh Tử Luân
周清=Chu Thanh
燕狂徒=Yến Cuồng Đồ
境州=Cảnh Châu
玄都观=Huyền Đô Quan
天相寺=Thiên Tướng Tự
觉真=Giác Chân
天龙相=Thiên Long Tướng
五鬼毒阴煞火=Ngũ Quỷ Độc Âm Sát Hỏa
阙境郡城=Khuyết Cảnh Quận Thành
天月郡城=Thiên Nguyệt Quận Thành
安琅=An Lang
天行神舟=Thiên Hành Thần Châu
重苍鼎=Trọng Thương Đỉnh
天龙寺=Thiên Long Tự
黄泉彻地境=Hoàng Tuyền Triệt Địa Cảnh
大齐=Đại Tề
八部天龙护法道=Bát Bộ Thiên Long Hộ Pháp Đạo
