阿耆=A Kỳ
伐楼拿=Phạt Lâu Na
畏怖尊=Bhairava
鸯耆罗=Angiras
祭主仙=Tế Chủ Tiên
灵鱼马特斯亚=Linh Ngư Matsya
太白仙人=Thái Bạch tiên nhân
婆力古=Bhrigu
夜叉=Dạ Xoa
阿修罗王金目=A Tu La Vương Kim Mục
炎拳=Viêm Quyền
阿周那=Arjuna
金翅大鹏=Kim Sí Đại Bằng
须弥芥子=Tu Di Giới Tử
金目阿修罗王=Kim Mục A Tu La Vương
阿修罗导师=Đạo sư A Tu La
底提之子=Đế Đề Chi Tử
金目和金床=Kim Mục và Kim Sàng
檀奴之子=Đàn Nô Chi Tử
眉心轮=Mi Tâm Luân
顶轮=Đỉnh Luân
梵我合一=Phạm Ngã Hợp Nhất
金目阿修罗=Kim Mục A Tu La
魔怪诃拉诃拉=Ma quái Hô-la-hô-la
野猪化身=Dã Trư Hóa Thân
筏罗诃=Varaha
摩耶幻术=Ma Da Huyễn Thuật
野猪筏罗诃=Dã Trư Phiệt La Ha
灵龟库尔玛=Linh Quy Khố Nhĩ Mã
财富女神拉克什米=Nữ thần Tài Lộc Lạp Khắc Thập Mễ
毗恭吒=Tỳ Cung Tra
阎浮树=Cây Diêm Phù
提毗波=Dvipa
摩诃婆罗多=Mahabharata
般度族=Pandava
俱卢族=Kaurava
瞿陀尼=Cù Đà Ni
拉伊哈罗巴舞=Lai Haroba
摩诃=Ma Ha
伽罗尼米=Già La Ni Mễ
迦罗尼弥=Ca La Ni Di
护世神=Hộ Thế Thần
太阳神殿=Đền Thần Mặt Trời
云神——娑罗尼尤=Vân Thần - Sāraṇyū
阿修罗金床=Giường Vàng Asura
杜尔迦马=Durgama
粗恶苑=Thô Ác Uyển
喜林苑=Hỷ Lâm Uyển
众车苑=Chúng Xa Uyển
霍丽嘉=Holiqa
爱神迦摩=Thần Tình Yêu Kama
弥娜迦=Menaka
人狮=Nhân Sư
毗老师=Thầy Tỳ
罗辛哈=Narasimha
狮鹫=Sư Ưng
人狮那罗辛哈=Nhân Sư Na La Tân Ha
那罗辛哈=Narasimha
蓝光=Lam Quang
深蓝圆舞曲=Thâm Lam Viên Vũ Khúc
陈云=Trần Vân
桔梨箩柚=Quất Lê La Dữu
吴明=Ngô Minh
鸯耆罗仙人=Angiras
山羊=Dê
羚羊=Linh Dương
王中因陀罗=Vương Trung Nhân Đà La
十字戏=Thập Tự Hí
礼貌天帝=Thiên Đế Lễ Phép
库摩兰妮=Kumolanani
坦达瓦=Tandava
圣餐=Thánh thiện
因陀罗之矢=Mũi tên Indra
海螺=Ốc xà cừ
风群之主=Phong Quần Chi Chủ
伽陀神锤=Chùy Gada
维摩纳斯=Vimanas
娜迦蛇王=Naga Xà Vương
礼赞那罗~那罗延=Lễ tán Nara~Narayana
月宫=Nguyệt Cung
达陀利耶=Đạt Đà Lợi Da
摩耶智慧=Trí tuệ Maya
恒河女神=Hằng Hà Nữ Thần
金床阿修罗=Kim Sàng A Tu La
天帝阿耆尼=Thiên Đế Agni
帕尔瓦蒂女神=Nữ thần Parvati
南阎浮提州=Nam Diêm Phù Đề Châu
神马=Thần Mã
诃拉=Ha Lạp
青狮=Thanh Sư
敝衣仙=Tệ Y Tiên
摩耶之力=Ma Da Chi Lực
妙相=Diệu Tướng
礼赞天神=Lễ Tán Thiên Thần
礼赞迦叶波仙人=Lễ Tán Ca Diệp Ba Tiên Nhân
阿修罗界=A Tu La Giới
嗡拿马西瓦=Om Namah Shivaya
商吉婆尼咒=Chú Thương Cát Bà Ni
大天之子=Đại Thiên Chi Tử
南无希瓦=Namo Shivaya
伐樓那=Varuna
娑羅室伐底=Sa La Thất Phạt Để
太阳神马=Thái Dương Thần Mã
护世神毗湿奴=Hộ Thế Thần Tỳ Thấp Nô
达玛鲁=Damaru
葛兰花=Hoa Kanak Champa
檀那婆王普罗曼=Vua Danava Proman
泥犁=Nê lê
泥犁若=Nê lê nhược
地狱=Địa ngục
礼赞大天=Lễ tán Đại Thiên
苏利耶之子=Tô Lợi Da Chi Tử
云神娑罗尼尤=Vân Thần Toa La Ni Vưu
旱魔弗栗多=Hạn Ma Phất Lật Đa
金星仙人=Tiên nhân Kim Tinh
摩利坎杜=Marikandu
生主达刹=Sinh Chủ Đạt Sát
黄金山羊=Hoàng Kim Sơn Dương
圣城迦尸=Thánh Thành Ca Thi
爱罗婆多神庙=Đền Airavata
吠陀守护者=Người bảo vệ Veda
敝衣=Bế Y
月神殿=Nguyệt Thần Điện
长暗仙人=Trường Ám Tiên Nhân
正理经=Chánh Lý Kinh
塔拉=Tháp Lạp
约尼=Ước Ni
阿底利=A Để Lợi
阿诃利耶=A Kha Lợi Gia
乔答摩仙人=Kiều Đáp Ma tiên nhân
阎摩判官=Diêm Ma Phán Quan
魔王金眼睛=Quỷ vương Mắt Vàng
魔王金垫子=Quỷ vương Đệm Vàng
乔答摩=Gautama
补米伽=Bhumika
甘露=Amrita
哈斯底=Hastin
毗达斯=Vitas
吐浑=Tuhan
阿沃索希=A-wo-suo-xi
拘魂套索=Câu Hồn Sáo Tác
上主那罗延=Thượng Chủ Narayana
蛇床者=Xà sàng giả
里婆蒂=Lý Bà Đế
神庙=đền thờ
摩诃阿底提耶=Ma Ha A Để Đề Gia
迦尸城=Ca Thi Thành
正法之神=Chính Pháp Chi Thần
摩西湿=Ma Tây Thấp
善见城=Thiện Kiến Thành
四部吠陀=Tứ Bộ Vệ Đà
正法神=Chính Pháp Thần
毗诃波提=Tỳ Ha Ba Đề
檀那婆普罗曼=Đàn Na Bà Phổ La Mạn
阎浮树叶=Diêm Phù Thụ Diệp
全胜祭=Toàn Thắng Tế
第259章=Chương 259
牟质=Mưu Chất
神甲=Thần Giáp
黄金太阳神甲=Hoàng Kim Thái Dương Thần Giáp
因陀罗之轮=Luân xa của Indra
祭主仙人=Tế Chủ Tiên Nhân
手持雷杵=Vajra-Holder
杀弗栗多=Vritra-Slayer
斩那牟质=Namuchi-Slayer
英武天神=Valiant Deva
身披金闪衣=Golden-Clad
钵利阿修罗王=Bát Lợi A Tu La Vương
摩诃钵利=Ma Ha Bát Lợi
第275章=Chương 275
伐摩那=Phạt Ma Na
迦拘吒迦=Ca Câu Tra Ca
沙罗宝多迦=Sa La Bảo Đa Ca
骄罗毗耶=Kiêu La Tỳ Da
沙利耶迦=Sa Lợi Da Ca
杵瘤=Xử Lựu
蛇族=Tộc rắn
礼赞上主=Lễ tán Thượng chủ
礼赞三相神=Lễ tán Tam tướng thần
金刚身阿修罗=Kim Cang Thân Asura
静修林=Tĩnh Tu Lâm
斗宿=Đẩu Túc
檀那婆族=Đàn Na Bà Tộc
兰巴阿修罗=Lan Ba A Tu La
摩西沙阿修罗=Ma Tây Sa A Tu La
阎浮提树=Cây Jambu
达录那=Daruna
阿那罗=Anala
阿尼罗=Anila
蛇王舍沙=Xà Vương Xá Sa
诃德莉=Ha Đức Lị
智人迦玛帕拉=Trí Nhân Già Ma Ba Lạp
蛇母迦德卢=Xà Mẫu Ca Đức Lâu
多刹迦=Đa Sát Ca
神犬萨罗摩=Thần Khuyển Tát La Ma
六月=Tháng Sáu
天授海螺=Thiên Thụ Hải Loa
神象之王=Thần Tượng Chi Vương
白象爱罗婆多=Bạch Tượng Ai La Bà Đa
美娜=Mina
室利那罗延=Sri Narayana
阿修罗陀罗迦=Asura Taraka
月铃母=Nguyệt Linh Mẫu
大天生子=Đại Thiên Sinh Tử
群山=Quần Sơn
日落山=Nhật Lạc Sơn
班苏里笛=Ban Tô Lý Địch
汉塔克=Hantake
阎浮提=Jambudvipa
婆稚=Vamana
吉提迦=Cát Đề Ca
希雅=Hi Á
普里提=Phổ Lí Đề
桑娜提=Tang Na Đề
毗奢密多罗=Vishwamitra
极裕仙人=Vasishtha
神矛=Thần mâu
木橘叶=Mộc Quất Diệp
曲女城=Khúc Nữ Thành
拘湿迦=Câu Thấp Ca
梵仙=Phạn Tiên
搭帕=Đát Mạt
迦尔吉=Kalki
阿底提耶=A Để Đề Gia
阿达=Ada
爱婆罗多=Airavata
五色孔雀=Khổng Tước Ngũ Sắc
卡尼拉=Tạp Ni Lạp
那兰奇=Na Lan Kỳ
巴乎迦=Ba Hô Già
露兜花=Hoa Lộ Đâu
阿奴苏耶=A Nô Tô Gia
妙光=Diệu Quang
金眼=Kim Nhãn
宽阔=Khoan Khoát
心水=Tâm Thủy
激流=Kích Lưu
妙竹=Diệu Trúc
净流=Tịnh Lưu
怛（da）罗女神=Đát La Nữ Thần
财神=Thần Tài
日出山=Nhật Xuất Sơn
雪山女神=Tuyết Sơn Nữ Thần
五子阿修罗=Ngũ Tử A Tu La
提迭=Die
弥那迦山=Di Na Ca Sơn
室建陀=Skanda
力量之主=Lực Lượng Chi Chủ
力主=Lực Chủ
舍脂之主=Xá Chi Chi Chủ
苏利耶之子娑尼=Tô Lợi Gia Chi Tử Sa Ni
爱罗婆多主神庙=Ái La Bà Đa Chủ Thần Miếu
盎伽=Áng Già
因陀罗尼=Nhân Đà La Ni
杜摩陀耆尼=Đỗ Ma Đà Kỳ Ni
卡库=Kaku
迦尸=Già Thi
兽主法宝=Thú Chủ Pháp Bảo
死神阎摩=Tử Thần Diêm Ma
众友=Chúng Hữu
利吉迦=Lợi Cát Ca
须弥=Tu Di
马提迦婆多=Matika婆多
水神=Thần Nước
火神=Thần Lửa
昴星神=Pleiades
巴图克=Batuque
婆罗娑罗摩=Parashurama
碳叶=Thán Diệp
奇车王=Kỳ Xa Vương
迦尸之城=Ca Thi Chi Thành
毗里妮=Virini
罗蒂=Rati
不幸女神【耶瑟陀】=Nữ thần bất hạnh [Yeshetha]
月神之子【布陀】=Con trai của Thần Mặt Trăng [Budha]
干燥之雷=Khô Táo Chi Lôi
湿润之雷=Ướt Át Chi Lôi
曼妲=Manda
步摇=Bộ Dao
多福=Đa Phúc
阿布婆=A Bố Bà
摩耶阿修=Ma Da A Tu La
红冠=Hồng Quán
雷杵阵=Lôi Xử Trận
苏羯罗导师=Đạo sư Tô Yết La
林迦柱=Lâm Già Trụ
盖图跋=Cái Đồ Bạt
礼赞耶瑟陀=Lễ tán Da Sắt Đà
姜黄粉=Bột nghệ
红花粉=Bột hồng hoa
月桂叶=Lá nguyệt quế
丁香花粉=Bột đinh hương
蛇床=Xà Sàng
摩耶苍穹=Ma Gia Thương Khung
迷醉=Mê Túy
牛节望=Uchchaihshravas
星盘阵=Tinh Bàn Trận
杜鲁刚=Đỗ Lỗ Cương
丰饶=Phong Nhiêu
杜兰塔克=Đỗ Lan Tháp Khắc
城堡破坏者=Kẻ Phá Hoại Thành Trì
百祭=Bách Tế
桑布提=Sambūti
战神=Chiến Thần
昴星女神=Mão Tinh Nữ Thần
灵鱼摩蹉=Linh Ngư Ma Tha
马特斯亚=Mattysia
青颈=Thanh Kình
兽主=Thú Chủ
舞王=Vũ Vương
辉煌=Huy Hoàng
高丽=Gauri
妙相仙人=Diệu Tướng Tiên Nhân
梵卵=Brahmanda
阿特曼=Atman
阿诃姆=Aham
象魔阿修罗=Tượng Ma A Tu La
阿特曼林迦=Atman Linga
天帝神殿=Thiên Đế Thần Điện
盗取鲜花者=Kẻ trộm hoa
阿修罗王钵利=Asura Vương Bali
渡津者=Độ Tân Giả
吠陀智人=Phệ Đà Trí Nhân
正法战士=Chiến binh chính pháp
吠陀守护者因陀罗=Thần Indra Người bảo vệ Veda
神杵=Thần Xử
摩利=Malli
须摩利=Sumali
主母=Chủ Mẫu
萨克蒂女神=Nữ Thần Shakti
度母=Độ Mẫu
怛罗女神=Tara
怛罗=Tara
大天湿婆=Đại Thiên Shiva
迦娜=Gana
提婆达多=Devadatta
阎摩使=Sứ giả Diêm Ma
曼荼罗山=Mạn Đồ La Sơn
阿努波=A Nậu Ba
莱奴迦=Lai Nô Già
舍波罗=Shebala
太阳神=Thái Dương Thần
业果神=Nghiệp Quả Thần
正法=Chánh Pháp
梨多=Rita
宁三叉戟=Ninh Tam Xoa Kích
娑罗室伐底河=Sông Toa La Thất Phạt Để
象魔=Tượng Ma
千首蛇王舍沙=Thiên Thủ Xà Vương Xá Sa
金翅鸟迦楼罗=Kim Sí Điểu Già Lâu La
梵湖=Phạm Hồ
群山之翼=Cánh núi non
五识=Ngũ Thức
五体=Ngũ Thể
取胜=Thắng Lợi
南儋部州=Jambudvipa
补卢山=Bổ Lư Sơn
安伽城=An Già Thành
洛摩巴陀=Lạc Ma Ba Đà
繁荣=Phồn Vinh
神劈=Thần Phách
诃拉诃拉之箭=Mũi tên Hala Hala
因陀罗之弓=Cung Indra
王冠=Vương miện
阿斯多山=A Tư Đa Sơn
大雪山=Đại Tuyết Sơn
东弗婆提=Đông Phất Bà Đề
利吉迦仙人=Lợi Cát Già Tiên Nhân
食火仙人=Thực Hỏa Tiên Nhân
众友仙人=Chúng Hữu Tiên Nhân
伽亭=Già Đình
拘湿伽=Câu Thấp Già
俱卢之野=Câu Lư Chi Dã
布湿波迦=Bùshī bōjiā
恰雅=Qià yǎ
伽奢南达=Già Xa Nam Đà
昔弥女神=Tích Di Nữ Thần
杂林苑=Tạp Lâm Uyển
星辰母=Mẹ của Các Vì Sao
永劫回归=Vĩnh Kiếp Quy Hồi
青天=Thanh Thiên
伽陀神杵=Gada Thần Xử
戳眼者=Người Chọc Mắt
班达阿修罗=Ban Đạt A Tu La
死神套索=Dây thòng lọng Thần Chết
吠陀女神=Nữ thần Veda
仙人们=Các vị Tiên
苦行者=Khổ hạnh giả
苏摩酒=rượu Soma
日轮=Nhật Luân
曼陀罗山脉=Dãy núi Mandara
商波尊=Shambhu
西瞿陀尼=West Godhaniya
陀罗迦阿修罗=Tu La Đà La Ca
西方水域=Thủy Vực Phương Tây
万相=Vạn Tướng
商吉婆尼之咒=Thương Cát Bà Ni Chi Chú
萨奇帕提=Tát Kỳ Mạt Đề
业果神娑尼=Nghiệp Quả Thần Sa Ni
阿修罗女舍脂=A Tu La Nữ Xá Chi
耶瑟陀女神=Gia Sắt Đà Nữ Thần
匠神=Tượng Thần
计都=Ketu
罗睺星=Sao La Hầu
计都星=Sao Kế Đô
阿拉克什米=A Lạp Khắc Thập Mễ
提婆希那=Đề Bà Hi Na
提迭希那=Đề Điệt Hi Na
跋录吉=Bạt Lục Cát
迦罗=Kala
商吉婆尼=Sanjivani
三首万相=Tam Thủ Vạn Tướng
毗首羯磨之妻=Tỳ Thủ Yết Ma Chi Thê
迦频奢罗鸟=Ca Tần Xa La Điểu
迦陵频迦鸟=Ca Lăng Tần Già Điểu
恶鬼迦娜=Ác Quỷ Ca Na
神马高耳=Thần Mã Cao Nhĩ
青颈之主=青颈之主 - Chúa tể cổ xanh
第511章=Chương 511
万相仙人=Vạn Tướng Tiên Nhân
吉祥之音=Âm thanh cát tường
黄金之城=Thành phố vàng
摩西妮=Mohini
莲花落=Liên Hoa Lạc
罗摩衍那=Luómóyǎnà
焚烬=Phần Tẫn
比那迦=Pinaka
伐兰妮=Phạt Lan Ni
礼赞仁慈的天帝=Ca ngợi Thiên Đế nhân từ
礼赞持金刚杵者=Ca ngợi người giữ Kim Cang Chử
大地女神=Đại Địa Nữ Thần
智人=Trí Nhân
达玛鲁鼓=Đạt Ma Lỗ Cổ
大地女神昔弥=Đại Địa Nữ Thần Tích Di
三叉戟=Tam Xoa Kích
火星=Hỏa Tinh
曜星=Diệu Tinh
伽奢南=Già Xa Nam
檀奴克=Đàn Nô Khắc
檀奴迦=Đàn Nô Già
永童仙人=Yong Tong Xianren
古昔仙人=Gu Xi Xianren
有喜仙人=You Xi Xianren
常在仙人=Chang Zai Xianren
乔斯图跋宝石=Jewel Kaustubha
喜天仙人=Hỷ Thiên Tiên Nhân
克劳恰=Khắc Lao Xa
金星之神=Kim Tinh Chi Thần
摩羯罗=Makara
毗那夜迦=Vinayaka
乾达摩陀那山=Càn Đạt Ma Đà Na Sơn
鬈发城=Quyền Phát Thành
如意神牛=Như Ý Thần Ngưu
月神苏摩=Nguyệt Thần Soma
辛杜拉=Tân Đỗ La
陀提遮=Đà Đề Già
瞻巴拉=Chiêm Ba Lạp
陀提遮仙人=Đà Đề Già Tiên Nhân
十首罗刹=Thập Thủ La Sát
陀娑羯里婆=Đà Sa Yết Lí Bà
奢耶=Jaya
毗奢耶=Vijaya
重名者钵利=Trùng Danh Giả Bát Lợi
爱罗婆罗=Ái La Bà La
金刚=Kim Cang
北俱卢=Bắc Câu Lô
怛特罗=Đát Đặc La
摩伽婆=Ma Già Bà
杜浑陀=Đỗ Hỗn Đà
牛节=Ngưu Tiết
雪山=Tuyết Sơn
底提耶=Ditiye
达刹=Daksha
檀奴=Danu
鸠摩罗=Kumara
南阎浮提=Nam Diêm-phù-đề
第564章=Chương 564
安陀迦那=An Đà Ca Na
昌德=Chanda
蒙德=Munda
天神=Thiên Thần
索兰达=Solanda
星目阿修罗=Tinh Mục A Tu La
宇智波=Uchiha
龟仙人=Quy Tiên Nhân
穆湿伽=Mushika
檀那婆=Đàn Na Bà
烟目阿修罗=Yên Mục A Tu La
牛节王=Ngưu Tiết Vương
神光棒=Thần Quang Bổng
烟目=Yên Mục
乔斯图跋=Jostubha
萨罗摩=Tát La Ma
尼迦斯=Ni Ca Tư
陀兰那=Đà Lan Na
广袤神=Quảng Mậu Thần
地母昔弥=Địa Mẫu Tích Di
不死苏摩=Bất Tử Tô Ma
方位者=Phương vị Giả
卢茜尼=Lư Tây Ni
跋兰妮=Bạt Lan Ni
阿娑妮=A Sa Ni
摩梨伽尸罗=Ma Lê Già Thi La
阿婆罗=A Bà La
神光神波罗跋娑=Thần Quang Thần Ba La Bạt Ta
摩羯=Ma Yết
吠琉璃=Phệ Lưu Li
罗毗=La Tỳ
巴湿伽罗=Ba Thấp Già La
尼婆多迦婆遮=Ni Bà Đa Già Bà Che
头提头颅者=Đầu Đề Đầu Lư Giả
昔弥天=Tích Di Thiên
苏摩天=Tô Ma Thiên
阎摩天=Diêm Ma Thiên
阿耆尼天=A Kỳ Ni Thiên
伐由天=Phạt Do Thiên
苏利耶天=Tô Lợi Da Thiên
伐楼那天=Phạt Lâu Na Thiên
双马童天=Song Mã Đồng Thiên
广袤阿迦奢天=Quảng Mậu A Già Xa Thiên
摩伽罗之剑=Ma Già La Chi Kiếm
雄贤=Hùng Hiền
被缚者=Người bị trói
帕媚陀拉妮=Patumtara
广袤神阿迦奢=Quảng Mậu Thần A-ca-xá
跋伽=Bạt Già
阎蜜=Diêm Mật
摩根德耶=Ma Căn Đức Gia
普鲁沙=Phổ Lỗ Sa
伽旃延那=Già Chiên Diên Na
伽旃延妮=Già Chiên Diên Ni
底提=Đế Đề
由旬=Do Tuần
千眼的大神=Vị thần ngàn mắt
雪山神女帕尔瓦蒂=Nữ thần Tuyết Sơn Parvati
迦旃延那=Katyayana
大地=Đại Địa
五指山=Ngũ Chỉ Sơn
孔雀=Khổng Tước
花尾=Hoa Vĩ
诃耶羯里婆=Ha Da Yết Lí Bà
石像=Tượng đá
阿修罗王=A Tu La Vương
那牟质=Na Mâu Chất
马首=Mã Thủ
婆毗文=Bà Tỳ Văn
迦旃延妮=Ca Chiên Diên Ni
曼陀罗花=Hoa Mạn Đà La
九曜星=Cửu Diệu Tinh
摩图=Ma Đồ
盖达跋=Cái Đạt Bạt
马首阿修罗=Mã Thủ A Tu La
壳生女神=Xác Sinh Nữ Thần
摩诃因陀罗=Ma Ha Nhân Đà La
摩厘耶梵山=Ma Lị Gia Phạn Sơn
大迦那主=Đại Ca Na Chủ
迦叶波仙人=Ca Diếp Ba Tiên Nhân
上主=Thượng Chủ
第593章=Chương 593
灭世班达=Diệt Thế Ban Đà
黑天=Hắc Thiên
摩诃迦梨=Ma Ha Ca Lỵ
解脱者=Giải Thoát Giả
摩诃班达=Ma Ha Ban Đà
二分时代=Nhị Phân Thời Đại
斗争时代=Đấu Tranh Thời Đại
迦梨时代=Ca Lỵ Thời Đại
金刚菩提子=Kim Cương Bồ Đề Tử
崩德罗迦=Paundraka
伽罗=Kala
车底国=Nước Chedi
天女=Thiên Nữ
金星=Kim Tinh
阿摩迦之矛=A Ma Già Chi Mâu
维摩那斯=Duy Ma Na Tư
菩提叶=Bồ Đề Diệp
尼奢陀=Nishaadha
毗德尔跋=Vidarbha
达摩衍蒂=Damayanti
毗毗陀迦树=cây Vibhitaka
讫利多=Krita
特雷达=Treta
德伐波罗=Dvapara
异界毗首羯磨=Dị Giới Tỳ Thủ Yết Ma
异界伐楼那=Dị Giới Phạt Lâu Na
麻鹬山=Ma Úc Sơn
异界因陀罗=Dị Giới Nhân Đà La
异界苏利耶=Dị Giới Tô Lợi Gia
异界阿耆尼=Dị Giới A Kỳ Ni
异界伐由=Dị Giới Phạt Do
室利因陀罗=Thất Lợi Nhân Đà La
大力罗摩=Đại Lực La Ma
甘陀利=Cam Đà Lợi
缚罪者=Phược Tội Giả
摩耶城=Ma Da Thành
阿迪湿婆=A Địch Thấp婆
阿迪瑜吉=A Địch Du Già
因陀罗耆特=Nhân Đà La Kỳ Đặc
奎师那=Khuê Sư Na
吠陀经=Phệ Đà Kinh
暴躁苏利耶=Bạo Táo Tô Lợi Gia
大梵天=Đại Phạm Thiên
香醉山=Hương Túy Sơn
神矛阿摩迦=Thần Mâu A Ma Già
达湿罗=Đạt Thấp La
钵底=Bát Để
光辉之城=Quang Huy Chi Thành
世尊梵天=Thế Tôn Phạm Thiên
暴躁因陀罗=Bạo Táo Nhân Đà La
娑底耶=Ta Để Gia
毗波制底=Tỳ Ba Chế Để
世尊大梵天=Thế Tôn Đại Phạm Thiên
九龙=Cửu Long
乌格罗坦瓦=Ugrotanva
古鲁达=Guruda
孙尼塔=Sunita
乌格罗迦=Ugroka
巴利=Bali
帕罗格=Paroga
因陀罗尼耶=Indraniye
明度贝=Mindobe
萨蒂=Sati
三相神=Trimurti
补卢罗婆娑=Bổ Lư La Bà Sa
洪呼王=Hồng Hô Vương
伊拉=Y Lạp
浑陀=Hỗn Đà
恶鬼=Ác Quỷ
迦那=Già Na
娑罗尼尤=Salarinju
弗栗多=Vritra
吠陀=Veda
上主梵天=Thượng Chủ Phạm Thiên
乌辫若旋釜，恒河溅玉飞！=Ô biện nhược toàn phủ, Hằng hà tiên ngọc phi!
虬藤翻潦浪，灿然额前辉！=Cù đằng phiên lạo lãng, Sán nhiên ngạch tiền huy!
敝衣仙人=Tệ Y Tiên Nhân
阿底利仙人=Atri tiên nhân
罗睺计都=Rahu Ketu
贪欲阿修罗=Tham Dục A-tu-la
情欲阿修罗=Tình Dục A-tu-la
安奢那=Anjana
吉什金陀=Kishkindha
阿迦沙耶=Akasha
苏羯里婆=Sugriva
阿闼婆吠陀=Atharvaveda
孙悟空=Tôn Ngộ Không
菩提老祖=Bồ Đề Lão Tổ
那罗陀仙人=Narada Tiên nhân
那吒俱伐罗=Na Tra Câu Phạt La
曼度陀里=Mạn Độ Đà Lí
顶礼那罗延=Đỉnh Lễ Na La Diên
辩才天女=Biện Tài Thiên Nữ
风神=Thần Gió
财神俱毗罗=Thần Tài Kubera
跋陀罗=Bhadra
苇轭=Veeyoga
宝贤=Ratnagarbha
老师=Lão sư
小象神伽内什=Thần Voi Ganesha
正法之网=Lưới Chánh Pháp
罗刹之王罗波那=La Sát Vương Ravana
天界警备队=Thiên Giới Cảnh Bị Đội
狮面阿修罗=Sư Diện A Tu La
楞伽城=Lăng Già Thành
维毗沙那=Vibhishana
吉吉迦=Kikasa
溺爱阿修罗=Nịch Ái A Tu La
比那迦神弓=Pinaka
神牛南笛=Nandi
亚穆纳河=Yamuna
阿修罗蒙达苏尔=A Tu La Mông Đạt Tô Nhĩ
转轮圣王=Chuyển Luân Thánh Vương
时夜=Thời Dạ
人界=Nhân Giới
猴国=Hầu Quốc
月魇=Nguyệt Yểm
阿摩迦=A Ma Già
楞伽=Lăng Già
曼罗迦=Manasa
波陀罗=Patala
阿修罗阿鲁纳=A Tu La Aruna
陀罗迦=Draka
摩耶幻力=Maya Ảo Lực
白马=Bạch Mã
那罗陀=Narada
迦德卢=Kadru
蛇王婆苏吉=Xà Vương Vasuki
蛇女曼罗迦=Xà Nữ Mạn La Già
阿鲁纳=A Lỗ Nạp
爱罗婆多=Ái La Bà Đa
狮面=Sư Diện
阿利耶迦=A Lợi Da Ca
吉古罗=Cát Cổ La
毗娜达=Tỳ Na Đạt
德髻=Đức Kế
蛇界=Xà Giới
吉祥女神=Cát Tường Nữ Thần
拉克什米女神=Lakshmi
雪山神女=Tuyết Sơn Thần Nữ
金床=Kim Sàng
婆苏吉=Vasuki
妙颜=Diệu Nhan
诃利阿修罗=Hà Lợi A Tu La
苏维妮=Suvini
三摩地=Tam Ma Địa
莲目=Liên Mục
星目=Tinh Mục
电环=Điện Hoàn
金刚身=Kim Cang Thân
檀那婆王=Đàn Na Bà Vương
普罗曼=Phổ La Mạn
妙见=Diệu Kiến
苏羯罗仙人=Tiên nhân Sukra
诃利=Hari
摩多梨=Matali
太阳神苏利耶=Thần Mặt Trời Surya
毗湿摩=Bhishma
那罗迦=Na La Ca
舍脂=Xá Chi
苏摩耶=Tô Ma Gia
迦叶波=Ca Diếp Ba
勇莲=Dũng Liên
狮头=Sư Đầu
象面=Tượng Diện
羊面=Dương Diện
尼孙跋=Ni Tôn Bạt
罗刹十首=La Sát Thập Thủ
南阎浮提洲=Nam Diêm Phù Đề Châu
东弗婆提洲=Đông Phất Bà Đề Châu
东光国=Đông Quang Quốc
蛇女=Xà Nữ
阿迦奢=A Già Xa
波罗跋娑=Ba La Bạt Sa
阿底提=A Để Đề
如意神树=Như Ý Thần Thụ
乌玛=Uma
阿底=Adi
班达=Ban Đạt
蒙达苏尔=Mông Đạt Tô Nhĩ
卡玛苏尔=Tạp Mã Tô Nhĩ
詹巴拉=Chiêm Ba Lạp
娑尼=Sa Ni
祭主=Tế Chủ
神光=Thần Quang
广袤=Quảng Mậu
迦利=Già Lợi
火星曼迦勒=Hỏa Tinh Mạn Già Lặc
战神迦希吉夜=Chiến Thần Già Hi Cát Dạ
除障者伽内什=Trừ Chướng Giả Già Nội Thập
卢西檀=Lư Tây Đàn
伽罗尼弥=Già La Ni Di
金目=Kim Mục
曼迦勒=Mạn Già Lặc
天日=Thiên Nhật
铁首=Thiết Thủ
毗罗=Tỳ La
摩鲁特=Marut
摩伽罗=Makara
美发=Mỹ Phát
难胜=Nan Thắng
独目=Độc Mục
迦娄陀=Ca Lâu Đà
毗羚陀=Tỳ Lăng Đà
阿修罗神殿=A Tu La Thần Điện
白象之王=Bạch Tượng Chi Vương
娜迦之王=Na Già Chi Vương
乳海=Nhũ Hải
拉克什米=Lakshmi
舍沙=Shesha
钵罗诃罗陀=Bát La Ha La Đà
高耳=Cao Nhĩ
月神=Nguyệt Thần
水星神=Thủy Tinh Thần
万寿王=Vạn Thọ Vương
持金刚杵者=Trì Kim Cương Chử Giả
尘云=Trần Vân
黑面=Hắc Diện
毗首羯磨=Tỳ Thủ Yết Ma
阿格尼亚=Agniya
阿鲁诺=Aruna
布陀=Budha
伊罗=Ila
哈姆萨=Hamsa
持斧罗摩=Trì Phủ La Ma
迦玛帕拉=Già Ma Mạt Lạp
迪利波=Địch Lợi Ba
蚁蛭=Nghĩ Điệt
蚁蛭仙人=Nghĩ Điệt Tiên Nhân
甘蔗族=Cam Giá Tộc
血种=Huyết Chủng
天界=Thiên Giới
杜尔迦玛=Đỗ Nhĩ Già Ma
毗婆罗吉提=Tỳ Bà La Cát Đề
辛希嘉=Tân Hi Gia
三连城=Tam Liên Thành
罗刹之王=La Sát Chi Vương
苏陀罗界=Tô Đà La Giới
苏陀罗之王=Tô Đà La Chi Vương
天帝=Thiên Đế
十首=Thập Thủ
波陀罗界=Ba Đà La Giới
十首罗波那=Thập Thủ La Bà Na
钵利王=Bát Lợi Vương
孙跋阿修罗=Tôn Bạt A-tu-la
特里库=Đặc Lí Khố
时夜女神=Thời Dạ Nữ Thần
丹巴=Đan Ba
钵那阿修罗=Bát Na A Tu La
水神伐楼那=Thủy Thần Phạt Lâu Na
月魇之刀=Nguyệt Yểm Chi Đao
钵利=Bát Lợi
苏摩=Tô Ma
维纳琴=Đàn Vina
血城=Huyết Thành
苏陀罗之界=Tô Đà La Chi Giới
毗卢遮那=Tỳ Lô Già Na
阿迦=A Già
十车=Thập Xa
优多摩仙人=Ưu Đa Ma Tiên Nhân
安伽=An Già
天帝因陀罗=Thiên Đế Nhân Đà La
罗睺=La Hầu
劫末之火=Kiếp Mạt Chi Hỏa
乾达婆=Càn-thát-bà
钵那=Bát-Na
床界山=Sàng Giới Sơn
哈奴曼耆特=Hanuman
康巴哈那=Kumbhakarna
弥提罗国=Mithila
遮那迦=Janaka
梵天界=Phạm Thiên Giới
苏陀罗=Sutala
波陀罗之界=Patala Giới
弥迦那陀=Mê Già Na Đà
诃拉诃拉之毒=Độc Hala Hala
梵力=Phạm Lực
毗娜迦神弓=Cung thần Pinaka
俱毗罗=Câu Tỳ La
毗尸罗婆=Tỳ Thi La Bà
阿迦提耶=A Ca Đề Da
妙项=Diệu Hạng
迦楼罗=Già Lâu La
优多摩=Ưu Đa Ma
十车王=Dasharatha
婆罗多=Bharata
设阇卢祇那=Shatrughna
无忧妙=Vô Ưu Diệu
匠神毗首羯磨=Vishwakarma
太阳神甲=Thái Dương Thần Giáp
善心之甲=Thiện Tâm Chi Giáp
摩耶迷宫=Ma Da Mê Cung
补罗私底耶=Bổ La Tư Để Da
罗延=La Duyên
里拉=Lila
友邻=Hữu Lân
阿逾陀国=A Du Đà Quốc
千眼=Thiên Nhãn
罗怙=La Hộ
萨克蒂=Sakti
阿逾陀城池=Thành A Du Đà
友邻王=Hữu Lân Vương
四大部洲=Tứ Đại Bộ Châu
诃拉诃拉=Halahala
彩虹桥=Cầu vồng
投山仙人=Đầu Sơn Tiên Nhân
阎摩城=Diêm Ma Thành
雪山王=Tuyết Sơn Vương
毗娜迦=Pinaka
梵天之颅=Sọ Phạm Thiên
骄生=Kiêu Sinh
东杜毗=Đông Đỗ Tì
曼陀罗山=Mạn Đà La Sơn
波林=Ba Lâm
时轮=thời luân
那罗=Nara
妙见神轮=Diệu Kiến Thần Luân
骄生阿修罗=Kiêu Sinh A Tu La
哈奴曼=Hanuman
娑罗树=cây Sa La
曼陀罗=Mạn Đà La
阿逾陀=Ayodhya
迦尔纳=Karna
孙跋=Tôn Bạt
三界=Tam Giới
地界=Địa Giới
达尔蒂=Đạt Nhĩ Đế
达尔蒂·玛塔=Đạt Nhĩ Đế · Mã Tháp
罗什曼那=La Thập Mạn Na
创界山=Sáng Giới Sơn
摩罗=Ma La
毗娜迦之弓=Cung Pinaka
金刚杵=Kim Cang Chử
三十三天=Tam Thập Tam Thiên
风神伐由=Phong Thần Phạt Do
火神阿耆尼=Hỏa Thần A Kỳ Ni
梵颅=Phạn Lô
娑罗室伐底=Sarasvati
摩奴=Manu
摩磋=Matsya
阿修罗=Asura
血种阿修罗=Asura Huyết Chủng
娑罗室伐底女神=Nữ thần Sarasvati
迦梨女神=Nữ thần Kali
悉多梵=Sita Phạm
大天=Đại Thiên
迦希吉夜=Kashyapa
水持=Svadhisthana
安陀迦=Andhaka
梨俱吠陀=Rigveda
娑摩吠陀=Samaveda
夜柔吠陀=Yajurveda
阿达婆吠陀=Atharvaveda
林迦=Linga
摩西沙=Moshisha
兰巴=Lamba
摩喜施末底=Mahishmati
穆俱昆陀=Mukunda
商波罗=Shambala
娜迦=Naga
毗贡吒=Vaikuntha
苏羯罗=Sukra
文底耶山=Vindhya
昔弥=Tích Di
摩耶=Maya
罗刹=La sát
药叉=Dược Xoa
恒河=Hằng Hà
那罗延=Narayana
罗波那=La Bà Na
摩耶阿修罗=Ma Gia A Tu La
三十三天神力=Tam Thập Tam Thiên Thần Lực
萨克蒂之力=Tát Khắc Đế Chi Lực
伐由之力=Phạt Do Chi Lực
伐楼那之力=Phạt Lâu Na Chi Lực
毗湿奴之力=Tỳ Thấp Nô Chi Lực
阿耆尼之影=A Kỳ Ni Chi Ảnh
娑罗室伐底女神之力=Ta Bà Thất Phạt Để Nữ Thần Chi Lực
湿婆神力=Thấp Bà Thần Lực
迦摩=Ca Ma
耶瑟陀=Gia Sắt Đà
阿迦奢之力=A Già Xá Chi Lực
阎摩=Diêm Ma
双马童=Song Mã Đồng
因陀罗=Nhân Đà La
梵天=Phạm Thiên
异界梵天=Phạm Thiên Dị Giới
摩耶之光=Ma Da Chi Quang
毗湿奴=Tỳ Thấp Nô
异界毗湿奴=Tỳ Thấp Nô Dị Giới
苏利耶=Tô Lợi Gia
伐由=Phạt Do
阿耆尼=A Kỳ Ni
伐楼那=Phạt Lâu Na
迦梨=Già Lê
罗摩=La Ma
悉多=Tất Đa
帕尔瓦蒂=Ba Lạp Ngõa Đề
吉罗娑=Cát La Sa
湿婆=Thấp Bà
南笛=Nam Địch
伽内什=Già Nội Thập
