丁修远=Đinh Tu Viễn
丁弘=Đinh Hoằng
丁彦=Đinh Ngạn
万岁=Vạn tuế
万贺县=Vạn Hạ Huyện
三江口=Tam Giang Khẩu
三英坊=Tam Anh Phường
东城=Đông Thành
东宫=Đông Cung
东山府=Đông Sơn Phủ
丹陛=Đan Bệ
乌纱翼善冠=Ô Sa Dực Thiện Quan
乾安宫=Càn An Cung
乾安殿=Điện Càn An
了凡=Liễu Phàm
了尘=Liễu Trần
二柳坊=Nhị Liễu Phường
云六=Vân Lục
云唐山=Vân Đường Sơn
五台山=Ngũ Đài Sơn
京城=Kinh thành
京畿=Kinh Kỳ
京畿郡=Kinh Kỳ Quận
何四道=Hà Tứ Đạo
何大人=Hà đại nhân
何大明=Hà Đại Minh
何家=Hà gia
何家庄=Hà Gia Trang
何小旗=Hà Tiểu Kỳ
何府=Hà Phủ
何文林=Hà Văn Lâm
何正阳=Hà Chính Dương
何鸿贤=Hà Hồng Hiền
侍卫司=Thị Vệ Ty
侯元亮=Hầu Nguyên Lượng
侯家=Hầu Gia
侯府=Hầu phủ
侯蕴合=Hầu Uẩn Hợp
侯诗筠=Hầu Thi Quân
俞昌会=Du Xương Hội
候知府=Hầu Tri phủ
允儿=Duẫn Nhi
元县=Nguyên huyện
元平侯夫人=Nguyên Bình Hầu Phu Nhân
元平侯府=Nguyên Bình Hầu phủ
元阳=Nguyên Dương
元阳北城=Nguyên Dương Bắc Thành
元阳卫=Nguyên Dương Vệ
元阳吴家=Ngô Gia Nguyên Dương
元阳城=Nguyên Dương Thành
元阳府=Nguyên Dương Phủ
元阳府城=Nguyên Dương phủ thành
元阳府衙=Nguyên Dương phủ nha
元阳王宫=Nguyên Dương Vương cung
元阳知府=Nguyên Dương Tri Phủ
元阳码头=Bến tàu Nguyên Dương
公正所=Công Chính Sở
公羊坊=Công Dương phường
兰儿=Lan Nhi
兰台坊=Lan Đài Phường
关和泰=Quan Hòa Thái
关长史=Quan Trưởng Sử
兴盛坊=Hưng Thịnh Phường
兴远县城=Huyện Thành Hưng Viễn
兴远王=Hưng Viễn Vương
兴远王府=Hưng Viễn Vương Phủ
兵马司=Binh Mã Tư
典簿所=Điển Bộ Sở
冯方=Phùng Phương
凤辇=Phượng liễn
刑部=Hình Bộ
刘二狗=Lưu Nhị Cẩu
刘元合=Lưu Nguyên Hợp
刘元和=Lưu Nguyên Hòa
刘公公=Lưu công công
刘宝=Lưu Bảo
刘小旗=Lưu Tiểu Kỳ
刘山=Lưu Sơn
刘德=Lưu Đức
刘思福=Lưu Tư Phúc
刘恩福=Lưu Ân Phúc
刘成俊=Lưu Thành Tuấn
刘景辉=Lưu Cảnh Huy
刘正=Lưu Chính
刘氏=Lưu thị
北地郡=Bắc Địa Quận
北城=Bắc Thành
北城侯府=Hầu phủ Bắc Thành
北城安和门=Bắc Thành An Hòa Môn
南北二城门=Nam Bắc Nhị Thành môn
南城=Nam Thành
南阳郡=Nam Dương Quận
卧龙寺=Ngọa Long Tự
卫所=Vệ sở
原山府=Nguyên Sơn Phủ
古秦国=Cổ Tần Quốc
台山府=Đài Sơn phủ
吉祥客栈=Khách điếm Cát Tường
吕后=Lã Hậu
听风阁=Thính Phong Các
吴丁元=Ngô Đinh Nguyên
吴三=Ngô Tam
吴允升=Ngô Duẫn Thăng
吴允合=Ngô Duẫn Hợp
吴刘氏=Ngô Lưu Thị
吴大壮=Ngô Đại Tráng
吴夫人=Ngô phu nhân
吴宏=Ngô Hoành
吴家=Ngô Gia
吴家堡=Ngô Gia Bảo
吴府=Ngô phủ
吴忠=Ngô Trung
吴老三=Ngô Lão Tam
吴老六=Ngô Lão Lục
周关=Chu Quan
周成=Chu Thành
周承平=Chu Thừa Bình
周振=Chu Chấn
周遭=Chu Tao
周长史=Chu Trưởng Sử
咸福宫=Hàm Phúc Cung
喜胜坊=Hỉ Thắng Phường
国舅爷=Quốc cữu gia
城德=Thành Đức
城德县=Thành Đức huyện
大奎=Đại Khuê
大山=Đại Sơn
大市坊=Đại Thị Phường
大晋=Đại Tấn
大晋太宗=Đại Tấn Thái Tông
大晋太宗皇帝=Đại Tấn Thái Tông hoàng đế
大晋朝廷=Đại Tấn triều đình
大晋王朝=Đại Tấn vương triều
大柱=Đại Trụ
大河=Đại Hà
大理寺=Đại Lý Tự
大贵=Đại Quý
大运河=Đại Vận Hà
大雄宝殿=Đại Hùng Bảo Điện
天帝=Thiên Đế
天帝神庭=Thiên Đế Thần Đình
天金府=Thiên Kim phủ
天马堡=Thiên Mã bảo
天马寨=Thiên Mã Trại
天马山=Thiên Mã Sơn
太子=Thái Tử
太子妃=Thái tử phi
太子赵延隽=Thái Tử Triệu Diên Tuấn
太安=Thái An
太安二十四年=Thái An năm thứ hai mươi tư
太安帝=Thái An Đế
太安皇帝=Thái An Hoàng đế
太宗=Thái Tông
太宗皇帝=Thái Tông Hoàng Đế
太平盛世=Thái Bình Thịnh Thế
太清观=Thái Thanh Quan
太皇太后=Thái Hoàng Thái Hậu
太祖=Thái Tổ
奉先殿=Phụng Tiên Điện
奉天承运皇帝=Phụng Thiên Thừa Vận Hoàng Đế
奉天门=Phụng Thiên Môn
妙音=Diệu Âm
孝宗皇帝=Hiếu Tông Hoàng Đế
孟海=Mạnh Hải
安东县城=An Đông Huyện Thành
安和门=An Hòa Môn
安坪县=An Bình Huyện
安广坊=An Quảng Phường
安王=An Vương
安都=An Đô
安都县=An Đô huyện
安都县城=An Đô huyện thành
宗正府=Tông Chính Phủ
小三子=Tiểu Tam Tử
小岩=Tiểu Nham
小张公公=Tiểu Trương công công
居士院=Cư Sĩ Viện
山南郡=Sơn Nam Quận
崇政殿=Sùng Chính Điện
崔兴安=Thôi Hưng An
崔副千户=Thôi Phó Thiên Hộ
崔千户=Thôi thiên hộ
巡抚衙门=Tuần phủ Nha Môn
工正所=Công Chính Sở
巾帽局=Cân Mạo Cục
布政使=Bố Chính Sứ
布政使衙门=Bố Chánh sứ nha môn
广阳=Quảng Dương
广阳郡=Quảng Dương quận
库管所=Khố Quản Sở
庞安=Bàng An
廖启光=Liêu Khải Quang
延峰县=Diên Phong huyện
延平卫=Diên Bình Vệ
延平县=Diên Bình huyện
张二升=Trương Nhị Thăng
张二木=Trương Nhị Mộc
张仁礼=Trương Nhân Lễ
张合=Trương Hợp
张君如=Trương Quân Như
张启云=Trương Khải Vân
张吴=Trương Ngô
张吴冯=Trương Ngô Phùng
张大石=Trương Đại Thạch
张子明=Trương Tử Minh
张安=Trương An
张家=Trương gia
张小旗=Trương Tiểu Kỳ
张志奇=Trương Chí Kỳ
张忠=Trương Trung
张总旗=Trương tổng kỳ
张扬=Trương Dương
张明凤=Trương Minh Phượng
张明德=Trương Minh Đức
张林=Trương Lâm
张榜=Trương bảng
张氏=Trương Thị
张猛=Trương Mãnh
张相=Trương Tương
张谢=Trương Tạ
徐三福=Từ Tam Phúc
徐宇=Từ Vũ
徐氏=Từ Thị
徐玉=Từ Ngọc
御史林观海=Ngự sử Lâm Quan Hải
总旗=Tổng Kỳ
恒山=Hằng Sơn
成化门=Thành Hóa Môn
成府=Thành phủ
成文光=Thành Văn Quang
按察使=Án sát sứ
方丈静室=Phương Trượng Tĩnh Thất
方同=Phương Đồng
方胜=Phương Thắng
明玉湖=Minh Ngọc Hồ
明王=Minh Vương
明王殿下=Minh Vương điện hạ
昭明=Chiêu Minh
晋璋=Tấn Chương
景王=Cảnh Vương
曹云辉=Tào Vân Huy
曹嘉勋=Tào Gia Huân
曹嘉盛=Tào Gia Thịnh
曹国舅=Tào Quốc Cữu
朔方=Sóc Phương
朱孝勇=Chu Hiếu Dũng
朱家军=Chu Gia Quân
朱晋璋=Chu Tấn Chương
朱棣=Chu Lệ
朱氏=Chu thị
朱贵=Chu Quý
李一春=Lý Nhất Xuân
李三秋=Lý Tam Thu
李世民=Lý Thế Dân
李二夏=Lý Nhị Hạ
李成安=Lý Thành An
李素欣=Lý Tố Hân
李选侍=Lý Tuyển Thị
杨举人=Dương Cử nhân
杨千=Dương Thiên
杨奇=Dương Kỳ
杨安=Dương An
杨家=Dương gia
杨家庄=Dương Gia Trang
杨家祖宅=Dương Gia Tổ Trạch
杨小旗=Dương Tiểu Kỳ
杨府=Dương phủ
杨德秋=Dương Đức Thu
杨成=Dương Thành
杨氏=Dương Thị
杨贺=Dương Hạ
杨青=Dương Thanh
林全=Lâm Toàn
林大贵=Lâm Đại Quý
林家=Lâm gia
林徐氏=Lâm Từ Thị
林观海=Lâm Quan Hải
林静玉=Lâm Tĩnh Ngọc
枢密使=Xu Mật Sứ
枢密院=Xu Mật Viện
柳家庄=Liễu Gia Trang
校场=Giáo Trường
桂花巷=Nguyệt Quế Hạng
桃花岛=Đào Hoa Đảo
桐昌=Đồng Xương
桐昌县=Đồng Xương Huyện
桐昌县城=Đồng Xương Huyện Thành
正王政钧=Chính Vương Chính Quân
武台山=Võ Đài Sơn
武成=Võ Thành
武皇=Võ Hoàng
段宏=Đoạn Hoành
殿前卫=Điện Tiền Vệ
殿前右卫=Điện Tiền Hữu Vệ
水沟村=Thủy Câu Thôn
永宁巷=Vĩnh Ninh Hạng
永宁门=Vĩnh Ninh Môn
永安殿=Vĩnh An Điện
永安门=Vĩnh An Môn
永定门=Vĩnh Định Môn
永福宫=Vĩnh Phúc Cung
汪成=Uông Thành
河东=Hà Đông
河城=Hà Thành
河城元县=Hà Thành Nguyên huyện
河城县=Hà Thành huyện
河城西安=Hà Thành Tây An
河西=Hà Tây
河西郡=Hà Tây quận
济世斋=Tế Thế Trai
淮阳郡=Hoài Dương Quận
清河郡=Thanh Hà Quận
灞河=Bá Hà
灵素=Linh Tố
牛尚忠=Ngưu Thượng Trung
玉妃=Ngọc Phi
玉娘娘=Ngọc Nương Nương
玉琼苑=Ngọc Quỳnh Uyển
玉竹=Ngọc Trúc
王三=Vương Tam
王东南=Vương Đông Nam
王命=Vương mệnh
王喜良=Vương Hỉ Lương
王妃=Vương phi
王安=Vương An
王宗=Vương Tông
王山=Vương Sơn
王府=Vương phủ
王座=Vương Tọa
王庭鹤=Vương Đình Hạc
王总=Vương Tổng
王扬=Vương Dương
王政均=Vương Chính Quân
王政钧=Vương Chính Quân
王昌信=Vương Xương Tín
王爷=Vương gia
王百户=Vương Bách Hộ
王神医=Vương Thần Y
王贵人=Vương Quý Nhân
王选侍=Vương Tuyển Thị
王钊=Vương Chiêu
王阁老=Vương Các Lão
瑞和坊=Thụy Hòa Phường
田大人=Điền đại nhân
田张谢=Điền Trương Tạ
田景同=Điền Cảnh Đồng
百花厅=Bách Hoa sảnh
皇后=Hoàng hậu
皇太后=Hoàng Thái Hậu
皇子所=Hoàng Tử Sở
皇极殿=Hoàng Cực Điện
石头=Thạch Đầu
礼官=Lễ quan
礼部=Lễ Bộ
秦昊=Tần Hạo
秦王=Tần Vương
秦王府=Tần Vương phủ
程春=Trình Xuân
空远=Không Viễn
端妃=Đoan Phi
端妃娘娘=Đoan phi nương nương
端敬=Đoan Kính
素素=Tố Tố
老吴=Lão Ngô
老徐=Lão Từ
老谢=Lão Tạ
老陈头儿=Lão Trần Đầu
胡大彪=Hồ Đại Bưu
胡家=Hồ Gia
胡家巷=Hồ Gia Hạng
胡家巷子=Hồ Gia hạng tử
胡家粮仓=Kho lương nhà họ Hồ
胡小旗=Hồ Tiểu Kỳ
胡山=Hồ Sơn
胡茂德=Hồ Mậu Đức
臬台=Nhiết Đài
良两山=Lương Lưỡng Sơn
良医正=Lương Y Chính
苏家庄=Tô Gia Trang
苏平川=Tô Bình Xuyên
苏平河=Tô Bình Hà
苏楚云=Tô Sở Vân
蓉妃=Dung Phi
蓉妃娘娘=Dung Phi nương nương
蓉娘娘=Dung nương nương
薛宝筠=Tiết Bảo Quân
藩台=Phiên Đài
藩臬二司=Phiên Nhiết nhị tư
虎大岭=Hổ Đại Lĩnh
蜀郡=Thục Quận
袁广=Viên Quảng
袁海=Viên Hải
西城=Tây Thành
观音院=Quán Âm Viện
觉远=Giác Viễn
许洪=Hứa Hồng
谢孝方=Tạ Hiếu Phương
谢家=Tạ gia
谨身殿=Cẩn Thân điện
谨身门=Cẩn Thân Môn
谭鲁=Đàm Lỗ
贾家三公子=Giả gia tam công tử
赵三刀=Triệu Tam Đao
赵千川=Triệu Thiên Xuyên
赵延=Triệu Diên
赵延垣=Triệu Diên Viên
赵延庆=Triệu Diên Khánh
赵延庭=Triệu Diên Đình
赵延旭=Triệu Diên Húc
赵延昭=Triệu Diên Chiêu
赵延松=Triệu Diên Tùng
赵延洵=Triệu Diên Tuân
赵延熹=Triệu Diên Hi
赵延菘=Triệu Diên Tùng
赵延隽=Triệu Diên Duẫn
赵惟恒=Triệu Duy Hằng
赵惟隆=Triệu Duy Long
赵氏=Triệu thị
赵永铖=Triệu Vĩnh Sấn
赵洵=Triệu Tuân
辑事监=Tập Sự Giám
辽平=Liêu Bình
辽平府=Liêu Bình phủ
郑柱=Trịnh Trụ
都司衙门=Đô Tư nha môn
都察院=Đô Sát Viện
醉仙=Túy Tiên
针工局=Châm Công Cục
钦天监=Khâm Thiên Giám
钱家=Tiền gia
镇西关=Trấn Tây Quan
长史司=Trưởng Sử Tư
长安镇=Trường An Trấn
长定门=Trường Định Môn
长春宫=Trường Xuân Cung
长相=Trường Tương
长福镇=Trường Phúc Trấn
长马坊=Trường Mã Phường
阴神教=Âm Thần Giáo
陆朝文=Lục Triều Văn
陇右=Lũng Hữu
陇右布政使衙门=Lũng Hữu Bố Chính Sử Nha Môn
陇右转运使衙门=Lũng Hữu Chuyển Vận Sứ Nha Môn
陇右郡=Lũng Hữu quận
陇右都司=Lũng Hữu Đô Tư
陇右都指挥使司=Lũng Hữu Đô Chỉ Huy Sứ Ty
陈三=Trần Tam
陈公公=Trần Công Công
陈关=Trần Quan
陈大人=Trần đại nhân
陈大猪=Trần Đại Trư
陈大科=Trần Đại Khoa
陈安明=Trần An Minh
陈家=Trần gia
陈府=Trần phủ
陈扬智=Trần Dương Trí
陈枢密=Trần Khu Mật
陈玉=Trần Ngọc
陈玉和=Trần Ngọc Hòa
陈瑞林=Trần Thụy Lâm
陈皮=Trần Bì
陈翰祉=Trần Hàn Chỉ
陈长河=Trần Trường Hà
陶阳伯=Đào Dương Bá
陶阳伯府=Đào Dương Bá Phủ
雍军=Ung quân
雍王=Ung Vương
雍王府=Ung Vương phủ
雍王殿下=Ung Vương điện hạ
霍安=Hoắc An
青舟=Thanh Chu
靖海=Tĩnh Hải
静东=Tĩnh Đông
静东县=Tĩnh Đông Huyện
静妃=Tĩnh Phi
韵儿=Vận Nhi
飘香楼=Phiêu Hương Lâu
飞扬的大胖子=Phi Dương Đích Đại Bàn Tử
飞雨轩=Phi Vũ Hiên
马保=Mã Bảo
马山=Mã Sơn
马志=Mã Chí
马成=Mã Thành
马氏=Mã Thị
马长安=Mã Trường An
驯兽监=Thuần Thú Giám
高升坊=Cao Thăng Phường
高成安=Cao Thành An
高成昱=Cao Thành Dục
高正安=Cao Chính An
高永发=Cao Vĩnh Phát
黄天眼=Hoàng Thiên Nhãn
黄天衍=Hoàng Thiên Diễn
黄志成=Hoàng Chí Thành
黄忠长=Hoàng Trung Trường
黄蓉蓉=Hoàng Dung Dung
龙潜坊=Long Tiềm Phường
