李家嫂子=Lý gia tẩu tử
张屠夫=Trương Đồ Phu
红云大将军=Hồng Vân Đại Tướng Quân
宋秀才=Tống Tú Tài
大虎=Đại Hổ
二牛=Nhị Ngưu
岳都城=Nhạc Đô Thành
祥瑞谱=Tường Thụy Phổ
闻教友=Văn Giáo Hữu
雄鸡=Hùng Kê
卤猪舌=Lư Trư Thiệt
小三子=Tiểu Tam Tử
经堂大师兄=Kinh Đường đại sư huynh
彭师傅=Bành sư phó
朗婆婆=Lãng bà bà
虎姑婆=Hổ cô bà
江南七县=Giang Nam thất huyện
刘捕快=Lưu bộ khoái
下马盗=Hạ Mã Đạo
郎婆婆=Lang bà bà
蔡知味=Thái Tri Vị
陈师爷=Trần Sư Gia
孙将军=Tôn Tướng Quân
喜娃=Hỉ Oa
大老爷=Đại lão gia
桃红=Đào Hồng
柳翠=Liễu Thúy
金鸡桩=Kim Kê thọc
周老三=Chu Lão Tam
货郎=Người bán hàng rong
书生=Thư sinh
树妖姥姥=Thụ Yêu Lão Lão
倩女幽魂=Thiện Nữ U Hồn
兰若寺=Lan Nhược Tự
燕赤霞=Yến Xích Hà
夏侯剑客=Hạ Hầu Kiếm Khách
郭北县=Quách Bắc Huyện
黑山老妖=Hắc Sơn Lão Yêu
虎大王=Hổ Đại Vương
娴娘=Hiền Nương
老夫人=Lão phu nhân
大公子=Đại công tử
赵员外=Triệu viên ngoại
二公子=Nhị công tử
姜家庄园=Khương Gia trang viên
小云姐=Tiểu Vân tỷ
老秦=Lão Tần
三恶道=Tam Ác Đạo
畜面之法=Súc Diện Chi Pháp
石僧=Thạch Tăng
龙神=Long Thần
姜家=Khương Gia
姜老爷=Khương lão gia
小云=Tiểu Vân
孙氏甜醴=Tôn Thị Điềm Lễ
孙老头=Tôn lão đầu
孙屠夫=Tôn Đồ Phu
李寡妇=Lý Quả Phụ
大汉奇烈=Đại Hán Kỳ Liệt
神火飞鸦=Thần Hỏa Phi Nha
耳报神=Nhĩ Báo Thần
大青=Đại Thanh
戒西=Giới Tây
喜运斋=Hỷ Vận Trai
多宝堂=Đa Bảo Đường
去疾=Khứ Tật
弃病=Khí Bệnh
施药罗汉=Thi Dược La Hán
乔峰=Kiều Phong
虎骨酒=Hổ Cốt Tửu
张三丰=Trương Tam Phong
监院=Giam Viện
袈裟僧=Ca Sa Tăng
红袍僧=Hồng Bào Tăng
灰袍僧=Hôi Bào Tăng
比丘=Tỳ Kheo
风流果二郎=Phong Lưu Quả Nhị Lang
唐家小姐=Đường gia tiểu thư
真业师父=Chân Nghiệp sư phụ
唐夫人=Đường phu nhân
张员外=Trương viên ngoại
真业大师=Chân Nghiệp đại sư
唐小姐=Đường tiểu thư
唐宅=Đường Trạch
首座=Thủ Tọa
梅园=Mai Viên
唐老爷=Đường lão gia
大猴子=Đại Hầu Tử
二猴子=Nhị Hầu Tử
龙子=Long Tử
二龙子=Nhị Long Tử
方正主持=Phương Chính trụ trì
小比丘=Tiểu Tỳ Khưu
秘药工坊=Bí Dược Công Phường
戒念=Giới Niệm
山越=Sơn Việt
毗卢帽=Tỳ Lư Mạo
罗汉鞋=La Hán Hài
三大殿=Tam Đại Điện
妙色王求法偈=Diệu Sắc Vương Cầu Pháp Kệ
昙花一现=Đàm Hoa Nhất Hiện
坛经=Đàn Kinh
心宗=Tâm Tông
金丹=Kim đan
谛听神贝=Đế Thính Thần Bối
千手观音=Thiên Thủ Quan Âm
太上道君=Thái Thượng Đạo Quân
贾队长=Giả đội trưởng
韵达=Vận Đạt
会稽郡城=Hội Kê quận thành
培根=Bacon
黑犬=Hắc Khuyển
透骨浆=Thấu Cốt Tương
红药=Hồng Dược
豆兵=Đậu Binh
炼气丹=Luyện Khí Đan
寂寂还真，呼阖抱阳=Tịch Tịch Hoàn Chân, Hô Hạp Bão Dương
气行则通，气滞则停=Khí Hành Tắc Thông, Khí Trệ Tắc Đình
感之者众，食之者寡=Cảm Chi Giả Chúng, Thực Chi Giả Quả
一气不生，万法无明=Nhất Khí Bất Sinh, Vạn Pháp Vô Minh
蔡伯=Thái Bá
县城=Huyện thành
三瘸子=Tam Què
西域大雪山=Tây Vực Đại Tuyết Sơn
雪斑灵蚕=Tuyết Ban Linh Tằm
盐枭王转轮=Diêm Kiêu Vương Chuyển Luân
游侠奇烈=Du Hiệp Kỳ Liệt
六道=Lục Đạo
杜狂禽=Đỗ Cuồng Cầm
无名怪僧=Vô Danh Quái Tăng
儒圣=Nho Thánh
閻尊者=Diêm tôn giả
紙幻=Chỉ Huyễn
鐵風車=Thiết Phong Xa
纸幻=Chỉ Huyễn
地行者=Địa Hành Giả
玉兔=Ngọc Thỏ
秦岭=Tần Lĩnh
晋陵七县=Tấn Lăng Thất Huyện
摧山客=Tồi Sơn Khách
鬼鸩=Quỷ Trấm
小乙=Tiểu Ất
经堂=Kinh Đường
观音寺=Quan Âm Tự
慧能=Huệ Năng
六组坛经=Lục Tổ Đàn Kinh
神秀=Thần Tú
岭南=Lĩnh Nam
郭德纲=Quách Đức Cương
驴谦=Lư Khiêm
y-u=y-u
县令大老爷=Huyện lệnh đại lão gia
雅诗兰黛=Estée Lauder
粉金坊=Phấn Kim Phường
天山雪莲=Thiên Sơn Tuyết Liên
董大爷=Đổng đại gia
乔东=Kiều Đông
四方=Tứ Phương
虫老头=Trùng lão đầu
至圣先师=Chí Thánh Tiên Sư
李二=Lý Nhị
苦水桥=Khổ Thủy Kiều
张二狗=Trương Nhị Cẩu
牛鬼=Ngưu Quỷ
关家嫂子=Quan gia tẩu tử
富贵家的=Phú Quý gia đích
狗子=Cẩu Tử
观音大士=Quán Âm Đại Sĩ
观音=Quán Âm
送子观音=Tống Tử Quan Âm
张老三=Trương Lão Tam
小宝儿=Tiểu Bảo Nhi
孔子=Khổng Tử
少正卯=Thiếu Chính Mão
郭七=Quách Thất
宋夫子=Tống phu tử
方参将=Phương Tham tướng
孙副将=Tôn phó tướng
陆文生=Lục Văn Sinh
青蚨=Thanh Phù
青蚨母=Thanh Phù Mẫu
百步飞剑=Bách Bộ Phi Kiếm
和老头=Hòa Lão Đầu
汉武帝=Hán Vũ Đế
望月台=Vọng Nguyệt Đài
御使=Ngự Sử
驿站=Dịch Trạm
闵太守=Mẫn thái thú
孙参将=Tham tướng Tôn
萧门甄氏=Tiêu Môn Chân Thị
白沙=Bạch Sa
祁连世家=Kỳ Liên Thế Gia
国朝=Quốc Triều
祁连秀=Kỳ Liên Tú
向御使=Hướng Ngự Sử
虞婆婆=Ngu Bà Bà
蜮婆婆=Vực Bà Bà
祁连县=Kỳ Liên Huyện
崇圣心法=Sùng Thánh Tâm Pháp
斗百毒=Đấu Bách Độc
大金袍=Đại Kim Bào
雄鸡一唱天下白=Hùng Kê Nhất Xướng Thiên Hạ Bạch
掌心雷=Chưởng Tâm Lôi
撒豆成兵=Tát Đậu Thành Binh
战阵=Chiến Trận
飞剑术=Phi Kiếm Thuật
引香寻踪=Dẫn Hương Tầm Tung
纸幻术=Chỉ Huyễn Thuật
御兽术=Ngự Thú Thuật
驱鬼术=Khu Quỷ Thuật
道袍=Đạo bào
郡治=Quận Trị
冠洗=Quan Tẩy
子清=Tử Thanh
山阳学院=Học viện Sơn Dương
清平镇=Trấn Thanh Bình
文入道=Văn Nhập Đạo
赖秀才=Lại Tú Tài
赖夫人=Lại Phu Nhân
庙祝=Miếu Chúc
五通庙=Miếu Ngũ Thông
獬豸令=Giải Trãi lệnh
五通神庙=Miếu Ngũ Thông Thần
琉璃心境=Lưu Ly Tâm Cảnh
收魂袋=Thu Hồn Túi
马妖=Mã Yêu
桃木剑=Đào Mộc Kiếm
玉玦=Ngọc Quyết
异种豆兵=Dị Chủng Đậu Binh
食指大动=Thực Chỉ Đại Động
同光帝=Đồng Quang Đế
皇太后=Hoàng Thái Hậu
渤海郡=Bột Hải quận
清明=Thanh Minh
普洱=Phổ Nhĩ
茶博士=Trà bác sĩ
黄山隐修=Hoàng Sơn ẩn tu
道童百丈=Đạo Đồng Bách Trượng
药师寺=Dược Sư Tự
山东=Sơn Đông
胶东郡=Giao Đông quận
鲁家=Lỗ gia
极西之地=Cực Tây Chi Địa
湘西=Tương Tây
淮南=Hoài Nam
田忌赛马=Điền Kỵ Tái Mã
入京僧团=Nhập Kinh Tăng Đoàn
穆森=Mục Sâm
兰陵=Lan Lăng
杨戬=Dương Tiễn
鲁大汉=Lỗ Đại Hán
梅山=Mai Sơn
綦毋=Cơ Vô
綦毋隐士=Cơ Vô ẩn sĩ
八公山隐士=Ẩn sĩ Bát Công Sơn
罗大汉=La Đại Hán
果二郎=Quả Nhị Lang
黄山道宗=Hoàng Sơn Đạo Tông
常昊=Thường Hạo
飞剑奴=Phi Kiếm Nô
戒嗔=Giới Sân
持正=Trì Chính
川西=Xuyên Tây
松竹道士=Tùng Trúc đạo sĩ
本县=Bản Huyện
嫁衣=Giá Y
裁云=Tài Vân
巴雷特=Ba-ret
县衙=Huyện Nha
县令=Huyện Lệnh
易阳县=Dịch Dương huyện
沐富成=Mộc Phú Thành
沐财主=Mộc tài chủ
郭三=Quách Tam
星石=Tinh Thạch
星蛊=Tinh Cổ
三尾守宫=Tam Vĩ Thủ Cung
斩妖咒=Trảm Yêu Chú
祁连县令=Huyện lệnh Kỳ Liên
茱萸=Thù Du
阿塔=A Tháp
刺星部=Thích Tinh Bộ
阿叔=A Thúc
铜鼎部=Đồng Đỉnh Bộ
马信郎=Mã Tín Lang
灵屋山=Linh Ốc Sơn
三娃子=Tam Oa Tử
牛饮渡=Ngưu Ẩm Độ
张狗娃=Trương Cẩu Oa
赤焰沙=Xích Diễm Sa
火孟尝=Hỏa Mạnh Thường
辟火飞甲=Tích Hỏa Phi Giáp
烈风客=Liệt Phong Khách
奇烈方斗=Kỳ Liệt Phương Đấu
火器精要=Hỏa Khí Tinh Yếu
铁风车=Thiết Phong Xa
丹火雷珠=Đan Hỏa Lôi Châu
火器门=Hỏa Khí Môn
莲花冠=Liên Hoa Quan
太极八卦道袍=Thái Cực Bát Quái Đạo Bào
山鬼符召=Sơn Quỷ Phù Triệu
山神=Sơn Thần
九天雷神=Cửu Thiên Lôi Thần
窦娥=Đậu Nga
孙大圣=Tôn Đại Thánh
天池=Thiên Trì
药辛子=Dược Tân Tử
明珢=Minh Ngân
区青鹤=Khu Thanh Hạc
挂印真人=Quải Ấn Chân Nhân
彩雉=Thải Trĩ
乔叔=Kiều Thúc
黄山松竹道士=Hoàng Sơn Tùng Trúc Đạo Sĩ
南宫山=Nam Cung Sơn
晋南武安山=Tấn Nam Võ An Sơn
狮子山=Sư Tử Sơn
天平山=Thiên Bình Sơn
花岩山=Hoa Nham Sơn
琉璃眼=Lưu Ly Nhãn
吃货=Ngật Hóa
心火朱雀=Tâm Hỏa Chu Tước
坛主=Đàn chủ
鬼哭愁云大阵=Quỷ Khốc Sầu Vân Đại Trận
天王殿罗汉=Thiên Vương Điện La Hán
盛叔=Thịnh Thúc
晋南世家=Tấn Nam Thế Gia
侯六哥=Hầu Lục Ca
天池山=Thiên Trì Sơn
千机盘=Thiên Cơ Bàn
黑云=Hắc Vân
鬼哭愁云=Quỷ Khốc Sầu Vân
北邙=Bắc Mang
五行山=Ngũ Hành Sơn
聚魂幡=Tụ Hồn phan
阎尊者=Diêm Tôn Giả
章老鬼=Chương Lão Quỷ
赤火旗=Xích Hỏa Kỳ
紫气东来旗=Tử Khí Đông Lai Kỳ
金钱旗=Kim Tiền Kỳ
姜家庄=Khương Gia Trang
管头儿=Quản Đầu Nhi
江宁郡=Giang Ninh quận
老刘头=Lão Lưu Đầu
江门廖氏=Giang Môn Liêu Thị
江氏=Giang Thị
江三公子=Giang tam công tử
严思贤=Nghiêm Tư Hiền
向光明=Hướng Quang Minh
江正道=Giang Chính Đạo
江家二少=Giang gia Nhị Thiếu
江三少=Giang Tam Thiếu
江家三少爷=Tam thiếu gia Giang gia
存异道长=Tồn Dị đạo trưởng
中平观=Trung Bình Quan
廖五=Liêu Ngũ
江老爷=Giang Lão gia
肾水玄武=Thận Thủy Huyền Vũ
江家=Giang gia
廖氏=Liêu thị
南火朱雀=Nam Hỏa Chu Tước
青丘狐族=Thanh Khâu Hồ Tộc
六神厌术=Lục Thần Yếm Thuật
章老祖=Chương Lão Tổ
青丘纯狐=Thanh Khâu Thuần Hồ
纯狐=Thuần Hồ
天王寺=Thiên Vương Tự
太常寺=Thái Thường Tự
墨林院=Mặc Lâm Viện
饕餮食客=Thao Thiết Thực Khách
青龙大街=Thanh Long Đại Nhai
白虎大街=Bạch Hổ Đại Nhai
昴宿区=Mão Túc Khu
余老三=Dư Lão Tam
长庚星=Sao Trường Canh
太白星=Sao Thái Bạch
刀公公=Đao công công
工部=Công Bộ
兵部=Binh Bộ
户部=Hộ Bộ
刑部=Hình Bộ
吏部=Lại Bộ
木德=Mộc Đức
临信锦妃=Lâm Tín Cẩm Phi
赶尸道人=Người đuổi xác
太阴炼形=Thái Âm Luyện Hình
飞僵=Phi Cương
镇魔=Trấn Ma
拜神=Bái Thần
五通神=Ngũ Thông Thần
彭踞=Bành Cứ
彭踬=Bành Chí
彭蹻=Bành Kiêu
庚申日=Ngày Canh Thân
祁连=Kỳ Liên
皇宫=Hoàng cung
祭天坛广场=Quảng trường Tế Thiên Đàn
太后=Thái hậu
道士=Đạo sĩ
三尸守神法=Tam Thi Thủ Thần Pháp
睡魔=Thụy Ma
瞌睡虫=Khạp Thụy Trùng
不动如山真明王=Bất Động Như Sơn Chân Minh Vương
道祖=Đạo Tổ
晋地=Tấn Địa
荆地=Kinh Địa
淮地=Hoài Địa
孔九变=Khổng Cửu Biến
神农=Thần Nông
神农陵=Thần Nông Lăng
神农氏=Thần Nông Thị
刑部天牢=Hình Bộ Thiên Lao
獬豸=Giải Trãi
扶天华表=Phù Thiên Hoa Biểu
黄巾力士=Hoàng Cân Lực Sĩ
牵牛星=Sao Ngưu Lang
织女星=Sao Chức Nữ
王母=Vương Mẫu
玄武镇天赐=Huyền Vũ Trấn Thiên Tứ
无量天尊=Vô Lượng Thiên Tôn
道琴=Đạo Cầm
青玖师兄=Thanh Cửu sư huynh
裁缝剑法=Tài Phùng Kiếm Pháp
萧师侄=Tiêu sư điệt
风尘师叔=Phong Trần sư thúc
青词=Thanh từ
海渊法师=Hải Uyên pháp sư
明皋法师=Minh Cao pháp sư
麻衣道人=Ma y đạo nhân
仙娥=Tiên Nga
织女=Chức Nữ
牛郎=Ngưu Lang
青龙脉=Thanh Long Mạch
天堕湖=Thiên Đọa Hồ
西南剑仙=Tây Nam Kiếm Tiên
大叔=Đại thúc
屠龙阵=Đồ Long Trận
镇脉金人=Trấn Mạch kim nhân
大运河=Đại Vận Hà
神行草鞋=Thần Hành thảo hài
火锅郎=Lẩu Lang
过去现在未来无漏佛眼=Quá Khứ Hiện Tại Vị Lai Vô Lậu Phật Nhãn
大衍神算=Đại Diễn Thần Toán
刑天杖=Hình Thiên trượng
剑阁栈道=Kiếm Các Sạn Đạo
酆都鬼城=Phong Đô Quỷ Thành
鬼门关=Quỷ Môn Quan
幽冥鬼界=U Minh Quỷ Giới
大将军=Đại Tướng Quân
墨家=Mặc gia
法家=Pháp gia
邵家主=Thiệu Gia Chủ
禁咒司=Cấm Chú Tư
清江=Thanh Giang
青铜剑=Thanh đồng kiếm
畜生道=Súc Sinh Đạo
鳄灵=Ngạc Linh
鸩灵=Chẩm Linh
五脏庙=Ngũ Tạng Miếu
六神=Lục Thần
钢鞭道士=Cương Tiên Đạo Sĩ
右长老=Hữu Trưởng Lão
阴老鬼=Âm Lão Quỷ
丧老鬼=Tang Lão Quỷ
九阴鬼尊=Cửu Âm Quỷ Tôn
五行大磨盘=Ngũ Hành Đại Ma Bàn
五色=Ngũ Sắc
五音=Ngũ Âm
五行天堕=Ngũ Hành Thiên Đọa
正反磨盘卸劫大阵=Chính Phản Ma Bàn Tá Hiếp Đại Trận
明觉道长=Minh Giác đạo trưởng
三大夜叉=Tam Đại Dạ Xoa
地形夜叉=Địa Hình Dạ Xoa
水行夜叉=Thủy Hành Dạ Xoa
六目四臂=Lục Mục Tứ Tý
郎七=Lang Thất
药王殿=Dược Vương Điện
明彦=Minh Ngạn
北邙山=Bắc Mang Sơn
荼老祖=Đồ Lão Tổ
紫府神雷=Tử Phủ Thần Lôi
大五行流转秘录=Đại Ngũ Hành Lưu Chuyển Bí Lục
紫府五行六神秘炼正篇=Tử Phủ Ngũ Hành Lục Thần Bí Luyện Chính Thiên
五行内炼=Ngũ Hành Nội Luyện
炼宝决=Luyện Bảo Quyết
分光化影禁制=Phân Quang Hóa Ảnh Cấm Chế
苗疆刺星部=Miêu Cương Thích Tinh Bộ
七星索命=Thất Tinh Tác Mệnh
鲁迭尔=Lỗ Điệt Nhĩ
导师=Đạo sư
松竹老道士=Tùng Trúc lão đạo sĩ
八公山=Bát Công Sơn
綦毋坐忘=Cơ Vô Tọa Vong
山中教院=Sơn Trung Giáo Viện
掌教老爷=Chưởng giáo lão gia
周天一炁还章=Chu Thiên Nhất Khí Hoàn Chương
食气法=Thực Khí Pháp
云符小挪移=Vân Phù Tiểu Na Di
周天遁法=Chu Thiên Độn Pháp
云雾腾飞术=Vân Vụ Đằng Phi Thuật
五行遁术=Ngũ Hành Độn Thuật
鸟篆云符周天转轮诀=Điểu Triện Vân Phù Chu Thiên Chuyển Luân Quyết
罗汉汀=La Hán Đinh
紫府正篇=Tử Phủ Chính Thiên
白鹿=Bạch Lộc
青檀=Thanh Đàn
杨桃藤=Dương Đào Đằng
孙大掌柜=Tôn đại chưởng quỹ
乌巢林=Ô Sào Lâm
朱雀神=Chu Tước Thần
孙二掌柜=Tôn Nhị chưởng quầy
桃花瘴气=Đào Hoa chướng khí
胡僧=Hồ Tăng
桃胶=Đào giao
善佑=Thiện Hữu
善佑老道士=Thiện Hữu lão đạo sĩ
雷击木林=Lôi Kích Mộc Lâm
黄山道藏=Hoàng Sơn Đạo Tàng
桃符=Đào Phù
真箓=Chân Lục
东南道宗=Đông Nam Đạo Tông
桃山观=Đào Sơn Quán
桃林=Đào Lâm
掌教师兄=Chưởng giáo sư huynh
朱聪=Chu Thông
柳条子街=Liễu Điều Tử Nhai
鹿公子=Lộc công tử
玉钱=Ngọc Tiền
欲乐无极=Dục Lạc Vô Cực
狈掌柜=Bại Chưởng Quỹ
尤叔=Vưu thúc
尤贤弟=Vưu hiền đệ
太守大人=Thái thú đại nhân
招贤令=Chiêu Hiền Lệnh
石心秘术=Thạch Tâm Bí Thuật
井口=Tỉnh Khẩu
三姐=Tam Tỷ
叱咤一炁=Sất Trá Nhất Khí
十八姐=Thập Bát tỷ
十七姐=Thập Thất tỷ
重阳大阵=Trùng Dương đại trận
黄泉=Hoàng Tuyền
桑木弓=Cung Tang Mộc
宝剑=Bảo Kiếm
桑木长枪=Thương Dài Tang Mộc
五木之精=Ngũ Mộc Chi Tinh
桑柳榆桃槐=Tang Liễu Du Đào Hòe
狐妖=Hồ yêu
青丘谣=Thanh Khâu Dao
青丘楼=Thanh Khâu Lâu
狐妖三姐=Hồ Yêu Tam Tỷ
颜无双=Nhan Vô Song
桑老儿=Tang Lão Nhi
雷击桃木=Lôi kích đào mộc
狐族老祖=Hồ tộc lão tổ
青丘=Thanh Khâu
黄山主峰=Đỉnh chính Hoàng Sơn
鹿妖=Lộc Yêu
桑村=Tang Thôn
丹阳太守=Đan Dương thái thú
少冲=Thiếu Xung
百丈大佛=Bách Trượng Đại Phật
天圣观=Thiên Thánh Quan
火浣观=Hỏa Hoán Quan
华阳观=Hoa Dương Quan
元符观=Nguyên Phù Quan
白云观=Bạch Vân Quan
玉泉观=Ngọc Tuyền Quan
乾元观=Càn Nguyên Quan
金豆兵=Kim Đậu Binh
传承道箓=Truyền Thừa Đạo Lục
玉佛脂=Ngọc Phật Chi
飞天夜叉=Phi Thiên Dạ Xoa
避火阵=Tị Hỏa Trận
空中火=Không Trung Hỏa
紫金丹炉=Tử Kim Đan Lô
三昧火=Tam Muội Hỏa
龙门异术=Long Môn Dị Thuật
叶庆=Diệp Khánh
石山=Thạch Sơn
珠峰=Châu Phong
极乐城=Cực Lạc Thành
凤玄道士=Phượng Huyền đạo sĩ
天河之水=Thiên Hà chi thủy
法力僧=Pháp Lực Tăng
法师=Pháp Sư
丰神俊朗=Phong Thần Tuấn Lãng
乌铁环=Ô Thiết Hoàn
鸟篆云符=Điểu Triện Vân Phù
小转轮诀=Tiểu Chuyển Luân Quyết
斗百毒心法=Đấu Bách Độc Tâm Pháp
蛊王珠=Cổ Vương Châu
山川潜行术=Sơn Xuyên Tiềm Hành Thuật
腾云驾雾诀=Đằng Vân Giá Vụ Quyết
星宿挪移术=Tinh Túc Na Di Thuật
云雾飞腾术=Vân Vụ Phi Đằng Thuật
朱雀火雷=Chu Tước Hỏa Lôi
六心老人=Lục Tâm Lão Nhân
姚青藤=Diêu Thanh Đằng
欧阳瓠=Âu Dương Hỗ
颜太守=Nhan Thái Thú
风玄=Phong Huyền
三吉观=Tam Cát Quan
丹芝山=Đan Chi Sơn
萧乐师=Tiêu Nhạc Sư
梅山道巫=Mai Sơn Đạo Vu
名教大儒=Danh Giáo Đại Nho
百家家主=Bách Gia Gia Chủ
丹阳黄山=Đan Dương Hoàng Sơn
教储=Giáo Trữ
桂林=Quế Lâm
洞庭湖=Động Đình Hồ
江西封云山=Giang Tây Phong Vân sơn
恶虎道长=Ác Hổ đạo trưởng
雷马=Lôi Mã
南明观=Nam Minh Quan
石青=Thạch Thanh
闽西=Mân Tây
岳阳=Nhạc Dương
伏波道长=Phục Ba Đạo Trưởng
石青道长=Thạch Thanh Đạo Trưởng
恶虎=Ác Hổ
三清符钱=Tiền phù Tam Thanh
符剑=Phù kiếm
岳阳道长=Đạo trưởng Nhạc Dương
清心符咒=Thanh tâm phù chú
三清=Tam Thanh
章明老祖=Chương Minh Lão Tổ
左子扇=Tả Tử Phiến
桃山=Đào Sơn
陶家=Đào gia
江北=Giang Bắc
京官=Kinh quan
鸡鸣寺=Chùa Kê Minh
蔡捕头=Thái bổ đầu
钱员外=Tiền viên ngoại
阿姆=A Mỗ
玄心道长=Huyền Tâm Đạo Trưởng
阿月=A Nguyệt
苗家月=Miêu Gia Nguyệt
苗寨=Miêu Trại
神鸡爷爷=Thần Kê gia gia
神鸡寨=Thần Kê Trại
圣女=Thánh Nữ
金鸡诀=Kim Kê Quyết
玄武小镇=Huyền Vũ Tiểu Trấn
邵子灵=Thiệu Tử Linh
左长老=Tả Trưởng Lão
碧血丹心=Bích Huyết Đan Tâm
师叔=Sư thúc
金钱豹=Kim Tiền Báo
豹子妖=Báo Tử Yêu
金鸡体=Kim Kê Thể
戊土精气=Mậu Thổ Tinh Khí
饮火老人=Ẩm Hỏa Lão Nhân
赵芒=Triệu Mang
焰霄居=Diệm Tiêu Cư
苏醒=Tô Tỉnh
薛小娘子=Tiết Tiểu Nương Tử
桑村学派=Tang Thôn Học Phái
小方大师=Tiểu Phương đại sư
薛娘子=Tiết nương tử
羊小五=Dương Tiểu Ngũ
雄蛟妖王=Hùng Giao Yêu Vương
豹将军=Báo tướng quân
野猪将军=Lợn Rừng tướng quân
昭日仙君=Chiêu Nhật Tiên Quân
蜘蛛妖=Nhện Yêu
小方=Tiểu Phương
血玉蛛丝=Huyết Ngọc Chu Ti
金针婆婆=Kim Châm bà bà
维扬太守=Dương Châu thái thú
幻蜃珠=Huyễn Thận Châu
太守府=Thái thú phủ
红衣少女=Thiếu nữ áo đỏ
桑夫子=Tang Phu Tử
圣僧本源=Thánh Tăng Bản Nguyên
烩龙卵=Hối Long Noãn
凤髓=Phượng Tủy
恶蛟=Ác Giao
青狮=Thanh Sư
娜迦龙王=Na Già Long Vương
西游记=Tây Du Ký
四海龙王=Tứ Hải Long Vương
佛教=Phật giáo
天龙八部=Thiên Long Bát Bộ
封神之战=Phong Thần chi chiến
通天教主=Thông Thiên giáo chủ
金光仙=Kim Quang Tiên
小白龙=Tiểu Bạch Long
八部天龙=Bát Bộ Thiên Long
无量寿佛=Vô Lượng Thọ Phật
正气歌=Chính Khí Ca
枣木戒尺=Tảo Mộc Giới Xích
玉蝉=Ngọc Thiền
天龙念法=Thiên Long Niệm Pháp
步步生莲=Bộ Bộ Sinh Liên
神足通=Thần Túc Thông
窃寿蝉=Thiết Thọ Thiền
阿芬=A Phân
维扬=Dương Châu
太守=Thái thú
袁先生=Viên tiên sinh
闻先生=Văn tiên sinh
妖王大殿=Yêu Vương Đại Điện
猞猁将军=Hồ Ly tướng quân
小狐狸=Tiểu Hồ Ly
维扬妖王=Duy Dương Yêu Vương
雄蛟大王=Hùng Giao Đại Vương
地煞天兵=Địa sát thiên binh
广林牛鼻子=Quảng Lâm Ngưu Tị Tử
地煞天音=Địa Sát Thiên Âm
七龙女=Thất Long Nữ
七九=Thất Cửu
小貂儿=Tiểu Điêu Nhi
真龙大人=Chân Long đại nhân
穿山甲将军=Tướng quân Tê tê
雄蛟=Hùng Giao
蜘蛛林=Rừng Nhện
道袍怪僧=Đạo bào quái tăng
地煞大手印=Địa Sát Đại Thủ Ấn
羽衣=Vũ y
太子=Thái tử
血髓蛛丝=Huyết tủy tri chu ti
运河=Vận Hà
风尘老儿=Phong Trần lão nhi
吴钩=Ngô Câu
凌霄锋=Lăng Tiêu Phong
白帝门人=Bạch Đế Môn Nhân
聂小倩=Nhiếp Tiểu Thiện
宁采臣=Ninh Thái Thần
龙菩萨=Long Bồ Tát
龙王=Long Vương
天庐=Thiên Lư
张默=Trương Mặc
川蜀=Xuyên Thục
剑阁=Kiếm Các
南宁=Nam Ninh
金招=Kim Chiêu
白帝山=Bạch Đế Sơn
青城山=Thanh Thành Sơn
莲花山丘=Liên Hoa Sơn Khâu
青城派=Thanh Thành Phái
佘山主=Xa Sơn Chủ
凌霄山=Lăng Tiêu Sơn
雪顶山三老=Tuyết Đỉnh Sơn Tam Lão
独脚叟=Độc Cước Tẩu
白帝门=Bạch Đế Môn
张磨李炼=Trương Ma Lý Luyện
慧剑=Tuệ Kiếm
提灯鬼=Đề Đăng Quỷ
子母鬼=Tử Mẫu Quỷ
百鬼图鉴=Bách Quỷ Đồ Giám
学舌鬼=Học Thiệt Quỷ
百鬼同游=Bách Quỷ Đồng Du
役鬼书=Dịch Quỷ Thư
飞天=Phi Thiên
夜叉=Dạ Xoa
毒鸠=Độc Cưu
巨鳄=Cự Ngạc
三大罗刹=Tam Đại La Sát
飞天罗刹=Phi Thiên La Sát
犬灵=Khuyển Linh
地行罗刹=Địa Hành La Sát
山鬼=Sơn Quỷ
游鬼大阵=Du Quỷ Đại Trận
百里=Bách Lí
白骨古筝=Bạch Cốt Cổ Tranh
入蜀=Nhập Thục
少山主=Thiếu Sơn Chủ
骑将=Kỵ Tướng
白金吐息=Bạch Kim Thổ Tức
冥童子=Minh Đồng Tử
血葡萄=Huyết Bồ Đào
犬鬼=Khuyển Quỷ
杜忠=Đỗ Trung
虹洞山=Hồng Động Sơn
铁穗子=Thiết Tuệ Tử
绿玉山=Lục Ngọc Sơn
钧天师兄=Quân Thiên sư huynh
万象剑演阵母=Vạn Tượng Kiếm Diễn Trận Mẫu
绿玉十杰=Lục Ngọc Thập Kiệt
孔雀剑阵=Khổng Tước Kiếm Trận
天台山=Thiên Thai Sơn
刃轮剑阵=Nhận Luân Kiếm Trận
徐祖=Từ Tổ
天府之国=Thiên Phủ Chi Quốc
蔺师兄=Lận sư huynh
钧天=Quân Thiên
雪顶联盟=Liên minh Tuyết Đỉnh
毒心三煞=Độc Tâm Tam Sát
毒地陀=Độc Địa Đà
贪毒地煞=Tham Độc Địa Sát
戊土地煞=Mậu Thổ Địa Sát
七星煞气=Thất Tinh Sát Khí
荼老鬼=Đồ Lão Quỷ
夜冥=Dạ Minh
孤山=Cô Sơn
千头鬼云=Thiên Đầu Quỷ Vân
巫山雾罩=Vu Sơn Vụ Tráo
庚金地煞=Canh Kim Địa Sát
鱼非江=Ngư Phi Giang
莲花山=Liên Hoa Sơn
雪山=Tuyết Sơn
眉山=Mi Sơn
青铜飞剑=Thanh Đồng Phi Kiếm
雪顶=Tuyết Đỉnh
七星地煞=Thất Tinh Địa Sát
五行精煞=Ngũ Hành Tinh Sát
鬼将军=Quỷ tướng
辛金地煞=Tân Kim Địa Sát
甲木=Giáp Mộc
丙火=Bính Hỏa
戊土=Mậu Thổ
庚金=Canh Kim
壬水=Nhâm Thủy
乙木=Ất Mộc
丁火=Đinh Hỏa
辛金=Tân Kim
癸水=Quý Thủy
五大鬼尊=Ngũ Đại Quỷ Tôn
涉川=Thiệp Xuyên
还婴=Hoàn Anh
莲花山剑法=Liên Hoa Sơn Kiếm Pháp
妙法莲华=Diệu Pháp Liên Hoa
素因圣僧=Tố Nhân Thánh Tăng
性空=Tính Không
鬼王=Quỷ vương
宗河=Tông Hà
夜冥鬼尊=Dạ Minh Quỷ Tôn
黑火鬼王=Hắc Hỏa Quỷ Vương
还婴鬼王=Hoàn Anh Quỷ Vương
鬼都=Quỷ Đô
北氓=Bắc Mang
凌霄一剑=Lăng Tiêu Nhất Kiếm
冥府鬼都=Minh Phủ Quỷ Đô
望帝杜鹃=Vọng Đế Đỗ Quyên
凌霄飞剑=Lăng Tiêu Phi Kiếm
鬼尊=Quỷ Tôn
仙剑碎片=Tiên Kiếm Toái Phiến
蒲头=Bồ Đầu
黑池=Hắc Trì
丘望月=Khâu Vọng Nguyệt
斩鬼大祭=Trảm Quỷ Đại Tế
鳄龙鬼王=Ngạc Long Quỷ Vương
鬼王令=Quỷ Vương Lệnh
黑池鬼王=Hắc Trì Quỷ Vương
青城少渔翁=Thanh Thành Thiếu Ngư Ông
宗河鬼尊=Tông Hà Quỷ Tôn
涉川鬼尊=Thiệp Xuyên Quỷ Tôn
冥河血遁=Minh Hà Huyết Độn
忘川不返遁=Vong Xuyên Bất Phản Độn
鬼王城=Quỷ Vương Thành
鳄龙=Ngạc Long
气味鬼王=Khí Vị Quỷ Vương
紫金天罡=Tử Kim Thiên Cương
金召=Kim Triệu
柏灌=Bách Quán
鱼凫=Ngư Phù
望帝=Vọng Đế
杜鹃=Đỗ Quyên
开明=Khai Minh
蒲头鬼王=Bồ Đầu Quỷ Vương
西山=Tây Sơn
玺印=Ấn Tín
勾陈=Câu Trần
凌霄剑法=Lăng Tiêu kiếm pháp
白帝剑法=Bạch Đế kiếm pháp
青城剑法=Thanh Thành kiếm pháp
蚕丛授丝=Tàm Tùng thụ ti
离合之道=Ly Hợp chi đạo
蒋道理=Tưởng Đạo Lý
蛟龙=Giao Long
蚕丛=Tàm Tùng
西山炼剑池=Tây Sơn Luyện Kiếm Trì
狗儿=Cẩu Nhi
小花=Tiểu Hoa
谭家婆婆=Đàm gia bà bà
鬼节=Quỷ Tiết
刘老汉=Lưu Lão Hán
西南巫师=Vu sư Tây Nam
金环巫师=Vu sư Kim Hoàn
蚁水巫师=Nghĩ Thủy Vu sư
莱莱巫师=Lai Lai Vu sư
黎古巫师=Lê Cổ Vu sư
高师=Cao Sư
功曹=Công Tào
七大巫王=Thất Đại Vu Vương
十二都天神魔大阵=Thập Nhị Đô Thiên Thần Ma Đại Trận
新巫祖讲道=Tân Vu Tổ Giảng Đạo
万巫起源=Vạn Vu Khởi Nguyên
灵米巫经=Linh Mễ Vu Kinh
赤巫经=Xích Vu Kinh
盘古=Bàn Cổ
蜀地=Thục Địa
钱高师=Tiền Cao Sư
十二祖巫=Thập Nhị Tổ Vu
蜀道=Thục Đạo
赤苗巫师=Xích Miêu Vu Sư
剑狱天动大转轮=Kiếm Ngục Thiên Động Đại Chuyển Luân
毁天灭地覆灭章=Hủy Thiên Diệt Địa Phúc Diệt Chương
巫王=Vu Vương
赤苗=Xích Miêu
巫师=Vu Sư
赤巫王=Xích Vu Vương
长江=Trường Giang
六丁六甲=Lục Đinh Lục Giáp
晓月观主=Hiểu Nguyệt Quan Chủ
铁脚罗汉=Thiết Cước La Hán
天罡丹余=Thiên Cương Đan Dư
地煞广林=Địa Sát Quảng Lâm
巫经=Vu kinh
戒严大师=Giới Nghiêm đại sư
僧院=Tăng viện
戒平=Giới Bình
天王殿=Thiên Vương điện
红袍=Hồng Bào
灰袍=Hôi Bào
小沙弥=Tiểu Sa Di
护法夜叉=Hộ Pháp Dạ Xoa
弥勒佛=Phật Di Lặc
戒空=Giới Không
僧院主事=Tăng Viện Chủ Sự
方丈=Phương Trượng
方正=Phương Chính
西沱寺=chùa Tây Đà
苍水主持=Trụ trì Thương Thủy
第591章=Chương 591
袈裟=Ca sa
本源老和尚=Bản Nguyên lão hòa thượng
剑修=Kiếm tu
知客僧=Tri khách tăng
金蚕=Kim tằm
血蚕=Huyết tằm
金蚕丝=Kim Tàm Ti
销金山=Tiêu Kim Sơn
血蚕丝=Huyết Tàm Ti
红花山=Hồng Hoa Sơn
金蚕袈裟=Kim Tàm Ca Sa
血蚕僧袍=Huyết Tàm Tăng Bào
天蚕丝=Thiên Tàm Ti
江汉儒生=Giang Hán Nho Sinh
封朗=Phong Lãng
冰火剑=Băng Hỏa Kiếm
卧虎藏龙=Ngọa Hổ Tàng Long
扫地僧=Tảo Địa Tăng
北方四灵道宗=Đạo tông Tứ Linh phương Bắc
四灵内景大开宫真法=Tứ Linh Nội Cảnh Đại Khai Cung Chân Pháp
北方真水玄功=Bắc Phương Chân Thủy Huyền Công
癸水神雷=Quý Thủy Thần Lôi
赵师叔=Triệu sư thúc
于秋暮=Vu Thu Mộ
第598章=Chương 598
方丈主持=Phương trượng trụ trì
药师殿=Dược Sư Điện
戒行=Giới Hành
药师王佛=Dược Sư Vương Phật
观音菩萨=Quan Âm Bồ Tát
玄武童子=Huyền Vũ Đồng Tử
玄霆神雷=Huyền Đình Thần Lôi
玄武神雷=Huyền Vũ Thần Lôi
普照大阵=Phổ Chiếu Đại Trận
曹洞穴=Tào Động Huyệt
天庐剑阵=Thiên Lư Kiếm Trận
云山雾罩=Vân Sơn Vụ Tráo
白帝城=Bạch Đế Thành
曹洞玄=Tào Động Huyền
雀儿山=Tước Nhi Sơn
天炉剑阵=Thiên Lô Kiếm Trận
剑狱天动正反大转轮=Kiếm Ngục Thiên Động Chính Phản Đại Chuyển Luân
河洛神算=Hà Lạc Thần Toán
金鸡元神=Kim Kê Nguyên Thần
古泉观=Cổ Tuyền Quán
符钱=Phù Tiền
小柴=Tiểu Sài
清风谷=Thanh Phong Cốc
崇安=Sùng An
太乙山洞天=Thái Ất Sơn Động Thiên
紫微道脉=Tử Vi Đạo Mạch
成礼爵=Thành Lễ Tước
星辰道宗=Tinh Thần Đạo Tông
太微道脉=Thái Vi Đạo Mạch
名优道人=Danh Ưu Đạo Nhân
本源=Bản Nguyên
非相=Phi Tướng
素因=Tố Nhân
海渊=Hải Uyên
唐僧=Đường Tăng
黄山本宗=Hoàng Sơn bản tông
中原=Trung Nguyên
天下四京十三州=Thiên hạ tứ kinh thập tam châu
侯勋=Hầu Huân
伏波=Phục Ba
金天义=Kim Thiên Nghĩa
漓江=Li Giang
上京=Thượng Kinh
荀秃子=Tuân trọc tử
尉迟道友=Úy Trì đạo hữu
麻飞灵=Ma Phi Linh
尉迟=Úy Trì
枯荣妙法=Khô Vinh Diệu Pháp
三头罗刹=Tam Đầu La Sát
圆通和尚=Viên Thông hòa thượng
慕容=Mộ Dung
菩提枯荣=Bồ Đề Khô Vinh
金甲客=Kim Giáp Khách
明子=Minh Tử
光明佛=Quang Minh Phật
封神=Phong Thần
十绝阵=Thập Tuyệt Trận
昆仑十二金仙=Côn Lôn Thập Nhị Kim Tiên
先天易数=Tiên Thiên Dịch Số
大儒=Đại Nho
真空五德=Chân Không Ngũ Đức
素真师叔=Tố Chân Sư Thúc
风恶真人=Phong Ác chân nhân
天罡法坛=Thiên Cương pháp đàn
地煞道冠=Địa Sát đạo quan
大五行天轮剑狱=Đại Ngũ Hành Thiên Luân kiếm ngục
罡煞天书=Cương Sát thiên thư
广利真人=Quảng Lợi chân nhân
阳神遍知=Dương Thần Biến Tri
明皋掌教=Minh Cao chưởng giáo
会稽明皋=Hội Kê Minh Cao
天市道脉=Thiên Thị đạo mạch
龙象经院=Long Tượng Kinh Viện
六晦师叔=Lục Hối sư thúc
避光咒=Tị Quang chú
障目诀=Chướng Mục quyết
乐青羊=Lạc Thanh Dương
无明师兄=Vô Minh sư huynh
三善道=Tam Thiện Đạo
阿修罗道=A Tu La Đạo
阿修罗战体=A Tu La Chiến Thể
人相=Nhân Tướng
八臂陀罗=Bát Tí Đà La
迦楼罗=Ca Lâu La
麻不仁=Ma Bất Nhân
五德宗=Ngũ Đức Tông
金服=Kim Phục
道乐宗=Đạo Nhạc Tông
东玄=Đông Huyền
北河=Bắc Hà
西升=Tây Thăng
四方道宗=Tứ Phương Đạo Tông
会稽挂印观=Hội Kê Quải Ấn Quán
烈火遁=Liệt Hỏa Độn
炉火纯青=Lô Hỏa Thuần Thanh
烈火门=Liệt Hỏa Môn
金玄宗=Kim Huyền Tông
水灵道脉=Thủy Linh Đạo Mạch
饮海=Ẩm Hải
小云雾术=Tiểu Vân Vụ Thuật
照孽镜=Chiếu Nghiệt Kính
南北道宗=Nam Bắc đạo tông
荷芳=Hà Phương
六合总揽天地翻覆大阵=Lục Hợp Tổng Lãm Thiên Địa Phiên Phúc Đại Trận
沉鉴浮稷=Trầm Giám Phù Tắc
枯木黄冠=Khô Mộc Hoàng Quan
道家四真人=Đạo gia Tứ Chân Nhân
旁门五真人=Bàng Môn Ngũ Chân Nhân
磨转真人=Ma Chuyển Chân Nhân
大念=Đại Niệm
斟海玉斗=Châm Hải Ngọc Đấu
乌光=Ô Quang
磨转=Ma Chuyển
大念真人=Đại Niệm chân nhân
易醍醐=Dịch Đề Hồ
半鋒真人=Bán Phong Chân Nhân
三大劍仙=Tam Đại Kiếm Tiên
鎮國劍仙空自若=Trấn Quốc Kiếm Tiên Không Tự Nhược
破滅真玉=Phá Diệt Chân Ngọc
天方=Thiên Phương
荆楚=Kinh Sở
淮北=Hoài Bắc
天方真人=Thiên Phương chân nhân
六合大阵=Lục Hợp Đại Trận
丹阳九华寺=Đan Dương Cửu Hoa Tự
表里山河=Biểu Lý Sơn Hà
饮海真人=Ẩm Hải chân nhân
玉斗=Ngọc Đấu
金枝真人=Kim Chi chân nhân
浮稷=Phù Tắc
龙固=Long Cố
丹余=Đan Dư
五旬道士=Đạo sĩ ngũ tuần
后土道脉=Hậu Thổ Đạo Mạch
江南地区=Khu vực Giang Nam
龙固真人=Long Cố chân nhân
麻教教储=Ma Giáo Giáo Trữ
北斗勾命诀=Bắc Đẩu Câu Mệnh Quyết
浮稷真人=Phù Tắc chân nhân
道宗=Đạo Tông
半锋=Bán Phong
南明离火=Nam Minh Ly Hỏa
沉鉴真人=Trầm Giám chân nhân
广林=Quảng Lâm
风尘=Phong Trần
火德=Hỏa Đức
童心和尚=Đồng Tâm hòa thượng
白骨观=Bạch Cốt Quán
漓江道脉=Li Giang đạo mạch
祁连太师=Kỳ Liên thái sư
丽妃=Lệ phi
凤德=Phượng Đức
黄石道士=Hoàng Thạch đạo sĩ
伏波道士=Phục Ba đạo sĩ
童心=Đồng Tâm
牟陀=Mâu Đà
沉鉴=Trầm Giám
黄冠=Hoàng Quan
江岸边=Bờ sông
缚魂结=Phược Hồn Kết
钢尺=Thước Thép
定元神=Định Nguyên Thần
旗门阵=Kỳ Môn Trận
定风珠=Định Phong Châu
黄石=Hoàng Thạch
何卷帘=Hà Quyển Liêm
五宝金花=Ngũ Bảo Kim Hoa
老五=Lão Ngũ
景玉=Cảnh Ngọc
在世明王=Tại thế Minh Vương
张三哥=Trương Tam ca
九子鬼母=Cửu Tử Quỷ Mẫu
族长=Tộc trưởng
九娘=Cửu Nương
穆帘将军=Mục Liêm tướng quân
应娘=Ứng Nương
真空道尊=Chân Không Đạo Tôn
四大方面神将=Tứ Đại Phương Diện Thần Tướng
北面神将=Bắc Diện Thần Tướng
南面神将=Nam Diện Thần Tướng
罗将军=La tướng quân
罗家军=La gia quân
吴佳琪=Ngô Giai Kỳ
老天爷=Lão Thiên Gia
苍天=Thương Thiên
青天=Thanh Thiên
青冥=Thanh Minh
苍穹=Thương Khung
帝释天=Đế Thích Thiên
阿修罗=A Tu La
明王僧珈蓝=Minh Vương Tăng Già Lam
西面神将=Tây Diện Thần Tướng
诺亚方舟=Nô-ê Phương Chu
玉环县=Ngọc Hoàn huyện
穆帘=Mục Liêm
金钹僧=Kim Bạt Tăng
丹阳石佛山=Đan Dương Thạch Phật Sơn
东面神将=Đông Diện Thần Tướng
江口县=Huyện Giang Khẩu
翁景玉=Ông Cảnh Ngọc
佘赤心=Xà Xích Tâm
彭石匠=Bành Thạch Tượng
候六哥=Hầu Lục Ca
丹阳释门=Đan Dương Thích Môn
金刚护法=Kim Cương Hộ Pháp
明王军=Minh Vương Quân
四面神将=Tứ Diện Thần Tướng
明忝=Minh Thiểm
钢鞭道人=Cương Tiên Đạo Nhân
胜圣僧=Thắng Thánh Tăng
帝子剑=Đế Tử Kiếm
樊湘=Phàn Tương
七星剑印=Thất Tinh Kiếm Ấn
雪莲=Tuyết Liên
车迟老儿=Xa Trì lão nhi
丹融道士=Đan Dung đạo sĩ
胡前辈=Hồ tiền bối
白前辈=Bạch tiền bối
无弱前辈=Vô Nhược tiền bối
车迟=Xa Trì
无弱=Vô Nhược
蜀山=Thục Sơn
北凉王=Bắc Lương Vương
九命枯禅功=Cửu Mệnh Khô Thiền Công
襄樊=Tương Phàn
汉水=Hán Thủy
方某=Phương Mỗ
青河县=Thanh Hà huyện
戊戌年=Mậu Tuất niên
晋陵福元寺=Tấn Lăng Phúc Nguyên Tự
丹阳道家=Đan Dương đạo gia
黄山掌教=Hoàng Sơn chưởng giáo
西极轮=Tây Cực Luân
东流海=Đông Lưu Hải
六英=Lục Anh
八雄=Bát Hùng
三大天骄=Tam Đại Thiên Kiêu
雪顶少主=Tuyết Đỉnh Thiếu Chủ
蜀道口=Thục Đạo Khẩu
米长顾=Mễ Trường Cố
维扬郡=Duy Dương Quận
青城兆瑶芝=Thanh Thành Triệu Dao Chi
兆瑶芝=Triệu Dao Chi
双轮海=Song Luân Hải
僧珈蓝=Tăng Già Lam
千叶等=Thiên Diệp đẳng
诛仙=Tru Tiên
良亲王=Lương Thân Vương
本源圣僧=Bản Nguyên Thánh Tăng
斩仙神剑=Trảm Tiên Thần Kiếm
祖老爷=Tổ gia
剑门关=Kiếm Môn Quan
重六=Trọng Lục
珠毫飞剑=Châu Hào Phi Kiếm
水府=Thủy Phủ
鲶鱼=Niêm Ngư
罗云纱=La Vân Sa
丹生=Đan Sinh
白老汉=Bạch Lão Hán
白家山=Bạch Gia Sơn
西疆=Tây Cương
关老爷=Quan Lão Gia
白老爷子=Bạch lão gia tử
喜高义=Hỉ Cao Nghĩa
水妖大王=Thủy Yêu Đại Vương
蛤蟆妖=Hà Mô Yêu
关中水妖=Quan Trung Thủy Yêu
奇烈=Kỳ Liệt
妖王=Yêu Vương
黑衣青年=Thanh niên áo đen
新间真人=Tân Gian chân nhân
空玄子=Không Huyền Tử
海渊圣僧=Hải Uyên thánh tăng
福严寺=Phúc Nghiêm tự
金鳞王=Kim Lân Vương
金枝=Kim Chi
蓝异真人=Lam Dị chân nhân
凌霄城=Lăng Tiêu thành
黑水妖王=Hắc Thủy yêu vương
天河大妖=Thiên Hà Đại Yêu
关中=Quan Trung
白家=Bạch Gia
白三才=Bạch Tam Tài
金鸡内丹=Kim Kê Nội Đan
盛家=Thịnh Gia
盛执令=Thịnh Chấp Lệnh
晋南=Tấn Nam
晋南地区=Khu vực Tấn Nam
神蟾会=Thần Thiềm Hội
郭大力=Quách Đại Lực
郭财主=Quách Tài Chủ
锦妃=Cẩm Phi
神龙=Thần Long
凤凰=Phượng Hoàng
神蟾=Thần Thiềm
山岳巨猿=Sơn Nhạc Cự Viên
噬火狻猊=Phệ Hỏa Toan Nghê
白玉蟾=Bạch Ngọc Thiềm
战神=Chiến Thần
风婆=Phong Bà
老君=Lão Quân
金蟾钱=Kim Thiềm Tiền
月宫=Nguyệt Cung
罡煞道冠=Cương Sát Đạo Quan
财神=Tài Thần
星官=Tinh Quan
广寒之地=Quảng Hàn Chi Địa
桂树=Quế Thụ
圣僧分身圆通=Thánh Tăng Phân Thân Viên Thông
儒生袁养正=Nho Sinh Viên Dưỡng Chính
三足金蟾=Tam túc Kim Thiềm
钱家=Tiền gia
谭家=Đàm gia
钱公=Tiền Công
谭副教主=Đàm Phó Giáo chủ
谭功曹=Đàm Công Tào
半锋真人=Bán Phong chân nhân
水神=Thủy Thần
会稽郡=Hội Kê Quận
太湖=Thái Hồ
蜀中凌霄城=Thục Trung Lăng Tiêu Thành
少渔翁=Thiếu Ngư Ông
袁天河=Viên Thiên Hà
大越=Đại Việt
钱婆=Tiền Bà
巫道=Vu Đạo
圣僧圆通=Thánh tăng Viên Thông
黑水王=Hắc Thủy Vương
老坛真人=Lão Đàn chân nhân
日月鳌=Nhật Nguyệt Ngao
鲤三郎=Lý Tam Lang
震天雷鼓=Chấn Thiên Lôi Cổ
铜山玉磬=Đồng Sơn Ngọc Khánh
天弦瑶琴=Thiên Huyền Dao Cầm
孤星=Cô Tinh
积雷云=Tích Lôi Vân
避雷诀=Tị Lôi Quyết
利空真人=Lợi Không Chân Nhân
捧日司晨仙君=Phụng Nhật Tư Thần tiên quân
捧日宫司晨仙殿=Phụng Nhật Cung Tư Thần tiên điện
始祖=Thủy tổ
钧天锋=Quân Thiên Phong
陈空虚=Trần Không Hư
太玄生=Thái Huyền Sinh
金眼雕=Kim Nhãn Điêu
梁山=Lương Sơn
千叶=Thiên Diệp
三仙境=Tam Tiên Cảnh
太乙山=Thái Ất Sơn
枯木黄芽=Khô Mộc Hoàng Nha
萍末=Bình Mạt
隆光爷=Long Quang Gia
恭良爷=Cung Lương Gia
齐聚勾曲山=Tề tụ Câu Khúc Sơn
黔中=Kiềm Trung
兵圣=Binh Thánh
东海=Đông Hải
白衣佛兵=Bạch Y Phật Binh
红头贼=Hồng Đầu Tặc
黄芽真人=Hoàng Nha chân nhân
小洞天=Tiểu Động Thiên
丹余真人=Đan Dư chân nhân
十方无量经=Thập Phương Vô Lượng Kinh
吴光真人=Ngô Quang chân nhân
净角真人=Tịnh Giác chân nhân
梓笔真人=Tử Bút chân nhân
空剑仙=Không Kiếm Tiên
蜀中三家=Thục Trung Tam Gia
钦差=Khâm sai
石佛山=Thạch Phật Sơn
枯木=Khô Mộc
鬼尊令=Quỷ Tôn Lệnh
招魂谷=Chiêu Hồn Cốc
轮回转生池=Luân Hồi Chuyển Sinh Trì
福宝=Phúc Bảo
六芒鬼尊=Lục Mang Quỷ Tôn
邪冥鬼王=Tà Minh Quỷ Vương
楚墟=Sở Khư
紫府雷法=Tử Phủ Lôi Pháp
五师兄=Ngũ sư huynh
天雷宗=Thiên Lôi Tông
楚墟鬼尊=Sở Khư Quỷ Tôn
石像地藏=Thạch Tượng Địa Tạng
千眼万瞳桩=Thiên Nhãn Vạn Đồng Tràng
楚墟真人=Sở Khư chân nhân
中山氏=Trung Sơn Thị
还婴鬼尊=Hoàn Anh Quỷ Tôn
万灵胎膜=Vạn Linh Thai Mô
归真鉴=Quy Chân Giám
邙山鬼尊=Mang Sơn Quỷ Tôn
冥府鬼王=Minh Phủ Quỷ Vương
转轮鬼王=Chuyển Luân Quỷ Vương
泰山鬼王=Thái Sơn Quỷ Vương
泰山王=Thái Sơn Vương
鬼童子=Quỷ Đồng Tử
冥府之主=Minh Phủ chi Chủ
曹营=Tào doanh
大师=Đại sư
轮回台=Luân Hồi Đài
转生池=Chuyển Sinh Trì
老僧=Lão tăng
萍末真人=Bình Mạt Chân Nhân
释门圣僧=Thích Môn Thánh tăng
北宗=Bắc Tông
神思妙想空间=Thần Tư Diệu Tưởng Không Gian
喜财宝宝=Hỉ Tài Bảo Bảo
悬壶神眼=Huyền Hồ Thần Nhãn
随身仙剑=Tùy Thân Tiên Kiếm
善财宝宝=Thiện Tài Bảo Bảo
蜃龙舍利=Thận Long Xá Lợi
旁门真人=Bàng Môn chân nhân
伪帝=Ngụy Đế
锦绣暗卫=Cẩm Tú Ám Vệ
隆光通宝=Long Quang Thông Bảo
恭良通宝=Cung Lương Thông Bảo
正统通宝=Chính Thống Thông Bảo
穿山甲老妖=Xuyên Sơn Giáp Lão Yêu
大青骡=Đại Thanh La
杞子圣贤=Kỷ Tử Thánh Hiền
三毒飞剑=Tam Độc Phi Kiếm
驰于=Trì Vu
天下第四位剑仙=Thiên hạ đệ tứ vị kiếm tiên
轮回剑仙=Luân Hồi Kiếm Tiên
吴起=Ngô Khởi
魏国=Nước Ngụy
秦国=Nước Tần
燕太子=Yên Thái Tử
荆轲=Kinh Kha
秦王殿=Tần Vương Điện
小剑仙=Tiểu Kiếm Tiên
皇城=Hoàng thành
鱼肠=Ngư Tràng
大巫=Đại Vu
恭良帝=Cung Lương Đế
新生伪帝=Tân Sinh Ngụy Đế
新生帝=Tân Sinh Đế
和善=Hòa Thiện
刺客师徒=Sư đồ thích khách
刺八郎=Thích Bát Lang
老三=Lão Tam
新京城=Tân Kinh Thành
德夫子=Đức Phu Tử
白虎堂=Bạch Hổ Đường
镇国剑仙空自若=Trấn Quốc Kiếm Tiên Không Tự Nhược
老僧地藏=Lão tăng Địa Tạng
枯荣禅院=Khô Vinh Thiền Viện
田道友=Điền đạo hữu
兵家圣人=Binh Gia Thánh Nhân
狗赖子=Cẩu Lại Tử
郑青云=Trịnh Thanh Vân
中山行述=Trung Sơn Hành Thuật
屯田=Đồn Điền
田老丈=Điền lão trượng
郑青天=Trịnh Thanh Thiên
阴谋家=Âm Mưu Gia
锦绣使者=Cẩm Tú Sứ Giả
隆光=Long Quang
恭良=Cung Lương
田前辈=Điền tiền bối
刺客老三=Thích khách Lão Tam
冶金家=Dã Kim Gia
湛然心火=Trạm Nhiên Tâm Hỏa
碧血=Bích Huyết
五色神土=Ngũ Sắc Thần Thổ
八卦紫金丹炉=Bát Quái Tử Kim Đan Lô
兜率=Đâu Suất
屯田所=Đồn Điền Sở
刺客=Thích Khách
捕风捉影=Bổ Phong Tróc Ảnh
刺猬=Nhím
空谈家=Không Đàm Gia
空想家=Không Tưởng Gia
火龙=Hỏa Long
清源圣僧=Thanh Nguyên Thánh Tăng
五行轮转=Ngũ Hành Luân Chuyển
金中生火=Kim Trung Sinh Hỏa
铁火=Thiết Hỏa
先天剑仙=Tiên Thiên Kiếm Tiên
濯根水=Trạc Căn Thủy
蜀锦=Thục Cẩm
聚宝金蛛=Tụ Bảo Kim Chu
北地青罗道脉=Bắc Địa Thanh La Đạo Mạch
惜宝真人=Tích Bảo Chân Nhân
震四方大铁戟=Chấn Tứ Phương Đại Thiết Kích
震四方=Chấn Tứ Phương
阴奉学派=Âm Phụng học phái
司空补天=Tư Không Bổ Thiên
田老头=Điền lão đầu
田为民=Điền Vi Dân
神农鞭=Thần Nông Tiên
吴光=Ngô Quang
净角=Tịnh Giác
百子回归=Bách Tử Quy Hồi
京城之战=Kinh Thành chi chiến
黄冠真人=Hoàng Quan chân nhân
吴光净=Ngô Quang Tịnh
三家=Tam gia
五行道宗=Ngũ Hành Đạo Tông
正统朝廷=Triều đình Chính Thống
五大重关=Năm cửa ải trọng yếu
李叔=Lý thúc
熊瞎子=Hùng hạt tử
葛物联=Cát Vật Liên
枯荣寺=Khô Vinh Tự
龙象精元=Long Tượng Tinh Nguyên
旁门联盟=Bàng Môn Liên Minh
道士丹融=Đạo sĩ Đan Dung
和尚圆通=Hòa thượng Viên Thông
书生袁养正=Thư sinh Viên Dưỡng Chính
梅鹤公=Mai Hạc Công
葛头儿=Cát Đầu Nhi
小三儿=Tiểu Tam Nhi
天河群妖=Thiên Hà Quần Yêu
定水分山兽=Định Thủy Phân Sơn Thú
天听兽=Thiên Thính Thú
五关=Ngũ Quan
逝水关前=Trước Thệ Thủy Quan
金乌密卷=Kim Ô Mật Quyển
火凤道友=Hỏa Phượng đạo hữu
金山=Kim Sơn
天问=Thiên Vấn
乘龙御法=Thừa Long Ngự Pháp
金剪子=Kim Tiễn Tử
金山关=Kim Sơn Quan
陈木关=Trần Mộc Quan
厚德关=Hậu Đức Quan
烈芳关=Liệt Phương Quan
鸟妖=Điểu yêu
青白焰光=Thanh bạch diễm quang
太阳真火=Thái Dương chân hỏa
蚁婆神=Nghĩ Bà thần
九凤世家=Cửu Phượng thế gia
狱门神象=Ngục Môn Thần Tượng
破风针=Phá Phong Châm
火凤=Hỏa Phượng
五行道人=Ngũ Hành đạo nhân
旁门=Bàng môn
商家=Thương gia
权书公=Quyền Thư Công
南倾=Nam Khuynh
天倾刃=Thiên Khuynh Nhận
南倾真人=Nam Khuynh chân nhân
汗青公=Hãn Thanh công
九宫门=Cửu Cung môn
六不戒律=Lục Bất Giới Luật
兴霸=Hưng Bá
逝水关山=Thệ Thủy Quan Sơn
西南米巫=Tây Nam Mễ Vu
巫术=Vu thuật
磁宝天心=Từ Bảo Thiên Tâm
空谈=Không Đàm
空想=Không Tưởng
水火道袍=Thủy Hỏa Đạo Bào
纯阳老祖=Thuần Dương Lão Tổ
冶兵家主=Diã Binh Gia Chủ
学派真人=Học Phái Chân Nhân
德六艺=Đức Lục Nghệ
太阳真人=Thái Dương chân nhân
青风山岚=Thanh Phong Sơn Lam
新生阵营=Tân Sinh Trận Doanh
牛武=Ngưu Vũ
小五子=Tiểu Ngũ Tử
鸦公壶=Nha Công Hồ
广林真人=Quảng Lâm Chân Nhân
罡煞门=Cương Sát Môn
西南米教=Tây Nam Mễ Giáo
金乌烈焰=Kim Ô Liệt Diễm
先天易经=Tiên Thiên Dịch Kinh
沭阳真人=Thuật Dương Chân Nhân
殷老=Ân lão
烈雀=Liệt Tước
凌霄白帝=Lăng Tiêu Bạch Đế
七尾龟=Thất Vĩ Quy
顶天白虎=Đỉnh Thiên Bạch Hổ
黄山丹融=Hoàng Sơn Đan Dung
青龙旗=Thanh Long kỳ
丹融真人=Đan Dung chân nhân
小黄山=Tiểu Hoàng Sơn
眉山文集=Mi Sơn văn tập
朱雀星座=Chu Tước tinh tọa
无病=Vô Bệnh
千波幻鲤刃=Thiên Ba Huyễn Lí Nhận
朱雀旗=Chu Tước Kỳ
鱼羊公=Ngư Dương Công
巫童=Vu Đồng
红线=Hồng Tuyến
淑阳真人=Thục Dương chân nhân
太上忘情=Thái Thượng Vong Tình
周天星罗=Chu Thiên Tinh La
星宿大挪移遁法=Tinh Túc Đại Na Di Độn Pháp
周天如意神游术=Chu Thiên Như Ý Thần Du Thuật
警醒红线=Cảnh Tỉnh Hồng Tuyến
兵主横空=Binh Chủ Hoành Không
方天画戟=Phương Thiên Hoạ Kích
君兴霸=Quân Hưng Bá
毛姓小将=Mao tính tiểu tướng
龙女=Long Nữ
殷老大=Ân Lão Đại
明月=Minh Nguyệt
元亨=Nguyên Hanh
利贞=Lợi Trinh
雪顶三老=Tuyết Đỉnh Tam Lão
张磨=Trương Ma
李炼=Lý Luyện
大智慧=Đại Trí Tuệ
知见障=Tri Kiến Chướng
大乘=Đại Thừa
十方天眼=Thập Phương Thiên Nhãn
三尸升天图=Tam Thi Thăng Thiên Đồ
睡尸=Thụy Thi
慧尸=Tuệ Thi
百胜=Bách Thắng
须弥山=Tu Di Sơn
牟尼环=Mâu Ni Hoàn
莲花秘镜=Liên Hoa Bí Kính
神足圣僧=Thần Túc Thánh Tăng
圆融=Viên Dung
金鳌=Kim Ngao
净世弥陀=Tịnh Thế Di Đà
燃灯古佛=Nhiên Đăng Cổ Phật
无量如来=Vô Lượng Như Lai
愚剑=Ngu Kiếm
金鳌圣僧=Kim Ngao Thánh Tăng
神足=Thần Túc
无量如来佛祖=Vô Lượng Như Lai Phật Tổ
雪炎=Tuyết Viêm
护法罗刹=Hộ Pháp La Sát
净世十炎=Tịnh Thế Thập Viêm
红莲=Hồng Liên
天行=Thiên Hành
地形=Địa Hình
果泉圣僧=Quả Tuyền Thánh Tăng
百胜圣僧=Bách Thắng Thánh Tăng
九霄积雷云=Cửu Tiêu Tích Lôi Vân
合欢和尚=Hợp Hoan hòa thượng
天门=Thiên Môn
蜀中酆都山=Thục Trung Phong Đô Sơn
十殿王者=Thập Điện Vương Giả
黄泉道=Hoàng Tuyền Đạo
枉死城=Uổng Tử Thành
转轮王=Chuyển Luân Vương
白无常=Bạch Vô Thường
黑无常=Hắc Vô Thường
熊大=Hùng Đại
熊二=Hùng Nhị
王转轮=Vương Chuyển Luân
死神来了=Điểm Đến Cuối Cùng
勾曲山洞天=Câu Khúc Sơn động thiên
残魂=Tàn Hồn
生死簿的精气=Tinh khí từ Sổ Sinh Tử
晋陵郡=Tấn Lăng quận
金鸡=Kim Kê
明皋=Minh Cao
凤玄=Phượng Huyền
延寿=Diên Thọ
崇阳派=Sùng Dương Phái
尊星派=Tôn Tinh Phái
凤鸣九霄=Phượng Minh Cửu Tiêu
会稽山=Hội Kê Sơn
延寿丹=Diên Thọ Đan
冰清子=Băng Thanh Tử
双炎道宗=Song Viêm đạo tông
枯木真人=Khô Mộc chân nhân
生死簿=Sinh Tử Bộ
佛祖=Phật Tổ
平原镇=Trấn Bình Nguyên
老员外=Lão viên ngoại
火凤真人=Hỏa Phượng chân nhân
明师弟=Minh sư đệ
盗家明三手=Đạo gia Minh Tam Thủ
北方道宗神霄派=Bắc Phương Đạo Tông Thần Tiêu Phái
天皇老子=Thiên Hoàng Lão Tử
神霄派冲雷子=Thần Tiêu Phái Xung Lôi Tử
雷签=Lôi thiêm
明涧秋=Minh Giản Thu
张冠=Trương Quan
李戴=Lý Đới
张三李四=Trương Tam Lý Tứ
神霄派=Thần Tiêu Phái
北方本处真人=Bắc Phương Bản Xứ chân nhân
会稽=Hội Kê
千秋社=Thiên Thu Xã
晋陵=Tấn Lăng
明三手=Minh Tam Thủ
阳鼎派=Dương Đỉnh Phái
五气朝元真人=Ngũ Khí Triều Nguyên Chân Nhân
江南=Giang Nam
明觉真人=Minh Giác Chân Nhân
顾及=Cố Cập
新生朝廷=Tân Sinh Triều Đình
伪丹家之子=Ngụy Đan Gia Chi Tử
卢青真人=Lư Thanh Chân Nhân
炼丹大师=Luyện Đan Đại Sư
道家真人=Đạo Gia Chân Nhân
元神=Nguyên Thần
兵家主公=Binh Gia chủ công
明觉=Minh Giác
偃家之子=Yển Gia Chi Tử
八水山道场=Bát Thủy Sơn Đạo Tràng
晶石葫芦=Tinh Thạch Hồ Lô
贫家之子=Bần Gia Chi Tử
三大剑派=Tam Đại Kiếm Phái
凤雏=Phượng Sồ
酆都山=Phong Đô Sơn
冥府=Minh Phủ
佘御冲=Xa Ngự Xung
雪顶山=Tuyết Đỉnh Sơn
霜灵米=Sương Linh Mễ
观星台=Quan Tinh Đài
阴阳望气术=Âm Dương Vọng Khí Thuật
左丘=Tả Khâu
右丘=Hữu Khâu
陆地真仙=Lục Địa chân tiên
佛家=Phật Gia
逝水关=Thệ Thủy Quan
兵家主=Binh Gia Chủ
释门之子圆通=Thích Môn Chi Tử Viên Thông
大乘圣僧=Đại Thừa Thánh Tăng
通天三足炉=Thông Thiên Tam Túc Lô
云鼎宗=Vân Đỉnh Tông
腾蛇=Đằng Xà
老和尚=Lão hòa thượng
净世明焰=Tịnh Thế Minh Diễm
风劫=Phong Kiếp
彻地印=Triệt Địa Ấn
散修联盟=Tán Tu Liên Minh
尔不复=Nhĩ Bất Phục
释门之子=Thích Môn Chi Tử
绿意老翁=Lục Ý Lão Ông
采风之子=Thải Phong chi tử
月明祖师=Nguyệt Minh Tổ Sư
丹炉=Đan lô
龙虎炉=Long Hổ Lô
用家=Dụng gia
采风家=Thái Phong Gia
净道之子=Tịnh Đạo chi tử
阿弥陀佛=A Di Đà Phật
腾蛇炉=Đằng Xà Lô
惊梦龙虎丹炉=Kinh Mộng Long Hổ Đan Lô
邙山鬼修=Mang Sơn quỷ tu
善恶两心炉=Thiện Ác Lưỡng Tâm Lô
十全炉=Thập Toàn Lô
八干山=Bát Can Sơn
人还丹=Nhân Hoàn Đan
殷绝世=Ân Tuyệt Thế
云销雨霁水帘帕=Vân Tiêu Vũ Tễ Thủy Liêm Mạt
风水=Phong Thủy
七星锥=Thất Tinh Tr錐
纵地金光=Túng Địa Kim Quang
药家=Dược Gia
身败名裂=Thân Bại Danh Liệt
隐名咒=Ẩn Danh Chú
荣辱不惊、去留无意=Vinh Nhục Bất Kinh, Khứ Lưu Vô Ý
三昧真火=Tam Muội Chân Hỏa
北斗朝元真人=Bắc Đẩu Triều Nguyên Chân Nhân
纵横=Tung Hoành
纵横之术=Tung Hoành Chi Thuật
孤星坠=Cô Tinh Trụy
公无病=Công Vô Bệnh
南北双子=Nam Bắc Song Tử
凌霄真人=Lăng Tiêu chân nhân
纯阳高徒=Thuần Dương cao đồ
遁天神剑=Độn Thiên Thần Kiếm
八水=Bát Thủy
万古=Vạn Cổ
周天星斗大挪移=Chu Thiên Tinh Đẩu Đại Na Di
蜀中剑派=Thục Trung Kiếm Phái
艳尸=Diễm Thi
渔翁=Ngư Ông
太虚垂钓术=Thái Hư Thùy Điếu Thuật
八水山洞天=Bát Thủy Sơn động thiên
纵横之道=Tung Hoành chi đạo
真空朝元真人=Chân Không Triều Nguyên chân nhân
纯阳火=Thuần Dương hỏa
钩沉=Câu Trầm
渔家太虚垂钓术=Ngư gia Thái Hư thùy điếu thuật
丹湘子=Đan Tương Tử
学派之子=Học phái chi tử
九头怪鸟=Cửu Đầu Quái Điểu
阴阳天眼=Âm Dương Thiên Nhãn
三十二金蟒=Tam Thập Nhị Kim Mãng
御兽真人=Ngự thú chân nhân
奈何桥=Cầu Nại Hà
勾魂使者=Câu Hồn Sứ Giả
北方道子=Bắc Phương đạo tử
鹅老大=Nga lão đại
采风=Thải Phong
采风门人=Thải Phong môn nhân
狮驼鹅=Sư Đà Nga
娘娘=Nương Nương
白裘=Bạch Cừu
小狐=Tiểu Hồ
小雀=Tiểu Tước
黄将军=Hoàng tướng quân
白姐姐=Bạch tỷ tỷ
白家大姐=Bạch Gia Đại Tỷ
妖界=Yêu Giới
名家堂=Danh Gia Đường
道子尘冲虚=Đạo Tử Trần Xung Hư
南北道子=Nam Bắc Đạo Tử
挂印观=Quải Ấn Quán
掌教松竹=Chưởng Giáo Tùng Trúc
地藏老和尚=Địa Tạng Lão Hòa Thượng
真空真人=Chân Không chân nhân
震神锤=Chấn Thần Chùy
五德真人=Ngũ Đức chân nhân
南方=Nam Phương
北方=Bắc Phương
黄山道术=Hoàng Sơn Đạo Thuật
周天=Chu Thiên
一炁=Nhất Khí
猪戒=Trư Giới
西游=Tây Du
真空道人=Chân Không đạo nhân
诸界无空=Chư Giới Vô Không
北斗真人=Bắc Đẩu chân nhân
周天轮转=Chu Thiên Luân Chuyển
有无相生=Hữu Vô Tương Sinh
星辰陨光=Tinh Thần Vẫn Quang
五德朝元真人=Ngũ Đức Triều Nguyên chân nhân
五德=Ngũ Đức
真空道宗=Chân Không Đạo Tông
真空=Chân Không
北斗=Bắc Đẩu
渡江论道=Độ Giang luận đạo
纯阳道人=Thuần Dương đạo nhân
混洞镜=Hỗn Động kính
五德道宗=Ngũ Đức đạo tông
五行=Ngũ hành
君臣圣僧=Quân Thần thánh tăng
戒严=Giới Nghiêm
神眼僧=Thần Nhãn tăng
万镜横空 无所遁藏=Vạn Kính Hoành Không Vô Sở Độn Tàng
九头大哥=Cửu Đầu đại ca
白老三=Bạch Lão Tam
盲僧=Manh Tăng
祖庭=Tổ Đình
圣天子=Thánh Thiên Tử
纯阳狂人=Thuần Dương Cuồng Nhân
南方道宗=Nam Phương Đạo Tông
八水真人=Bát Thủy Chân Nhân
北方真人=Bắc Phương Chân Nhân
文通明=Văn Thông Minh
诸天社=Chư Thiên Xã
龙象社=Long Tượng Xã
无名=Vô Danh
心月狐=Tâm Nguyệt Hồ
莲生社=Liên Sinh Xã
金刚社=Kim Cương Xã
千佛梵唱=Thiên Phật Phạm Xướng
太阴=Thái Âm
洞天=Động Thiên
觜火猴=Tủy Hỏa Hầu
水神巫支祈=Thủy Thần Vu Chi Kỳ
举父=Cử Phụ
长右=Trường Hữu
朱厌=Chu Yếm
净道无明=Tịnh Đạo Vô Minh
梵教合欢=Phạn Giáo Hợp Hoan
地藏金身=Địa Tạng Kim Thân
白虎第七宿=Bạch Hổ Đệ Thất Túc
地狱=Địa Ngục
许判官=Hứa Phán Quan
生死谱=Sinh Tử Phổ
地藏菩萨=Địa Tạng Bồ Tát
女妖王=Nữ Yêu Vương
佛光=Phật Quang
铁皮蛤蟆=Thiết Bì Cáp Mô
蛤蟆吞天术=Cáp Mô Thôn Thiên Thuật
古铜大鳄=Cổ Đồng Đại Ngạc
多臂人佛=Đa Tí Nhân Phật
千手无量=Thiên Thủ Vô Lượng
无畏印=Vô Úy Ấn
方便印=Phương Tiện Ấn
狮子印=Sư Tử Ấn
千手宝相=Thiên Thủ Bảo Tướng
邪魔辟易=Tà Ma Tịch Dịch
千江不流盏=Thiên Giang Bất Lưu Trản
风水之子=Phong Thủy Chi Tử
万字=Vạn Tự
光字=Quang Tự
铁签=Thiết Thiêm
水脉=Thủy Mạch
人间三家=Nhân Gian Tam Gia
空行=Không Hành
水行=Thủy Hành
地行=Địa Hành
罗刹=La Sát
护法明王=Hộ Pháp Minh Vương
三尊罗刹=Tam Tôn La Sát
结社=Kết Xã
金身=Kim Thân
大禹=Đại Vũ
九州=Cửu Châu
定水神针=Định Thủy Thần Châm
白虎七宿=Bạch Hổ Thất Túc
巫支祈=Vu Chi Kỳ
宿老=Túc Lão
小芳=Tiểu Phương
火龙瓮=Hỏa Long Úng
归元戳=Quy Nguyên Xúc
寻芳炉=Tầm Phương Lô
女妖=Nữ Yêu
河獾=Hà Hoan
金毛犼=Kim Mao Hống
独角蛇=Độc Giác Xà
熊虎豹=Hùng Hổ Báo
白象=Bạch Tượng
净道普照=Tịnh Đạo Phổ Chiếu
梵教并蒂双尊=Phạn Giáo Tịnh Đế Song Tôn
分水犀=Phân Thủy Tê
东方青龙七宿=Đông Phương Thanh Long Thất Tú
北方玄武七宿=Bắc Phương Huyền Vũ Thất Tú
南方朱雀七宿=Nam Phương Chu Tước Thất Tú
西方白虎七宿=Tây Phương Bạch Hổ Thất Tú
轸水蚓=Chẩn Thủy Dẫn
西方白虎=Tây Phương Bạch Hổ
南方朱雀=Nam Phương Chu Tước
北方玄武=Bắc Phương Huyền Vũ
十方无量=Thập Phương Vô Lượng
贝妖=Bối yêu
红莲烈火=Hồng Liên Liệt Hỏa
佛光如箭=Phật Quang Như Tiễn
祖庭山=Tổ Đình Sơn
九头=Cửu Đầu
真灵=Chân Linh
佛道三宗=Phật Đạo Tam Tông
南北真人=Chân nhân Nam Bắc
南北两岸=Nam Bắc Lưỡng Ngạn
光明精舍=Quang Minh Tinh Xá
南方真人=Chân Nhân Phương Nam
普照圣僧=Phổ Chiếu Thánh Tăng
并蒂双尊=Tịnh Đế Song Tôn
纯阳种子=Thuần Dương Chủng Tử
天河之璧=Thiên Hà Chi Bích
方斗剑仙=Phương Đấu Kiếm Tiên
通天河=Thông Thiên Hà
河伯=Hà Bá
释子圆通=Thích Tử Viên Thông
碧眼狮子=Bích Nhãn Sư Tử
天帝候选=Thiên Đế Hậu Tuyển
扬眉吐气=Dương Mi Thổ Khí
本处真人=Bản Xử Chân Nhân
冶金家之子=Dã Kim Gia Chi Tử
凤血石=Phượng Huyết Thạch
无情灭度=Vô Tình Diệt Độ
凤凰真血=Phượng Hoàng Chân Huyết
凤凰真火=Phượng Hoàng Chân Hỏa
凤凰真君=Phượng Hoàng Chân Quân
普照=Phổ Chiếu
冲虚道子=Xung Hư Đạo Tử
奎木狼=Khuê Mộc Lang
青龙=Thanh Long
白虎=Bạch Hổ
朱雀=Chu Tước
箕水豹=Ki Thủy Báo
壁水貐=Bích Thủy Du
无明=Vô Minh
合欢=Hợp Hoan
十方俱灭=Thập Phương Câu Diệt
角木蛟=Giác Mộc Giao
东方青龙=Đông Phương Thanh Long
净道=Tịnh Đạo
梵教=Phạm Giáo
三大剑仙=Tam Đại Kiếm Tiên
星宿=Tinh Tú
参水猿=Tham Thủy Viên
九头凤=Cửu Đầu Phượng
黄山小洞天=Hoàng Sơn Tiểu Động Thiên
鸡鸣庙=Kê Minh Miếu
帝心小和尚=Tiểu hòa thượng Đế Tâm
百丈红鸾=Bách Trượng Hồng Loan
生辰铁=Sinh Thần Thiết
阴阳髓=Âm Dương Tủy
三花聚顶=Tam Hoa Tụ Đỉnh
五气朝元=Ngũ Khí Triều Nguyên
僧道=Tăng Đạo
巫婆神汉=Vu Bà Thần Hán
散修=Tán Tu
地藏=Địa Tạng
珠毫剑=Châu Hào Kiếm
名剑篇=Danh Kiếm Thiên
蜀中三大仙剑=Thục Trung Tam Đại Tiên Kiếm
七星=Thất Tinh
珠毫=Châu Hào
沧海剑=Thương Hải Kiếm
沧海珠=Thương Hải Châu
镇国剑仙方斗=Trấn Quốc Kiếm Tiên Phương Đấu
杜朝化=Đỗ Triều Hóa
本初=Bản Sơ
道宫=Đạo Cung
真佛=Chân Phật
斗姆三清=Đẩu Mẫu Tam Thanh
正统皇帝=Chính Thống Hoàng Đế
大白胖子=Đại Bạch Bàn Tử
隆光帝=Long Quang Đế
玄武镇=Huyền Vũ Trấn
天子=Thiên Tử
京畿地区=Khu vực Kinh Kỳ
正统帝=Chính Thống Đế
释子=Thích Tử
净子=Tịnh Tử
梵子=Phạm Tử
文曲=Văn Khúc
武曲=Võ Khúc
礼部=Lễ Bộ
道乐司=Đạo Nhạc Tư
丹阳=Đan Dương
风尘真人=Phong Trần chân nhân
佛诞节=Phật Đản tiết
东华门=Đông Hoa Môn
佛子=Phật tử
猪八戒=Trư Bát Giới
冠子清=Quan Tử Thanh
纯阳剑仙=Thuần Dương Kiếm Tiên
人皇稻=Nhân Hoàng Đạo
劝农司=Khuyến Nông Tư
王法=Vương pháp
巫教=Vu giáo
持重=Trì Trọng
陛下=Bệ Hạ
迎客馆=Nghênh Khách Quán
农老头=Nông Lão Đầu
神稻=Thần Đạo
南道子=Nam Đạo Tử
大希公=Đại Hy Công
钦天监=Khâm Thiên Giám
农家=Nông Gia
蜀中贵女=Thục Trung Quý Nữ
麻教=Ma Giáo
泰山祭天台=Đài tế trời Thái Sơn
京中=Kinh Trung
泰山君=Thái Sơn Quân
农子=Nông Tử
勾曲山剑仙方斗=Câu Khúc Sơn Kiếm Tiên Phương Đấu
军臣=Quân Thần
凌火阁=Lăng Hỏa Các
火焰山=Hỏa Diệm Sơn
道子=Đạo Tử
厨家=Trù Gia
冶兵家=Dã Binh Gia
丹家=Đan Gia
南方道子=Nam Phương Đạo Tử
纵横子=Tông Hoành Tử
蜀中白帝剑仙=Thục Trung Bạch Đế Kiếm Tiên
王灵管=Vương Linh Quan
九天=Cửu Thiên
玉玺=Ngọc Tỉ
韦陀杵=Chử Vi Đà
关公战秦琼=Quan Công chiến Tần Quỳnh
王灵官=Vương Linh Quan
泰山神=Thái Sơn Thần
贤劫诸佛=Hiền kiếp chư Phật
悲华经=Bi Hoa kinh
火部铠甲=Hỏa bộ khải giáp
雷霆=Lôi đình
四方战将=Tứ phương chiến tướng
雷火=Lôi hỏa
百家教派=Bách Gia Giáo Phái
医家=Y Gia
雷火斗=Lôi Hỏa Đấu
本初真人=Bản Sơ chân nhân
蜀中剑修=Thục Trung kiếm tu
无漏钟=Vô Lậu Chung
毒家=Độc gia
提江真人=Đề Giang Chân Nhân
毒家之子=Độc Gia Chi Tử
商家之子=Thương Gia chi tử
灵米=Linh Mễ
命理家=Mệnh Lý Gia
阴阳家之子=Âm Dương Gia chi tử
苦行家=Khổ Hạnh Gia
行者杖=Hành Giả Trượng
盗家=Đạo Gia
盗家之子=Đạo Gia chi tử
容家=Dung Gia
命理家之子=Mệnh Lý Gia Chi Tử
乐家之子=Nhạc Gia Chi Tử
容家之子=Dung Gia chi Tử
真人=Chân Nhân
朝元=Triều Nguyên
窃影神通=Thiết Ảnh Thần Thông
吞天真气=Thôn Thiên Chân Khí
释门=Thích Môn
月明=Nguyệt Minh
北山之巅=Bắc Sơn Chi Điên
袁养正=Viên Dưỡng Chính
米巫=Mễ Vu
巫山云=Vu Sơn Vân
青山公=Thanh Sơn Công
白石公=Bạch Thạch Công
白泽=Bạch Trạch
灵明石猴=Linh Minh Thạch Hầu
悟空=Ngộ Không
麒麟=Kỳ Lân
北山=Bắc Sơn
蜀中三剑仙=Thục Trung Tam Kiếm Tiên
妙笔公=Diệu Bút Công
牧野战歌=Mục Dã Chiến Ca
青骑公=Thanh Kỵ Công
让骑=Nhượng Kỵ
白虹贯日=Bạch Hồng Quán Nhật
双子=Song Tử
南方道子丹融=Đạo Tử Đan Dung phương Nam
北方道子尘冲虚=Đạo Tử Trần Xung Hư phương Bắc
仙弈公=Tiên Dịch Công
陆地纵横=Lục Địa Tung Hoành
风水家之子=Phong thủy gia chi tử
镇国剑仙=Trấn quốc kiếm tiên
乐家=Nhạc gia
阴阳家=Âm Dương Gia
纵横之子=Tung Hoành Chi Tử
纵横家=Tung Hoành Gia
先天阴阳易经=Tiên Thiên Âm Dương Dịch Kinh
书万象=Thư Vạn Tượng
太上真君=Thái Thượng Chân Quân
二郎神=Nhị Lang Thần
天师=Thiên Sư
八水山=Bát Thủy Sơn
老火=Lão Hỏa
羽毛=Vũ Mao
青城剑仙=Thanh Thành kiếm tiên
岐黄之术=Kỹ thuật Kỳ Hoàng
纵横家之子=Con trai của nhà Tung Hoành
眉山公=Mi Sơn Công
凌霄剑仙=Lăng Tiêu Kiếm Tiên
天河水妖=Thiên Hà Thủy Yêu
渔家之子=Ngư Gia Chi Tử
厨家之子=Trù Gia Chi Tử
冶兵家之子=Dã Binh Gia Chi Tử
纯阳真人月明=Thuần Dương chân nhân Nguyệt Minh
蜀中仙剑=Thục Trung Tiên Kiếm
名教儒公=Danh Giáo Nho Công
医学家之子=Y học gia chi tử
苟曲山=Cẩu Khúc Sơn
金翅鹏=Kim Sí Bằng
军臣圣僧=Quân Thần Thánh Tăng
名子=Danh Tử
色空咖蓝=Sắc Không Già Lam
无相=Vô Tướng
黑子=Hắc Tử
百子元神=Bách Tử Nguyên Thần
白子=Bạch Tử
阴阳家主=Âm Dương Gia Chủ
米斗=Mễ Đấu
圣米=Thánh Mễ
天眼=Thiên Nhãn
星官神袍=Tinh Quan Thần Bào
十方世界=Thập Phương Thế Giới
六道轮回=Lục Đạo Luân Hồi
黑白双子=Hắc Bạch Song Tử
苗疆=Miêu Cương
昴宿=Mão Tú
卯日星君=Mão Nhật Tinh Quân
米斗空间=Mễ Đấu Không Gian
点星笔=Điểm Tinh Bút
托塔罗汉=Thác Tháp La Hán
功名榜=Công Danh Bảng
星轨册=Tinh Quỹ Sách
星官长袍=Tinh Quan Trường Bào
天将变=Thiên Tướng Biến
太阳真君=Thái Dương Chân Quân
日轮帝君=Nhật Luân Đế Quân
金乌=Kim Ô
轻影钱=Khinh Ảnh Tiền
鉴家之子=Giám Gia chi tử
巫家=Vu Gia
苦行家之子=Khổ Hành Gia chi tử
行天法杖=Hành Thiên Pháp Trượng
刑天=Hình Thiên
火部天章=Hỏa Bộ Thiên Chương
雷部正法=Lôi Bộ Chính Pháp
斗部神诀=Đấu Bộ Thần Quyết
风水家=Phong Thủy Gia
渔家=Ngư Gia
纯阳散人=Thuần Dương Tán Nhân
头陀=Đầu Đà
天闲星=Thiên Nhàn Tinh
地暗星=Địa Ám Tinh
三十六天罡=Tam Thập Lục Thiên Cương
七十二地煞=Thất Thập Nhị Địa Sát
北斗道宗=Bắc Đẩu Đạo Tông
紫胡子仙人=Tử Hồ Tử Tiên Nhân
雷火斗瘟四部=Lôi Hỏa Đấu Ôn Tứ Bộ
斗部=Đấu Bộ
斗姆元君=Đẩu Mẫu Nguyên Quân
月神=Nguyệt Thần
南斗星君=Nam Đẩu Tinh Quân
紫薇星君=Tử Vi Tinh Quân
天罡三十六=Thiên Cương Tam Thập Lục
地煞七十二=Địa Sát Thất Thập Nhị
天罡地煞=Thiên Cương Địa Sát
地暴星=Địa Bạo Tinh
九霄云外=Cửu Tiêu Vân Ngoại
韦驮天=Vi Đà Thiên
蜀中三位剑仙=Thục Trung Tam Vị Kiếm Tiên
天罡地煞神将=Thiên Cương Địa Sát Thần Tướng
承天景命=Thừa Thiên Cảnh Mệnh
帝师=Đế Sư
白帝剑仙=Bạch Đế Kiếm Tiên
儒公=Nho Công
星宿神兽=Tinh Tú Thần Thú
南极仙翁=Nam Cực Tiên Ông
南斗仙君=Nam Đẩu Tiên Quân
北斗星君=Bắc Đẩu Tinh Quân
二乌门=Nhị Ô Môn
群贤圣庙=Quần Hiền Thánh Miếu
山主老爷=Sơn chủ Lão gia
女少主=Nữ Thiếu Chủ
德芳=Đức Phương
拜祭学派=Bái Tế Học Phái
天河=Thiên Hà
天机星=Thiên Cơ Tinh
牧野公=Mục Dã Công
百家学派=Bách Gia Học Phái
补天长剑=Bổ Thiên Trường Kiếm
八九金罩=Bát Cửu Kim Tráo
雷部=Lôi Bộ
女土蝠=Nữ Thổ Bức
昴宿星官=Mão Túc Tinh Quan
武曲星君=Vũ Khúc Tinh Quân
朝元真人=Triều Nguyên chân nhân
纯火镯子=Vòng tay Thuần Hỏa
仙界=Tiên giới
丹家之子=Đan gia chi tử
大江之战=Đại Giang chi chiến
佛道菩萨=Phật Đạo Bồ Tát
九头鸟=Cửu Đầu Điểu
轮回=Luân Hồi
补天=Bổ Thiên
雷陨=Lôi Vẫn
相济=Tương Tế
星君=Tinh quân
巫家之子=Vu gia chi tử
火德星君=Hỏa Đức tinh quân
泰山=Thái Sơn
玉龙配=Ngọc Long Phối
纯阳真人=Chân Nhân Thuần Dương
蜀中三大剑仙=Thục Trung Tam Đại Kiếm Tiên
瘟部神通=Ôn Bộ Thần Thông
瘟部=Ôn Bộ
鲸袄=Kình Ảo
阴阳双子=Âm Dương song tử
水火星君=Thủy Hỏa tinh quân
鲸袄真人=Kình Áo Chân Nhân
北斗神将=Bắc Đẩu Thần Tướng
米教=Mễ Giáo
大觉=Đại Giác
九华=Cửu Hoa
佛子圆通=Phật Tử Viên Thông
圣僧=Thánh Tăng
道子丹融=Đạo Tử Đan Dung
北方道宗=Đạo Tông Phương Bắc
剑仙方斗=Kiếm Tiên Phương Đấu
百丈真人=Bách Trượng chân nhân
松竹=Tùng Trúc
秋收大祭=Thu Thu Đại Tế
九华寺=Cửu Hoa Tự
纯阳丹=Thuần Dương Đan
少年皇帝=Thiếu Niên Hoàng Đế
状元=Trạng Nguyên
巡边大臣=Tuần Biên Đại Thần
莫独玉=Mạc Độc Ngọc
黄山=Hoàng Sơn
山蓍=San Thi
山蓍真人=Sơn Thi chân nhân
明净=Minh Tịnh
大江=Đại Giang
女主岛=Nữ Chủ Đảo
慕容露娜=Mộ Dung Lộ Na
方小友=Phương tiểu hữu
短发真人=Đoản Phát Chân Nhân
穿山甲=Xuyên Sơn Giáp
佩玉真人=Bội Ngọc chân nhân
黄华=Hoàng Hoa
福元寺=Phúc Nguyên tự
观音殿=Quan Âm điện
元磁神光旗=Nguyên từ thần quang kỳ
红铜针=Hồng đồng châm
元磁神光针=Nguyên từ thần quang châm
许斗=Hứa Đấu
血咒玉简=Huyết chú ngọc giản
轮回转生盘=Luân hồi chuyển sinh bàn
地府=Địa phủ
天赐=Thiên Tứ
方老剑仙=Phương lão kiếm tiên
黄吻岛=Hoàng Vẫn Đảo
左岭=Tả Lĩnh
巢海三雄=Sào Hải Tam Hùng
皇岛国=Hoàng Đảo Quốc
慕容罗娜=Mộ Dung La Na
兵家=Binh gia
旋灵岛主=Toàn Linh đảo chủ
销金锉=Tiêu Kim Thoa
明王=Minh Vương
二凶=Nhị Hung
三凶=Tam Hung
鸡大师=Kê đại sư
星官变=Tinh Quan Biến
岳老儿=Nhạc lão nhi
祖骸=Tổ Hài
至凶鬼面=Chí hung quỷ diện
玉京=Ngọc Kinh
大凶=Đại Hung
巢海=Sào Hải
唐鸡可得=Đường Kê Khả Đắc
旋灵岛=Toàn Linh Đảo
六阳魁首=Lục Dương Khôi Thủ
封神演义=Phong Thần Diễn Nghĩa
花狐貂=Hoa Hồ Điêu
肖千帆=Tiêu Thiên Phàm
肖元帅=Tiêu Nguyên Soái
奇舟道友=Kỳ Chu đạo hữu
主瓶=Chủ Bình
七恶天王=Thất Ác Thiên Vương
唐姓真人=Đường Tính chân nhân
唐姓少年真人=Đường Tính Thiếu Niên Chân Nhân
归光岛主=Quy Quang đảo chủ
乾贝道友=Càn Bối đạo hữu
五路烽烟=Ngũ Lộ Phong Yên
奇舟道人=Kỳ Chu Đạo Nhân
黑瓜老怪=Hắc Qua lão quái
奇月真人=Kỳ Nguyệt chân nhân
古海之地=Cổ Hải Chi Địa
光阴贝=Quang Âm Bối
鹤首钢杖=Hạc Thủ Cương Trượng
丑恶天王=Xú Ác Thiên Vương
凶恶天王=Hung Ác Thiên Vương
扶桑=Phù Tang
扶桑爪牙=Phù Tang Trảo Nha
唐道友=Đường đạo hữu
谈贤弟=Đàm hiền đệ
谈兄=Đàm huynh
五恶天王=Ngũ Ác Thiên Vương
天残毒忍=Thiên Tàn Độc Nhẫn
古真人=Cổ chân nhân
恶天王=Ác Thiên Vương
黄花真人=Hoàng Hoa chân nhân
宝瓶真人=Bảo Bình chân nhân
草舟=Thảo Chu
黑爪邪党=Hắc Trảo tà đảng
海遁=Hải Độn
邙山=Mang Sơn
五鬼宗=Ngũ Quỷ Tông
鬼狱=Quỷ Ngục
奇舟=Kỳ Chu
乾贝=Càn Bối
黑爪老怪=Hắc Trảo Lão Quái
唐贤弟=Đường Hiền Đệ
地皇阎君=Địa Hoàng Diêm Quân
黄华真人=Hoàng Hoa Chân Nhân
星岛国=Tinh Đảo Quốc
万海盟=Vạn Hải Minh
陆地剑仙=Lục Địa Kiếm Tiên
巢海三凶=Sào Hải Tam Hung
丧魂客=Tang Hồn Khách
兵家之子=Binh Gia Chi Tử
正统=Chính Thống
新生=Tân Sinh
左岭真人=Tả Lĩnh Chân Nhân
女主国=Nữ Chủ Quốc
天瓶岛=Đảo Thiên Bình
东南道主=Đạo chủ Đông Nam
陆地=Lục Địa
劫主令=Kiếp Chủ Lệnh
方仙剑=Phương Tiên Kiếm
金线蛟=Kim Tuyến Giao
功德寻芳炉=Công Đức Tầm Phương Lô
天夜叉=Thiên Dạ Xoa
蜀中剑仙=Thục Trung kiếm tiên
西南=Tây Nam
通天宝扇=Thông Thiên Bảo Phiến
兵主旗=Binh Chủ Kỳ
扶桑秀士=Phù Tang Tú Sĩ
玄武元神=Huyền Vũ Nguyên Thần
问心剑路=Vấn Tâm Kiếm Lộ
万剑归一=Vạn Kiếm Quy Nhất
不断桑=Bất Đoạn Tang
太虚神戟=Thái Hư Thần Kích
劫主=Kiếp Chủ
方剑仙=Phương Kiếm Tiên
不休桑=Bất Hưu Tang
卢起=Lư Khởi
乾贝真人=Càn Bối chân nhân
岳尊=Nhạc Tôn
奇舟真人=Kỳ Chu chân nhân
百家天子=Bách Gia Thiên Tử
丹阳郡=Đan Dương Quận
师兄=Sư huynh
朝廷=Triều đình
名家=Danh gia
转世仙人=Chuyển thế tiên nhân
水德星君=Thủy Đức Tinh Quân
空自若=Không Tự Nhược
神目天君=Thần Mục Thiên Quân
代天选帝=Đại Thiên Tuyển Đế
仙人=Tiên Nhân
元磁神光=Nguyên Từ Thần Quang
捧日仙君=Bổng Nhật Tiên Quân
博学圣僧=Bác Học Thánh Tăng
大日=Đại Nhật
三帝=Tam Đế
显三家=Hiển Tam Gia
朝堂=Triều Đường
名教之子=Danh Giáo chi Tử
京城=Kinh Thành
海国=Hải Quốc
西域佛门=Tây Vực Phật Môn
紫微星=Tử Vi Tinh
玄武=Huyền Vũ
阎君=Diêm Quân
龙战于野，其血玄黄=Long chiến vu dã, kỳ huyết huyền hoàng
人皇=Nhân Hoàng
仙剑=Tiên Kiếm
佛陀=Phật Đà
净土=Tịnh Thổ
佛帝=Phật Đế
大师兄=Đại Sư Huynh
小师妹=Tiểu Sư Muội
剑仙=Kiếm Tiên
梦中龙战于野=Mộng Trung Long Chiến Ư Vuã
凌霄=Lăng Tiêu
白帝=Bạch Đế
青城=Thanh Thành
贵妃=Quý Phi
蜀中=Thục Trung
北斗星将=Bắc Đẩu Tinh Tướng
天罡=Thiên Cương
地煞=Địa Sát
自在天=Tự Tại Thiên
声闻天=Thanh Văn Thiên
吉祥天=Cát Tường Thiên
善财天=Thiện Tài Thiên
欢喜天=Hoan Hỉ Thiên
天魁星=Thiên Khôi Tinh
中土=Trung Thổ
海外=Hải Ngoại
西域=Tây Vực
文曲星=Văn Khúc Tinh
兵子=Binh Tử
武曲星=Vũ Khúc Tinh
白虎衔尸图=Bạch Hổ Hàm Thi Đồ
杜山恩=Đỗ Sơn Ân
愚公=Ngu Công
紫薇=Tử Vi
百子=Bách Tử
皇帝=Hoàng Đế
圣贤=Thánh Hiền
儒子=Nho Tử
医学家=Y Học Gia
医子=Y Tử
亢金龙=Kháng Kim Long
二十四诸天=Nhị Thập Tứ Chư Thiên
空门=Không Môn
散瘟天尊=Tán Ôn Thiên Tôn
罗汉=La Hán
乌门=Ô Môn
帝储=Đế Trữ
天河水军=Thiên Hà Thủy Quân
金木水火土=Kim Mộc Thủy Hỏa Thổ
星樽=Tinh Tôn
勾曲山=Câu Khúc Sơn
方王京=Phương Vương Kinh
剑山=Kiếm Sơn
尘冲虚=Trần Xung Hư
百丈=Bách Trượng
黄山道脉=Hoàng Sơn đạo mạch
道家=Đạo gia
天庭=Thiên Đình
冲虚=Xung Hư
菩萨=Bồ Tát
智慧神象=Trí tuệ thần tượng
荆棘公=Kinh Cức Công
游侠之子=Du Hiệp Chi Tử
求剑叟=Cầu Kiếm Tẩu
文武双星=Văn Võ Song Tinh
二十八星宿=Nhị Thập Bát Tinh Tú
一百零八天罡地煞=Nhất Bách Linh Bát Thiên Cương Địa Sát
二十八诸天=Nhị Thập Bát Chư Thiên
十八罗汉=Thập Bát La Hán
四正谛=Tứ Chính Đế
八正道=Bát Chính Đạo
珈蓝菩萨=Già Lam Bồ Tát
杞子=Kỷ Tử
五德星君=Ngũ Đức Tinh Quân
修天赐=Tu Thiên Tứ
圆通=Viên Thông
丹融=Đan Dung
帝心=Đế Tâm
佛道=Phật Đạo
名教=Danh Giáo
百家=Bách Gia
方玉京=Phương Ngọc Kinh
名家之子=Danh Gia Chi Tử
纯阳=Thuần Dương
狂人=Cuồng Nhân
天帝=Thiên Đế
方斗=Phương Đấu
袁明=Viên Minh
休天赐=Hưu Thiên Tứ
红鸾=Hồng Loan
天后=Thiên Hậu
英招山=Anh Chiêu Sơn
月明真人=Nguyệt Minh chân nhân
