丁巳月=Đinh Tị nguyệt
丙子日=Bính Tý nhật
天玑殿=Thiên Cơ Điện
风云台=Phong Vân Đài
丁丑=Đinh Sửu
丁亥=Đinh Hợi
丁酉=Đinh Dậu
丁未=Đinh Mùi
丁巳=Đinh Tỵ
丁卯=Đinh Mão
甲子=Giáp Tý
甲戌=Giáp Tuất
甲申=Giáp Thân
甲午=Giáp Ngọ
甲辰=Giáp Thìn
甲寅=Giáp Dần
浑元功=Hỗn Nguyên Công
追风掌=Truy Phong Chưởng
安拉胡阿克巴=Allahu Akbar
大周姬氏=Đại Chu Cơ thị
姜仲元=Khương Trọng Nguyên
游神行气法=Du Thần Hành Khí Pháp
观星望气=Quan Tinh Vọng Khí
水晶之肚=Thủy Tinh Chi Đổ
九阳神功=Cửu Dương Thần Công
江百川=Giang Bách Xuyên
丁震=Đinh Chấn
蔡志英=Thái Chí Anh
易扬=Dịch Dương
姜姓=họ Khương
纵横道=Tung Hoành Đạo
孙长老=Tôn trưởng lão
陈述=Trần Thuật
惊鸿七度=Kinh Hồng Thất Độ
赤岚烟罗=Xích Lam Yên La
阿宾=A Tân
女先生白洁=Nữ tiên sinh Bạch Khiết
天河神沙=Thiên Hà Thần Sa
青阳=Thanh Dương
惊雷=Kinh Lôi
祖师九天尚父五方都总管北极左垣上将都统大元帅天蓬真君=Tổ Sư Cửu Thiên Thượng Phụ Ngũ Phương Đô Tổng Quản Bắc Cực Tả Viên Thượng Tướng Đô Thống Đại Nguyên Soái Thiên Bồng Chân Quân
北斗破军星=Bắc Đẩu Phá Quân Tinh
七殿之主=Thất Điện Chi Chủ
兰花拂穴手=Lan Hoa Phất Huyệt Thủ
先天功=Tiên Thiên Công
阴符七术·实意法螣蛇=Âm phù thất thuật - Thực ý pháp Đằng Xà
剑心通明=Kiếm tâm thông minh
赤霞烟岚=Xích Hà Yên Lam
风伯雨师=Phong Bá Vũ Sư
天女=Thiên Nữ
大荒北经=Đại Hoang Bắc Kinh
五龙=Ngũ Long
庚申月=Canh Thân nguyệt
辛丑日=Tân Sửu nhật
惊雷师兄=Kinh Lôi sư huynh
秋水师姐=Thu Thủy sư tỷ
万叶飞花掌=Vạn Diệp Phi Hoa Chưởng
萧师道=Tiêu Sư Đạo
公孙师姐=Công Tôn sư tỷ
叶雨迟=Diệp Vũ Trì
袁天罡=Viên Thiên Cương
全真=Toàn Chân
卡兹=Katz
地风升=Địa Phong Thăng
九黎刀章=Cửu Lê Đao Chương
九窍=Cửu Khiếu
天下会=Thiên Hạ Hội
地灵草=Địa Linh Thảo
桥县=Kiều Huyện
碧水镇=Bích Thủy Trấn
龙泉镇=Long Tuyền Trấn
崇明岛=Sùng Minh Đảo
急急如律令=Cấp Cấp Như Luật Lệnh
少侠阿宾=Thiếu Hiệp A Bin
常山郡=Thường Sơn Quận
巨鹿郡=Cự Lộc Quận
清河=Thanh Hà
神都云县=Thần Đô Vân Huyện
王越=Vương Việt
六丁六甲=Lục Đinh Lục Giáp
六品道器=Lục Phẩm Đạo Khí
李鬼=Lý Quỷ
纪师兄=Kỷ sư huynh
谯明之山=Tiều Minh Chi Sơn
谯水=Tiều Thủy
山巅天枢殿=Sơn Điên Thiên Xu Điện
紫袍中年天玑长老=Tử Bào Trung Niên Thiên Cơ trưởng lão
暗世玄流=Ám Thế Huyền Lưu
何罗鱼=Hà La Ngư
玄门三皇派=Huyền Môn Tam Hoàng Phái
姬氏皇族=Cơ Thị Hoàng Tộc
张振阳=Trương Chấn Dương
世本=Thế Bản
李重岳=Lý Trọng Nhạc
天兵神威=Thiên Binh Thần Uy
奉天讨逆=Phụng Thiên Thảo Nghịch
六合枪法=Lục Hợp Thương Pháp
黄铜浑天仪=Hoàng Đồng Hỗn Thiên Nghi
文士=Văn sĩ
尾闾关=Vĩ Lư Quan
命门关=Mệnh Môn Quan
艮山=Cấn Sơn
孔夫子=Khổng Phu Tử
鼎湖北面=Đỉnh Hồ bắc diện
北玄=Bắc Huyền
丘怀安=Khâu Hoài An
天玑师兄=Thiên Cơ sư huynh
天玑禄存=Thiên Cơ Lộc Tồn
玉衡廉贞=Ngọc Hành Liêm Trinh
紫山根=Tử Sơn Căn
金戈草=Kim Qua Thảo
紫荆花=Tử Kinh Hoa
《百草经》=《Bách Thảo Kinh》
奎木星官=Khuê Mộc Tinh Quan
大菩萨=Đại Bồ Tát
骠骑将军·冠军侯=Phiêu Kỵ Tướng Quân - Quán Quân Hầu
百草经=Bách Thảo Kinh
西方昆虚仙宫=Tây Phương Côn Khư Tiên Cung
织女=Chức Nữ
裁云=Tài Vân
真定姜家=Chân Định Khương Gia
阴山鬼王=Âm Sơn Quỷ Vương
真定郡=Chân Định Quận
圣地=Thánh địa
悟空=Ngộ Không
应龙之鳞=Ứng Long Chi Lân
罗仪=La Nghi
天目符=Thiên Mục Phù
五力士符=Ngũ Lực Sĩ Phù
绝处逢生，华而不败=Tuyệt xứ phùng sinh, hoa nhi bất bại
姜师兄=Khương sư huynh
春满楼=Xuân Mãn Lâu
小桃红=Tiểu Đào Hồng
搬山力士=Bàn Sơn Lực Sĩ
神行符=Thần Hành Phù
阳山=Dương Sơn
阳水=Dương Thủy
伊水=Y Thủy
斩妖吞孽咒=Trảm Yêu Thôn Nghiệt Chú
姜冲=Khương Xung
杨冲=Dương Xung
任县令=Nhậm huyện lệnh
医者=Y giả
律令=Luật Lệnh
凰君=Hoàng Quân
南飞云=Nam Phi Vân
巫觋=Vu Hịch
向枢使=Hướng Khu Sứ
月老=Nguyệt Lão
连天璇=Liên Thiên Toàn
李寻欢=Lý Tầm Hoan
墨蛇=Mặc Xà
千机伞=Thiên Cơ Tán
神行太保枢使向云天=Thần Hành Thái Bảo Xu Sứ Hướng Vân Thiên
景云县=Cảnh Vân huyện
江怀民=Giang Hoài Dân
白门楼=Bạch Môn Lâu
彦祖=Ngạn Tổ
方天画戟=Phương Thiên Họa Kích
易数玄学=Dịch số huyền học
祝融相=Chúc Dung Tướng
狐岐=Hồ Kỳ
九灲（xiāo）离经=Cửu Tiêu Ly Kinh
岐山姜=Kỳ Sơn Khương
七星=Thất Tinh
姜府=Khương phủ
姜大善人=Khương Đại Thiện Nhân
姜家大爷=Khương gia đại gia
飞云=Phi Vân
指南剑法=Chỉ Nam Kiếm Pháp
岐山县城=Kỳ Sơn Huyện Thành
七叶断肠草=Thất Diệp Đoạn Trường Thảo
无生花=Vô Sinh Hoa
紫棘叶=Tử Gai Diệp
眠狂草=Miên Cuồng Thảo
昴日鸡=Mão Nhật Kê
炎阳刀=Viêm Dương Đao
九泉心诀=Cửu Tuyền Tâm Quyết
左辅=Tả Phụ
右弼=Hữu Bật
文昌=Văn Xương
阴阳双流掌=Âm Dương Song Lưu Chưởng
飞云姜家=Phi Vân Khương Gia
龙爪=Long Trảo
姜元奇=Khương Nguyên Kỳ
曹丞相=Tào Thừa Tướng
华容道=Hoa Dung Đạo
飞云镇=Phi Vân Trấn
姜无咎=Khương Vô Cữu
大周朝=Đại Chu Triều
祝师=Chúc Sư
天人合一=Thiên Nhân Hợp Nhất
眉心紫府=Mi Tâm Tử Phủ
上丹田=Thượng Đan Điền
心窍绛宫=Tâm Khiếu Giáng Cung
中丹田=Trung Đan Điền
腹下黄庭=Phúc Hạ Hoàng Đình
下丹田=Hạ Đan Điền
神都飞云姜家=Thần Đô Phi Vân Khương Gia
姬家=Cơ Gia
李县令=Lý huyện lệnh
任子和=Nhậm Tử Hòa
李翼=Lý Dực
云兄=Vân huynh
岐山姜氏=Kỳ Sơn Khương Thị
扶风郡守=Phù Phong Quận Thủ
野狐岭=Dã Hồ Lĩnh
姜无野=Khương Vô Dã
姜昭义=Khương Chiêu Nghĩa
剪云峰=Tiễn Vân Phong
天山遁=Thiên Sơn Độn
姜昭仁=Khương Chiêu Nhân
福神道器玉如意=Phúc Thần Đạo Khí Ngọc Như Ý
司晨啼晓=Tư Thần Đề Hiểu
扶风郡城=Phù Phong quận thành
并州高阳=Tịnh Châu Cao Dương
钟师兄=Chung sư huynh
并州=Tịnh Châu
那伽=Na Già
扶风=Phù Phong
格物=Cách Vật
元帅横天乱地咒=Nguyên Soái Hoành Thiên Loạn Địa Chú
人皇轩辕=Nhân Hoàng Hiên Viên
神都皇宫=Thần Đô Hoàng Cung
小雷仙·杨殛=Tiểu Lôi Tiên · Dương Cực
天慧堂=Thiên Tuệ Đường
临山=Lâm Sơn
回春符=Hồi Xuân Phù
养气符=Dưỡng Khí Phù
孟元支=Mạnh Nguyên Chi
獬豸=Giải Trãi
雨师祭坛=Vũ Sư Tế Đàn
雨师道果=Vũ Sư Đạo Quả
傩面=Na Diện
姜敬元=Khương Kính Nguyên
六合符阵=Lục Hợp Phù Trận
阴符七术·养志法灵龟=Âm Phù Thất Thuật · Dưỡng Chí Pháp Linh Quy
青阳符剑=Thanh Dương Phù Kiếm
一气大擒拿=Nhất Khí Đại Cầm Nã
风师兄=Phong sư huynh
明真道人=Minh Chân Đạo Nhân
鱼奉先=Ngư Phụng Tiên
董相国=Đổng Tướng Quốc
紫气东来=Tử Khí Đông Lai
天众=Thiên Chúng
提婆族=Đề Bà Tộc
大衍五十=Đại Diễn Ngũ Thập
明光符=Minh Quang Phù
碧焰阴雷刀=Bích Diễm Âm Lôi Đao
罗刹=La Sát
赤红剑光=Xích Hồng Kiếm Quang
格物刀=Cách Vật Đao
纪云流=Kỷ Vân Lưu
捷疾可畏=Tiệp Tật Khả Úy
神通力=Thần Thông Lực
暴恶鬼面=Bạo Ác Quỷ Diện
雷部正神三五火车雷公=Lôi Bộ Chính Thần Tam Ngũ Hỏa Xa Lôi Công
佑圣真君=Hữu Thánh Chân Quân
姜道山=Khương Đạo Sơn
文宗=Văn Tông
天符号雷=Thiên Phù Hào Lôi
雷边捷鬼=Lôi Biên Tiệp Quỷ
七星河=Thất Tinh hà
八神主=Bát Thần Chủ
淮河水神=Hoài Hà Thủy Thần
守静心诀=Thủ Tĩnh Tâm Quyết
幽灵牛车=U Linh Ngưu Xa
牛角=Ngưu Giác
太白经天=Thái Bạch Kinh Thiên
马面罗刹=Mã Diện La Sát
狱吏=Ngục Lại
日巡=Nhật Tuần
勾魂使者=Câu Hồn Sứ Giả
妖人=Yêu Nhân
庚金剑气=Canh Kim Kiếm Khí
天蓬咒=Thiên Bồng Chú
九天雷霆=Cửu Thiên Lôi Đình
马面=Mã Diện
阴风鬼蜮=Âm Phong Quỷ Vực
临山镇=Lâm Sơn trấn
凤泉河=Phượng Tuyền hà
阎罗道果=Diêm La đạo quả
西极=Tây Cực
福神玉如意=Phúc Thần Ngọc Như Ý
西凉山=Tây Lương Sơn
神农像=Tượng Thần Nông
六丁六甲护身符=Lục Đinh Lục Giáp hộ thân phù
鲁王世子姬承业=Lỗ Vương thế tử Cơ Thừa Nghiệp
大阿罗汉=Đại A La Hán
御士=Ngự Sĩ
牛头马面=Ngưu Đầu Mã Diện
天鼋=Thiên Nguyên
轩辕剑典=Hiên Viên Kiếm Điển
封狼居胥=Phong Lang Cư Tư
西方=Tây Phương
白莲=Bạch Liên
萧九娘=Tiêu Cửu Nương
火宅佛狱之主=Hỏa Trạch Phật Ngục Chi Chủ
秋水=Thu Thủy
墨武=Mặc Võ
九元煞童=Cửu Nguyên Sát Đồng
阴阳本根=Âm Dương Bản Căn
高周波=Cao Chu Ba
六道轮回浮屠禁典=Lục Đạo Luân Hồi Phù Đồ Cấm Điển
降魔印=Hàng Ma Ấn
天龙吼=Thiên Long Hống
养元丹=Dưỡng Nguyên Đan
活神露=Hoạt Thần Lộ
担山超海=Đảm Sơn Siêu Hải
千秋永存=Thiên Thu Vĩnh Tồn
真龙血裔=Chân Long Huyết Duệ
碑镇山河=Bi Trấn Sơn Hà
长寿吉祥=Trường Thọ Cát Tường
风乎舞雩=Phong Hồ Vũ Vu
正气歌=Chính Khí Ca
秋水剑=Thu Thủy Kiếm
鲁王姬野=Lỗ Vương Cơ Dã
长驸马风满楼=Trưởng Phò Mã Phong Mãn Lâu
华阳长公主=Hoa Dương Trưởng công chúa
中指峰=Trung Chỉ Phong
太清神光=Thái Thanh Thần Quang
雷火=Lôi Hỏa
大周朝廷=Đại Chu Triều Đình
帝流浆=Đế Lưu Tương
庚申=Canh Thân
苦一苦=Khổ Nhất Khổ
巽位=Tốn vị
雍州刺史洪好古=Thứ sử Ung Châu Hồng Hảo Cổ
天水郡=Thiên Thủy quận
天水郡守王奇=Thái thú Thiên Thủy quận Vương Kỳ
王奇=Vương Kỳ
安定郡=An Định quận
安定郡守杨淼=Thái thú An Định quận Dương Miểu
杨淼=Dương Miểu
扶风郡守姜之焕=Thái thú Phù Phong quận Khương Chi Hoán
玉虚=Ngọc Hư
值年太岁=Trực Niên Thái Tuế
增福神=Tăng Phúc Thần
炎武阁=Viêm Võ Các
北斗=Bắc Đẩu
南斗=Nam Đẩu
艾草=Ngải cứu
陵光姑姑=Lăng Quang cô cô
姬野=Cơ Dã
孟婆汤=Canh Mạnh Bà
楚江王=Sở Giang Vương
少教主杨殛=Thiếu giáo chủ Dương Cực
真人=Chân Nhân
真人之境=Chân Nhân Chi Cảnh
赤翎殿=Xích Linh Điện
巳时=Tị thời
苍梧=Thương Ngô
关师叔=Quan sư thúc
求返其真=Cầu Phản Kỳ Chân
天赐神兵=Thiên Tứ Thần Binh
奉天征讨=Phụng Thiên Chinh Thảo
巡值四方=Tuần Trị Tứ Phương
功曹道果=Công Tào Đạo Quả
墨武刀=Mặc Võ Đao
龙虎天师=Long Hổ Thiên Sư
李真君=Lý Chân Quân
楚昭元=Sở Chiêu Nguyên
辛酉月=Tân Dậu nguyệt
戊子日=Mậu Tý nhật
天权星=Thiên Quyền Tinh
族老=Tộc lão
雷地豫=Lôi Địa Dự
赐福天官=Tứ Phúc Thiên Quan
老五=Lão Ngũ
太玄金刀=Thái Huyền Kim Đao
瑶池仙舟=Dao Trì Tiên Chu
金童·牛郎=Kim Đồng・Ngưu Lang
摇光师弟=Dao Quang sư đệ
少阳天箓=Thiếu Dương Thiên Lục
武曲坪=Vũ Khúc Bình
曹玄德=Tào Huyền Đức
宋朝=Tống Triều
旗山=Kỳ Sơn
麟德历=Lân Đức Lịch
推背图=Thôi Bối Đồ
后土相=Hậu Thổ Tướng
神躯=Thần Khu
降妖伏魔=Hàng Yêu Phục Ma
纠罚=Củ Phạt
护法=Hộ Pháp
八部天龙广力普萨之相=Bát Bộ Thiên Long Quảng Lực Phổ Tát Chi Tướng
方丈=Phương Trượng
瀛州=Doanh Châu
广明道长=Quảng Minh đạo trưởng
剑峰=Kiếm Phong
玄明道士=Huyền Minh đạo sĩ
凌厉=Lăng Lệ
太阳金羽=Thái Dương Kim Vũ
柔云精粹=Nhu Vân Tinh Túy
神珍铁=Thần Trân Thiết
玉虚观剑法·太乙分光剑=Ngọc Hư Quan Kiếm Pháp · Thái Ất Phân Quang Kiếm
先天木炁=Tiên Thiên Mộc Khí
紫雷金铜=Tử Lôi Kim Đồng
天志战剑=Thiên Chí Chiến Kiếm
看胸识人=Khán Hung Thức Nhân
玄明=Huyền Minh
大匠师=Đại tượng sư
巽剑道=Tốn Kiếm Đạo
超电磁剑诀=Siêu Điện Từ Kiếm Quyết
罗刹鬼王=La Sát Quỷ Vương
乾剑道=Càn Kiếm Đạo
上穷碧落=Thượng Cùng Bích Lạc
龙岳大匠师=Long Nhạc đại tượng sư
福留肾穴=Phúc Lưu Thận Huyệt
天沉铁=Thiên Trầm Thiết
金乌羽=Kim Ô Vũ
西方精金=Tây Phương Tinh Kim
柔云之精=Nhu Vân Chi Tinh
紫电金铜=Tử Điện Kim Đồng
如意玄铁=Như Ý Huyền Thiết
木炁=Mộc Khí
金炁=Kim Khí
复古派=Phái Phục Cổ
华岳神女=Hoa Nhạc Thần Nữ
灵曲河=Linh Khúc Hà
造化神刀=Tạo Hóa Thần Đao
云莱岛=Vân Lai Đảo
明玉真=Minh Ngọc Chân
净坤体=Tịnh Khôn Thể
九幽素阴元女道体=Cửu U Tố Âm Nguyên Nữ Đạo Thể
青龙孟家=Thanh Long Mạnh Gia
孟晚舟=Mạnh Vãn Chu
接仙台=Tiếp Tiên Đài
陆小凤=Lục Tiểu Phụng
璇玑殿=Toàn Cơ Điện
幻灵慑心阵=Huyễn Linh Nhiếp Tâm Trận
龙渊=Long Uyên
纯阳真人吕洞宾=Thuần Dương chân nhân Lã Động Tân
钟离权=Chung Ly Quyền
紫极殿=Tử Cực Điện
三清神像=Tượng Tam Thanh
咸鱼=Cá muối
三清殿=Tam Thanh Điện
提挈天地=Đề Huề Thiên Địa
寿敝天地=Thọ Tệ Thiên Địa
剑光分化=Kiếm Quang Phân Hóa
本命飞剑=Bản Mệnh Phi Kiếm
明月=Minh Nguyệt
通明堂=Thông Minh Đường
飞剑斩黄龙=Phi Kiếm Trảm Hoàng Long
鬼影鞭=Quỷ Ảnh Tiên
崔判官=Thôi Phán Quan
万寿山=Vạn Thọ Sơn
四季花=Tứ Quý Hoa
抱朴堂=Bão Phác Đường
四魔=Tứ Ma
云县姜氏=Vân Huyện Khương Thị
他化自在天主——大自在天子波旬=Tha Hóa Tự Tại Thiên Chủ - Đại Tự Tại Thiên Tử Ba Tuần
九尾狐=Cửu Vĩ Hồ
神都云县姜氏=Thần Đô Vân Huyện Khương Thị
褚江=Chử Giang
云断青天=Vân Đoạn Thanh Thiên
如履平地=Như Lí Bình Địa
神行八步=Thần Hành Bát Bộ
飞云使者=Phi Vân Sứ Giả
封云杰=Phong Vân Kiệt
小高=Tiểu Cao
黄庭=Hoàng Đình
神都王家=Thần Đô Vương gia
杜少保=Đỗ Thiếu Bảo
东厢房=Đông Sương Phòng
西厢房=Tây Sương Phòng
纯阳=Thuần Dương
袇房=Nhiễm Phòng
步仙子=Bộ Tiên Tử
沈大人=Thẩm đại nhân
姬成稷=Cơ Thành Tắc
高侃=Cao Khản
沈可法=Thẩm Khả Pháp
王千峰=Vương Thiên Phong
九月初一=Ngày 1 tháng 9 âm lịch
壬戌月=Tháng Nhâm Tuất
丙午日=Ngày Bính Ngọ
射龙台=Xạ Long Đài
姜家=Khương Gia
文虚真人=Văn Hư chân nhân
姜氏族人=Khương thị tộc nhân
周太祖=Chu Thái Tổ
尔康=Nhĩ Khang
东山=Đông Sơn
千钧臂=Thiên Quân Tí
坤阴=Khôn Âm
幽天玄金体=U Thiên Huyền Kim Thể
西华妙道真经=Tây Hoa Diệu Đạo Chân Kinh
左枢使=Tả Khu Sứ
先天真身法=Tiên Thiên Chân Thân Pháp
铁柱=Thiết Trụ
南天司枢使·左招=Nam Thiên Tư Xu Mật Sử · Tả Chiêu
玄皓=Huyền Hạo
江离=Giang Ly
太白真君李玄=Thái Bạch Chân Quân Lý Huyền
噙血荡元=Hàm huyết đãng nguyên
明珠在椟，含光忍辱=Minh châu tại độc, hàm quang nhẫn nhục
宗明=Tông Minh
擎羊=Kình Dương
铃星=Linh Tinh
左卿=Tả Khanh
姬承源=Cơ Thừa Nguyên
六识颠倒=Lục thức điên đảo
气浊血滞=Khí trọc huyết trệ
魂离魄散=Hồn ly phách tán
赤龙=Xích Long
形销骨立=Hình tiêu cốt lập
四皇子姬承源=Tứ hoàng tử Cơ Thừa Nguyên
瘟癀大帝=Ôn Hoằng Đại Đế
神都城=Thần Đô Thành
白云=Bạch Vân
道光=Đạo Quang
兜率紫火=Đâu Suất Tử Hỏa
文虚=Văn Hư
龙吟=Long Ngâm
兜率神火=Đâu Suất Thần Hỏa
凭虚御风=Bằng Hư Ngự Phong
关家=Quan Gia
昭华炉=Chiêu Hoa Lô
三尸神=Tam Thi Thần
蟠桃=Bàn Đào
金丹=Kim Đan
云县姜家=Vân Huyện Khương Gia
吕祖=Lã Tổ
沐凌衣=Mộc Lăng Y
太学大祭酒=Thái Học Đại Tế Tửu
冯正=Phùng Chính
承源=Thừa Nguyên
阿鱼=A Ngư
明德坊=Minh Đức Phường
常洛=Thường Lạc
大荒经=Đại Hoang Kinh
流波山=Lưu Ba Sơn
九卿=Cửu Khanh
国庆=Quốc khánh
夫子=Phu Tử
云山=Vân Sơn
方云山=Phương Vân Sơn
许邈=Hứa Miểu
太医令=Thái y lệnh
太医署=Thái y thự
抡语=Luân ngữ
蓝蝶=Lam Điệp
听风阁=Thính Phong Các
祭酒=Tế Tửu
文昌殿=Văn Xương Điện
崔向忠=Thôi Hướng Trung
通元子=Thông Nguyên Tử
怀义=Hoài Nghĩa
狴犴=Bệ Ngạn
万辅座=Vạn Phụ Tọa
万卿=Vạn Khanh
五浊=Ngũ Trược
姬常洛=Cơ Thường Lạc
曹元龙=Tào Nguyên Long
大公公曹林=Đại công công Tào Lâm
云明阁=Vân Minh Các
京兆府左内史=Kinh Triệu Phủ Tả Nội Sử
沈府=Phủ Thẩm
一阳初生=Nhất Dương Sơ Sinh
长乐门=Trường Lạc Môn
开元门=Khai Nguyên Môn
红云散花针=Hồng Vân Tán Hoa Châm
红云散花=Hồng Vân Tán Hoa
纤云弄巧=Tiêm Vân Lộng Xảo
七杀破军，羊铃为虐=Thất Sát Phá Quân, Dương Linh Vi Ngược
赤犬=Xích Khuyển
北山经=Bắc Sơn Kinh
狱法之山=Ngục Pháp Chi Sơn
公孙氏=Công Tôn Thị
齐王=Tề Vương
庄王=Trang Vương
代王=Đại Vương
奉常=Phụng Thường
司录参军=Tư Lục Tham Quân
司法参军=Tư Pháp Tham Quân
司兵参军=Tư Binh Tham Quân
云县=Vân Huyện
墨剑=Mặc Kiếm
廉贞=Liêm Trinh
九天聚仙=Cửu Thiên Tụ Tiên
众星拱月=Chúng Tinh Củng Nguyệt
受命于天=Thụ Mệnh Vu Thiên
小红狗=Tiểu Hồng Cẩu
红莲=Hồng Liên
家主=Gia chủ
师宝男=Sư Bảo Nam
观音菩萨=Quan Âm Bồ Tát
青玥郡主=Thanh Nguyệt Quận Chúa
我妈=Mẹ tôi
姬承稷=Cơ Thừa Tắc
宗海=Tông Hải
角木蛟=Giác Mộc Giao
盘龙枪=Bàn Long Thương
红狗=Hồng Cẩu
君子风=Quân Tử Phong
来福=Lai Phúc
常威=Thường Uy
萨卡斯基=Sakazuki
司马=Tư Mã
天青化龙诀=Thiên Thanh Hóa Long Quyết
京兆府=Kinh Triệu phủ
沈源=Thẩm Nguyên
步玉笙=Bộ Ngọc Sanh
孟修吾=Mạnh Tu Ngô
黄龙街=Hoàng Long Nhai
王守立=Vương Thủ Lập
杜家=Đỗ gia
齐家=Tề gia
萧家=Tiêu gia
高岳=Cao Nhạc
华阳公主=Hoa Dương công chúa
黄帝土皇道=Hoàng Đế Thổ Hoàng Đạo
九地锁天罡=Cửu Địa Tỏa Thiên Cương
道德紫气=Đạo Đức Tử Khí
明扬=Minh Dương
府君=Phủ Quân
广寒月神=Quảng Hàn Nguyệt Thần
太阴星=Thái Âm Tinh
华阳公主府=Phủ Hoa Dương Công chúa
判官崔珏=Phán Quan Thôi Giác
玉华宫=Ngọc Hoa Cung
王家=Vương gia
孟长林=Mạnh Trường Lâm
阎王=Diêm Vương
赵客=Triệu Khách
钟兄=Chung huynh
判官·钟馗=Phán Quan · Chung Quỳ
阳灵鬼武诀=Dương Linh Quỷ Võ Quyết
太清九天剑=Thái Thanh Cửu Thiên Kiếm
现象玩占=Hiện Tượng Ngoạn Chiêm
舆鬼五星=Dư Quỷ Ngũ Tinh
神剑御雷高周波真诀=Thần Kiếm Ngự Lôi Cao Chu Ba Chân Quyết
乾阳殿=Càn Dương Điện
姬氏宗正=Cơ Thị Tông Chính
纳魂布袋=Nạp Hồn Bố Đại
都统=Đô Thống
崔府君=Thôi Phủ Quân
孟家主=Mạnh gia chủ
紫阳宗=Tử Dương Tông
伏牛山=Phục Ngưu Sơn
鬼金羊=Quỷ Kim Dương
星日马=Tinh Nhật Mã
周明云=Chu Minh Vân
神农九泉=Thần Nông Cửu Tuyền
超电磁真诀=Siêu Điện Từ Chân Quyết
赤霞山=Xích Hà Sơn
妖王=Yêu Vương
夜游神=Dạ Du Thần
封豨=Phong Hi
庚金不灭体=Canh Kim Bất Diệt Thể
老五凌无觉=Lão Ngũ Lăng Vô Giác
李某=Lý mỗ
西边=phía Tây
郡城平昌=Quận thành Bình Xương
阿修罗道果=A Tu La Đạo Quả
化蛇=Hóa Xà
灶公=Táo Công
九玄代身符=Cửu Huyền Đại Thân Phù
红孩儿=Hồng Hài Nhi
玄冥一气雷=Huyền Minh Nhất Khí Lôi
江阳县=Giang Dương huyện
魔罗波旬=Ma La Ba Tuần
舍卫国祇树给孤独园=Xá Vệ Quốc Kỳ Thụ Cấp Cô Độc Viên
大雷音剑诀=Đại Lôi Âm Kiếm Quyết
庚金剑诀=Canh Kim Kiếm Quyết
八荒凶神=Bát Hoang Hung Thần
索命夜叉=Sách Mệnh Dạ Xoa
六阴鬼王=Lục Âm Quỷ Vương
武阳=Võ Dương
魁梧=Khôi Ngô
天香阁=Thiên Hương Các
宙道=Trụ Đạo
苏厉=Tô Lệ
钦天监=Khâm Thiên Giám
江阳城=Giang Dương Thành
翻江蛟=Phiên Giang Giao
宇道阵法=Vũ Đạo Trận Pháp
谢将军=Tạ tướng quân
龙渊剑=Long Uyên Kiếm
真龙九击=Chân Long Cửu Kích
神蝗幡=Thần Hoàng Phiên
天龙探爪=Thiên Long Thám Trảo
敖丙=Ngao Bính
东海龙宫=Đông Hải Long Cung
曲灵言=Khúc Linh Ngôn
太白剑诀=Thái Bạch Kiếm Quyết
先天易剑=Tiên Thiên Dịch Kiếm
钟山=Chung Sơn
龙影=Long ảnh
槐江之山=Hòe Giang Chi Sơn
坤阴真元=Khôn Âm Chân Nguyên
盘龙=Bàn Long
坤元=Khôn Nguyên
姜林=Khương Lâm
魔罗之境=Ma La Chi Cảnh
殷师叔=Ân sư thúc
洛南郡=Lạc Nam Quận
拘夷那竭国=Câu Di Na Yết Quốc
大圆镜智=Đại Viên Kính Trí
大自在天主业如来=Đại Tự Tại Thiên Chủ Nghiệp Như Lai
齐阳河=Tề Dương Hà
西土佛国=Tây Thổ Phật Quốc
七星龙渊=Thất Tinh Long Uyên
洛书阵法=Lạc Thư Trận Pháp
法外逍遥李清涟=Pháp Ngoại Tiêu Dao Lý Thanh Liên
江罗汉=Giang La Hán
文虚师兄=Văn Hư sư huynh
人王·禹=Nhân Vương · Vũ
李清涟师兄=Lý Thanh Liên sư huynh
祖地=Tổ Địa
地云黄霙=Địa Vân Hoàng Anh
黄天庙=Hoàng Thiên miếu
神州姜氏=Thần Châu Khương thị
赵盾=Triệu Thuẫn
晋灵公=Tấn Linh Công
赵穿=Triệu Xuyên
破军榜=Phá Quân bảng
北极四圣=Bắc Cực Tứ Thánh
真武大帝=Chân Võ Đại Đế
丧门星=Tang Môn Tinh
青玉坛=Thanh Ngọc Đàn
蹈海力士=Đạp Hải Lực Sĩ
雷鼓力士=Lôi Cổ Lực Sĩ
撼山手=Hám Sơn Thủ
北斗七元=Bắc Đẩu Thất Nguyên
天罡大圣=Thiên Cương Đại Thánh
北斗七元符=Bắc Đẩu Thất Nguyên Phù
巨灵崩天捶=Cự Linh Băng Thiên Chuy
巨灵真罡经=Cự Linh Chân Cương Kinh
安期生=An Kỳ Sinh
青元山人=Thanh Nguyên Sơn Nhân
朱裳=Chu Thường
褚延=Chử Diên
八岐大神=Bát Kỳ Đại Thần
崇山峻岭=Sùng Sơn Tuấn Lĩnh
雷坤=Lôi Khôn
蜀郡二圣庙=Thục Quận Nhị Thánh Miếu
云海天光镜=Vân Hải Thiên Quang Kính
雍州姜氏=Ung Châu Khương thị
炎帝神像=Viêm Đế thần tượng
崔珏=Thôi Giác
墨侠=Mặc Hiệp
寿华之野=Thọ Hoa Chi Dã
昆仑虚=Côn Luân Hư
摇光师兄=Dao Quang sư huynh
育归流=Dục Quy Lưu
春秋剑=Xuân Thu Kiếm
天荡式=Thiên Đãng Thức
干戚舞=Càn Thích Vũ
断崖之剑=Đoạn Nhai chi kiếm
归藏定位=Quy Tàng Định Vị
短狐=Đoản Hồ
育藏海=Dục Tàng Hải
风、火、兵三灾=Phong, Hỏa, Binh Tam Tai
墨门剑法=Mặc Môn kiếm pháp
天厉刃=Thiên Lệ Nhận
坎宫斗姆=Khảm Cung Đẩu Mẫu
姬玄=Cơ Huyền
天之厉刃=Thiên Chi Lệ Nhận
众星化海=Chúng Tinh Hóa Hải
墨武战匣=Mặc Võ Chiến Hạp
左招=Tả Chiêu
净尘咒=Tịnh Trần Chú
水灵愈体符=Thủy Linh Dũ Thể Phù
昆仑镜=Côn Luân Kính
何罗=Hà La
百草=Bách Thảo
庄周梦蝶=Trang Chu mộng điệp
庄子三剑=Trang Tử Tam Kiếm
鲲鹏=Côn Bằng
南华经=Nam Hoa Kinh
佛门六字大明咒=Phật Môn Lục Tự Đại Minh Chú
方叶生=Phương Diệp Sinh
天蓬师兄=Thiên Bồng sư huynh
神木战袍=Thần Mộc Chiến Bào
大圜=Đại Hoàn
二圣庙=Nhị Thánh Miếu
轩辕殿=Hiên Viên Điện
九天聚仙阵=Cửu Thiên Tụ Tiên Trận
八邪罗生=Bát Tà La Sinh
姜之焕=Khương Chi Hoán
扶风郡=Phù Phong Quận
地祇=Địa Kỳ
癸卯年=Quý Mão Niên
乙丑月=Ất Sửu Nguyệt
壬申日=Nhâm Thân Nhật
酉时三刻=Dậu Thời Tam Khắc
许知林=Hứa Tri Lâm
云明郡=Vân Minh Quận
江正=Giang Chính
玉疏颜=Ngọc Sơ Nhan
谶纬=Sấm Vĩ
蜀王妃=Thục Vương Phi
黄龙丹=Hoàng Long Đan
天木重劫=Thiên Mộc Trọng Kiếp
郡城=Quận thành
霸下=Bá Hạ
先贤=Tiên Hiền
幽山君=U Sơn Quân
南华真人=Nam Hoa Chân Nhân
壬水神雷=Nhâm Thủy Thần Lôi
沧浪池=Thương Lãng Trì
神将=Thần Tướng
赤血龙旗=Xích Huyết Long Kỳ
齐物论=Tề Vật Luận
沧海横流=Thương Hải Hoành Lưu
燹骨成丘=Tiển Cốt Thành Khâu
太阴炼神法=Thái Âm Luyện Thần Pháp
净天地神咒=Tịnh Thiên Địa Thần Chú
作家助手=Trợ lý tác giả
关圣帝君=Quan Thánh Đế Quân
赤铜元身=Xích Đồng Nguyên Thân
赤阳刀=Xích Dương Đao
凌波微步=Lăng Ba Vi Bộ
伏羲血脉=Phục Hy Huyết Mạch
明德街=Minh Đức Nhai
辟水=Tích Thủy
观明=Quan Minh
沧水=Thương Thủy
左轻鸿=Tả Khinh Hồng
莫邪=Mạc Tà
炳灵公=Bỉnh Linh Công
黄天化=Hoàng Thiên Hóa
楼观剑法=Lâu Quan kiếm pháp
梁州刺史=Lương Châu Thứ Sử
神农殿=Thần Nông Điện
梧桐路=Ngô Đồng Lộ
李观明=Lý Quan Minh
易天绝剑=Dịch Thiên Tuyệt Kiếm
绝剑·水逝=Tuyệt Kiếm · Thủy Thệ
炼气士=Luyện Khí Sĩ
绝剑·天诛=Tuyệt Kiếm · Thiên Tru
禹王的道果=Vũ Vương Đạo Quả
蛟太子=Giao Thái Tử
天龙吟=Thiên Long Ngâm
太古妖兽夔牛=Thái Cổ Yêu Thú Quỳ Ngưu
镇海眼神通=Trấn Hải Nhãn Thần Thông
九天息壤=Cửu Thiên Tức Nhưỡng
鱼嘴=Ngư Chủy
辟水口=Tích Thủy Khẩu
天河关=Thiên Hà Quan
屠龙=Đồ Long
骑虎道人=Kỵ Hổ đạo nhân
星河横天=Tinh Hà Hoành Thiên
唐合=Đường Hợp
任海=Nhậm Hải
哼哈二将=Hanh Cáp Nhị Tướng
梦蝶=Mộng Điệp
还珠楼=Hoàn Châu Lâu
羽山=Vũ Sơn
赤霞丹=Xích Hà Đan
巨灵=Cự Linh
神农炎帝=Thần Nông Viêm Đế
始祖=Thủy Tổ
风雨雷电=Phong Vũ Lôi Điện
平成郡=Bình Thành Quận
李安=Lý An
无量天尊=Vô Lượng Thiên Tôn
通文长老=Thông Văn Trưởng Lão
三清道尊=Tam Thanh Đạo Tôn
凿齿=Tạc Xỉ
秦始皇=Tần Thủy Hoàng
摧花道人=Tồi Hoa đạo nhân
獬豸玉像=Giải Trãi Ngọc Tượng
墨武剑=Mặc Vũ Kiếm
分秋剑=Phân Thu Kiếm
大圜劍=Đại Hoàn Kiếm
元浮散人=Nguyên Phù Tán Nhân
混元功=Hỗn Nguyên Công
太乙乾元诀=Thái Ất Càn Nguyên Quyết
太平要术=Thái Bình Yếu Thuật
张角=Trương Giác
奉先=Phụng Tiên
淮水龙宫=Hoài Thủy Long Cung
水猴子=Thủy Hầu Tử
伏羲氏=Phục Hy Thị
李泌=Lý Bật
三山=Tam Sơn
巫山妖神教=Vu Sơn Yêu Thần Giáo
廉贞殿=Liêm Trinh Điện
螣蛇=Đằng Xà
山海经·大荒西经=Sơn Hải Kinh - Đại Hoang Tây Kinh
丰沮=Phong Trở
玉门=Ngọc Môn
日月=Nhật Nguyệt
灵山十巫=Linh Sơn Thập Vu
巫即=Vu Tức
巫朌=Vu Phán
巫彭=Vu Bành
巫姑=Vu Cô
巫礼=Vu Lễ
巫谢=Vu Tạ
巫罗=Vu La
常凯申=Tưởng Giới Thạch
王大锤=Vương Đại Chùy
六欲天女=Lục Dục Thiên Nữ
善乐天女=Thiện Lạc Thiên Nữ
毕方真神=Tất Phương Chân Thần
淮水真神=Hoài Thủy Chân Thần
草还丹=Thảo Hoàn Đan
星孛=Tinh Bội
炼气化神=Luyện Khí Hóa Thần
英招=Anh Chiêu
风氏族人=Phong Thị Tộc Nhân
法外逍遥=Pháp Ngoại Tiêu Dao
定海神珍铁=Định Hải Thần Trân Thiết
灵山会=Linh Sơn Hội
迦叶=Ca Diếp
摩诃迦叶=Ma Ha Ca Diếp
天遁剑意=Thiên Độn Kiếm Ý
正法眼藏=Chánh Pháp Nhãn Tạng
金丹妙道=Kim Đan Diệu Đạo
莲纹甲=Liên Văn Giáp
天水珠=Thiên Thủy Châu
螣蛇剑=Đằng Xà Kiếm
巫咸=Vu Hàm
雷光=Lôi Quang
渠帅=Cừ Soái
天将·顺风耳=Thiên Tướng - Thuận Phong Nhĩ
亢金龙=Kang Kim Long
天罡亢龙=Thiên Cương Kang Long
裂云手=Liệt Vân Thủ
儒门绝箭·射天狼=Nho Môn Tuyệt Tiễn · Xạ Thiên Lang
潜龙出渊=Tiềm Long Xuất Uyên
含沙射影=Hàm Sa Xạ Ảnh
天狼=Thiên Lang
日诛恶=Nhật Tru Ác
九虫诀·噙血荡元=Cửu Trùng Quyết · Hàm Huyết Đãng Nguyên
万鼎天=Vạn Đỉnh Thiên
岳陵郡=Nhạc Lăng quận
蜀王府=Thục Vương phủ
向怀义=Hướng Hoài Nghĩa
朱氏=Chu thị
五经博士=Ngũ Kinh bác sĩ
东江=Đông Giang
二弟=Nhị đệ
夔鼓雷音=Quỳ Cổ Lôi Âm
夔牛变=Quỳ Ngưu Biến
华而不败=Hoa Nhi Bất Bại
大圜剑光=Đại Hoàn Kiếm Quang
犴嗷=Hãn Ngao
黄帝内传=Hoàng Đế Nội Truyện
玄女=Huyền Nữ
大周律=Đại Chu Luật
姜氏子=Khương thị tử
关玉山=Quan Ngọc Sơn
阴神=Âm Thần
宗正姬博古=Tông Chính Cơ Bác Cổ
夔牛道果=Quỳ Ngưu đạo quả
太上洞玄灵宝救苦妙经=Thái Thượng Động Huyền Linh Bảo Cứu Khổ Diệu Kinh
姜少主=Khương Thiếu Chủ
朱某=Chu mỗ
玉衡殿=Ngọc Hành Điện
神农石像=Thần Nông Thạch Tượng
三皇五帝=Tam Hoàng Ngũ Đế
百草识别=Bách thảo nhận biết
药理之祖=Dược lý chi tổ
性命双修=Tính mệnh song tu
曹师叔=Tào sư thúc
天玑师伯=Thiên Cơ sư bá
正一玄坛元帅·赵公明=Chính Nhất Huyền Đàn Nguyên Soái Triệu Công Minh
禄存星君=Lộc Tồn Tinh Quân
天元台=Thiên Nguyên Đài
掌门=Chưởng môn
天璇师姐=Thiên Toàn sư tỷ
太乘长老=Thái Thừa trưởng lão
铁柱观洞天=Thiết Trụ Quan động thiên
天枢=Thiên Xu
天蓬长老=Thiên Bồng trưởng lão
五丁都司=Ngũ Đinh Đô Tư
高刁北翁=Cao Điêu Bắc Ông
曹元升=Tào Nguyên Thăng
纯阳道心=Thuần Dương Đạo Tâm
钁天大斧=Quắc Thiên Đại Phủ
斩鬼五形=Trảm Quỷ Ngũ Hình
七杀=Thất Sát
羊铃=Dương Linh
宇道=Vũ Đạo
功曹=Công Tào
直达天听=Trực Đạt Thiên Thính
公孙寿=Công Tôn Thọ
公孙太乘=Gongsun Taicheng
曹易玄=Cao Dịch Huyền
黄龙变=Hoàng Long Biến
太素剑=Thái Tố Kiếm
阴符七术=Âm Phù Thất Thuật
散势法鸷鸟=Tán Thế Pháp Trĩ Điểu
盛神法五龙=Thịnh Thần Pháp Ngũ Long
分威法伏熊=Phân Uy Pháp Phục Hùng
养志法灵龟=Dưỡng Chí Pháp Linh Quy
转圆法猛兽=Chuyển Viên Pháp Mãnh Thú
损兑法灵蓍=Tổn Đoái Pháp Linh Thi
希夷剑诀=Hy Di Kiếm Quyết
折花手=Chiết Hoa Thủ
黄帝内经=Hoàng Đế Nội Kinh
李淳风=Lý Thuần Phong
乙巳占=Ất Tị Chiêm
第二百八十四章=Chương 284
金堤之战=Kim Đê Chi Chiến
天水峡=Thiên Thủy Hạp
明远=Minh Viễn
烈山茶=Liệt Sơn trà
北辰星=Bắc Thần tinh
北辰辨=Bắc Thần Biện
曾子=Tăng Tử
三省吾身=Tam Tỉnh Ngô Thân
舞雩=Vũ Vu
格物天弓=Cách Vật Thiên Cung
文昌帝君=Văn Xương Đế Quân
文虚道人=Văn Hư Đạo Nhân
九幽之神=Cửu U Chi Thần
岳陵=Nhạc Lăng
姬氏诸王=Cơ thị chư vương
阳锋=Dương Phong
于琴弦=Vu Cầm Huyền
阴干=Âm Can
太平之战=Thái Bình chi chiến
北小年=Bắc Tiểu Niên
神秀=Thần Tú
春秋=Xuân Thu
姬博古=Cơ Bác Cổ
八景山=Bát Cảnh Sơn
龙宫之主=Long Cung Chi Chủ
娄云青=Lâu Vân Thanh
天暴星=Thiên Bạo Tinh
广阳郡=Quảng Dương Quận
张盘=Trương Bàn
宗门=Tông Môn
六殿=Lục Điện
天元洞天=Thiên Nguyên Động Thiên
太上长老=Thái Thượng Trưởng Lão
太上长老公孙鞅=Thái Thượng Trưởng Lão Công Tôn Ưởng
应龙道器=Ứng Long Đạo Khí
秘地=Bí Địa
指南车=Chỉ Nam Xa
风坟=Phong Phần
杀贼=Sát Tặc
应供=Ứng Cung
敖云=Ngao Vân
迦叶尊者=Ca Diếp Tôn Giả
阿难尊者=A Nan Tôn Giả
心魔秘剑=Tâm Ma Bí Kiếm
天子望气术=Thiên Tử Vọng Khí Thuật
无生老母，真空家乡=Vô Sanh Lão Mẫu, Chân Không Gia Hương
正定印=Chính Định Ấn
弥勒佛=Di Lặc Phật
近道宗师=Cận Đạo Tông Sư
天地人神四盘=Thiên Địa Nhân Thần Tứ Bàn
昊阳=Hạo Dương
南方天帝=Nam Phương Thiên Đế
太阳之神=Thái Dương Chi Thần
炎波=Diễm Ba
日丽中天=Nhật Lệ Trung Thiên
白莲菩萨=Bạch Liên Bồ Tát
长虹=Trường Hồng
风神=Phong Thần
县衙=Huyện nha
蓬安郡=Bồng An quận
郡守=Quận thủ
五浊之剑=Ngũ Trược Chi Kiếm
神火弩=Thần Hỏa Nỗ
蓬安全郡=Bồng An Toàn Quận
雷泽之神=Lôi Trạch Chi Thần
玉枢雷=Ngọc Xu Lôi
艮卦=Quẻ Cấn
天兵=Thiên Binh
天将=Thiên Tướng
太昊镜=Thái Hạo Kính
天君·公孙弃=Thiên Quân - Công Tôn Khí
天府=Thiên Phủ
先天风炁=Tiên Thiên Phong Khí
先天火炁=Tiên Thiên Hỏa Khí
先天山炁=Tiên Thiên Sơn Khí
紫微天府=Tử Vi Thiên Phủ
大周天子=Đại Chu Thiên Tử
先天八景功=Tiên Thiên Bát Cảnh Công
先天乾坤功=Tiên Thiên Càn Khôn Công
东林县=Đông Lâm Huyện
五莲之体=Ngũ Liên Chi Thể
净坛使者=Tịnh Đàn Sứ Giả
龙须白虎=Long Tu Bạch Hổ
白莲圣母菩萨（八部天龙广力菩萨）=Bạch Liên Thánh Mẫu Bồ Tát
玄门三清派=Huyền Môn Tam Thanh Phái
元宵节=Tết Nguyên Tiêu
齐师兄=Tề sư huynh
西乡郡=Tây Hương Quận
卢川郡=Lô Xuyên Quận
岐山姜家=Kỳ Sơn Khương Gia
佛狱业印=Phật Ngục Nghiệp Ấn
黑天=Hắc Thiên
托塔天王=Thác Tháp Thiên Vương
天门峰=Thiên Môn Phong
冬神玄冥=Đông Thần Huyền Minh
神门峰=Thần Môn Phong
吴钩剑=Ngô Câu Kiếm
渊兮·用不盈=Uyên Hề · Dụng Bất Doanh
三十六柄天罡刀=Ba mươi sáu thanh Thiên Cương Đao
文殊一脉=Văn Thù Nhất Mạch
惠岸行者木吒=Huệ Ngạn Hành Giả Mộc Tra
浩浩长风=Hạo Hạo Trường Phong
瀚海沧溟=Hãn Hải Thương Minh
普贤真人=Phổ Hiền Chân Nhân
大周皇室=Đại Chu Hoàng Thất
朝廷=Triều Đình
西方极乐世界=Tây Phương Cực Lạc Thế Giới
黄庭经=Hoàng Đình Kinh
殷师叔祖=Ân sư thúc tổ
广阳=Quảng Dương
舍卫国=Xá Vệ quốc
祗树给孤独园=Kỳ Thụ Cấp Cô Độc Viên
金刚经=Kim Cương Kinh
姜施主=Khương thí chủ
天疏=Thiên Sơ
定风珠=Định Phong Châu
广元师弟=Quảng Nguyên sư đệ
云衣=Vân Y
云华天女=Vân Hoa Thiên Nữ
阎罗王=Diêm La Vương
大威天龙=Đại Uy Thiên Long
阿罗汉=A La Hán
离剑道=Ly Kiếm Đạo
金刚狮子吼=Kim Cương Sư Tử Hống
金吒=Kim Tra
木吒=Mộc Tra
李靖=Lý Tịnh
毗沙门天王=Tỳ Sa Môn Thiên Vương
观主=Quan Chủ
二郎神·杨戬=Nhị Lang Thần - Dương Tiễn
司法天神·杨戬=Tư Pháp Thiên Thần - Dương Tiễn
戮天吴=Lục Thiên Ngô
太阿=Thái A
有穷=Hữu Cùng
军荼利明王菩萨=Quân Trà Lợi Minh Vương Bồ Tát
川主=Xuyên Chủ
李二郎=Lý Nhị Lang
赵二郎=Triệu Nhị Lang
遁龙桩=Độn Long Thung
卫宫士郎=Emiya Shirou
无限剑制=Unlimited Blade Works
玄甲墨扇=Huyền Giáp Mặc Phiến
王重阳=Vương Trùng Dương
蹴鞠神=Xúc Cúc Thần
哪吒=Na Tra
柳宗元=Liễu Tông Nguyên
龙城录=Long Thành Lục
玉鼎真人=Ngọc Đỉnh Chân Nhân
嫦娥=Hằng Nga
青鸾=Thanh Loan
九幽素女=Cửu U Tố Nữ
莲华印诀=Liên Hoa Ấn Quyết
智慧印=Trí Tuệ Ấn
黄龙法身=Hoàng Long Pháp Thân
惠岸行者=Huệ Ngạn Hành Giả
金玉=Kim Ngọc
西华妙真玄气=Tây Hoa Diệu Chân Huyền Khí
天衣无缝=Thiên Y Vô Phùng
甘露太子=Cam Lộ Thái Tử
军荼利明王=Quân Trà Lợi Minh Vương
佛光=Phật Quang
琉璃炽盛=Lưu Ly Sí Thịnh
看门罗汉=Khán Môn La Hán
开心罗汉=Khai Tâm La Hán
托塔罗汉=Thác Tháp La Hán
骑鹿罗汉=Kỵ Lộc La Hán
静坐罗汉=Tĩnh Tọa La Hán
举钵罗汉=Cử Bát La Hán
探手罗汉=Tham Thủ La Hán
芭蕉罗汉=Ba Tiêu La Hán
长眉罗汉=Trường Mi La Hán
天龙=Thiên Long
三昧耶印=Tam Muội Da Ấn
龙蛇体=Long Xà Thể
六丁六甲符=Lục Đinh Lục Giáp Phù
五丁开山符=Ngũ Đinh Khai Sơn Phù
游神慑鬼符=Du Thần Nhiếp Quỷ Phù
天府云波符=Thiên Phủ Vân Ba Phù
老六=Lão Lục
地府=Địa Phủ
阴间=Âm Gian
大师兄=Đại Sư Huynh
姜姓申氏=Khương Tính Thân Thị
无害=Vô Hại
乱神咒=Loạn Thần Chú
铁棒=Thiết Bổng
西天大雷音寺=Tây Thiên Đại Lôi Âm Tự
素女=Tố Nữ
天仙·白云子=Thiên Tiên · Bạch Vân Tử
惠岸行者·木吒=Huệ Ngạn Hành Giả · Mộc Tra
甘露太子·金吒=Cam Lộ Thái Tử · Kim Tra
九头虫=Cửu Đầu Trùng
赵玄坛=Triệu Huyền Đàn
紫微斗数=Tử Vi Đẩu Số
芭蕉扇=Ba Tiêu Phiến
文曲=Văn Khúc
贪狼=Tham Lang
天之道=Thiên Chi Đạo
广乘观主=Quảng Thừa Quan Chủ
六景=Lục Cảnh
天地二景=Thiên Địa Nhị Cảnh
阳形日=Dương Hình Nhật
龙族=Long Tộc
屠龙道人=Đồ Long Đạo Nhân
灵羽=Linh Vũ
屠龙师伯=Đồ Long Sư Bá
白鹤=Bạch Hạc
尚卡秋=Thượng Tạp Thu
婆罗门=Bà La Môn
日月二神=Nhật Nguyệt Nhị Thần
天眼通=Thiên Nhãn Thông
无相转轮=Vô Tướng Chuyển Luân
三元合一=Tam Nguyên Hợp Nhất
三分归元气=Tam Phân Quy Nguyên Khí
离卦=Quẻ Ly
大明咒=Đại Minh Chú
大乘魔掌=Đại Thừa Ma Chưởng
勾招法=Câu Chiêu Pháp
荡魔真气=Đãng Ma Chân Khí
罗睺障月=La Hầu Chướng Nguyệt
八邪秽世=Bát Tà Uế Thế
黑天之甲=Hắc Thiên Chi Giáp
金蝉子=Kim Thiền Tử
奶奶的因果集=Nãi nãi đích nhân quả tập
三品·大自在天道果=Tam phẩm · Đại Tự Tại Thiên Đạo Quả
广陵=Quảng Lăng
清虚道德天尊=Thanh Hư Đạo Đức Thiên Tôn
广陵道人=Quảng Lăng đạo nhân
玉虚关=Ngọc Hư Quan
灵官=Linh Quan
都天大灵官=Đô Thiên Đại Linh Quan
王去恶=Vương Khứ Ác
玉枢火府天将=Ngọc Xu Hỏa Phủ Thiên Tướng
三五火车雷公=Tam Ngũ Hỏa Xa Lôi Công
王灵官=Vương Linh Quan
西游记=Tây Du Ký
灵霄殿=Linh Tiêu Điện
太极八卦=Thái Cực Bát Quái
玄门两大气刃=Huyền Môn Lưỡng Đại Khí Nhận
混天绫=Hỗn Thiên Lăng
天罡刀=Thiên Cương Đao
吴钩双剑=Ngô Câu Song Kiếm
元经会=Nguyên Kinh Hội
紫微帝星=Tử Vi Đế Tinh
北极=Bắc Cực
姬承业=Cơ Thừa Nghiệp
冠军侯=Quán Quân Hầu
东林之战=Đông Lâm Chi Chiến
雍州之战=Ung Châu Chi Chiến
广明=Quảng Minh
帝师=Đế Sư
火云殿=Hỏa Vân Điện
先天金炁=Tiên Thiên Kim Khí
九五=Cửu Ngũ
紫阳=Tử Dương
梁州西边=Lương Châu Tây biên
巨灵胡=Cự Linh Hồ
天蓬=Thiên Bồng
雷法枢机=Lôi Pháp Xu Cơ
止藏渊=Chỉ Tàng Uyên
巴郡=Ba Quận
燕寒清=Yến Hàn Thanh
雍梁=Ung Lương
瘟癀昊天大帝=Ôn Hoảng Hạo Thiên Đại Đế
六极=Lục Cực
天蓬元帅=Thiên Bồng Nguyên Soái
破军星=Phá Quân Tinh
天蓬神咒=Thiên Bồng Thần Chú
九天应元普化天尊=Cửu Thiên Ứng Nguyên Phổ Hóa Thiên Tôn
天志=Thiên Chí
西苑=Tây Uyển
太常=Thái Thường
姜氏家主=Gia chủ Khương thị
太祝令=Thái Chúc Lệnh
太宰令=Thái Tể Lệnh
林奇然=Lâm Kỳ Nhiên
于安=Vu An
天下三剑=Thiên Hạ Tam Kiếm
庶人剑=Thứ Nhân Kiếm
天遁剑法=Thiên Độn Kiếm Pháp
太平教尊=Thái Bình Giáo Tôn
中黄太一=Trung Hoàng Thái Nhất
苍天之力=Thương Thiên Chi Lực
千里之地=Thiên Lí Chi Địa
潺亭=Sàn Đình
铁甲神雷=Thiết Giáp Thần Lôi
九天十地十九神魔=Cửu Thiên Thập Địa Thập Cửu Thần Ma
巽风=Tốn Phong
道兵巨灵神=Đạo Binh Cự Linh Thần
上清派掌门=Thượng Thanh Phái Chưởng Môn
李逵=Lý Quỳ
姜师侄=Khương sư điệt
道仙后=Đạo Tiên Hậu
潺亭县=Sàn Đình Huyện
宗经=Tông Kinh
凤来琴=Phượng Lai Cầm
东方忌=Đông Phương Kỵ
九虫诀=Cửu Trùng Quyết
瘟部=Ôn Bộ
武修=Võ Tu
符修=Phù Tu
术修=Thuật Tu
纯阳祖师=Thuần Dương Tổ Sư
纯阳剑仙=Thuần Dương Kiếm Tiên
啸命风雷=Khiếu Mệnh Phong Lôi
元经=Nguyên Kinh
禹步=Vũ Bộ
嵩山=Tung Sơn
梁州鼎=Lương Châu Đỉnh
黄龙=Hoàng Long
真罡=Chân Cương
梁州大鼎=Lương Châu Đại Đỉnh
毕方妖神=Tất Phương Yêu Thần
凰鸟=Hoàng Điểu
雷神电母=Lôi Thần Điện Mẫu
毕方=Tất Phương
清风=Thanh Phong
三清派=Tam Thanh Phái
三皇派=Tam Hoàng Phái
黑水玄蛇=Hắc Thủy Huyền Xà
上神都=Thượng Thần Đô
天地无极=Thiên Địa Vô Cực
子夏=Tử Hạ
卜子=Bốc Tử
曾参=Tăng Sâm
公羊学派=Công Dương Học Phái
于潺亭县=Vu Sằn Đình Huyện
聂政=Nhiếp Chính
白虹贯日=Bạch Hồng Quán Nhật
潺亭城=Sầm Đình Thành
草雉剑=Thảo Trĩ Kiếm
巨灵胡神通·【擘山分河】=Cự Linh Hồ Thần Thông · [Bách Sơn Phân Hà]
华山=Hoa Sơn
黄河=Hoàng Hà
大小如意=Đại Tiểu Như Ý
五岳之形=Ngũ Nhạc Chi Hình
震雷之相=Chấn Lôi Chi Tướng
袁洪=Viên Hồng
一气仙=Nhất Khí Tiên
禹步大统摄雷=Vũ Bộ Đại Thống Nhiếp Lôi
铁柱观=Thiết Trụ Quan
瘟癀阵=Ôn Hoằng Trận
坤地=Khôn Địa
五雷都司=Ngũ Lôi Đô Tư
天心正法=Thiên Tâm Chính Pháp
三十六天罡=Tam Thập Lục Thiên Cương
张教主=Trương Giáo Chủ
巴东=Ba Đông
靖平=Tĩnh Bình
修凡=Tu Phàm
怀远侯=Hoài Viễn Hầu
姬明方=Cơ Minh Phương
东林=Đông Lâm
天罡=Thiên Cương
西华妙真=Tây Hoa Diệu Chân
玄冥真道=Huyền Minh Chân Đạo
金母=Kim Mẫu
先天坎离水火=Tiên Thiên Khảm Ly Thủy Hỏa
元磁=Nguyên Từ
天罡九节杖=Thiên Cương Cửu Tiết Trượng
黄天之目=Hoàng Thiên Chi Mục
罡斗神雷=Cương Đấu Thần Lôi
太乐令明少微=Thái Nhạc Lệnh Minh Thiếu Vi
太子长琴=Thái Tử Trường Cầm
东林城=Đông Lâm Thành
罗教=La Giáo
白莲教=Bạch Liên Giáo
蝗神=Hoàng Thần
龙岳=Long Nhạc
龙伯巨人=Long Bá Cự Nhân
魏元舒=Ngụy Nguyên Thư
姜家主=Khương Gia Chủ
岳陵城=Nhạc Lăng Thành
靖平军=Tĩnh Bình Quân
苍天化身=Thương Thiên Hóa Thân
燕国地图=Yến Quốc Địa Đồ
孟大人=Mạnh đại nhân
太仓令=Thái Thương Lệnh
八十一郡=Bát Thập Nhất Quận
判官=Phán Quan
宇文邕=Vũ Văn Ung
宇文护=Vũ Văn Hộ
李世民=Lý Thế Dân
李渊=Lý Uyên
朱雀楼=Chu Tước Lâu
天君公孙弃=Thiên Quân Công Tôn Khí
九州八十一郡=Cửu Châu Bát Thập Nhất Quận
钟无期=Chung Vô Kỳ
钟馗=Chung Quỳ
孟云帆=Mạnh Vân Phàm
玉楼=Ngọc Lâu
雷公=Lôi Công
电母=Điện Mẫu
魏征=Ngụy Trưng
泾河龙王=Kính Hà Long Vương
帝颛顼=Đế Chuyên Húc
风伯=Phong Bá
连山=Liên Sơn
庆忌=Khánh Kỵ
吕忘机=Lữ Vong Cơ
文殊师利=Văn Thù Sư Lợi
姜无明=Khương Vô Minh
羽流=Vũ Lưu
大荒东经=Đại Hoang Đông Kinh
夸父=Khoa Phụ
三相化生妙法=Tam Tương Hóa Sinh Diệu Pháp
洛神=Lạc Thần
黄泉=Hoàng Tuyền
玉如意=Ngọc Như Ý
首山赤铜=Thủ Sơn Xích Đồng
逍遥游=Tiêu Dao Du
形坟·土形山=Hình Phần · Thổ Hình Sơn
气坟·山气止=Khí Phần · Sơn Khí Chỉ
山兮·鬼神惊=Sơn Hề · Quỷ Thần Kinh
震卦=Quẻ Chấn
大汉=Đại Hán
蚩尤氏=Xi Vưu Thị
太平教四神=Thái Bình Giáo Tứ Thần
都天生煞=Đô Thiên Sinh Sát
杨殛=Dương Tắc
雨师符诏=Vũ Sư Phù Chiếu
天犬=Thiên Khuyển
东宫=Đông Cung
武曲=Vũ Khúc
第九十八章=Chương 98
伏羲大神=Phục Hy Đại Thần
关武阳=Quan Vũ Dương
三垣二十八宿=Tam Viên Nhị Thập Bát Tú
凤凰变=Phượng Hoàng Biến
五炁星君=Ngũ Khí Tinh Quân
凤凰印=Phượng Hoàng Ấn
玉镜=Ngọc Kính
先天真身=Tiên Thiên Chân Thân
金霞冠=Kim Hà Quan
担山赶日=Đảm Sơn Cản Nhật
寰宇昭空阵=Hoàn Vũ Chiêu Không Trận
烛龙道果=Chúc Long Đạo Quả
弥罗妙境=Di La Diệu Cảnh
烛龙之眼=Chúc Long Chi Nhãn
朱雀华裳=Chu Tước Hoa Thường
跪火莲=Quỳ Hỏa Liên
火莲=Hỏa Liên
乾形天=Càn Hình Thiên
水形川=Thủy Hình Xuyên
雨形云=Vũ Hình Vân
风形气=Phong Hình Khí
禺强=Ngu Cường
乾坤弓=Càn Khôn Cung
震天箭=Chấn Thiên Tiễn
北海龙王=Bắc Hải Long Vương
庄子=Trang Tử
射蛟台=Xạ Giao Đài
明姬=Minh Cơ
摘星=Trích Tinh
六相=Lục Tướng
无极=Vô Cực
九天荡魔真气=Cửu Thiên Đãng Ma Chân Khí
姜氏族地=Khương thị tộc địa
衔雨=Hàm Vũ
摘星楼=Trích Tinh Lâu
天权殿=Thiên Quyền Điện
罗刹女=La Sát Nữ
摇光殿=Dao Quang Điện
蚩尤相=Xi Vưu Tướng
太虚幻境=Thái Hư Huyễn Cảnh
地祇神域=Địa Kỳ Thần Vực
实意法螣蛇=Thực Ý Pháp Đằng Xà
姜洛=Khương Lạc
姜炀=Khương Dương
司空府=Tư Không Phủ
齐长生=Tề Trường Sinh
太微玄术=Thái Vi Huyền Thuật
北斗九皇=Bắc Đẩu Cửu Hoàng
飞天罗刹=Phi Thiên La Sát
赤地千里=Xích Địa Thiên Lý
书友=Độc giả
护法天璇=Hộ Pháp Thiên Toàn
万星袍=Vạn Tinh Bào
火德=Hỏa Đức
阴炁=Âm Khí
星辰寰宇=Tinh Thần Hoàn Vũ
借形代果符=Tá Hình Đại Quả Phù
昆虚=Côn Khư
九如袈裟=Cửu Như Ca Sa
何罗神=Hà La Thần
广乘师兄=Quảng Thừa sư huynh
玄冥神通=Huyền Minh Thần Thông
器阁=Khí Các
荒神教=Hoang Thần Giáo
圣德=Thánh Đức
牛头=Ngưu Đầu
龙王=Long Vương
文殊菩萨=Văn Thù Bồ Tát
天璇长老=Thiên Toàn Trưởng Lão
神农姜氏=Thần Nông Khương Thị
神农百草丹=Thần Nông Bách Thảo Đan
观音大士=Quán Âm Đại Sĩ
淮水=Hoài Thủy
沙悟净=Sa Ngộ Tịnh
金身罗汉=Kim Thân La Hán
无畏印=Vô Úy Ấn
与愿印=Dữ Nguyện Ấn
道友请留步=Đạo hữu thỉnh lưu bộ
玄门=Huyền Môn
昊天镜碎片=Hạo Thiên Kính Toái Phiến
姜水=Khương Thủy
天下第一搅屎棍=Thiên Hạ Đệ Nhất Giảo Thỉ Côn
阿难=A Nan
矩子=Củ Tử
无生佛=Vô Sinh Phật
金刚力士=Kim Cương Lực Sĩ
黄巾力士=Hoàng Cân Lực Sĩ
靖阳军=Tĩnh Dương Quân
孟修凡=Mạnh Tu Phàm
司马家=Tư Mã gia
西昆虚=Tây Côn Khư
黄云=Hoàng Vân
姜别鹤=Khương Biệt Hạc
青木小树=Tiểu Thụ Thanh Mộc
七杀星辰=Thất Sát Tinh Thần
大风=Đại Phong
壬水=Nhâm Thủy
癸水=Quý Thủy
水伯天吴=Thủy Bá Thiên Ngô
遁甲阵势=Độn Giáp Trận Thế
帝坐命库=Đế Tọa Mệnh Khố
金舆扶辇=Kim Dư Phù Liễn
彤弓=Đồng Cung
素箭=Tố Tiễn
贯天恸日=Quán Thiên Thống Nhật
大宇轮转=Đại Vũ Luân Chuyển
众星法域=Chúng Tinh Pháp Vực
天星遁法=Thiên Tinh Độn Pháp
无为先生=Vô Vi tiên sinh
后天人种袋=Hậu Thiên Nhân Chủng Túi
姜逐云=Khương Trục Vân
混世四猴=Hỗn Thế Tứ Hầu
二郎显圣真君=Nhị Lang Hiển Thánh Chân Quân
摇光破军=Dao Quang Phá Quân
万佛窟=Vạn Phật Quật
须菩提祖师=Tu Bồ Đề Tổ Sư
持国天王=Trì Quốc Thiên Vương
增长天王=Tăng Trưởng Thiên Vương
广目天王=Quảng Mục Thiên Vương
多闻天王=Đa Văn Thiên Vương
白帝子=Bạch Đế Tử
东胜大神洲=Đông Thắng Đại Thần Châu
花果山=Hoa Quả Sơn
灵台方寸祖=Linh Đài Phương Thốn Tổ
烈山袍=Liệt Sơn Bào
转轮菩萨=Chuyển Luân Bồ Tát
十殿阎王=Thập Điện Diêm Vương
六耳神通=Lục Nhĩ Thần Thông
天魔=Thiên Ma
他化自在天主=Tha Hóa Tự Tại Thiên Chủ
应龙变=Ứng Long Biến
张良=Trương Lương
白莲圣母=Bạch Liên Thánh Mẫu
有穷后羿=Hữu Cùng Hậu Nghệ
夏朝=Hạ Triều
天照大御神=Thiên Chiếu Đại Ngự Thần
日游神=Nhật Du Thần
炎帝烈血=Viêm Đế Liệt Huyết
姜其中=Khương Kỳ Trung
有穷夷羿=Hữu Cung Di Nghệ
纯狐=Thuần Hồ
少康=Thiếu Khang
天王神像=Thiên Vương Thần Tượng
阿修罗=A Tu La
长阿含经=Trường A Hàm Kinh
日月天子=Nhật Nguyệt Thiên Tử
佛狱第四王=Phật Ngục Đệ Tứ Vương
阿修罗王非天=A Tu La Vương Phi Thiên
阿修罗王罗睺=A Tu La Vương La Hầu
戈壁荒漠=Sa mạc Gobi
转轮=Chuyển Luân
金刚手菩萨=Kim Cương Thủ Bồ Tát
天子魔=Thiên Tử Ma
夔鼓=Khuy Cổ
夔牛=Khuy Ngưu
广元=Quảng Nguyên
非天=Phi Thiên
灵感寺=Linh Cảm Tự
鼎湖天璇=Đỉnh Hồ Thiên Toàn
般若=Bát Nhã
萧西涯=Tiêu Tây Nhai
岐山=Kỳ Sơn
鬼面人=Quỷ Diện Nhân
巫抵=Vu Để
姜氏祖地=Khương Thị Tổ Địa
广元道长=Quảng Nguyên Đạo Trưởng
天之刃=Thiên Chi Nhận
白龙=Bạch Long
大日经=Đại Nhật Kinh
天照道果=Thiên Chiếu Đạo Quả
阎浮檀紫摩金色=Diêm Phù Đàn Tử Ma Kim Sắc
扶桑=Phù Tang
八部天龙广力菩萨=Bát Bộ Thiên Long Quảng Lực Bồ Tát
天照=Thiên Chiếu
菩提萨埵=Bồ Đề Tát Đỏa
天魅真身=Thiên Mị Chân Thân
三位大士=Tam Vị Đại Sĩ
雌雄剑=Thư Hùng Kiếm
王云蓝=Vương Vân Lam
乙巳年=Ất Tỵ Niên
庚辰月=Canh Thìn Nguyệt
辛未日=Tân Vị Nhật
林风=Lâm Phong
江鸣=Giang Minh
生死簿=Sinh Tử Bộ
黄粱=Hoàng Lương
修罗=Tu La
首座=Thủ Tọa
掌中佛国=Chưởng Trung Phật Quốc
降龙罗汉=Hàng Long La Hán
过江罗汉=Quá Giang La Hán
欢喜罗汉=Hoan Hỉ La Hán
布袋罗汉=Bố Đại La Hán
挖耳罗汉=Oạt Nhĩ La Hán
沉思罗汉=Trầm Tư La Hán
笑狮罗汉=Tiếu Sư La Hán
骑象罗汉=Kỵ Tượng La Hán
岐山县=Kỳ Sơn Huyện
二宫主=Nhị Cung chủ
孟府=Mạnh Phủ
紫极=Tử Cực
金刚藏=Kim Cương Tàng
大兴城=Đại Hưng Thành
刺史府=Thứ Sử Phủ
大行山脉=Đại Hành Sơn Mạch
盗版猴=Khỉ nhái
元炁=Nguyên Khí
人种袋=Nhân Chủng Đại
洪好古=Hồng Hảo Cổ
神域=Thần Vực
姜流光=Khương Lưu Quang
羊脂玉净瓶=Dương Chi Ngọc Tịnh Bình
水火锋=Thủy Hỏa Phong
白猿=Bạch Viên
八卦紫绶衣=Bát Quái Tử Thụ Y
光聚佛顶印=Quang Tụ Phật Đỉnh Ấn
般若剑=Bát Nhã Kiếm
天志剑=Thiên Chí Kiếm
金仙·赤精子=Kim Tiên - Xích Tinh Tử
阴阳镜=Âm Dương Kính
太平教主=Thái Bình Giáo Chủ
无生佛友=Vô Sinh Phật Hữu
纵地金光术=Túng Địa Kim Quang Thuật
青龙偃月刀=Thanh Long Yển Nguyệt Đao
白毛猿猴=Bạch Mao Viên Hầu
大兴郡=Đại Hưng Quận
天惊地动=Thiên Kinh Địa Động
风兮·破地=Phong hề · Phá Địa
大日笼御=Đại Nhật Lung Ngự
无涯不及=Vô Nhai Bất Cập
火兮·焚野=Hỏa hề · Phần Dã
雷兮·天地碎=Lôi hề · Thiên Địa Toái
裂天之境=Liệt Thiên Chi Cảnh
断生矛=Đoạn Sinh Mâu
长安=Trường An
华山论键=Hoa Sơn luận kiếm
神人=Thần Nhân
二品道果=Nhị Phẩm Đạo Quả
大日如来法相=Đại Nhật Như Lai Pháp Tướng
菩萨乘=Bồ Tát Thừa
阿逸多=A Dật Đa
观音=Quan Âm
南无大日如来毗卢遮那佛=Nam Mô Đại Nhật Như Lai Tỳ Lô Giá Na Phật
九黎寰空禁法=Cửu Lê Hoàn Không Cấm Pháp
未来佛祖=Vị Lai Phật Tổ
杨柳枝=Cành dương liễu
玉净瓶=Ngọc Tịnh Bình
太白星君=Thái Bạch Tinh Quân
白帝白招拒=Bạch Đế Bạch Chiêu Cự
云中子=Vân Trung Tử
火神·重黎=Hỏa Thần · Trọng Lê
帝高阳=Đế Cao Dương
姬姓=Cơ Tính
风姓=Phong Tính
大兴=Đại Hưng
殷师弟=Ân sư đệ
清君侧=Thanh Quân Trắc
太尉=Thái Úy
青龙七宿=Thanh Long Thất Tú
箕水豹=Cơ Thủy Báo
五炁真君=Ngũ Khí Chân Quân
火府星=Hỏa Phủ Tinh
南方朱雀=Nam Phương Chu Tước
万木朝春=Vạn Mộc Triều Xuân
荧惑守心=Huỳnh Hoặc Thủ Tâm
大皇子姬承天=Đại Hoàng Tử Cơ Thừa Thiên
防风氏=Phòng Phong Thị
会稽山=Hội Kê Sơn
羽流姑姑=Vũ Lưu cô cô
老太尉=Lão Thái Úy
木德星君=Mộc Đức Tinh Quân
曹司空=Tào Tư Không
姜逐流=Khương Trục Lưu
先天八炁=Tiên Thiên Bát Khí
风后罗盘=Phong Hậu La Bàn
风后奇门=Phong Hậu Kỳ Môn
八门=Bát Môn
九星=Cửu Tinh
八神=Bát Thần
阴阳五行=Âm Dương Ngũ Hành
三奇六仪=Tam Kỳ Lục Nghi
周天星辰=Chu Thiên Tinh Thần
首创种桑养蚕=Thủ Sáng Chủng Tang Dưỡng Tằm
先蚕神=Tiên Tằm Thần
虞渊=Ngu Uyên
第791章=Chương 791
平乱=Bình loạn
三煞位=Tam Sát Vị
鬼道=Quỷ Đạo
玄通=Huyền Thông
太乐令=Thái Nhạc lệnh
明少微=Minh Thiếu Vi
朱雀法坛=Chu Tước pháp đàn
七尊神将=Thất Tôn Thần Tướng
般若慧剑=Bát Nhã Huệ Kiếm
金乌遗骨=Kim Ô Di Cốt
宗室=Tông thất
紫微=Tử Vi
南苑=Nam Uyển
无生=Vô Sinh
大士=Đại Sĩ
姬承天=Cơ Thừa Thiên
尚书台=Thượng Thư Đài
太官令=Thái Quan Lệnh
北门=Bắc Môn
寒浞=Hàn Trạc
封禅剑法=Phong Thiện Kiếm Pháp
天下归一=Thiên Hạ Quy Nhất
诸侯之剑=Chư Hầu Chi Kiếm
以元经会=Dĩ Nguyên Kinh Hội
军神四兵=Quân Thần Tứ Binh
气坟·时乘六龙=Khí phần - Thời thừa Lục Long
形坟·阳形日=Hình phần - Dương hình Nhật
九宫八卦=Cửu Cung Bát Quái
血荐轩辕=Huyết tiến Hiên Viên
天眼=Thiên Nhãn
至人之心=Chí Nhân Chi Tâm
姜离王=Khương Ly Vương
《气坟》=《Khí Phần》
朱翼=Chu Dực
太卜令姬远=Thái Bốc Lệnh Cơ Viễn
二皇子=Nhị hoàng tử
太易=Thái Dịch
应龙法身=Ứng Long Pháp Thân
应龙真身=Ứng Long Chân Thân
天牢=Thiên Lao
天魅真神=Thiên Mị Chân Thần
大乘教=Đại Thừa Giáo
狐岐山=Hồ Kỳ Sơn
《梦中斩龙》=《Mộng Trung Trảm Long》
《阴符经》=《Âm Phù Kinh》
巫山神女=Vu Sơn Thần Nữ
瑶姬=Dao Cơ
朝华阁=Triều Hoa Các
文帝钱=Văn Đế Tiền
山海经=Sơn Hải Kinh
甘渊=Cam Uyên
帝俊=Đế Tuấn
十大金乌=Thập Đại Kim Ô
羲和道果=Nghi Hòa đạo quả
射日弓=Xạ Nhật cung
寒浞道果=Hàn Trạc đạo quả
后羿=Hậu Nghệ
碎日天冰箭=Toái Nhật Thiên Băng tiễn
金乌道果=Kim Ô đạo quả
太微赋=Thái Vi Phú
太阳居午，日丽中天=Thái Dương Cư Ngọ, Nhật Lệ Trung Thiên
紫微天府，辅弼之功=Tử Vi Thiên Phủ, Phụ Bật Chi Công
吴王=Ngô Vương
龙王赘婿=Long Vương tế tế
朱雀道果=Chu Tước đạo quả
孟钧=Mạnh Quân
青龙道果=Thanh Long đạo quả
四象=Tứ Tượng
烈山殿=Liệt Sơn Điện
东华宝树=Đông Hoa Bảo Thụ
司空姜离=Tư Không Khương Ly
少府=Thiếu Phủ
三相化生=Tam Tương Hóa Sinh
日御=Nhật Ngự
日母=Nhật Mẫu
羲和玉璧=Hi Hòa Ngọc Bích
老君观=Lão Quân Quan
大宗师=Đại Tông Sư
摄政王=Nhiếp Chính Vương
摇光=Dao Quang
长老=Trưởng Lão
赘婿=Con rể
真如=Chân Như
魔波旬=Ma Ba Tuần
八正城=Bát Chính Thành
四大阿修罗王=Tứ Đại A Tu La Vương
往生经=Vãng Sinh Kinh
中原=Trung Nguyên
赤衣僧人=Hồng y tăng nhân
无生老母大士=Vô Sinh Lão Mẫu Đại Sĩ
姬施主=Cơ thí chủ
西华镜=Tây Hoa Kính
南无阿弥多婆夜=Nam mô A Di Đa Bà Dạ
哆他伽多夜=Đa Tha Già Đa Dạ
姜氏主家=Khương thị chủ gia
姜逐阳=Khương Trục Dương
十殿阎罗=Thập Điện Diêm La
齐天大圣孙悟空=Tề Thiên Đại Thánh Tôn Ngộ Không
四海朝元阵=Tứ Hải Triều Nguyên Trận
上清灵宝=Thượng Thanh Linh Bảo
玉虚宫=Ngọc Hư Cung
十二金仙=Thập Nhị Kim Tiên
黄龙真人=Hoàng Long Chân Nhân
金毛猴子=Kim Mao Hầu Tử
过去=Quá Khứ
现在=Hiện Tại
未来=Vị Lai
三大劫法=Tam Đại Kiếp Pháp
七佛灭罪真言=Thất Phật Diệt Tội Chân Ngôn
白山黑水=Bạch Sơn Hắc Thủy
凤鸣山=Phượng Minh Sơn
六字大明咒=Lục Tự Đại Minh Chú
地藏王菩萨=Địa Tạng Vương Bồ Tát
未来星宿劫法=Vị Lai Tinh Tú Kiếp Pháp
八部天龙=Bát Bộ Thiên Long
五道轮回=Ngũ đạo luân hồi
九黎寰空=Cửu Lê Hoàn Không
裂天玄境=Liệt Thiên Huyền Cảnh
蚩尤三盘=Xi Vưu Tam Bàn
都天凝相=Đô Thiên Ngưng Tướng
幽冥之天=U Minh Chi Thiên
龙蛇变=Long Xà Biến
九索=Cửu Tác
五道将军姬玄通=Ngũ Đạo Tướng Quân Cơ Huyền Thông
五道将军=Ngũ Đạo Tướng Quân
幽都=U Đô
幽都大罗掌=U Đô Đại La Chưởng
太素之道=Thái Tố Chi Đạo
太极之道=Thái Cực Chi Đạo
幽王=U Vương
姬玄通=Cơ Huyền Thông
日御·羲和=Nhật Ngự · Hi Hòa
禄存星=Lộc Tồn Tinh
珈蓝宝树=Già Lam Bảo Thụ
僧邸佛钟=Tăng Để Phật Chung
上城=Thượng Thành
内城=Nội Thành
上城区=Thượng Thành Khu
太子=Thái Tử
大祭酒=Đại Tế Tửu
舍祭城=Xá Tế Thành
申侯道长=Thân Hầu Đạo Trưởng
世尊=Thế Tôn
巡海夜叉=Tuần Hải Dạ Xoa
如意金箍棒=Như Ý Kim Cô Bổng
天丛云剑=Thiên Tùng Vân Kiếm
蛟龙=Giao Long
龙渊湖=Long Uyên Hồ
龙宫海神=Long Cung Hải Thần
蛟魔王=Giao Ma Vương
哮天犬=Hống Thiên Khuyển
天权长老=Trưởng lão Thiên Quyền
文曲星君=Văn Khúc Tinh Quân
八峰山=Bát Phong Sơn
上清凌虚子=Thượng Thanh Lăng Hư Tử
八岐大蛇=Bát Kỳ Đại Xà
弥勒菩萨=Di Lặc Bồ Tát
五兵=Ngũ Binh
大禹=Đại Vũ
天子之剑=Thiên Tử Chi Kiếm
道莅天下，其鬼不神=Đạo Lệ Thiên Hạ, Kỳ Quỷ Bất Thần
天龙八峰=Thiên Long Bát Phong
第四王=Đệ Tứ Vương
大圣=Đại Thánh
广目=Quảng Mục
大荒漠=Đại Hoang Mạc
广目城=Quảng Mục Thành
善乐城=Thiện Lạc Thành
云九夜=Vân Cửu Dạ
玉虚峰=Ngọc Hư Phong
九华寺=Cửu Hoa Tự
白莲圣母菩萨=Bạch Liên Thánh Mẫu Bồ Tát
大菩萨·地藏=Đại Bồ Tát Địa Tạng
阎浮提=Diêm Phù Đề
罗汉=La Hán
《佛说力士移山经》=《Phật Thuyết Lực Sĩ Di Sơn Kinh》
番天印=Phiên Thiên Ấn
苦集灭道=Khổ Tập Diệt Đạo
涅槃寂静=Niết Bàn Tịch Tĩnh
三论宗=Tam Luận Tông
密宗=Mật Tông
华严宗=Hoa Nghiêm Tông
金刚藏菩萨=Kim Cương Tạng Bồ Tát
天台宗=Thiên Thai Tông
净土宗=Tịnh Độ Tông
灵吉菩萨=Linh Cát Bồ Tát
他化自在六天=Tha Hóa Tự Tại Lục Thiên
天兮·堕乾坤=Thiên Hề · Đọa Càn Khôn
九州版图=Cửu Châu Bản Đồ
先天八景=Tiên Thiên Bát Cảnh
鬼面男子=Quỷ Diện Nam Tử
佛土空间=Không gian Phật thổ
八景=Bát Cảnh
莲华圣耀=Liên Hoa Thánh Diệu
菩萨不灭体=Bồ Tát Bất Diệt Thể
三十三相·龙头观音=Tam Thập Tam Tướng · Long Đầu Quan Âm
金刚九会曼荼罗·三昧耶会=Kim Cương Cửu Hội Mạn Đà La · Tam Muội Da Hội
黄帝四相=Hoàng Đế Tứ Tướng
黑水河=Hắc Thủy Hà
海神=Hải Thần
庆云=Khánh Vân
六仪八卦=Lục Nghi Bát Quái
奇门遁甲=Kỳ Môn Độn Giáp
一气化三千=Nhất Khí Hóa Tam Thiên
既寿永昌=Ký Thọ Vĩnh Xương
杨戬=Dương Tiễn
韦陀菩萨=Vi Đà Bồ Tát
广力菩萨=Quảng Lực Bồ Tát
李老道=Lý lão đạo
炎帝神农=Viêm Đế Thần Nông
太极阴阳=Thái Cực Âm Dương
阴阳大磨=Âm Dương Đại Ma
都天=Đô Thiên
法天象地=Pháp Thiên Tượng Địa
庄周道果=Trang Chu Đạo Quả
佛土=Phật Thổ
七佛=Thất Phật
计都=Kế Đô
轮回盘=Luân hồi bàn
天道=Thiên đạo
人道=Nhân đạo
地狱道=Địa ngục đạo
饿鬼道=Ngạ quỷ đạo
畜生道=Súc sinh đạo
修罗道=Tu La đạo
过去七佛=Quá Khứ Thất Phật
太素之剑=Thái Tố Chi Kiếm
无面天君=Vô Diện Thiên Quân
毗卢遮那佛=Tỳ Lô Giá Na Phật
日曜=Nhật Diệu
极乐净土=Cực Lạc Tịnh Thổ
六道轮盘=Lục Đạo Luân Bàn
地藏菩萨=Địa Tạng Bồ Tát
乾坤=Càn Khôn
阴阳三才=Âm Dương Tam Tài
太上炼魔=Thái Thượng Luyện Ma
七星剑=Thất Tinh Kiếm
先天神魔=Tiên Thiên Thần Ma
玄穹高上玉皇大帝=Huyền Khung Cao Thượng Ngọc Hoàng Đại Đế
释迦牟尼=Thích Ca Mâu Ni
画地为牢=Vẽ đất thành lao
西土=Tây Thổ
长空万里，剑荡山河=Trường Không Vạn Lý, Kiếm Đãng Sơn Hà
万化生乎身=Vạn Hóa Sinh Hồ Thân
太微=Thái Vi
离合神光=Ly Hợp Thần Quang
龙头观音=Long Đầu Quan Âm
琉璃观音=Lưu Ly Quan Âm
杨柳观音=Dương Liễu Quan Âm
鱼篮观音=Ngư Lam Quan Âm
一如观音=Nhất Như Quan Âm
不二观音=Bất Nhị Quan Âm
菩萨=Bồ Tát
青木古树=Thanh Mộc Cổ Thụ
须弥山=Tu Di Sơn
迷者=Mê Giả
广力=Quảng Lực
韦陀=Vi Đà
慧能=Huệ Năng
慧轮=Huệ Luân
鲁迅=Lỗ Tấn
转轮王=Chuyển Luân Vương
六道轮回=Lục Đạo Luân Hồi
月净=Nguyệt Tịnh
高阳氏=Cao Dương Thị
大荒西经=Đại Hoang Tây Kinh
摇光长老=Dao Quang Trưởng Lão
开阳长老关武阳=Khai Dương trưởng lão Quan Vũ Dương
宝极洞天=Bảo Cực Động Thiên
西游=Tây Du
罗睺=La Hầu
楼双影=Lâu Song Ảnh
阿修罗王=A Tu La Vương
和业如来=Hòa Nghiệp Như Lai
波旬真灵=Ba Tuần Chân Linh
天皇伏羲=Thiên Hoàng Phục Hy
夏至日=Hạ Chí Nhật
神农百草经=Thần Nông Bách Thảo Kinh
素华宫=Tố Hoa Cung
鬼门关=Quỷ Môn Quan
晦庵先生=Hối Am tiên sinh
申侯道人=Thân Hầu đạo nhân
皇城轩辕台=Hoàng thành Hiên Viên Đài
中天北极紫微大帝=Trung Thiên Bắc Cực Tử Vi Đại Đế
百王=Bách Vương
宗正府=Tông Chính Phủ
昭元郡主=Chiêu Nguyên quận chúa
佛国灵台山=Phật Quốc Linh Đài Sơn
轩辕台洞天=Hiên Viên Đài Động Thiên
朱雀殿=Chu Tước Điện
天寿山=Thiên Thọ Sơn
皇陵=Hoàng Lăng
杨言=Dương Ngôn
嫘祖=Luy Tổ
太一=Thái Nhất
巨灵神=Cự Linh Thần
天坛=Thiên Đàn
神农之相=Thần Nông chi tướng
南极之地=Nam Cực chi địa
火德星君=Hỏa Đức Tinh Quân
神行太保=Thần Hành Thái Bảo
宗正姬长风=Tông Chính Cơ Trường Phong
三公=Tam Công
太尉孟钧=Thái Úy Mạnh Quân
姜韬=Khương Thao
司徒=Tư Đồ
司空=Tư Không
骠骑将军=Phiếu Kỵ Tướng Quân
三只眼=Tam Chỉ Nhãn
阿门=A-men
无生老母=Vô Sinh Lão Mẫu
破军=Phá Quân
巨门=Cự Môn
龙华树=Cây Long Hoa
圣莲卍化=Thánh Liên Vạn Hóa
弥勒道果=Di Lặc Đạo Quả
金光神咒=Kim Quang Thần Chú
恶蛟=Ác Giao
穹荒青龙旗=Khung Hoang Thanh Long Kỳ
孟家=Mạnh Gia
九宫乾天=Cửu Cung Càn Thiên
八极坤地=Bát Cực Khôn Địa
姻缘簿=Nhân Duyên Bộ
青龙=Thanh Long
火焰山=Hỏa Diệm Sơn
沧江=Thương Giang
大皇子=Đại hoàng tử
日御羲和=Nhật Ngự Hi Hòa
六龙之车=Lục Long chi xa
紫衣青年=Thanh niên áo tím
器阁长老=Khí Các trưởng lão
斗姆=Đẩu Mẫu
朱雀七宿=Chu Tước thất tú
姜师弟=Khương sư đệ
东平王=Đông Bình Vương
洪郡=Hồng Quận
武圣=Võ Thánh
关羽=Quan Vũ
开阳星君=Khai Dương Tinh Quân
武曲星君=Vũ Khúc Tinh Quân
青龙王=Thanh Long Vương
厉罡天斩=Lệ Cương Thiên Trảm
玄龟镇海诀=Huyền Quy Trấn Hải Quyết
水兮·滔天=Thủy Hề·Thao Thiên
玄武之御=Huyền Vũ chi Ngự
天涯=Thiên Nhai
咫尺=Chỉ Xích
禹王道果=Vũ Vương Đạo Quả
太昊庖羲氏=Thái Hạo Bào Hy Thị
华胥=Hoa Tư
天之相=Thiên Chi Tướng
觉者会=Giác Giả Hội
玉帝老儿=Ngọc Đế Lão Nhi
姜某人=Khương mỗ nhân
宇空之法=Vũ Không Chi Pháp
修罗鬼面=Tu La Quỷ Diện
巫真=Vu Chân
纯阳真人=Thuần Dương Chân Nhân
黄粱一梦=Hoàng Lương Nhất Mộng
阴象冬=Âm Tượng Đông
黄天之眼=Hoàng Thiên Chi Nhãn
崇山君=Sùng Sơn Quân
烈山民=Liệt Sơn Dân
潜山阴=Tiềm Sơn Âm
大鲲=Đại Côn
通闻符=Thông Văn Phù
勾陈上宫天皇大帝=Câu Trần Thượng Cung Thiên Hoàng Đại Đế
广成子=Quảng Thành Tử
姜司空=Khương Tư Không
六耳猕猴=Lục Nhĩ Mị Hầu
江河=Giang Hà
乾坤袋=Càn Khôn Đại
三清元神=Tam Thanh Nguyên Thần
元真=Nguyên Chân
太无=Thái Vô
玉虚开天剑=Ngọc Hư Khai Thiên Kiếm
墨家=Mặc Gia
墨子=Mặc Tử
矩子墨玄空=Củ Tử Mặc Huyền Không
金风玉露掌=Kim Phong Ngọc Lộ Chưởng
玉清道气=Ngọc Thanh Đạo Khí
东岸=Đông Ngạn
天皇宝诰=Thiên Hoàng Bảo Cáo
紫微宸极=Tử Vi Thần Cực
勾陈天宫=Câu Trần Thiên Cung
九光宝苑=Cửu Quang Bảo Uyển
五炁玄都=Ngũ Khí Huyền Đô
至心皈命礼=Chí Tâm Quy Mệnh Lễ
潜渊缩地=Tiềm Uyên Súc Địa
勾陈真灵=Câu Trần Chân Linh
李逍遥=Lý Tiêu Dao
拜月教主=Bái Nguyệt Giáo Chủ
勾陈六星=Câu Trần Lục Tinh
李玄=Lý Huyền
三易=Tam Dịch
太极之炁=Thái Cực Chi Khí
殁神戟=Một Thần Kích
灭元殳=Diệt Nguyên Thù
戮亡戈=Lục Vong Qua
灭生矛=Diệt Sinh Mâu
射天弓=Xạ Thiên Cung
风雨雷电四神=Phong Vũ Lôi Điện Tứ Thần
众星法界=Chúng Tinh Pháp Giới
金光咒=Kim Quang Chú
金仙·毗芦仙=Kim Tiên · Tỳ Lư Tiên
九黎寰空界法=Cửu Lê Hoàn Không Giới Pháp
刑囚夹印，刑杖惟司=Hình Tù Giáp Ấn, Hình Trượng Duy Tư
正是本宫=Chính Thị Bản Cung
七杀星=Thất Sát Tinh
廉贞星=Liêm Trinh Tinh
七杀廉贞，路上埋尸=Thất Sát Liêm Trinh, Lộ Thượng Mai Thi
太阴居子，水澄桂萼=Thái Âm Cư Tử, Thủy Trừng Quế Ngạc
火儿=Hỏa Nhi
板角青牛=Bản Giác Thanh Ngưu
剑斩天机=Kiếm Trảm Thiên Cơ
三洞=Tam Động
太白=Thái Bạch
汉江=Hán Giang
三洞之元=Tam Động Chi Nguyên
庚金不灭剑体=Canh Kim Bất Diệt Kiếm Thể
勾陈道果=Câu Trần Đạo Quả
太史令=Thái sử lệnh
广明道人=Quảng Minh đạo nhân
文殊大士=Văn Thù đại sĩ
白虎道果=Bạch Hổ đạo quả
东平郡王=Đông Bình quận vương
宝莲灯=Bảo Liên đăng
素云=Tố Vân
扬州牧=Dương Châu Mục
梁州牧=Lương Châu Mục
雍州牧=Ung Châu Mục
太平=Thái Bình
幽城=U Thành
阿须伦=A Tu Luân
十九神魔=Thập Cửu Thần Ma
三山之地=Tam Sơn chi địa
断天峡=Đoạn Thiên Hạp
地空=Địa Không
地劫=Địa Kiếp
截空=Tiệt Không
旬空=Tuần Không
庚金剑芒=Canh Kim Kiếm Mang
龙甲神章=Long Giáp Thần Chương
旱神掌=Hạn Thần Chưởng
火焚穹霄=Hỏa Phần Khung Tiêu
千钧一发=Thiên Quân Nhất Phát
庚金=Canh Kim
红葫芦=Hồng Hồ Lô
谈无言=Đàm Vô Ngôn
李太白=Lý Thái Bạch
开阳武曲=Khai Dương Vũ Khúc
圣婴=Thánh Anh
哪吒三太子=Na Tra Tam Thái Tử
道莅天下=Đạo Lệ Thiên Hạ
东华古树=Đông Hoa Cổ Thụ
如来不毁真身=Như Lai Bất Hủy Chân Thân
大常=Đại Thường
奢龙=Xa Long
祝融=Chúc Dung
大封=Đại Phong
后土=Hậu Thổ
大圜剑=Đại Hoàn Kiếm
太阳=Thái Dương
少阴=Thiếu Âm
少阳=Thiếu Dương
太素之炁=Thái Tố Chi Khí
五气朝元=Ngũ Khí Triều Nguyên
纯阳道体=Thuần Dương Đạo Thể
齐物与一=Tề Vật Dữ Nhất
肉身成圣=Nhục Thân Thành Thánh
通天灵剑=Thông Thiên Linh Kiếm
纯阳道祖=Thuần Dương Đạo Tổ
都天神雷=Đô Thiên Thần Lôi
神阙天眼=Thần Khuyết Thiên Nhãn
斩天拔剑术=Trảm Thiên Bạt Kiếm Thuật
黄帝六相=Hoàng Đế Lục Tướng
天子剑=Thiên Tử Kiếm
天宪=Thiên Hiến
四夷=Tứ Di
四时=Tứ Thời
五岳=Ngũ Nhạc
五行=Ngũ Hành
刑德=Hình Đức
阴阳=Âm Dương
春夏=Xuân Hạ
秋冬=Thu Đông
黄天真身=Hoàng Thiên Chân Thân
黑帝=Hắc Đế
一炁化三皇=Nhất Khí Hóa Tam Hoàng
人皇=Nhân Hoàng
绝地天通=Tuyệt Địa Thiên Thông
鱼妇=Ngư Phụ
弥勒童子=Di Lặc Đồng Tử
黄眉=Hoàng Mi
姜蜀黍=Khương Thục Thúc
越王=Việt Vương
梵音=Phạn Âm
论剑大会=Luận Kiếm đại hội
三族=Tam Tộc
三尸咒·邪罗灭元=Tam Thi Chú - Tà La Diệt Nguyên
大日如来金刚印=Đại Nhật Như Lai Kim Cang Ấn
弥勒尊佛=Di Lặc Tôn Phật
龙华宝树=Long Hoa Bảo Thụ
真空家乡=Chân Không Gia Hương
黄天法相=Hoàng Thiên Pháp Tướng
墨辩=Mặc Biện
姬温=Cơ Ôn
圣婴大王=Thánh Anh Đại Vương
太素之身=Thái Tố Chi Thân
姜叔叔=Khương thúc thúc
广乘=Quảng Thừa
魔祖波旬=Ma Tổ Ba Tuần
素色云界旗=Tố Sắc Vân Giới Kỳ
凌虚子=Lăng Hư Tử
斩仙飞刀=Trảm Tiên Phi Đao
道德=Đạo Đức
姬素云=Cơ Tố Vân
黄河阵=Hoàng Hà Trận
荆扬=Kinh Dương
宙光=Trụ Quang
黄眉大王=Hoàng Mi Đại Vương
西行路=Tây Hành Lộ
大雷音寺=Đại Lôi Âm Tự
小西天=Tiểu Tây Thiên
论剑海=Luận Kiếm Hải
东昆虚=Đông Côn Khư
金神蓐收=Kim Thần Nhục Thu
白虎=Bạch Hổ
商剑陵=Thương Kiếm Lăng
靖阳君=Tĩnh Dương Quân
二郎神=Nhị Lang Thần
三圣母=Tam Thánh Mẫu
七仙女=Thất Tiên Nữ
老猪=Lão Trư
老牛=Lão Ngưu
太祖=Thái Tổ
《蚩尤三盘经》=《Xi Vưu Tam Bàn Kinh》
宙光逆转=Trụ Quang nghịch chuyển
天子道果=Thiên Tử Đạo Quả
应龙道果=Ứng Long Đạo Quả
公孙弃=Công Tôn Khí
弥勒=Di Lặc
陵光=Lăng Quang
元希=Nguyên Hi
刑遇贪狼=Hình Ngộ Tham Lang
辅弼夹帝=Phụ Bật Giáp Đế
青玥=Thanh Nguyệt
太学=Thái học
妘秋池=Vân Thu Trì
九黎刀经=Cửu Lê Đao Kinh
蚩尤三盘经=Xi Vưu Tam Bàn Kinh
吕天蓬=Lữ Thiên Bồng
公孙羽流=Công Tôn Vũ Lưu
琼山=Quỳnh Sơn
墨夷=Mặc Di
太白金星=Thái Bạch Kim Tinh
观世音=Quan Thế Âm
元君=Nguyên Quân
太玄=Thái Huyền
鲁王世子=Lỗ Vương Thế Tử
鲁王=Lỗ Vương
四皇子=Tứ Hoàng Tử
宗正=Tông Chính
清河郡王=Thanh Hà Quận Vương
骠骑将军殷屠龙=Phiếu Kỵ Tướng Quân Ân Đồ Long
赤眉军=Xích Mi Quân
越王姬温=Việt Vương Cơ Ôn
圣德太子姬继稷=Thánh Đức Thái Tử Cơ Kế Tắc
萧秩=Tiêu Trật
圜丘台=Hoàn Khâu Đài
公孙家主=Công Tôn Gia Chủ
墨门矩子墨玄空=Mặc Môn Củ Tử Mặc Huyền Không
千佛山=Thiên Phật Sơn
泰神殿=Thái Thần Điện
皇城太庙=Hoàng Thành Thái Miếu
乾坤圈=Càn Khôn Quyển
太乙真人=Thái Ất Chân Nhân
火尖枪=Hỏa Tiêm Thương
神火九炼=Thần Hỏa Cửu Luyện
道空寰宇=Đạo Không Hoàn Vũ
造天法仪=Tạo Thiên Pháp Nghi
四姓家犬=Tứ Tính Gia Khuyển
姬继稷=Cơ Kế Tắc
张指玄=Trương Chỉ Huyền
九天应元雷声普化天尊=Cửu Thiên Ứng Nguyên Lôi Thanh Phổ Hóa Thiên Tôn
姜小子=Tiểu tử Khương
玄穹高上帝=Huyền Khung Cao Thượng Đế
汉武帝=Hán Vũ Đế
旱神掌·如惔如焚=Hạn Thần Chưởng · Như Đàm Như Phần
少昊金天氏=Thiếu Hạo Kim Thiên Thị
军神五兵=Quân Thần Ngũ Binh
皇极经世=Hoàng Cực Kinh Thế
黄帝阴符经=Hoàng Đế Âm Phù Kinh
青华古树=Thanh Hoa Cổ Thụ
金刚不坏身=Kim Cương Bất Hoại Thân
火眼金睛=Hỏa Nhãn Kim Tinh
兜率宫=Đâu Suất Cung
万仙大教=Vạn Tiên Đại Giáo
如来老儿=Như Lai Lão Nhi
玉清道统=Ngọc Thanh Đạo Thống
元始祖师=Nguyên Thủy Tổ Sư
太上老倌=Thái Thượng Lão Quán
周天子=Chu Thiên Tử
市医院=Bệnh viện thành phố
天吴=Thiên Ngô
无支祁=Vô Chi Kỳ
灵山大雷音寺=Linh Sơn Đại Lôi Âm Tự
大罗天=Đại La Thiên
大自在天=Đại Tự Tại Thiên
众生=Chúng Sinh
无障金刚=Vô Chướng Kim Cương
法轮印=Pháp Luân Ấn
金光佛轮=Kim Quang Phật Luân
玉清元始=Ngọc Thanh Nguyên Thủy
人间=Nhân Gian
首阳山=Thủ Dương Sơn
丹虚子=Đan Hư Tử
无为洞天=Vô Vi Động Thiên
金刚琢=Kim Cang Trạc
姜姓天子=Khương Tính Thiên Tử
水府星官=Thủy Phủ Tinh Quan
凌霄宝殿四大元帅=Lăng Tiêu Bảo Điện Tứ Đại Nguyên Soái
六耳=Lục Nhĩ
三身佛=Tam Thân Phật
法身佛=Pháp Thân Phật
报身佛=Báo Thân Phật
卢舍那佛=Lô Xá Na Phật
应身佛=Ứng Thân Phật
文殊广法天尊=Văn Thù Quảng Pháp Thiên Tôn
文殊师利菩萨=Văn Thù Sư Lợi Bồ Tát
中天紫微大帝=Trung Thiên Tử Vi Đại Đế
金轮炽盛光佛=Kim Luân Sí Thịnh Quang Phật
毗湿奴=Tỳ Thấp Nỗ
佛狱=Phật Ngục
弼马温=Bật Mã Ôn
琼宁苑=Quỳnh Ninh Uyển
风华殿=Phong Hoa Điện
太卜令=Thái Bốc Lệnh
姬长风=Cơ Trường Phong
姜伯维=Khương Bá Duy
姬远=Cơ Viễn
兖州=Duyện Châu
钟神秀=Chung Thần Tú
江南=Giang Nam
洞天福地=Động Thiên Phúc Địa
随世感应仙姑=Tùy Thế Cảm Ứng Tiên Cô
雷部二十四正神=Lôi Bộ Nhị Thập Tứ Chính Thần
三霄仙子=Tam Tiêu Tiên Tử
碧霄=Bích Tiêu
琼霄=Quỳnh Tiêu
云霄=Vân Tiêu
随世感应三仙姑=Tùy Thế Cảm Ứng Tam Tiên Cô
龙虎玄坛真君=Long Hổ Huyền Đàn Chân Quân
天玑=Thiên Cơ
玉衡=Ngọc Hành
天权=Thiên Quyền
开阳=Khai Dương
凌无觉=Lăng Vô Giác
口含天宪=Khẩu Hàm Thiên Hiến
道祖=Đạo Tổ
神农氏=Thần Nông Thị
赤帝=Xích Đế
万长老=Vạn trưởng lão
乔山岛=Kiều Sơn Đảo
玉衡长老=Ngọc Hành trưởng lão
天璇殿=Thiên Tuyền Điện
开阳长老=Khai Dương trưởng lão
首山=Thủ Sơn
开阳殿=Khai Dương Điện
道法阁=Đạo Pháp Các
老万头=Lão Vạn Đầu
公孙策=Công Tôn Sách
八岐=Bát Kỳ
雷神=Lôi Thần
思返谷=Tư Phản Cốc
雨师=Vũ Sư
颛顼帝=Chuyên Húc Đế
九黎=Cửu Lê
东阳长公主=Đông Dương Trưởng Công Chúa
姜氏天子=Khương Thị Thiên Tử
天女魃=Thiên Nữ Bạt
云长老=Vân trưởng lão
过去佛=Quá Khứ Phật
天枢殿=Thiên Xu Điện
上清洞天=Thượng Thanh Động Thiên
天玑长老=Thiên Cơ trưởng lão
荆扬之地=Kinh Dương Chi Địa
太史令萧秩=Thái Sử Lệnh Tiêu Trật
尚贤宫=Thượng Hiền Cung
东王公道果=Đông Vương Công Đạo Quả
天子玉玺=Thiên Tử Ngọc Tỉ
镇元子=Trấn Nguyên Tử
兵主蚩尤=Binh Chủ Xi Vưu
天界=Thiên Giới
阴世=Âm Thế
徐徐飞来的青木古树=Cổ Thụ Thanh Mộc từ từ bay đến
扶桑树=Cây Phù Tang
昆虚仙宫=Côn Khư Tiên Cung
土伯=Thổ Bá
阴律司=Âm Luật Tư
幽冥天=U Minh Thiên
陶钧万物=Đào Quân Vạn Vật
清浊=Thanh Trọc
五浊恶气=Ngũ Trọc Ác Khí
蓬莱山=Bồng Lai Sơn
冬神=Đông Thần
九元岛=Cửu Nguyên Đảo
四宫主=Tứ Cung Chủ
云妃=Vân Phi
龙须虎=Long Tu Hổ
东海分水将军=Đông Hải Phân Thủy Tướng Quân
皇城大明殿=Hoàng Thành Đại Minh Điện
东海郡=Đông Hải Quận
三千界=Tam Thiên Giới
三花聚顶=Tam Hoa Tụ Đỉnh
暝晦视明·天地双沉=Minh Hối Thị Minh·Thiên Địa Song Trầm
黄帝四面=Hoàng Đế Tứ Diện
玉玺=Ngọc Tỷ
轩辕台=Hiên Viên Đài
重阳全真开化真君=Trùng Dương Toàn Chân Khai Hóa Chân Quân
日母·羲和=Nhật Mẫu · Hi Hòa
日主=Nhật Chủ
昴日星官=Mão Nhật Tinh Quan
虚日星官=Hư Nhật Tinh Quan
东君=Đông Quân
炎帝真灵=Viêm Đế Chân Linh
少昊=Thiếu Hạo
颛顼=Chuyên Húc
太阳星君=Thái Dương Tinh Quân
紫微星=Tử Vi Tinh
开化万天=Khai Hóa Vạn Thiên
朕即国家=Trẫm Tức Quốc Gia
诛仙剑意=Tru Tiên Kiếm Ý
诛仙四剑=Tru Tiên Tứ Kiếm
王母=Vương Mẫu
人参果=Nhân Sâm Quả
姬道阳=Cơ Đạo Dương
药师袈裟=Dược Sư Ca Sa
东方药师琉璃光王如来=Đông Phương Dược Sư Lưu Ly Quang Vương Như Lai
玉皇道果=Ngọc Hoàng Đạo Quả
无佛寺=Vô Phật Tự
菩提树=Bồ Đề Thụ
炎黄=Viêm Hoàng
上清=Thượng Thanh
大明殿=Đại Minh Điện
冲虚真人·列子=Trùng Hư Chân Nhân · Liệt Tử
重阳全真开化真君·王重阳=Trùng Dương Toàn Chân Khai Hóa Chân Quân · Vương Trùng Dương
上仙·吕洞宾=Thượng Tiên · Lã Động Tân
纯阳帝君=Thuần Dương Đế Quân
东华帝君=Đông Hoa Đế Quân
吕洞宾=Lã Động Tân
蒙脱石散=Montmorillonit
牢姜=Lao Khương
曦贵妃=Hi Quý Phi
南明阁=Nam Minh Các
南天司=Nam Thiên Tư
太岁神=Thái Tuế Thần
龙渊阁=Long Uyên Các
释迦=Thích Ca
燃灯如来=Nhiên Đăng Như Lai
皇室=Hoàng Thất
墨门=Mặc Môn
转轮铳=Chuyển Luân Súng
火宅佛狱=Hỏa Trạch Phật Ngục
万里荒漠=Vạn Lí Hoang Mạc
药师佛=Dược Sư Phật
定光=Định Quang
天魔波旬=Thiên Ma Ba Tuần
喷射战士=Splatoon
琉璃=Lưu Ly
大日=Đại Nhật
梵文=Phạn văn
金刚界=Kim Cương Giới
胎藏界=Thai Tạng Giới
不空光明遍照=Bất Không Quang Minh Biến Chiếu
十二药叉=Thập Nhị Dược Xoa
月宫永德=Nguyệt Cung Vĩnh Đức
月光菩萨=Nguyệt Quang Bồ Tát
日光菩萨=Nhật Quang Bồ Tát
东方三圣=Đông Phương Tam Thánh
玉皇大帝=Ngọc Hoàng Đại Đế
昊天上帝=Hạo Thiên Thượng Đế
文殊=Văn Thù
皇极经世书=Hoàng Cực Kinh Thế Thư
连山阳=Liên Sơn Dương
藏山兵=Tàng Sơn Binh
迭山象=Điệt Sơn Tượng
暝晦视明=Minh Hối Thị Minh
佛门=Phật Môn
兼山物=Kiêm Sơn Vật
物阳火=Vật Dương Hỏa
先天西华=Tiên Thiên Tây Hoa
西华妙气=Tây Hoa Diệu Khí
先天西华妙气=Tiên Thiên Tây Hoa Diệu Khí
玉清=Ngọc Thanh
先天=Tiên Thiên
勾陈=Câu Trần
长生=Trường Sinh
北极紫微大帝=Bắc Cực Tử Vi Đại Đế
后土皇地祗=Hậu Thổ Hoàng Địa Kỳ
厉芒=Lệ Mang
血光=Huyết Quang
雷霆=Lôi Đình
三如来=Tam Như Lai
江山社稷图=Giang Sơn Xã Tắc Đồ
九鼎=Cửu Đỉnh
天人共尊=Thiên Nhân Cộng Tôn
南天门=Nam Thiên Môn
三界亚君=Tam Giới Á Quân
斗姆元君=Đẩu Mẫu Nguyên Quân
星宿分野=Tinh Tú Phân Dã
皇城=Hoàng Thành
太阳法相=Thái Dương Pháp Tướng
涿鹿之战=Trác Lộc Chi Chiến
太阴=Thái Âm
老妖精=Lão yêu tinh
朱晦庵=Chu Hối Am
燧人氏=Toại Nhân Thị
大羿=Đại Nghệ
列子=Liệt Tử
昆虚雪峰=Côn Khư Tuyết Phong
大周太祖=Đại Chu Thái Tổ
老君=Lão Quân
太清=Thái Thanh
天庭玉帝=Thiên Đình Ngọc Đế
昆虚山脉=Dãy núi Côn Khư
天罡三十六法=Thiên Cương Tam Thập Lục Pháp
颠倒阴阳=Điên Đảo Âm Dương
太清仙光=Thái Thanh Tiên Quang
广元道人=Quảng Nguyên Đạo Nhân
玉清殿=Ngọc Thanh Điện
李伯阳=Lý Bá Dương
观世音菩萨=Quan Thế Âm Bồ Tát
东方净琉璃世界=Thế giới Tịnh Lưu Ly phương Đông
金刚胎藏界=Kim Cang Thai Tạng Giới
婆娑世界=Thế giới Ta Bà
斗战胜佛=Đấu Chiến Thắng Phật
四大天王=Tứ Đại Thiên Vương
灵台山=Linh Đài Sơn
太极天轮=Thái Cực Thiên Luân
往生咒=Vãng Sanh Chú
曼荼罗=Mạn Đà La
七宝池=Thất Bảo Trì
燃灯佛=Nhiên Đăng Phật
燃灯=Nhiên Đăng
谈无为=Đàm Vô Vi
两界十方=Lưỡng Giới Thập Phương
金刚胎藏=Kim Cương Thai Tạng
须弥化芥子=Tu Di Hóa Giới Tử
大日如来法印=Đại Nhật Như Lai Pháp Ấn
旃檀佛光=Chiên Đàn Phật Quang
旃檀功德佛=Chiên Đàn Công Đức Phật
唐三藏=Đường Tam Tạng
金刚不坏佛=Kim Cương Bất Hoại Phật
宝光佛=Bảo Quang Phật
龙尊王佛=Long Tôn Vương Phật
水天佛=Thủy Thiên Phật
红焰帝幢王佛=Hồng Diễm Đế Tràng Vương Phật
第1049章=Chương 1049
八十八佛=Tám mươi tám vị Phật
菩萨罗汉=Bồ tát La hán
太始之炁=Thái Thủy chi Khí
阴阳两极剑=Âm Dương Lưỡng Cực Kiếm
欢喜道主=Hoan Hỉ Đạo Chủ
欢喜佛法相=Hoan Hỉ Phật Pháp Tướng
地水风火=Địa Thủy Phong Hỏa
道器=Đạo Khí
末法=Mạt Pháp
欢喜佛=Hoan Hỉ Phật
欲界第六天=Dục Giới Đệ Lục Thiên
大自在天主=Đại Tự Tại Thiên Chủ
心外物化=Tâm Ngoại Vật Hóa
五指山=Ngũ Chỉ Sơn
觉者=Giác Giả
药叉=Dược Xoa
伐折罗=Phạt Chiết La
过去庄严劫=Quá Khứ Trang Nghiêm Kiếp
现在贤劫=Hiện Tại Hiền Kiếp
未来星宿劫=Vị Lai Tinh Tú Kiếp
苦集灭道四圣谛=Khổ Tập Diệt Đạo Tứ Thánh Đế
地藏王=Địa Tạng Vương
白衣觉者=Bạch Y Giác Giả
魔罗=Ma La
太始之道=Thái Thủy Chi Đạo
阿閦=A Súc
金刚萨埵=Kim Cang Tát Đoả
佛说力士移山经=Phật Thuyết Lực Sĩ Di Sơn Kinh
大道化身=Đại Đạo Hóa Thân
阿弥陀佛法相=A Di Đà Phật Pháp Tướng
七佛灭罪=Thất Phật Diệt Tội
七邪荼黎=Thất Tà Đồ Lê
须弥=Tu Di
孔雀大明王=Khổng Tước Đại Minh Vương
五行山=Ngũ Hành Sơn
齐天大圣=Tề Thiên Đại Thánh
泽被万物=Trạch Bị Vạn Vật
真如居士=Chân Như Cư Sĩ
元始之道=Nguyên Thủy Chi Đạo
七色神光=Thất Sắc Thần Quang
姜檀越=Khương Đàn Việt
乔山=Kiều Sơn
震泽=Chấn Trạch
雷祖=Lôi Tổ
雷池=Lôi Trì
佛祖=Phật Tổ
准提=Chuẩn Đề
十二品金莲=Thập Nhị Phẩm Kim Liên
天君姬继稷=Thiên Quân Cơ Kế Tắc
六魂幡=Lục Hồn Phan
昆虚山=Côn Khư Sơn
雷泽龙神=Lôi Trạch Long Thần
神都皇城=Thần Đô Hoàng Thành
东王公=Đông Vương Công
太阳神炎帝=Thái Dương Thần Viêm Đế
天宫=Thiên Cung
八九玄功=Bát Cửu Huyền Công
蓬莱=Bồng Lai
墨学=Mặc Học
三州=Tam Châu
三昧真火=Tam Muội Chân Hỏa
天埑=Thiên Triệt
天魅妖神=Thiên Mị Yêu Thần
三坛海会大神=Tam Đàn Hải Hội Đại Thần
风火轮=Phong Hỏa Luân
百眼魔君=Bách Nhãn Ma Quân
百目金光=Bách Mục Kim Quang
孙行者=Tôn Hành Giả
玄暗之流=Huyền Ám Chi Lưu
东海龙王=Đông Hải Long Vương
离火之气=Ly Hỏa Chi Khí
金斗=Kim Đấu
无字天书=Vô Tự Thiên Thư
十日=Thập Nhật
相柳=Tương Liễu
玄灵七十变=Huyền Linh Thất Thập Biến
应龙=Ứng Long
太乙神数=Thái Ất Thần Số
北极神数=Bắc Cực Thần Số
黑帝颛顼=Hắc Đế Chuyên Húc
成王败寇=Thành Vương Bại Khấu
青帝=Thanh Đế
共工=Cộng Công
南明离火=Nam Minh Ly Hỏa
九曲黄河阵=Cửu Khúc Hoàng Hà Trận
混元金斗=Hỗn Nguyên Kim Đấu
闭仙诀=Bế Tiên Quyết
惑仙丹=Hoặc Tiên Đan
黑水玄流=Hắc Thủy Huyền Lưu
一元重水=Nhất Nguyên Trọng Thủy
九州山河社稷之图=Cửu Châu Sơn Hà Xã Tắc Chi Đồ
六龙天车=Lục Long Thiên Xa
太阴星君=Thái Âm Tinh Quân
九凤=Cửu Phượng
四海龙王=Tứ Hải Long Vương
朱雀=Chu Tước
巨鳌=Cự Ngao
三足金乌=Tam Túc Kim Ô
造人鞭=Tạo Nhân Tiên
九天玄女=Cửu Thiên Huyền Nữ
簪划天河=Trâm Hoa Thiên Hà
阴仪=Âm Nghi
元始=Nguyên Thủy
灵宝=Linh Bảo
女娲=Nữ Oa
浩然之气=Hạo Nhiên Chi Khí
穷寇莫追=Cùng Khấu Mạc Truy
极乐世界=Thế giới Cực Lạc
恒沙诸佛=Hằng Sa Chư Phật
诸因之果=Chư Nhân Chi Quả
太阳真火=Thái Dương Chân Hỏa
天子=Thiên Tử
社稷=Xã Tắc
神都=Thần Đô
先帝=Tiên Đế
蜀王=Thục Vương
如来佛=Như Lai Phật
经天纬地图=Kinh Thiên Vĩ Địa Đồ
魔罗剑典=Ma La Kiếm Điển
太上老君=Thái Thượng Lão Quân
天魔万化=Thiên Ma Vạn Hóa
神农=Thần Nông
公孙=Công Tôn
轩辕=Hiên Viên
老子=Lão Tử
三清之道=Tam Thanh chi Đạo
九天荡魔真诀=Cửu Thiên Đãng Ma Chân Quyết
张道一=Trương Đạo Nhất
太白真君=Thái Bạch Chân Quân
李清涟=Lý Thanh Liêm
万古愁=Vạn Cổ Sầu
四海=Tứ Hải
风氏始祖=Phong Thị Thủy Tổ
羲皇道果=Hy Hoàng Đạo Quả
风氏一族=Phong Thị Nhất Tộc
冲虚堪道=Xung Hư Kham Đạo
先天五太=Tiên Thiên Ngũ Thái
末法天尊=Mạt Pháp Thiên Tôn
因果集=Nhân Quả Tập
盘古左眼=Bàn Cổ Tả Nhãn
东海郡王=Đông Hải Quận Vương
长公主姬陵光=Trưởng công chúa Cơ Lăng Quang
佛国=Phật Quốc
鼎立九州=Đỉnh Lập Cửu Châu
五浊恶世=Ngũ Trược Ác Thế
波旬=Ba Tuần
一气化三清=Nhất Khí Hóa Tam Thanh
凌霄殿=Lăng Tiêu Điện
日轮=Nhật Luân
陆压道人=Lục Áp đạo nhân
赵公明=Triệu Công Minh
公孙皇后=Công Tôn Hoàng Hậu
姜子牙=Khương Tử Nha
蓬莱岛=Bồng Lai đảo
长公主=Trưởng công chúa
南离宫=Nam Ly Cung
姬陵光=Cơ Lăng Quang
玄冥=Huyền Minh
颜回=Nhan Hồi
仙宫=Tiên Cung
仙后=Tiên Hậu
公孙元希=Công Tôn Nguyên Hi
如来佛祖=Như Lai Phật Tổ
九黎氏=Cửu Lê Thị
二帝=Nhị Đế
三清天=Tam Thanh Thiên
天庭=Thiên Đình
凌霄宝殿=Lăng Tiêu Bảo Điện
清源妙道真君=Thanh Nguyên Diệu Đạo Chân Quân
一念三千界=Nhất Niệm Tam Thiên Giới
无上法身=Vô Thượng Pháp Thân
如来金身=Như Lai Kim Thân
三十六天罡星=Tam Thập Lục Thiên Cương Tinh
太平教=Thái Bình Giáo
三十六渠帅=Tam Thập Lục Cừ Soái
大日如来=Đại Nhật Như Lai
三尖两刃刀=Tam Tiêm Lưỡng Nhận Đao
梁州=Lương Châu
蜀郡=Thục Quận
金堤=Kim Đê
荆州=Kinh Châu
徐州=Từ Châu
墨夷陵=Mặc Di Lăng
禹王=Vũ Vương
息壤=Tức Nhưỡng
神州=Thần Châu
扬州=Dương Châu
雍州=Ung Châu
青州=Thanh Châu
豫州=Dự Châu
冀州=Ký Châu
阴符经=Âm Phù Kinh
黄天=Hoàng Thiên
人参果树=Nhân Sâm Quả Thụ
地仙之祖·镇元子=Địa Tiên Chi Tổ · Trấn Nguyên Tử
天庭四御=Thiên Đình Tứ Ngự
赤县神州=Xích Huyện Thần Châu
南海=Nam Hải
玉虚广乘=Ngọc Hư Quảng Thừa
天权文曲=Thiên Quyền Văn Khúc
豫州鼎=Dự Châu Đỉnh
冀州鼎=Ký Châu Đỉnh
墨门矩子=Mặc Môn Củ Tử
墨玄空=Mặc Huyền Không
易经=Dịch Kinh
仓颉=Thương Hiệt
诛仙剑=Tru Tiên Kiếm
玉皇=Ngọc Hoàng
太昊殿=Điện Thái Hạo
风紫阳=Phong Tử Dương
昊天金阙至尊玉皇赦罪大天尊玄穹高上帝=Hạo Thiên Kim Khuyết Chí Tôn Ngọc Hoàng Xá Tội Đại Thiên Tôn Huyền Khung Cao Thượng Đế
玉帝=Ngọc Đế
风清瑶=Phong Thanh Dao
太昊上帝=Thái Hạo Thượng Đế
姬轩辕=Cơ Hiên Viên
女魃=Nữ Bạt
上清派=Thượng Thanh Phái
八卦=Bát Quái
广乘道人=Quảng Thừa Đạo Nhân
太学祭酒=Thái Học Tế Tửu
鼎湖=Đỉnh Hồ
大宗正=Đại Tông Chính
旱魃=Hạn Bạt
申公豹=Thân Công Báo
轩辕黄帝=Hiên Viên Hoàng Đế
十二药叉大将=Thập Nhị Dược Xoa Đại Tướng
天皇=Thiên Hoàng
地皇=Địa Hoàng
阳仪=Dương Nghi
伏羲真灵=Phục Hy Chân Linh
三十三天=Tam Thập Tam Thiên
九地=Cửu Địa
三百六十五个洞天=Ba Trăm Sáu Mươi Lăm Động Thiên
庄周=Trang Chu
圣人=Thánh Nhân
《山坟》=《Sơn Phần》
《形坟》=《Hình Phần》
太昊伏羲=Thái Hạo Phục Hy
昊天金阙玉皇大帝=Hạo Thiên Kim Khuyết Ngọc Hoàng Đại Đế
九仪天尊剑=Cửu Nghi Thiên Tôn Kiếm
天极圣光=Thiên Cực Thánh Quang
封神榜=Phong Thần Bảng
打神鞭=Đả Thần Tiên
一尺之捶=Nhất Xích Chi Chùy
养生主=Dưỡng Sinh Chủ
青帝长生=Thanh Đế Trường Sinh
三元=Tam Nguyên
人定胜天=Nhân Định Thắng Thiên
乾卦=Càn Quái
太昊=Thái Hạo
混元一气上清神符=Hỗn Nguyên Nhất Khí Thượng Thanh Thần Phù
钉头七箭书=Đinh Đầu Thất Tiễn Thư
九州鼎=Cửu Châu Đỉnh
炎黄二帝=Viêm Hoàng Nhị Đế
洛书=Lạc Thư
河图=Hà Đồ
连山易=Liên Sơn Dịch
太极=Thái Cực
招妖幡=Chiêu Yêu Phiên
娲皇道器=Oa Hoàng Đạo Khí
申侯=Thân Hầu
蚩尤之旗=Xi Vưu Chi Kỳ
九品金莲=Cửu Phẩm Kim Liên
黄帝的轩辕剑=Hiên Viên Kiếm của Hoàng Đế
天河=Thiên Hà
老祖宗=Lão Tổ Tông
山河社稷图=Sơn Hà Xã Tắc Đồ
都天神煞=Đô Thiên Thần Sát
蚩尤=Xi Vưu
赭鞭=Giả Tiên
归藏=Quy Tàng
军神=Quân Thần
天君=Thiên Quân
汤谷=Thang Cốc
伏羲=Phục Hy
太初一指=Thái Sơ Nhất Chỉ
四极天柱=Tứ Cực Thiên Trụ
天柱山峰=Thiên Trụ Sơn Phong
先天一炁=Tiên Thiên Nhất Khí
宙光神通=Trụ Quang Thần Thông
道果=Đạo Quả
三坟=Tam Phần
《皇极经世书》=《Hoàng Cực Kinh Thế Thư》
烛九阴=Chúc Cửu Âm
风后=Phong Hậu
三皇=Tam Hoàng
五帝=Ngũ Đế
洛书河图=Lạc Thư Hà Đồ
烛龙=Chúc Long
风满楼=Phong Mãn Lâu
气坟=Khí Phần
东极=Đông Cực
龙宫=Long Cung
羲和=Hi Hòa
六轮太阳法相=Lục Luân Thái Dương Pháp Tướng
孙猴子=Tôn Hầu Tử
金箍棒=Kim Cô Bổng
九龙神火罩=Cửu Long Thần Hỏa Tráo
水晶殿=Thủy Tinh Điện
天鹏=Thiên Bằng
帝女魃=Đế Nữ Bạt
大鲲老人=Đại Côn Lão Nhân
玄武王=Huyền Vũ Vương
癸水神罩=Quý Thủy Thần Tráo
帝出乎震=Đế Xuất Hồ Chấn
猴子=Hầu Tử
老孙=Lão Tôn
玄武=Huyền Vũ
玄蛇=Huyền Xà
玄冥真水=Huyền Minh Chân Thủy
金乌=Kim Ô
佛陀=Phật Đà
昊天镜=Hạo Thiên Kính
紫微殿=Tử Vi Điện
巫山=Vu Sơn
天魅=Thiên Mị
妖神教=Yêu Thần Giáo
公孙青玥=Công Tôn Thanh Nguyệt
孙悟空=Tôn Ngộ Không
如来=Như Lai
北海=Bắc Hải
北极天柱=Bắc Cực Thiên Trụ
太学祭酒墨夷陵=Thái Học Tế Tửu Mặc Di Lăng
广乘道长=Quảng Thừa Đạo Trưởng
殷屠龙=Ân Đồ Long
黄海=Hoàng Hải
东海=Đông Hải
业如来=Nghiệp Như Lai
药师如来=Dược Sư Như Lai
南方=Nam Phương
檀越=Đàn Việt
风氏=Phong Thị
姜氏=Khương Thị
五色石=Ngũ Sắc Thạch
山坟=Sơn Phần
伏山臣=Phục Sơn Thần
天地烘炉=Thiên Địa Hồng Lô
娲皇=Oa Hoàng
炼妖壶=Luyện Yêu Hồ
不周山=Bất Chu Sơn
苍天=Thương Thiên
九州=Cửu Châu
大周=Đại Chu
赤霞=Xích Hà
三界=Tam Giới
太阳神=Thái Dương Thần
三宝玉如意=Tam Bảo Ngọc Như Ý
太阳星=Thái Dương Tinh
盘古幡=Bàn Cổ Phiên
青萍剑=Thanh Bình Kiếm
三清道果=Đạo quả Tam Thanh
伏羲道果=Đạo quả Phục Hy
人文初祖=Nhân văn sơ tổ
青帝道果=Đạo quả Thanh Đế
炎帝道果=Đạo quả Viêm Đế
玉皇大天尊=Ngọc Hoàng Đại Thiên Tôn
天尊=Thiên Tôn
阿弥陀佛=A Di Đà Phật
元始天尊=Nguyên Thủy Thiên Tôn
灵宝天尊=Linh Bảo Thiên Tôn
盘古=Bàn Cổ
大尊=Đại Tôn
遍照十方=Biến Chiếu Thập Phương
三清道器=Tam Thanh Đạo Khí
归藏易=Quy Tàng Dịch
乾坤易=Càn Khôn Dịch
神农鼎=Thần Nông Đỉnh
玄都=Huyền Đô
青牛=Thanh Ngưu
玄都道长=Huyền Đô Đạo Trưởng
啸天=Khiếu Thiên
姜天子=Khương Thiên Tử
道君=Đạo Quân
太极图=Thái Cực Đồ
玄都大法师=Huyền Đô Đại Pháp Sư
道德天尊=Đạo Đức Thiên Tôn
三清天尊=Tam Thanh Thiên Tôn
三清=Tam Thanh
形坟=Hình Phần
兵主=Binh Chủ
太素=Thái Tố
太始=Thái Thủy
太初=Thái Sơ
金刚镯=Kim Cang Trạc
离地焰光旗=Ly Địa Diệm Quang Kỳ
真武皂雕旗=Chân Võ Tạo Điêu Kỳ
天之厉=Thiên Chi Lệ
七宝妙树=Thất Bảo Diệu Thụ
姜离=Khương Ly
西王母=Tây Vương Mẫu
释迦如来=Thích Ca Như Lai
大天尊=Đại Thiên Tôn
天帝=Thiên Đế
姜天帝=Khương Thiên Đế
羲皇=Hi Hoàng
黄帝=Hoàng Đế
炎帝=Viêm Đế
准提佛母=Chuẩn Đề Phật Mẫu
后土皇地祇=Hậu Thổ Hoàng Địa Kỳ
玉虚观=Ngọc Hư Quan
道德宗=Đạo Đức Tông
南极长生大帝=Nam Cực Trường Sinh Đại Đế
勾陈大帝=Câu Trần Đại Đế
紫微大帝=Tử Vi Đại Đế
轩辕剑=Hiên Viên Kiếm
鼎湖派=Đỉnh Hồ Phái
天璇=Thiên Toàn
雨师元君=Vũ Sư Nguyên Quân
姬氏=Cơ Thị
公孙家=Công Tôn Gia
二月=Tháng Hai
