蜀仙界修魔归来的老爸=Người cha tu ma trở về từ Thục Tiên Giới
混元掌=Hỗn Nguyên Chưởng
快哉风=Khoái Tai Phong
浏阳帮=Lưu Dương Bang
孙河=Tôn Hà
大琅朝廷=Đại Lang triều đình
太乙宗=Thái Ất Tông
风祖师爷=Phong Tổ Sư Gia
混元三十六桩功=Hỗn Nguyên Tam Thập Lục Trang Công
乘龙仙婿=Thừa Long Tiên Tế
司徒宝威=Tư Đồ Bảo Uy
黑帆帮=Hắc Phàm Bang
三十六路混元桩功=Tam Thập Lục Lộ Hỗn Nguyên Thung Công
七十二路荡魔剑=Thất Thập Nhị Lộ Đãng Ma Kiếm
三绝顶=Tam Tuyệt Đỉnh
五大宗师=Ngũ Đại Tông Sư
邪道=Tà Đạo
剑神=Kiếm Thần
老饭骨菜=Lão Phạn Cốt Thái
乡村食叔菜=Hương Thôn Thực Thúc Thái
隋家菜=Tùy Gia Thái
王家菜=Vương Gia Thái
唐家菜=Đường Gia Thái
老杜=Lão Đỗ
大琅国=Đại Lang Quốc
苗老师=Miêu lão sư
孙青蛟=Tôn Thanh Giao
仙葫=Tiên Hồ
龙门派=Long Môn Phái
劳教主=Lao giáo chủ
毛宗刚=Mao Tông Cương
天枭爪=Thiên Kiêu Trảo
赤蝎手=Xích Yết Thủ
毛指挥使=Mao Chỉ Huy Sứ
宇阳太守=Vũ Dương Thái Thú
太湖十八寨=Thái Hồ Thập Bát Trại
池南宗=Trì Nam Tông
盛寒=Thịnh Hàn
孙有二=Tôn Hữu Nhị
元尚绣=Nguyên Thượng Tú
尉迟武=Uất Trì Vũ
劳家=Lao Gia
司马御史=Tư Mã Ngự Sử
峨眉屠龙=Nga Mi Đồ Long
金鹫九变=Kim Ưng Cửu Biến
司马承=Tư Mã Thừa
骆宾王=Lạc Tân Vương
苏东坡=Tô Đông Pha
李商隐=Lý Thương Ẩn
大仲马=Alexandre Dumas
郭某人=Quách Mỗ Nhân
司马家=Tư Mã gia
第一次魔法世界大战=Đệ nhất thứ Ma Pháp Thế Giới Đại Chiến
黑神刺=Hắc Thần Thứ
劳辛=Lao Tân
殷真人=Ân chân nhân
二十四路金筋玉骨拳=Nhị Thập Tứ Lộ Kim Cân Ngọc Cốt Quyền
玄黄道一脉=Huyền Hoàng Đạo Nhất Mạch
天龙门=Thiên Long Môn
无念僧=Vô Niệm Tăng
南夏皇室御天军=Nam Hạ Hoàng Thất Ngự Thiên Quân
孙道长=Tôn đạo trưởng
天机百变千幻十三式=Thiên Cơ Bách Biến Thiên Huyễn Thập Tam Thức
孙老前辈=Tôn lão tiền bối
劳家父女=Lao gia phụ nữ
武青莺=Võ Thanh Oanh
御史家=Ngự Sử Gia
天机门=Thiên Cơ Môn
杜万里=Đỗ Vạn Lí
杜千行=Đỗ Thiên Hành
灵蝶仙子=Linh Điệp Tiên Tử
虎贲郎将=Hổ Bí Lang Tướng
峨眉双秀=Nga Mi Song Tú
南梦二姐=Nam Mộng Nhị Tỷ
南梦四姐=Nam Mộng Tứ Tỷ
南梦七妹=Nam Mộng Thất Muội
南梦八妹=Nam Mộng Bát Muội
尉迟武恭=Úy Trì Võ Cung
枣阳棍=Táo Dương Côn
东三省=Đông Tam Tỉnh
流浪的蛤蟆=Lưu Lãng Đích Cáp Mô
大师伯=Đại sư bá
张远山=Trương Viễn Sơn
泰山=Thái Sơn
南天门=Nam Thiên Môn
陈沂=Trần Nghi
玉皇顶=Ngọc Hoàng Đỉnh
南梦家大姐=Nam Mộng Gia Đại Tỷ
魏宗师=Ngụy Tông Sư
道录司=Đạo Lục Tư
邪祖玄冥=Tà Tổ Huyền Minh
少禅空蝉=Thiếu Thiền Không Thiền
嵩阳远桥=Tung Dương Viễn Kiều
白客=Bạch Khách
月关=Nguyệt Quan
魏道姑=Ngụy đạo cô
灵剑=Linh Kiếm
司马真人=Tư Mã chân nhân
紫游观=Tử Du Quan
宇文骅=Vũ Văn Hoa
东崖=Đông Nhai
乌龙观=Ô Long Quan
司马师兄=Tư Mã sư huynh
俄叱=Nga Sất
君听云=Quân Thính Vân
瓷公子=Sứ công tử
苏红=Tô Hồng
留仙庄=Lưu Tiên Trang
王真人=Vương chân nhân
瓷公子苏红=Sứ Công Tử Tô Hồng
温不言=Ôn Bất Ngôn
温不语=Ôn Bất Ngữ
浑南路=Hỗn Nam Lộ
剑神胡青帝=Kiếm Thần Hồ Thanh Đế
柳七变=Liễu Thất Biến
高远=Cao Viễn
灵坛观=Linh Đàn Quán
宋祖儿=Tống Tổ Nhi
飞龙峰=Phi Long Phong
降龙十八掌=Giáng Long Thập Bát Chưởng
胡家混元三十六桩功=Hồ Gia Hỗn Nguyên Tam Thập Lục Trang Công
混元剑=Hỗn Nguyên Kiếm
嵩阳风老祖=Tung Dương Phong Lão Tổ
猿筋=Viên Cân
龙虎象=Long Hổ Tượng
快刀田三=Khoái đao Điền Tam
白莲师叔=Bạch Liên sư thúc
胡永=Hồ Vĩnh
朝霞六艺=Triều Hà lục nghệ
颜笙=Nhan Sanh
飞龙楼=Phi Long Lâu
大竹峰=Đại Trúc Phong
观云观=Quan Vân Quan
李道子=Lý Đạo Tử
云中君=Vân Trung Quân
公孙福=Công Tôn Phúc
天都楼=Thiên Đô Lâu
风老祖师=Phong Lão Tổ Sư
灵剑楼=Linh Kiếm Lâu
天机大圣孙云鹤=Thiên Cơ Đại Thánh Tôn Vân Hạc
灭神掌=Diệt Thần Chưởng
唐碎镜=Đường Toái Kính
三阳真经=Tam Dương Chân Kinh
听花剑=Thính Hoa Kiếm
赤楼=Xích Lâu
魏夫人=Ngụy phu nhân
金山楼=Kim Sơn Lâu
程咬金=Trình Giảo Kim
白虹掠地=Bạch Hồng Lược Địa
万里黄沙=Vạn Lý Hoàng Sa
千军辟易=Thiên Quân Tích Dịch
斩将夺旗=Trảm Tướng Đoạt Kỳ
一柱朝天=Nhất Trụ Triều Thiên
南梦薰=Nam Mộng Huân
南梦素=Nam Mộng Tố
南梦茶茶=Nam Mộng Trà Trà
寒酥=Hàn Tô
南梦栀=Nam Mộng Chi
青鸾=Thanh Loan
红凤=Hồng Phượng
南门家=Nam Môn Gia
夔兽=Quỳ Thú
程家=Trình Gia
夔阳山=Quỳ Dương Sơn
新加坡=Singapore
上海=Thượng Hải
浦东机场=Sân bay Phố Đông
长春=Trường Xuân
七绝七变困龙阵=Thất Tuyệt Thất Biến Khốn Long Trận
胡剑神=Hồ Kiếm Thần
困龙庄=Khốn Long Trang
二师伯=Nhị Sư Bá
七绝七变困龙杀阵=Thất Tuyệt Thất Biến Khốn Long Sát Trận
格马萨=Cách Mã Tát
青山帮=Thanh Sơn Bang
夔阳会=Quỳ Dương Hội
夔阳城=Quỳ Dương Thành
程家庄=Trình Gia Trang
嵩阳门=Tung Dương Môn
远桥=Viễn Kiều
天都峰=Thiên Đô Phong
如来十力经=Như Lai Thập Lực Kinh
焚袖=焚袖
无赦=Vô Xá
玄阳诀=Huyền Dương Quyết
玄黄诀=Huyền Hoàng Quyết
于锦亭=Vu Cẩm Đình
魏樱=Ngụy Anh
聆香观=Lắng Hương Quan
大琅天=Đại Lang Thiên
三寒隐脉=Tam Hàn Ẩn Mạch
诗经·陈风·月出=Thi Kinh · Trần Phong · Nguyệt Xuất
玄冥阴煞=Huyền Minh Âm Sát
鹿杖客=Lộc Trượng Khách
鹤笔翁=Hạc Bút Ông
游坦之=Du Thản Chi
左冷禅=Tả Lãnh Thiền
黑白子=Hắc Bạch Tử
红花帮=Hồng Hoa Bang
洪大春=Hồng Đại Xuân
飞虎镖局=Phi Hổ Tiêu Cục
京师=Kinh Sư
陈公公=Trần công công
陈彬=Trần Bân
陈政华=Trần Chính Hoa
冰夷=Băng Di
钱精忠=Tiền Tinh Trung
吏部=Lại Bộ
关外路=Quan Ngoại Lộ
东海道=Đông Hải Đạo
敖日温=Ngao Nhật Ôn
孙破虏=Tôn Phá Lỗ
福来客栈=Khách điếm Phúc Lai
粉红骑=Phấn Hồng Kỵ
海陵侯=Hải Lăng Hầu
月华隐脉=Nguyệt Hoa ẩn mạch
寒泉隐脉=Hàn Tuyền ẩn mạch
老瞎子=Lão hạt
太乙观门下=Môn hạ Thái Ất Quan
黄马=Hoàng Mã
虎啸龙吟君听云=Hổ Khiếu Long Ngâm Quân Thính Vân
南梦昙=Nam Mộng Đàm
婉拒=Uyển Cự
岳云鹏=Nhạc Vân Bằng
小沈阳=Tiểu Thẩm Dương
王老贼=Vương Lão Tặc
王老道=Vương Lão Đạo
天蝎帮=Thiên Yết Bang
阳金丹=Dương Kim Đan
七脉会武=Thất Mạch Hội Võ
杏花=Hạnh Hoa
苏状元=Tô Trạng Nguyên
夔阳=Quỳ Dương
血狼骑=Huyết Lang Kỵ
孙老爷子=Tôn lão gia tử
范闲=Phạm Nhàn
宁毅=Ninh Nghị
永州刺史=Thứ sử Vĩnh Châu
南桥=Nam Kiều
李贤弟=Lý hiền đệ
年大人=Niên đại nhân
大师兄=Đại sư huynh
灵剑山=Linh Kiếm Sơn
北峰=Bắc Phong
乔山=Kiều Sơn
天机大圣=Thiên Cơ Đại Thánh
嵩阳剑法=Tung Dương Kiếm Pháp
严鲁=Nghiêm Lỗ
龙象归藏=Long Tượng Quy Tàng
莫狂刀=Mạc Cuồng Đao
谷燕姿=Cốc Yến Tư
苏轼=Tô Thức
刘奕之=Lưu Dịch Chi
水性杨花孙娇娇=Thủy Tính Dương Hoa Tôn Kiều Kiều
寻花问柳屠却恶=Tầm Hoa Vấn Liễu Đồ Khước Ác
烛龙御晦=Chúc Long Ngự Hối
杜枯眉=Đỗ Khô Mi
向阳街=Hướng Dương Nhai
水性杨花=Thủy Tính Dương Hoa
娇杨恶柳=Kiều Dương Ác Liễu
东坡=Đông Pha
易安=Dịch An
放翁=Phóng Ông
稼轩=Giá Hiên
小李杜=Tiểu Lý Đỗ
柳三变=Liễu Tam Biến
秦少游=Tần Thiếu Du
年府=Niên Phủ
鱼玄机=Ngư Huyền Cơ
司马刺史=Tư Mã Thứ Sử
元稹=Nguyên Chẩn
孙娇娇=Tôn Kiều Kiều
屠却恶=Đồ Khước Ác
年家=Niên Gia
屠龙师太=Đồ Long Sư Thái
何府=Hà phủ
齐霄云=Tề Tiêu Vân
紫衫龙女=Tử Sam Long Nữ
香江=Hương Giang
张二师伯=Trương Nhị sư bá
胡云擎=Hồ Vân Kình
湘江=Tương Giang
何有真=Hà Hữu Chân
姜胭师姐=Khương Yên sư tỷ
严人雄=Nghiêm Nhân Hùng
胡云襄=Hồ Vân Tương
暨南路=Ký Nam lộ
小黄=Tiểu Hoàng
天机棒=Thiên Cơ Bổng
灵犀双剑=Linh Tê Song Kiếm
莎士比亚=Shakespeare
胡云稷=Hồ Vân Tắc
神僧=Thần tăng
苗胡=Miêu Hồ
林景=Lâm Cảnh
混元桩=Hỗn Nguyên Trang
苗家疗伤心法=Miêu gia liệu thương tâm pháp
惊鸿照影十三式=Kinh Hồng Chiếu Ảnh thập tam thức
踏雪寻梅=Đạp Tuyết Tầm Mai
燕返巢=Yến Phản Sào
折柳式=Chiết Liễu Thức
长短一十九路剑法=Trường Đoản nhất thập cửu lộ kiếm pháp
天蛇帮=Thiên Xà bang
张帆儿=Trương Phàm Nhi
地听=Địa Thính
须弥=Tu Di
无相=Vô Tướng
苏父=Tô Phụ
劳爱=Lao Ái
羌南路=Khương Nam Lộ
赵小哥=Triệu tiểu ca
王公子=Vương công tử
李公子=Lý công tử
大琅皇族=Đại Lang Hoàng Tộc
胡凤狂=Hồ Phượng Cuồng
胡家荡魔剑法=Hồ Gia Đãng Ma Kiếm Pháp
胡凤三=Hồ Phượng Tam
老衙役=Lão nha dịch
北方大店=Bắc Phương Đại Điếm
永州城=Vĩnh Châu Thành
胡凤阁=Hồ Phượng Các
九命猫=Cửu Mệnh Miêu
支夫人=Chi phu nhân
李翰林=Lý Hàn Lâm
支令旗=Chi Lệnh Kỳ
红货=Hồng hóa
惊蟾灵犀=Kinh Thiềm Linh Tê
京城=Kinh thành
玄门正宗=Huyền Môn Chính Tông
嵩阳镖局=Tung Dương Tiêu Cục
胡云阁=Hồ Vân Các
洛县=Lạc huyện
烟白楼=Yên Bạch Lâu
师温故=Sư Ôn Cố
关内路=Quan Nội Lộ
开宝寺=Khai Bảo Tự
飞星镖局=Phi Tinh Tiêu Cục
趟子手=Thảng Tử Thủ
天宝寺=Thiên Bảo Tự
司马小姐=Tư Mã tiểu thư
大琅武林=Đại Lang Võ Lâm
范成大=Phạm Thành Đại
洛神赋=Lạc Thần Phú
白居易=Bạch Cư Dị
惊雷刀客泰丙=Kinh Lôi Đao Khách Thái Bính
泰庚=Thái Canh
海陵侯府=Hải Lăng Hầu Phủ
龙威镖局=Long Uy Tiêu Cục
泰丙=Thái Bính
惊雷刀客=Kinh Lôi Đao Khách
金水河=Kim Thủy Hà
泰家=Thái Gia
泰蓉波=Thái Dung Ba
京师巡察司=Kinh Sư Tuần Sát Tư
游街虎=Du Nhai Hổ
芸贵妃=Vân Quý Phi
八皇子=Bát Hoàng Tử
北帝观=Bắc Đế Quan
鬼眼剑客=Quỷ Nhãn Kiếm Khách
贺兰小白=Hạ Lan Tiểu Bạch
玄黄老祖=Huyền Hoàng Lão Tổ
劳青山=Lao Thanh Sơn
春闱=Xuân Vi
殷王朝=Nhà Ân
银月王庭=Vương đình Ngân Nguyệt
银月王=Ngân Nguyệt Vương
阿如兰纳草场=Đồng cỏ A Như Lan Nạp
黄云观=Hoàng Vân Quan
大琅官话=Đại Lang Quan Thoại
锦楼=Cẩm Lâu
寇小半=Khấu Tiểu Bán
罕布德=Hãn Bố Đức
玄黄正脉=Huyền Hoàng Chính Mạch
秦绮云=Tần Khỉ Vân
万里飞书=Vạn Lý Phi Thư
紫禁之巅=Tử Cấm Chi Điên
三阳乾焰真火=Tam Dương Càn Diệm Chân Hỏa
殷老六=Ân Lão Lục
燕晚=Yến Vãn
龙象二经筋=Long Tượng Nhị Kinh Cân
萨日图=Tát Nhật Đồ
黑兔=Hắc Thố
文魁殿=Văn Khôi Điện
张铁林=Trương Thiết Lâm
张国立=Trương Quốc Lập
鲍国安=Bào Quốc An
韩湘子=Hàn Tương Tử
天阁寺=Thiên Các Tự
韩文公=Hàn Văn Công
唐朝=Đường triều
李白=Lý Bạch
杜甫=Đỗ Phủ
李林甫=Lý Lâm Phủ
贺知章=Hạ Tri Chương
王维=Vương Duy
柳公权=Liễu Công Quyền
韩愈=Hàn Dũ
柳宗元=Liễu Tông Nguyên
陈子昂=Trần Tử Ngang
张九龄=Trương Cửu Linh
柳补之=Liễu Bổ Chi
玲珑阁=Linh Lung Các
大内=Đại Nội
太乙混仙绫奇功=Thái Ất Hỗn Tiên Lăng Kỳ Công
南梦世家=Nam Mộng Thế Gia
三十二相神通=Tam Thập Nhị Tướng Thần Thông
半截诗蛤孙二郎=Bán Tiệt Thi Cáp Tôn Nhị Lang
尉迟寒=Uất Trì Hàn
冲天军=Xung Thiên Quân
彻地王=Triệt Địa Vương
郭山=Quách Sơn
穆老神仙=Mục lão thần tiên
韩幼娘=Hàn Ấu Nương
空蝉大师=Không Thiền đại sư
老黄忠=Lão Hoàng Trung
北燕玉佛哈斯格日勒=Bắc Yến Ngọc Phật Cáp Tư Cách Nhật Lặc
风花雪月=Phong Hoa Tuyết Nguyệt
双王四使=Song Vương Tứ Sử
司马二龙=Tư Mã Nhị Long
云台=Vân Đài
大黄=Đại Hoàng
探花郎=Thám Hoa Lang
魔教探花使=Ma Giáo Thám Hoa Sứ
四圣谛指=Tứ Thánh Đế Chỉ
黑索=Hắc Tác
至阳学=Chí Dương Huyệt
命门要穴=Mệnh Môn Yếu Huyệt
金发碧眼的女子=Cô gái tóc vàng mắt xanh
西门朱玉=Tây Môn Chu Ngọc
龙三娘子=Long Tam Nương Tử
百花缭乱大阵=Bách Hoa Liễu Loạn Đại Trận
灵蝶=Linh Điệp
苗师父=Miêu sư phụ
惊蟾=Kinh Thiềm
如意真气=Như Ý Chân Khí
地球=Địa Cầu
西域=Tây Vực
中原=Trung Nguyên
穹朝=Khung Triều
玉皇道祖=Ngọc Hoàng Đạo Tổ
天山派玉皇顶的朝天宫=Triều Thiên Cung trên đỉnh Ngọc Hoàng của Thiên Sơn Phái
潮州=Triều Châu
苦叶=Khổ Diệp
苦酒=Khổ Tửu
苦烦=Khổ Phiền
天山剑派=Thiên Sơn Kiếm Phái
空蝉神僧=Không Thiền Thần Tăng
大枯前辈=Đại Khô Tiền Bối
胡家八老=Hồ Gia Bát Lão
孙燕=Tôn Yến
百里长空=Bách Lý Trường Không
苦茶=Khổ Trà
苦荷=Khổ Hà
北燕苍狼=Bắc Yến Thương Lang
孙娴=Tôn Nhàn
迟宛=Trì Uyển
天山苦叶=Thiên Sơn Khổ Diệp
定军山=Định Quân Sơn
天山派=Thiên Sơn Phái
苍狼王=Thương Lang Vương
昂日=Ngang Nhật
阿鹿古丽=A Lộc Cổ Lệ
米兰札达=Mễ Lan Trát Đạt
云莱山=Vân Lai Sơn
石台=Thạch Đài
王爷=Vương gia
王庭=Vương Đình
王妃=Vương Phi
李元霸=Lý Nguyên Bá
李存孝=Lý Tồn Hiếu
项羽=Hạng Vũ
狂蟒过海=Cuồng Mãng Quá Hải
四象不过=Tứ Tượng Bất Quá
龙象般若=Long Tượng Bát Nhã
惊蟾剑=Kinh Thiềm Kiếm
巨鲸吞海=Cự Kình Thôn Hải
龙虎豹=Long Hổ Báo
人魔=Nhân Ma
大琅天子=Đại Lang Thiên Tử
少禅师=Thiếu Thiền Sư
唐嘉尧=Đường Gia Nghiêu
玄玉天罗手=Huyền Ngọc Thiên La Thủ
乾清真气=Càn Thanh chân khí
大魔牛王相=Đại Ma Ngưu Vương Tướng
阿勒坦乌尔=A Lặc Thản Ô Nhĩ
混元剑经=Hỗn Nguyên Kiếm Kinh
陶师兄=Đào sư huynh
天龙袈裟=Thiên Long Ca Sa
冲天王=Xung Thiên Vương
胡凤威=Hồ Phượng Uy
司马姐姐=Tư Mã tỷ tỷ
灵犀=Linh Tê
快哉风刀法=Khoái Tai Phong Đao Pháp
明轮=Minh Luân
武稚=Võ Trĩ
太乙青灵篇=Thái Ất Thanh Linh Thiên
大琅皇室=Đại Lang Hoàng Thất
龙藏=Long Tàng
玄冥老怪=Huyền Minh Lão Quái
四皇子=Tứ hoàng tử
神刀镖局=Thần Đao Tiêu Cục
八姬十二将=Bát Cơ Thập Nhị Tướng
石行业=Thạch Hành Nghiệp
大琅之地=Đại Lang Chi Địa
密迦=Mật Già
秃尾城=Ngốc Vĩ Thành
伯食话=Bá Thực Thoại
阿斯力求=A Tư Lực Cầu
顾大家=Cố Đại Gia
朱蝠=Chu Bức
黑大陆=Hắc Đại Lục
凌娅=Lăng Á
天山=Thiên Sơn
穆仙猿=Mục Tiên Viên
如兰部落=Như Lan Bộ Lạc
仁儿=Nhân Nhi
寺库里=Tự Khố Lí
张机=Trương Cơ
青龙楼=Thanh Long Lâu
魔礼不寿=Ma Lễ Bất Thọ
诸葛不良=Gia Cát Bất Lương
月华=Nguyệt Hoa
寒泉=Hàn Tuyền
黑潮=Hắc Triều
万魔堂=Vạn Ma Đường
玄黄五变=Huyền Hoàng Ngũ Biến
玄冥老祖=Huyền Minh Lão Tổ
草原上的大日金翎=Đại Nhật Kim Linh trên thảo nguyên
梵王蛇相=Già Phạn Vương Xà Tướng
东南方=Đông Nam Phương
枯荣功=Khô Vinh Công
青玉案·元夕=Thanh Ngọc Án - Nguyên Tịch
辛弃疾=Tân Khí Tật
三阳乾焰神功=Tam Dương Càn Diệm Thần Công
魏师姐=Ngụy sư tỷ
霞光之女=Hà Quang Chi Nữ
娜仁吒雅王妃=Na Nhân Tra Nhã Vương Phi
魔教小圣女=Ma Giáo Tiểu Thánh Nữ
密藏三十二相神通=Mật Tàng Tam Thập Nhị Tướng Thần Thông
玄昊神掌=Huyền Hạo Thần Chưởng
焚天百杀=焚天 Bách Sát
鹿王相=Lộc Vương Tướng
大雪山相=Đại Tuyết Sơn Tướng
千手破军佛王相=Thiên Thủ Phá Quân Phật Vương Tướng
娜仁吒雅=Na Nhân Trát Nhã
清溪=Thanh Khê
嵩阳六子=Tung Dương lục tử
玄黄=Huyền Hoàng
裴无赦=Bùi Vô Xá
令狐邵=Lệnh Hồ Thiệu
丁焚袖=Đinh Phần Tụ
王掌教=Vương Chưởng Giáo
燕州=Yến Châu
裴寒=Bùi Hàn
洈水=Ngỗi Thủy
达摩堂=Đạt Ma Đường
神山=Thần Sơn
梵拿珈=Phạn Nã Già
明轮和尚=Minh Luân Hòa Thượng
阿兰陀上师=A Lan Đà Thượng Sư
阿兰陀上人=A Lan Đà Thượng Nhân
哈斯格日勒=Cáp Tư Cách Nhật Lặc
玉佛=Ngọc Phật
五行五变=Ngũ Hành Ngũ Biến
如意神针=Như Ý Thần Châm
三山=Tam Sơn
冲天王张海=Xung Thiên Vương Trương Hải
晋升宗师=Tấn Thăng Tông Sư
宗正府=Tông Chính Phủ
张家皇族=Trương Gia Hoàng Tộc
玉佛哈斯格日勒=Ngọc Phật Cáp Tư Cách Nhật Lặc
天武踏龙诀=Thiên Võ Đạp Long Quyết
大势至无相般若波罗蜜三千界诸行念力=Đại Thế Chí Vô Tướng Bát Nhã Ba La Mật Tam Thiên Giới Chư Hành Niệm Lực
至尊舍利=Chí Tôn Xá Lợi
顾姐姐=Cố tỷ tỷ
送嵩阳七友=Tống Tung Dương Thất Hữu
定州城=Định Châu Thành
燕州城=Yến Châu Thành
重阳散人=Trùng Dương Tán Nhân
嵩阳掌教=Tung Dương Chưởng Giáo
孙氏武经下卷=Tôn Thị Võ Kinh Hạ Quyển
裂锦掌力=Liệt Cẩm Chưởng Lực
第247章 江湖仇杀惯常事（求月票）=Chương 247 Giang hồ cừu sát quán thường sự
伯食皇帝=Bá Thực Hoàng Đế
北燕人=Bắc Yến Nhân
曹蓁蓁=Tào Chân Chân
八姬=Bát Cơ
十二将=Thập Nhị Tướng
西域大雪山=Tây Vực Đại Tuyết Sơn
天蝎教=Thiên Hạt Giáo
十大剑派=Thập Đại Kiếm Phái
十大帮会=Thập Đại Bang Hội
红花会=Hồng Hoa Hội
胡小仙子=Hồ Tiểu Tiên Tử
大乘般若掌=Đại Thừa Bát Nhã Chưởng
争鼎之战=Tranh Đỉnh Chi Chiến
北燕小王爷=Bắc Yến Tiểu Vương Gia
大龙头=Đại Long Đầu
胡凌威=Hồ Lăng Uy
鹤唳青冥=Hạc Lệ Thanh Minh
小惊蛰指法=Tiểu Kinh Chập Chỉ Pháp
南梦宛儿=Nam Mộng Uyển Nhi
南梦=Nam Mộng
飞云八折=Phi Vân Bát Chiết
逐电剑式=Trục Điện Kiếm Thức
缩地剑法=Súc Địa Kiếm Pháp
有剑山庄=Hữu Kiếm Sơn Trang
苗有秀=Miêu Hữu Tú
宝音梵者=Bảo Âm Phạm Giả
梵拿珈二=Phạn Nã Già Nhị
无影剑宗=Vô Ảnh Kiếm Tông
马千罡=Mã Thiên Cương
大鹫=Đại Ưng
摩诃那叶=Ma Ha Na Diệp
魔僧业海=Ma Tăng Nghiệp Hải
大鹫禅师=Đại Ưng Thiền Sư
陈家=Trần Gia
不动明王神功=Bất Động Minh Vương Thần Công
千帆碧影=Thiên Phàm Bích Ảnh
大乌克拉斯钢=Đại Ô Khắc Lạp Tư Cương
不坏金刚法=Bất Hoại Kim Cang Pháp
金筋玉骨拳=Kim Cân Ngọc Cốt Quyền
大嵩阳神剑=Đại Tung Dương Thần Kiếm
红姬=Hồng Cơ
摩云金猴=Ma Vân Kim Hầu
绿姬=Lục Cơ
童宝=Đồng Bảo
孙破坚=Tôn Phá Kiên
粉姬=Phấn Cơ
红鬼=Hồng Quỷ
云中燕=Vân Trung Yến
明海=Minh Hải
智因=Trí Nhân
陈玄戈=Trần Huyền Qua
南北丐帮=Nam Bắc Cái Bang
白姬=Bạch Cơ
黑白双姬=Hắc Bạch Song Cơ
张大宗师=Trương Đại Tông Sư
大鹫和尚=Đại Ưng Hòa Thượng
紫姬=Tử Cơ
第五将智因=Đệ Ngũ Tướng Trí Nhân
第三将明海=Đệ Tam Tướng Minh Hải
许一城=Hứa Nhất Thành
少禅=Thiếu Thiền
荡魔剑法=Đãng Ma Kiếm Pháp
嵩阳派十三绝=Tung Dương Phái Thập Tam Tuyệt
孙氏=Tôn Thị
苗家兄弟=Miêu Gia Huynh Đệ
五大世家=Ngũ Đại Thế Gia
八大武阀世家=Bát Đại Võ Phiệt Thế Gia
师瓷=Sư Từ
南丐帮=Nam Cái Bang
师府=Sư phủ
太清道祖=Thái Thanh Đạo Tổ
太清道脉=Thái Thanh Đạo Mạch
鹰溪城=Ưng Khê Thành
大义分舵=Đại Nghĩa Phân Đà
廖雄=Liêu Hùng
黄骅=Hoàng Hoa
太乙镇=Thái Ất Trấn
师隐姝=Sư Ẩn Xu
师澹宁=Sư Đạm Ninh
鲁黄山=Lỗ Hoàng Sơn
洪帮主=Hồng bang chủ
传功=Truyền Công
持剑=Trì Kiếm
掌棒=Chưởng Bổng
染秋=Nhiễm Thu
李绾月=Lý Oản Nguyệt
北燕小王子=Bắc Yến Tiểu vương tử
执刑长老=Chấp Hình trưởng lão
胡突真=Hồ Đột Chân
无影剑派=Vô Ảnh Kiếm Phái
太清镇=Thái Thanh Trấn
阿衡=A Hoành
风老道=Phong Lão Đạo
步步生莲神足通=Bộ Bộ Sinh Liên Thần Túc Thông
无名剑经=Vô Danh Kiếm Kinh
南胜城=Nam Thắng Thành
苗沧浪=Miêu Thương Lãng
武经=Võ Kinh
卷天卷地=Quyển Thiên Quyển Địa
子午经=Tử Ngọ Kinh
八大奇经=Bát Đại Kỳ Kinh
十二正脉=Thập Nhị Chính Mạch
三十六隐脉=Tam Thập Lục Ẩn Mạch
玄天六艺=Huyền Thiên Lục Nghệ
风祖师=Phong Tổ Sư
无影真气=Vô Ảnh Chân Khí
无影心法=Vô Ảnh Tâm Pháp
无影剑谱=Vô Ảnh Kiếm Phổ
无影剑法=Vô Ảnh Kiếm Pháp
天魅变=Thiên Mị Biến
提天马帮=Đề Thiên Mã Bang
小七截阵=Tiểu Thất Tiệt Trận
龙象掌=Long Tượng Chưởng
龙象归藏掌=Long Tượng Quy Tàng Chưởng
骊龙棒法=Li Long Bổng Pháp
马俊武=Mã Tuấn Vũ
天武张家=Thiên Võ Trương Gia
快哉苗家=Khoái Tai Miêu Gia
神通马家=Thần Thông Mã Gia
暴雨梨花枪=Bạo Vũ Lê Hoa Thương
快哉苗=Khoái Tai Miêu
滕王阁序=Đằng Vương Các Tự
孙家=Tôn gia
天王楼=Thiên Vương Lâu
貂儿=Điêu Nhi
小蝴蝶=Tiểu Hồ Điệp
小南梦=Tiểu Nam Mộng
龙虎路=Long Hổ Lộ
渡厄观=Độ Ách Quan
先天境=Tiên Thiên Cảnh
天师=Thiên Sư
太阳神教=Thái Dương Thần Giáo
大嵩阳峰=Đại Tung Dương Phong
灵犀剑=Linh Tê Kiếm
伯食=Bá Thực
羽林卫=Vũ Lâm Vệ
烈马骑=Liệt Mã Kỵ
御天军=Ngự Thiên Quân
武军侯霍飞虎=Võ Quân Hầu Hoắc Phi Hổ
珞珈山=Lạc Già Sơn
玄黄道祖=Huyền Hoàng Đạo Tổ
太阳神庙=Thái Dương Thần Miếu
红龙木棒=Hồng Long Mộc Bổng
巴伦=Ba Luân
阿琉司=A Lưu Tư
冈第斯=Cương Đệ Tư
红都神庙=Hồng Đô Thần Miếu
大朗官话=Đại Lãng Quan Thoại
金帐=Kim Trướng
马家=Mã Gia
西西木里=Tây Tây Mộc Lí
耶律部=Gia Luật bộ
耶律鸠=Gia Luật Cưu
折石勃勃=Chiết Thạch Bột Bột
玄黄三化=Huyền Hoàng Tam Hóa
太阳圣女裘柏丝=Thái Dương Thánh Nữ Cừu Bá Ti
开州=Khai Châu
凤城=Phượng Thành
北燕王庭=Bắc Yến Vương Đình
金蟾=Kim Thiềm
王玄圭=Vương Huyền Khuê
大枯=Đại Khô
空蝉=Không Thiền
扎龙寺=Trát Long Tự
金貂府=Kim Điêu Phủ
沈阳=Thẩm Dương
沐凤池=Mộc Phượng Trì
开州城=Khai Châu Thành
乌云苏布德=Ô Vân Tô Bố Đức
金蟾和尚=Kim Thiềm Hòa Thượng
红龙木=Hồng Long Mộc
吐浑小王子=Thổ Hồn Tiểu Vương Tử
永州=Vĩnh Châu
苏挽红=Tô Vãn Hồng
灵剑峰=Linh Kiếm Phong
宫伟=Cung Vĩ
嵩阳=Tung Dương
天魔化胎法=Thiên Ma Hóa Thai Pháp
吐浑=Thổ Hồn
霸州=Bá Châu
陆双凤=Lục Song Phượng
秦成=Tần Thành
魔教军=Ma Giáo Quân
红莲会=Hồng Liên Hội
伯食人=Bá Thực Nhân
南梦棠=Nam Mộng Đường
南梦九=Nam Mộng Cửu
三魄两刃剑=Tam Phách Lưỡng Nhận Kiếm
空蝉和尚=Không Thiền Hòa Thượng
天武崩龙劲=Thiên Vũ Băng Long Kính
崩龙仙劲=Băng Long Tiên Kính
阳世筏=Dương Thế Phiệt
天武神功=Thiên Võ Thần Công
宗师=Tông sư
乘风诀=Thừa Phong quyết
天子张家=Thiên Tử Trương gia
踏龙诀=Đạp Long quyết
翰林=Hàn Lâm
庚金真气=Canh Kim chân khí
玄冰真气=Huyền Băng chân khí
太乙青灵真气=Thái Ất Thanh Linh chân khí
闻喜太师=Văn Hỉ thái sư
霍飞虎将军=Hoắc Phi Hổ tướng quân
四弟=Tứ đệ
天上天下金刚般若伏魔剑=Thiên Thượng Thiên Hạ Kim Cương Bát Nhã Phục Ma Kiếm
雒京城=Lạc Kinh Thành
丁凤=Đinh Phượng
翰林院=Hàn Lâm Viện
武经博士=Võ Kinh Bác Sĩ
大琅朝=Đại Lang Triều
苏南桥=Tô Nam Kiều
顾妥娘=Cố Thỏa Nương
北燕城=Bắc Yến Thành
太阳金经=Thái Dương Kim Kinh
太阳神殿=Thái Dương Thần Điện
清微剑派=Thanh Vi Kiếm Phái
盲公神剑=Manh Công Thần Kiếm
樊素=Phàn Tố
闻朱重=Văn Chu Trọng
五经十三绝=Ngũ Kinh Thập Tam Tuyệt
师姑姑=Sư Cô Cô
神通棒法=Thần Thông Bổng Pháp
大乐指法=Đại Nhạc Chỉ Pháp
大礼风姿=Đại Lễ Phong Tư
韩轼=Hàn Thức
太典博士卢操=Thái Điển bác sĩ Lư Thao
司马=Tư Mã
师仙子=Sư tiên tử
阳教主=Dương giáo chủ
玄冥道人=Huyền Minh đạo nhân
如意金针=Như Ý Kim Châm
赤精离火旗=Xích Tinh Ly Hỏa Kỳ
移岳珠=Di Nhạc Châu
大五行灭绝神光线=Đại Ngũ Hành Diệt Tuyệt Thần Quang Tuyến
招妖幡=Chiêu Yêu Phan
玄关=Huyền Quan
灵感=Linh Cảm
洞神=Động Thần
樊楼=Phàn Lâu
李忘忧=Lý Vong Ưu
黑侍中=Hắc Thị Trung
二皇子=Nhị Hoàng Tử
四皇弟=Tứ Hoàng Đệ
师家=Sư Gia
师昭质=Sư Chiêu Chất
韩氏=Hàn Thị
张家=Trương Gia
伯食国主=Bá Thực quốc chủ
大枯禅师=Đại Khô Thiền Sư
阿兰陀=A Lan Đà
玄黄十变=Huyền Hoàng Thập Biến
龙象归藏掌法=Long Tượng Quy Tàng Chưởng Pháp
打仙锤=Đả Tiên Chuy
人仙拳=Nhân Tiên Quyền
武经楼=Võ Kinh Lâu
东海关=Đông Hải Quan
孙云鹤=Tôn Vân Hạc
天机孙家=Thiên Cơ Tôn Gia
南梦家=Nam Mộng Gia
太清师家=Thái Thanh Sư Gia
曲寒衣=Khúc Hàn Y
红鱼=Hồng Ngư
玄黄童子=Huyền Hoàng Đồng Tử
学士府=Học Sĩ Phủ
光禄阁学士=Quang Lộc Các Học Sĩ
天机百变千幻十三式棒法=Thiên Cơ Bách Biến Thiên Huyễn Thập Tam Thức Bổng Pháp
峨眉=Nga Mi
孙氏武经=Tôn Thị Võ Kinh
六经章句集注=Lục Kinh Chương Cú Tập Chú
时弼=Thời Bật
嵩阳山=Tung Dương Sơn
镇国太师=Trấn Quốc Thái Sư
南梦宫=Nam Mộng Cung
卢家=Lư Gia
胡云恕=Hồ Vân Thứ
胡云璋=Hồ Vân Chương
上古伏魔剑法=Thượng Cổ Phục Ma Kiếm Pháp
荡魔剑=Đãng Ma Kiếm
混元剑法=Hỗn Nguyên Kiếm Pháp
光禄阁=Quang Lộc Các
太学院=Thái Học Viện
吉雅坦娜=Cát Nhã Thản Na
陶玄章=Đào Huyền Chương
天骄榜=Thiên Kiêu Bảng
魏樱笑=Ngụy Anh Tiếu
姜胭=Khương Yên
年龟寿=Niên Quy Thọ
年犀照=Niên Tê Chiếu
武林美人榜=Võ Lâm Mỹ Nhân Bảng
大日金翎=Đại Nhật Kim Linh
朱重=Chu Trọng
段玉=Đoạn Ngọc
江云成=Giang Vân Thành
荡魔庄=Đãng Ma Trang
心魔三问=Tâm Ma Tam Vấn
天武幻世法=Thiên Võ Huyễn Thế Pháp
追风小孙=Truy Phong Tiểu Tôn
玄黄道=Huyền Hoàng Đạo
太清=Thái Thanh
玉皇=Ngọc Hoàng
玄幻三化=Huyền Huyễn Tam Hóa
观心宗=Quan Tâm Tông
大琅王朝=Đại Lang Vương Triều
玄黄军=Huyền Hoàng Quân
霸州城=Bá Châu Thành
武军侯=Võ Quân Hầu
霍飞虎=Hoắc Phi Hổ
太师闻喜=Thái Sư Văn Hỉ
闻喜=Văn Hỉ
戒日双王=Giới Nhật Song Vương
金貂城=Kim Điêu Thành
伯食国=Bá Thực Quốc
剑山庄=Kiếm Sơn Trang
张海=Trương Hải
悬镜听花伏魔剑=Huyền Kính Thính Hoa Phục Ma Kiếm
雒京皇宫=Lạc Kinh Hoàng Cung
芸妃=Vân Phi
胡没影子=Hồ Một Bóng Tử
红龙木大棒=Hồng Long Mộc Đại Bổng
胡家五老=Hồ Gia Ngũ Lão
十二兽形隐脉=Thập Nhị Thú Hình Ẩn Mạch
蛮蛇=Man Xà
霸象=Bá Tượng
巴蝎=Ba Bò Cạp
斗蛛=Đấu Chu
箭蝶=Tiễn Điệp
三毒隐脉=Tam Độc Ẩn Mạch
玄冥阴煞功=Huyền Minh Âm Sát Công
大雪山=Đại Tuyết Sơn
冰蚕变=Băng Tằm Biến
玄黄真气=Huyền Hoàng Chân Khí
枯荣刀=Khô Vinh Đao
胡云寿=Hồ Vân Thọ
许长老=Hứa trưởng lão
胡云霁=Hồ Vân Tễ
四象元功=Tứ Tượng Nguyên Công
龙象归藏掌力=Long Tượng Quy Tàng Chưởng Lực
太史长老=Thái Sử Trưởng Lão
混元剑罡=Hỗn Nguyên Kiếm Cương
北丐帮=Bắc Cái Bang
巴天龙=Ba Thiên Long
洪神通=Hồng Thần Thông
胡云骞=Hồ Vân Khiên
冰蚕宝扇=Băng Tằm Bảo Phiến
殷白莲=Ân Bạch Liên
玄黄经=Huyền Hoàng Kinh
玄冰宝鉴=Huyền Băng Bảo Giám
水神冰夷=Thủy Thần Băng Di
如意乾坤袋=Như Ý Càn Khôn Đại
一气仙阳成子=Nhất Khí Tiên Dương Thành Tử
太乙真人=Thái Ất Chân Nhân
太乙混仙绫=Thái Ất Hỗn Tiên Lăng
太乙青灵丸=Thái Ất Thanh Linh Hoàn
太乙青灵扇奇功=Thái Ất Thanh Linh Phiến Kỳ Công
孔雀王=Khổng Tước Vương
镜花剑舫=Kính Hoa Kiếm Phưởng
中条派=Trung Điều Phái
中条五子=Trung Điều Ngũ Tử
嵩阳七友=Tung Dương Thất Hữu
中条双圣=Trung Điều Song Thánh
悬镜剑客=Huyền Kính Kiếm Khách
悬境听花伏魔剑=Huyền Cảnh Thính Hoa Phục Ma Kiếm
风老祖=Phong Lão Tổ
阳无忌=Dương Vô Kỵ
黑光翰=Hắc Quang Hàn
天魔功=Thiên Ma Công
张清溪=Trương Thanh Khê
苏妃=Tô Phi
雒京=Lạc Kinh
卢操=Lư Thao
司马紫嫣=Tư Mã Tử Yên
咒珈山=Chú Già Sơn
四大灵境=Tứ Đại Linh Cảnh
水帘洞=Thủy Liêm Động
凝碧崖=Ngưng Bích Nhai
惊绝宫=Kinh Tuyệt Cung
九九八十一路神通棒法=Cửu Cửu Bát Thập Nhất Lộ Thần Thông Bổng Pháp
戒日男王=Giới Nhật Nam Vương
如来十力=Như Lai Thập Lực
战佛图录=Chiến Phật Đồ Lục
真如不动剑=Chân Như Bất Động Kiếm
五台派=Ngũ Đài Phái
无相剑庐=Vô Tướng Kiếm Lư
太乙青灵扇=Thái Ất Thanh Linh Quạt
大琅=Đại Lang
胡家=Hồ Gia
荡魔胡家=Đãng Ma Hồ Gia
胡青帝=Hồ Thanh Đế
天魅无影=Thiên Mị Vô Ảnh
苗家=Miêu Gia
快哉刀=Khoái Tai Đao
崇阳城=Sùng Dương Thành
武雉=Vũ Trĩ
黑蛟城=Hắc Giao Thành
镜花剑派=Kính Hoa Kiếm Phái
皇甫紫=Hoàng Phủ Tử
青鸾画舫=Thanh Loan Họa Phường
无影侯=Vô Ảnh Hầu
巴天魔=Ba Thiên Ma
孙燕晚=Tôn Yến Vãn
师姒=Sư Tự
阳貂儿=Dương Điêu Nhi
孙灵蝶=Tôn Linh Điệp
魔教=Ma Giáo
戒日王=Giới Nhật Vương
南夏=Nam Hạ
玄冥=Huyền Minh
嵩阳派=Tung Dương Phái
太乙观=Thái Ất Quán
张远桥=Trương Viễn Kiều
天马帮=Thiên Mã Bang
少禅寺=Thiếu Thiền Tự
龙藏寺=Long Tàng Tự
金光洞=Kim Quang Động
太史=Thái Sử
北燕=Bắc Yến
砚池湖=Nghiên Trì Hồ
端木仙菱=Đoan Mộc Tiên Lăng
卢潮绣=Lư Triều Tú
许开天=Hứa Khai Thiên
