地藏王菩萨=Địa Tạng Vương Bồ Tát
元老会=Nguyên Lão Hội
纳斯古国=Nạp Tư Cổ Quốc
楚门=Sở Môn
哈尼死=Cáp Ni Tử
儋州=Đam Châu
T-BAG=T-BAG
伯爵别府=Bá tước biệt phủ
北魏国=Bắc Ngụy Quốc
雪山关=Tuyết Sơn Quan
剑圣=Kiếm Thánh
四顾剑法=Tứ Cố Kiếm Pháp
司南伯爵别府=Tư Nam Bá Tước Biệt Phủ
儋州港=Đạm Châu Cảng
靖哥哥=Tĩnh ca ca
马钰=Mã Ngọc
杀死比尔=Kill Bill
京都司南伯爵府=Kinh Đô Tư Nam Bá Tước phủ
老哈=Lão Cáp
五大人=Ngũ đại nhân
秦钟=Tần Chung
智能=Trí Năng
瑶州=Dao Châu
芸香草=Vân Hương Thảo
元老会领事大臣=Nguyên lão hội Lãnh sự Đại thần
监察院院长=Giám sát viện Viện trưởng
段子=Đoạn Tử
领事大臣=Lãnh sự đại thần
大岳=Đại Nhạc
江宁织造=Giang Ninh Chức tạo
孙氏=Tôn thị
康熙=Khang Hy
丹田=Đan điền
肾门雪山=Thận Môn Tuyết Sơn
期门=Kỳ Môn
天枢=Thiên Xu
四大宗师=Tứ Đại Tông Sư
太师祖根尘=Thái Sư Tổ Căn Trần
佛教=Phật giáo
清远禅师=Thanh Viễn Thiền Sư
二姨太=Nhị Di Thái
松永贞德=Tùng Vĩnh Trinh Đức
曹寅=Tào Dần
老诚王=Lão Thành Vương
伯爵=Bá tước
老黄头=Lão Hoàng Đầu
东城=Đông Thành
柳如玉=Liễu Như Ngọc
司南伯爵=Tư Nam Bá tước
五峰采花=Ngũ Phong Thái Hoa
詹事府=Chiêm Sự Phủ
南衙十二卫=Nam Nha Thập Nhị Vệ
老都察院=Lão Đô Sát Viện
翰林院=Hàn Lâm Viện
苏翁=Tô Ông
文英总校处=Văn Anh Tổng Hiệu Xứ
靖王妃=Tĩnh Vương phi
郡王府=Quận Vương Phủ
郭编纂=Quách biên soạn
集贤馆=Tập Hiền Quán
宋七力=Tống Thất Lực
天河大路=Thiên Hà đại lộ
项少龙=Hạng Thiếu Long
费老师=Phí lão sư
东山庙=Đông Sơn Miếu
林黛玉=Lâm Đại Ngọc
苏梦枕=Tô Mộng Chẩm
周瑜=Chu Du
林琴南=Lâm Cầm Nam
大禹=Đại Vũ
二姨娘=Nhị di nương
京都守备条例=Điều lệ phòng thủ kinh đô
洛东道=Lạc Đông Đạo
万卷堂=Vạn Quyển Đường
乾隆=Càn Long
多姑娘=Đa cô nương
洪太监=Hồng thái giám
林大人=Lâm đại nhân
辛老苏=Tân Lão Tô
李老杜=Lý Lão Đỗ
阴山=Âm Sơn
靖郡王世子=Tĩnh Quận Vương Thế tử
林晨儿=Lâm Thần Nhi
西海=Tây Hải
范若=Phạm Nhược
云梦泽=Vân Mộng Trạch
范伟=Phạm Vĩ
李杜苏三=Lý Đỗ Tô Tam
孟浩然=Mạnh Hạo Nhiên
张九龄=Trương Cửu Linh
王语嫣=Vương Ngữ Yên
段誉=Đoàn Dự
世子李弘成=Thế tử Lý Hoằng Thành
若若姐=Nhược Nhược tỷ
范林=Phạm Lâm
靖王府诗会=Thi Hội Tĩnh Vương Phủ
徐管家=Từ Quản Gia
梅大人=Mai đại nhân
靖郡王府=Tĩnh Quận Vương Phủ
郭公公=Quách công công
城西=Thành Tây
京都府尹梅执礼=Kinh Đô Phủ Doãn Mai Chấp Lễ
李治=Lý Trị
先帝=Tiên đế
永陶长公主=Vĩnh Đào Trưởng công chúa
京都府衙=Kinh Đô Phủ Nha
万里悲秋常作客=Vạn lý bi thu thường tác khách
司南伯家=Tư Nam Bá gia
大统领=Đại thống lĩnh
林姐姐=Lâm tỷ tỷ
御医=Ngự y
紫珠草=Tử Châu Thảo
黑山栀=Hắc Sơn Chi
黄芩=Hoàng Cầm
户部侍郎=Hộ bộ thị lang
院长大人=Viện trưởng đại nhân
瓦弄巷=Ngõ Ngõa Lộng
林小姐=Lâm tiểu thư
望春门=Vọng Xuân Môn
北伐=Bắc Phạt
陈长=Trần Trường
甲国=Giáp Quốc
乙国=Ất Quốc
丙国=Bính Quốc
张贤亮=Trương Hiền Lượng
余佻州=Dư Thiêu Châu
曹先生=Tào tiên sinh
巡城司=Tuần Thành Tư
方将军=Phương tướng quân
醉仙居=Túy Tiên Cư
白乐天=Bạch Lạc Thiên
崂山=Lao Sơn
小姐=Tiểu thư
方氏兄弟=Phương thị huynh đệ
方参将=Phương tham tướng
大内侍卫=Đại nội thị vệ
北三司=Bắc Tam Tư
方达人=Phương Đạt Nhân
焦子恒=Tiêu Tử Hằng
范氏子=Phạm Thị Tử
东夷剑=Đông Di Kiếm
朱雀大街=Đại lộ Chu Tước
庆历二年=Khánh Lịch năm thứ hai
若甫=Nhược Phủ
田陵候=Điền Lăng Hầu
方休=Phương Hưu
费T=Phí T
阴乱庆国=Âm Loạn Khánh Quốc
太常寺协律郎=Thái Thường Tự Hiệp Luật Lang
范族庄园=Phạm Tộc Trang Viên
侯三儿=Hầu Tam Nhi
辛弃疾=Tân Khí Tật
林家姐姐=Lâm gia tỷ tỷ
京志=Kinh Chí
太平别庄=Thái Bình Biệt Trang
范小姐=Phạm Tiểu Thư
叶大=Diệp Đại
七叶掌柜=Thất Diệp Chưởng Quỹ
司南=Tư Nam
叶重大人=Diệp Trọng đại nhân
夹竹道=Giáp Trúc Đạo
柳恒=Liễu Hằng
林晨=Lâm Thần
白雪公主=Bạch Tuyết Công Chúa
陇西=Lũng Tây
柳下惠=Liễu Hạ Huệ
大观园=Đại Quan Viên
邢夫人=Hình phu nhân
杨宗纬=Dương Tông Vĩ
文云=Văn Vân
宰相府=Tể Tướng Phủ
肖大人=Tiêu đại nhân
协律郎=Hiệp Luật Lang
瑶华宫=Diêu Hoa Cung
范公子=Phạm công tử
岳母=Nhạc mẫu
林冲=Lâm Xung
避暑庄=Tị Thử Trang
第一次北伐=Lần đầu tiên Bắc Phạt
乌鸦=Ô Nha
朔冬=Sóc Đông
八大处=Bát Đại Xử
宰相大人=Tể tướng đại nhân
任少卿=Nhậm Thiếu Khanh
张子乾=Trương Tử Càn
苏轼=Tô Thức
杜甫=Đỗ Phủ
苏东坡=Tô Đông Pha
杜牧=Đỗ Mục
柳三变=Liễu Tam Biến
李易安=Lý Dịch An
欧阳修=Âu Dương Tu
白居易=Bạch Cư Dị
龚自珍=Cung Tự Trân
毛东珠=Mao Đông Châu
四十二章经=Tứ Thập Nhị Chương Kinh
锁匠=Thợ Khóa
燕小艺=Yến Tiểu Nghệ
天祥缎=Thiên Tường Đoạn
辛二=Tân Nhị
太学正=Thái Học Chính
万松堂=Vạn Tùng Đường
老衡居=Lão Hành Cư
太学士=Thái Học Sĩ
文渊阁=Văn Uyên Các
皇商=Hoàng Thương
鸿胪寺少卿=Hồng Lư Tự Thiếu Khanh
皇室别院=Hoàng Thất Biệt Viện
八品协律郎=Bát Phẩm Hiệp Luật Lang
太原路=Thái Nguyên Lộ
登闻院=Đăng Văn Viện
永耀集=Vĩnh Diệu Tập
林氏=Lâm Thị
杨二=Dương Nhị
李弘子=Lý Hoằng Tử
宁贵嫔=Ninh Quý Tần
苍山雪=Thương Sơn Tuyết
红袖添香夜读书=Hồng Tụ Thiêm Hương Dạ Độc Thư
房玄龄=Phòng Huyền Linh
奉正=Phụng Chính
苍山别业=Thương Sơn biệt nghiệp
戌北神策军=Tuất Bắc Thần Sách Quân
镇北大都督=Trấn Bắc Đại Đô Đốc
唐伯虎=Đường Bá Hổ
皇室=Hoàng thất
林家小姐=Tiểu thư Lâm gia
太子东宫=Đông cung Thái tử
辛少卿=Tân Thiếu Khanh
藤大媳妇=Đằng Đại Tức Phụ
京中范府=Kinh Trung Phạm Phủ
崔先生=Thôi tiên sinh
半闲斋诗集=Bán Nhàn Trai Thi Tập
北方大都督=Bắc Phương Đại Đô Đốc
司凌妇人=Tư Lăng phu nhân
老秦大人=Lão Tần đại nhân
李太白=Lý Thái Bạch
第165章=Chương 165
惊雷=Kinh Lôi
三甲=Tam Giáp
郭府=Phủ Quách
贾宝玉=Giả Bảo Ngọc
迭衣巷=Điệt Y Hạng
岳丈=Nhạc Trượng
半闲斋=Bán Nhàn Trai
大理寺少卿=Đại Lý Tự Thiếu Khanh
巴陵郡=Ba Lăng Quận
二甲=Nhị Giáp
皇商内库=Hoàng Thương Nội Khố
郡主驸马=Quận Chúa Phò Mã
天河路=Thiên Hà Lộ
郭御史=Quách Ngự Sử
北齐上京=Bắc Tề Thượng Kinh
甲四号=Giáp Tứ Hào
金瓜葛=Kim Qua Cát
第181章=Chương 181
韩尚书=Hàn Thượng thư
储君=Trữ quân
姑母=Cô mẫu
二甲进士=Nhị Giáp Tiến sĩ
翰林=Hàn Lâm
肖申克=Tiêu Thân Khắc
黑骑军=Hắc Kỵ Quân
北齐国=Bắc Tề Quốc
诸侯国=Chư Hầu Quốc
夷州=Di Châu
女婿=Con rể
苍山别院=Thương Sơn Biệt Viện
北疆=Bắc Cương
李离思=Lý Ly Tư
信阳城=Tín Dương Thành
白袖招=Bạch Tụ Chiêu
红袖招=Hồng Tụ Chiêu
司凌=Tư Lăng
木槿茶=Mộc Cẩn Trà
吕静=Lữ Tĩnh
虎儿=Hổ Nhi
大湖=Đại Hồ
西南=Tây Nam
叶守备=Diệp Thủ Bị
北京=Bắc Kinh
河北=Hà Bắc
范正使=Phạm Chính Sứ
丽香院=Lệ Hương Viện
怀远大将军=Hoài Viễn Đại Tướng Quân
蛮人=Man Nhân
海棠姑娘=Hải Đường cô nương
雾渡河镇=Trấn Vụ Độ Hà
春雷=Xuân Lôi
小师姑=Tiểu sư cô
魏无忌=Ngụy Vô Kỵ
疏义郎=Sơ Nghĩa Lang
副招抚使=Phó Chiêu Phủ Sứ
长宁侯府=Trường Ninh Hầu Phủ
几叶=Kỷ Diệp
司南伯范建=Tư Nam Bá Phạm Kiến
夏容道=Hạ Dung Đạo
太皇=Thái Hoàng
沈指挥使=Thẩm Chỉ Huy Sứ
魏统领=Ngụy Thống Lĩnh
沈叔叔=Thẩm thúc thúc
沈大人=Thẩm đại nhân
卫少卿=Vệ Thiếu Khanh
潜龙湾=Tiềm Long Loan
太平巷=Thái Bình Hạng
费Ｔ=Phí T
哥罗芳=Cloroform
卫太后=Vệ Thái Hậu
盛掌柜=Thịnh chưởng quầy
南方=Phương Nam
董陆王=Đổng Lục Vương
张家店=Trương Gia Điếm
齐东=Tề Đông
崔公子=Thôi công tử
缇骑=Đề Kỵ
盛老板=Thịnh lão bản
萧元炳=Tiêu Nguyên Bỉnh
天宝=Thiên Bảo
丁字巷=Hẻm chữ Đinh
北镇抚司=Bắc Trấn Phủ Ti
南齐=Nam Tề
北牢关=Bắc Lao Quan
魏国=Ngụy Quốc
双营=Song Doanh
天旨=Thiên Chỉ
大雪山=Đại Tuyết Sơn
范正=Phạm Chính
京城=Kinh thành
云大才子=Vân Đại Tài Tử
燕山=Yên Sơn
宰相=Tể Tướng
汉武帝=Hán Vũ Đế
勾弋夫人=Câu Dặc phu nhân
百岁松居=Bách Tuế Tùng Cư
雪芹=Tuyết Cần
陈皮=Trần Bì
国师苦荷=Quốc sư Khổ Hà
程巨树=Trình Cự Thụ
叶灵=Diệp Linh
上杉=Thượng Sam
伍佰=Ngũ Bách
华英宫=Hoa Anh Cung
林妹妹=Lâm muội muội
郭嘉=Quách Gia
陈王=Trần Vương
平乐观=Bình Lạc Quan
李白=Lý Bạch
小谢=Tiểu Tạ
陈跛子=Trần Bễ Tử
北海雾=Bắc Hải Vụ
许三多=Hứa Tam Đa
北围=Bắc Vi
谭武=Đàm Vũ
龙泉驿=Long Tuyền Dịch
西风=Tây Phong
河东=Hà Đông
陈老跛子=Trần Lão Bả Tử
西军=Tây quân
四品居中郎=Tứ phẩm Cư Trung Lang
太学奉正=Thái học Phụng Chính
李清照=Lý Thanh Chiếu
司祺=Tư Kỳ
范侍郎=Phạm Thị lang
西路军=Tây lộ quân
兴庆宫=Hưng Khánh Cung
小皇子=Tiểu Hoàng Tử
流晶河畔=Lưu Tinh Hà Bạn
魏氏=Ngụy Thị
广惠库=Quảng Huệ Khố
承运库=Thừa Vận Khố
慕天颜=Mộ Thiên Nhan
宫统领=Cung Thống Lĩnh
崔清泉=Thôi Thanh Tuyền
钦天监监正=Khâm Thiên Giam Giam Chính
左副都御使=Tả Phó Đô Ngự Sử
云梦鱼=Vân Mộng Ngư
风儿=Phong Nhi
苏格兰场=Sở Cảnh sát Scotland Yard
静澄伯府=Tĩnh Trừng Bá Phủ
悟空=Ngộ Không
大通坊=Đại Thông Phường
江浙=Giang Triết
余佻=Dư Thiêu
成西林=Thành Tây Lâm
林宰相=Lâm Tể tướng
范诗仙=Phạm Thi Tiên
灯市口=Đăng Thị Khẩu
赖名成=Lại Danh Thành
御史贺宗纬=Ngự Sử Hạ Tông Vĩ
沈小姐=Thẩm Tiểu Thư
林家二公子=Lâm Gia Nhị Công Tử
葡萄架=Bồ Đào Giá
小秦=Tiểu Tần
尚书府=Thượng thư phủ
中书省=Trung Thư Tỉnh
太极宫=Thái Cực Cung
诚王=Thành Vương
红楼=Hồng Lâu
汤显祖=Thang Hiển Tổ
袁姐=Viên Tỷ
乔吉=Kiều Cát
罗真真=La Chân Chân
范一掌=Phạm Nhất Chưởng
天裳间=Thiên Thường Gian
刑部十三衙门=Hình bộ Thập Tam Nha Môn
燕山崖=Yên Sơn Nhai
瘦湖=Sấu Hồ
利物浦=Liverpool
米兰=Milan
彭先生=Bành tiên sinh
青州石=Thạch Thanh Châu
六部三司=Lục Bộ Tam Tư
尚书巷=Thượng Thư Hạng
袁姑娘=Viên cô nương
弘毅公=Hoằng Nghị Công
柳氏府=Liễu Thị Phủ
甘谢=Cam Tạ
徐曹=Từ Tào
范柳=Phạm Liễu
西亭=Tây Đình
松林包=Tùng Lâm Bao
大叶=Đại Diệp
奶奶=Nãi nãi
汪精卫=Uông Tinh Vệ
希特勒=Hitler
奥斯特洛夫斯基=Ostrovsky
第297章=Chương 297
范家二少爷=Phạm gia nhị thiếu gia
陈公子=Trần công tử
史先生=Sử tiên sinh
范家蔡家=Phạm gia Thái gia
蔡家=Thái Gia
抱日楼=Bão Nhật Lâu
三叶=Tam Diệp
尚书=Thượng Thư
御山道=Ngự Sơn Đạo
田靖牧=Điền Tĩnh Mục
彭亭生=Bành Đình Sinh
郑先生=Trịnh tiên sinh
京都府尹田靖牧=Kinh Đô phủ doãn Điền Tĩnh Mục
柳氏忠毅国府=Liễu thị Trung Nghị Quốc phủ
万岁爷=Vạn Tuế gia
依晨=Y Thần
京外=Ngoại kinh
大少爷=Đại thiếu gia
老祖宗=Lão tổ tông
京华江南=Kinh Hoa Giang Nam
李寻欢=Lý Tầm Hoan
吴孟达=Ngô Mạnh Đạt
陈园有客=Trần Viên hữu khách
太监=Thái Giám
郭家=Quách Gia
桑姑娘=Tang cô nương
东海郡=Đông Hải Quận
先皇=Tiên Hoàng
小秦大人=Tiểu Tần đại nhân
老秦将军=Lão Tần Tướng Quân
茅厕=Mao Xí
刑部衙门=Hình bộ nha môn
北边=Bắc Biên
门下议事=Môn Hạ Nghị Sự
澹菊花茶=Đạm Cúc Hoa Trà
元稹=Nguyên Chẩn
任家=Nhậm Gia
余暇=Dư Hà
天心台=Thiên Tâm Đài
吟风阁=Ngâm Phong Các
京南=Kinh Nam
洛州=Lạc Châu
毅公府=Nghị Công phủ
樱木=Sakuragi
圣眷=Thánh Quyến
衼邪珠=Trừ Tà Châu
汪元亭=Uông Nguyên Đình
梅园=Mai Viên
北齐公主=Công chúa Bắc Tề
七虎=Thất Hổ
西王母=Tây Vương Mẫu
大长今=Dae Jang Geum
小白=Tiểu Bạch
小黄=Tiểu Hoàng
小黑=Tiểu Hắc
司马光=Tư Mã Quang
深正道=Thâm Chính Đạo
少卿=Thiếu Khanh
小范夫人=Tiểu Phạm phu nhân
林府=Phủ họ Lâm
司库=Tư Khố
楼子=Lâu tử
狄飞惊=Địch Phi Kinh
秀水街=Tú Thủy Nhai
盛怀仁=Thịnh Hoài Nhân
余掌柜=Dư chưởng quỹ
妍儿=Nghiên Nhi
玉泉河=Ngọc Tuyền Hà
范老爷=Phạm lão gia
韦小宝=Vi Tiểu Bảo
吴三桂=Ngô Tam Quế
文书阁=Văn Thư Các
胡先生=Hồ tiên sinh
松居酒楼=Tùng Cư Tửu Lâu
尚书大人=Thượng Thư đại nhân
范大人=Phạm đại nhân
福康安=Phúc Khang An
毛阅良=Mao Duyệt Lương
齐庙=Tề Miếu
姚明=Diêu Minh
肖今=Tiêu Kim
奚官局=Ty Khí Quan
华阳门=Hoa Dương Môn
魏皇=Ngụy Hoàng
汉武=Hán Vũ
唐宗=Đường Tông
宋祖=Tống Tổ
神针记=Thần Châm Ký
陈小弟=Trần Tiểu Đệ
陈氏=Trần Thị
黎锦光=Lê Cẩm Quang
姚莉=Diêu Lị
白虹=Bạch Hồng
叶大掌柜=Diệp Đại Chưởng Quỹ
圣上=Thánh Thượng
范老爷子=Phạm Lão Gia Tử
田庄=Điền Trang
范族祠堂=Phạm Tộc Từ Đường
庄氏评论集=Trang Thị Bình Luận Tập
石头皇兄=Thạch Đầu Hoàng Huynh
大皇兄=Đại Hoàng Huynh
二虎滩=Nhị Hổ Than
虎卫高达=Hổ Vệ Cao Đạt
鄂州=Ngạc Châu
关河山=Quan Hà Sơn
夏氏=Hạ thị
小史=Tiểu Sử
明七爷=Minh Thất Gia
崔氏=Thôi Thị
王熙凤=Vương Hy Phượng
关姐=Quan tỷ
十二连环坞=Thập Nhị Liên Hoàn Ổ
许寿山=Hứa Thọ Sơn
许大人=Hứa Đại Nhân
镜泊弯=Kính Bạc Loan
阳州=Dương Châu
沙湖水师=Sa Hồ Thủy Sư
西席=Tây Tịch
明氏=Minh Thị
三嫂子=Tam tẩu tử
崔明=Thôi Minh
夏家=Hạ gia
凌提督=Lăng Đề đốc
陈大人=Trần đại nhân
西蛮=Tây Man
沙州城=Sa Châu Thành
沙湖=Sa Hồ
江南水师=Giang Nam Thủy Sư
沈守备=Thẩm Thủ Bị
施提督=Thi Đốc
伍麦=Ngũ Mạch
宋嫂=Tống tẩu
苏堤=Tô Đê
白堤=Bạch Đê
西子=Tây Tử
宋嫂鱼羹=Tống Tẩu ngư canh
东坡肉=Đông Pha nhục
叫化鸡=Khất Cái kê
莼菜汤=Thuần thái thang
龙井虾仁=Long Tỉnh tôm nõn
雷锋塔=Lôi Phong Tháp
断桥=Đoạn Kiều
四顾剑决=Tứ Cố Kiếm Quyết
楼上楼=Lâu Thượng Lâu
龙虎山=Long Hổ Sơn
明少东=Minh Thiếu Đông
樱木花道=Sakuragi Hanamichi
菊花古剑与酒之二=Cúc Hoa Cổ Kiếm và Rượu chi Nhị
龙空=Long Không
纽约剑修=New York Kiếm Tu
肥花猫=Phì Hoa Miêu
魔装=Ma Trang
四十七=Tứ Thập Thất
帮闲记=Bang Nhàn Ký
江南行=Giang Nam Hành
琴师=Cầm Sư
生活在异界=Sinh Hoạt Tại Dị Giới
清江=Thanh Giang
维克多=Victor
女王陛下=Nữ Vương Bệ Hạ
陶渊明=Đào Uyên Minh
俞门穴=Du Môn huyệt
景星庆云=Cảnh Tinh Khánh Vân
北齐大公长=Bắc Tề Đại Công Chúa
胶东路=Giao Đông Lộ
迟志强=Trì Chí Cường
闽中=Mân Trung
彭园=Bành Viên
马克思=Mác
太学司业=Thái Học Tư Nghiệp
太常寺少卿=Thái Thường Tự Thiếu Khanh
内库运使司正使=Nội Khố Vận Sử Tư Chính Sử
巡抚江南路=Tuần Phủ Giang Nam Lộ
龙抬头=Long Ngẩng Đầu
戴思成=Đái Tư Thành
右都御史=Hữu Đô Ngự Sử
兵部尚书=Binh Bộ Thượng Thư
黄大人=Hoàng đại nhân
苏州港=Cảng Tô Châu
万历=Vạn Lịch
巡抚大人=Tuần Phủ Đại Nhân
杭州知州=Hàng Châu Tri Châu
薛府=Tiết Phủ
大椿=Đại Xuân
柳如是=Liễu Như Thị
京船=Kinh Thuyền
松鹤居=Tùng Hạc Cư
瞎大师=Hạt Đại Sư
老爷子=Lão gia tử
秦山=Tần Sơn
黄完树=Hoàng Hoàn Thụ
顺德镇=Thuận Đức trấn
小诸侯国=Tiểu Chư Hầu Quốc
萧大人=Tiêu đại nhân
范老二=Phạm Lão Nhị
转运司副使=Chuyển Vận Tư Phó Sứ
山南=Sơn Nam
主薄=chủ bạc
草甸=Thảo Điền
张三=Trương Tam
李四=Lý Tứ
王八=Vương Bát
龙九=Long Cửu
萧主事=Tiêu chủ sự
滁州=Trừ Châu
萧敬=Tiêu Kính
胡金林=Hồ Kim Lâm
甲坊=Giáp Phường
乙坊=Ất Phường
东宫太子=Đông Cung Thái Tử
单达=Đan Đạt
叶参将=Diệp Tham Tướng
薛大人=Tiết Đại Nhân
明银=Minh Ngân
庆国朝廷=Khánh Quốc Triều Đình
武林大会=Võ Lâm Đại Hội
云大家=Vân Đại Gia
东顾城剑庐=Đông Cố Thành Kiếm Lư
三司=Tam Tư
刑部尚书=Hình Bộ Thượng Thư
韩志维=Hàn Chí Duy
老范尚书=Lão Phạm Thượng Thư
洗岛=Tẩy Đảo
明少爷=Minh Thiếu Gia
青娃儿=Thanh Oa Nhi
提司大人=Đề Tư Đại Nhân
才仔=Tài Tử
袁大家=Viên Đại Gia
崔芷慧=Thôi Chỉ Tuệ
邹磊=Trâu Lỗi
富春县=Phú Xuân Huyện
徐徐=Từ Từ
京都新风馆=Kinh Đô Tân Phong Quán
老姚=Lão Diêu
老侯=Lão Hầu
明七少爷=Minh Thất Thiếu Gia
马楷=Mã Khải
太后老祖宗=Thái Hậu Lão Tổ Tông
孙吉祥=Tôn Cát Tường
两淮=Lưỡng Hoài
竹园馆=Trúc Viên Quán
青夜穹顶=Thanh Dạ Khung Đỉnh
庆庙大祭祀=Khánh Miếu Đại Tế Tự
苦荷国师=Khổ Hà Quốc Sư
江南居=Giang Nam Cư
荆轲=Kinh Kha
夏当家=Hạ đương gia
乙四房=Ất Tứ phòng
甲一房=Giáp Nhất phòng
黄公公=Hoàng công công
沈万三=Thẩm Vạn Tam
小言=Tiểu Ngôn
古龙=Cổ Long
徐子陵=Từ Tử Lăng
苏州府衙=Tô Châu Phủ Nha
刑房=Hình phòng
北城=Bắc Thành
四处=Tứ Xử
二祭祀=Nhị Tế Tự
老玉米=Ngô già
火腿丁=Hăm băm nhỏ
西洋菜=Cải xoong
老太后=Lão Thái Hậu
明七公子=Minh thất công tử
明业=Minh Nghiệp
江南总督府=Giang Nam Tổng đốc phủ
转运司=Chuyển Vận Tư
世子=Thế Tử
钦差大人=Khâm Sai Đại Nhân
苏州千总=Tô Châu Thiên Tổng
熊百龄=Hùng Bách Linh
石牌村=Thạch Bài Thôn
西北路=Tây Bắc Lộ
袁先生=Viên Tiên Sinh
丁寒=Đinh Hàn
秦大人=Tần đại nhân
秦小将军=Tần tiểu tướng quân
御史郭铮=Ngự Sử Quách Tranh
少卿任少安=Thiếu Khanh Nhậm Thiếu An
刑部尚书颜行书=Hình Bộ Thượng Thư Nhan Hành Thư
老舒=Lão Thư
闲儿=Nhàn Nhi
山东路银钱司=Sơn Đông Lộ Ngân Tiền Tư
詹事=Chiêm Sự
袁伯安=Viên Bá An
广州=Quảng Châu
湘菜=Tương Thái
凯尔特人=Celtic
江左清吏司=Giang Tả Thanh Lại Tư
方励=Phương Lệ
南越=Nam Việt
胡虚之=Hồ Hư Chi
景明=Cảnh Minh
周某人=Chu mỗ nhân
明氏商行=Minh Thị Thương Hành
周管家=Chu Quản Gia
红楼梦=Hồng Lâu Mộng
薛总督=Tiết Tổng đốc
明老爷=Minh Lão gia
明二爷=Minh Nhị gia
琴帝=Cầm Đế
范钦差=Phạm Khâm Sai
老太君=Lão thái quân
青城=Thanh Thành
国库=Quốc Khố
明三爷=Minh Tam Gia
江南路总督衙门=Giang Nam Lộ Tổng Đốc Nha Môn
白鹿学院=Bạch Lộc Học Viện
方廷石=Phương Đình Thạch
周先生=Chu tiên sinh
邓迪文=Đặng Địch Văn
晚亭=Vãn Đình
七里坡=Thất Lí Pha
京华=Kinh Hoa
欧阳峰=Âu Dương Phong
林公子=Lâm công tử
梁点点=Lương Điểm Điểm
晴雯=Tình Văn
宝二爷=Bảo Nhị Gia
北魏=Bắc Ngụy
春林=Xuân Lâm
老宅=Lão trạch
瞎子叔=Hạt Tử Thúc
夏明氏=Hạ Minh Thị
夏明氏的商队=Thương đội của Hạ Minh Thị
江北之地=Giang Bắc Chi Địa
副使马楷=Phó Sứ Mã Khải
江南路总督薛清=Tổng Đốc Tiết Thanh Giang Nam Lộ
监察院六处=Giám Sát Viện Lục Xứ
霁月=Tễ Nguyệt
袁惊梦=Viên Kinh Mộng
总督府=Tổng Đốc Phủ
京中=Kinh Trung
江南总督薛清=Tổng đốc Giang Nam Tiết Thanh
王霸=Vương Bá
费老=Phí lão
太医正=Thái y chính
母猪=Lợn nái
一烟冰=Nhất yên băng
静官=Tĩnh Quan
食色无双=Thực Sắc Vô Song
兽血=Thú Huyết
CMFU=CMFU
沙州别院=Sa Châu Biệt Viện
天子之剑=Thiên Tử Chi Kiếm
总督=Tổng Đốc
巡抚=Tuần Phủ
知州=Tri Châu
范少奶奶=Phạm Thiếu Nãi Nãi
宫里=Trong cung
老曹=Lão Tào
巧姐=Xảo Tỷ
信阳离宫=Tín Dương Ly Cung
万民血书=Vạn Dân Huyết Thư
御前官司=Ngự Tiền Quan Ty
晨儿=Thần Nhi
吉州=Cát Châu
门师=Môn Sư
六处剑手=Lục Xứ Kiếm Thủ
林二公子=Lâm Nhị Công Tử
费立国=Phí Lập Quốc
花火=Hoa Hỏa
枕头=Chẩm Đầu
王诚=Vương Thành
五更冷=Ngũ Canh Lãnh
梅花=Mai Hoa
罗大佑=La Đại Hữu
宜昌=Nghi Xương
陈叔平=Trần Thúc Bình
成都=Thành Đô
海淀=Hải Điến
成朴竹=Thành Phác Trúc
庆历六年=Khánh Lịch năm thứ sáu
钦差大臣=Khâm sai đại thần
圣女=Thánh nữ
指挥使=Chỉ huy sứ
卫英宁=Vệ Anh Ninh
郡主娘娘=Quận chúa nương nương
卫家=Vệ gia
夷洞天=Di Động Thiên
少安=Thiếu An
珙儿=Củng Nhi
北齐太后=Bắc Tề Thái Hậu
春末=Cuối Xuân
德州=Đức Châu
次里=Thứ Lí
兰陵王=Lan Lăng Vương
狄青=Địch Thanh
老秦=Lão Tần
天子剑=Thiên Tử Kiếm
北齐锦衣卫=Cẩm Y Vệ Bắc Tề
天一道心法=Thiên Nhất Đạo Tâm Pháp
冰云=Băng Vân
胶州府=Giao Châu Phủ
岳父=Nhạc Phụ
那多叶=Na Đa Diệp
夏日=Hạ nhật
户部=Hộ Bộ
春闱案=Xuân Vi án
掌一处=Chưởng Nhất Xứ
叶秦两家=Diệp Tần Lưỡng Gia
阿甘=A Cam
楚留香=Sở Lưu Hương
许公子=Hứa công tử
泰山=Thái Sơn
四爷=Tứ gia
小红=Tiểu Hồng
老夫人=Lão phu nhân
藤大=Đằng Đại
林大少爷=Lâm Đại Thiếu Gia
小宝=Tiểu Bảo
老祖母=Lão Tổ mẫu
送菜老哈=Tống Thái Lão Cáp
胡大哥=Hồ đại ca
西施=Tây Thi
麦新儿=Mạch Tân Nhi
麦哥儿=Mạch Ca Nhi
提费先生=Đề Phí tiên sinh
麦苗儿=Mạch Miêu Nhi
伯爵府=Bá tước phủ
小雅=Tiểu Nhã
小青=Tiểu Thanh
三殿下=Tam điện hạ
范柳林=Phạm Liễu Lâm
傅家坡=Phó Gia Pha
渭河=Vị Hà
黑骑营=Hắc Kỵ Doanh
禁军=Cấm quân
北境=Bắc Cảnh
太后娘娘=Thái hậu nương nương
叶秦=Diệp Tần
汉武道=Hán Vũ Đạo
太宗=Thái Tông
ＳＭ=SM
叶小姐=Diệp tiểu thư
党骁波=Đảng Tiêu Ba
大庆国=Đại Khánh Quốc
燕都督=Yến Đô đốc
江南明家=Gia tộc họ Minh ở Giang Nam
柳姨=Liễu di
老王=Lão Vương
长宁候=Trường Ninh Hầu
沐大人=Mộc đại nhân
正卿=Chính Khanh
小侯爷=Tiểu Hầu Gia
大皇妃=Đại Hoàng Phi
胡族=Hồ Tộc
琅玡州=Lang Nha Châu
柳师傅=Liễu sư phó
鸿门宴=Hồng Môn Yến
袁梦=Viên Mộng
吴镇宇=Ngô Trấn Vũ
杨攻城=Dương Công Thành
紫竹苑=Tử Trúc Uyển
桂离坊=Quế Ly Phường
高山塔=Cao Sơn Tháp
江南总督=Giang Nam Tổng Đốc
灵儿=Linh Nhi
守备师=Thủ bị sư
莲衣=Liên Y
天牢=Thiên Lao
征北大都督=Chinh Bắc Đại Đô Đốc
朱格=Chu Cách
林相=Lâm tướng
曲向东=Khúc Hướng Đông
申冲文=Thân Xung Văn
执笔御史=Chấp Bút Ngự Sử
天子=Thiên Tử
澹泊=Đạm Bạc
祁连山=Kỳ Liên Sơn
南城门=Nam Thành Môn
天南城门司=Thiên Nam Thành Môn Tư
南庆使节=Nam Khánh Sứ Tiết
大皇子府=Đại Hoàng Tử Phủ
郑拓=Trịnh Thác
藤大家媳妇=Đằng Đại Gia Tức Phụ
上京太学=Thượng Kinh Thái Học
龙骑尉=Long Kỵ Úy
明青城=Minh Thanh Thành
苏妩媚=Tô Vũ Mị
范氏=Phạm thị
天一阁=Thiên Nhất Các
长公主李云睿=Trưởng công chúa Lý Vân Duệ
亦德=Diệc Đức
小洪公公=Tiểu Hồng công công
神武门=Thần Vũ Môn
禁军大统领=Cấm Quân Đại Thống Lĩnh
京里=Kinh Lý
明老太君=Minh Lão Thái Quân
九棵松=Cửu Khoa Tùng
浣衣局=Hoán Y Cục
皇帝陛下=Hoàng đế Bệ hạ
宰相公卿=Tể tướng công khanh
春闱=Xuân Vi
二殿下=Nhị Điện Hạ
年中=Niên Trung
林文=Lâm Văn
林静=Lâm Tĩnh
天一道大庙=Thiên Nhất Đạo Đại Miếu
西城=Tây Thành
河洛帮=Hà Lạc Bang
富嘴儿=Phú Chủy Nhi
北齐上京城=Thượng Kinh thành Bắc Tề
大公主=Đại công chúa
定州大都督=Định Châu Đại Đô Đốc
五一=Quốc tế Lao động
洛川帮=Lạc Xuyên bang
沈家=Thẩm gia
四祺=Tứ Kỳ
藤大家媳妇儿=Đằng Đại gia tức phụ nhi
高娃=Cao Oa
太子哥哥=Thái tử ca ca
二皇兄=Nhị Hoàng huynh
金先生=Kim tiên sinh
鹿鼎记=Lộc Đỉnh ký
杉树=Sam thụ
藤田淑子=Đằng Điền Thục Tử
一休=Nhất Hưu
费Ｔ老师=Phí T lão sư
太极大殿=Thái Cực điện
钦差=Khâm Sai
内库衙门=Nha Môn Nội Khố
明老三=Minh lão tam
明老七=Minh lão thất
思亲堂=Tư Thân Đường
皇后娘娘=Hoàng Hậu Nương Nương
先帝爷=Tiên Đế Gia
王坠儿=Vương Trụy Nhi
乾儿=Càn Nhi
净乐堂=Tịnh Lạc Đường
绣衣局=Tú Y Cục
杭州西湖=Hàng Châu Tây Hồ
邸报=Đề Báo
礼部员外郎=Lễ Bộ Viên Ngoại Lang
闽北三大坊=Mân Bắc Tam Đại Phường
苏州城内库转运司=Tô Châu Thành Nội Khố Chuyển Vận Tư
明六爷=Minh Lục Gia
老叶掌柜=Lão Diệp Chưởng Quỹ
内库转运副使=Nội Khố Chuyển Vận Phó Sứ
闽初=Mân Sơ
行北路=Hành Bắc Lộ
行南路=Hành Nam Lộ
施辟宝=Thi Bích Bảo
石碌=Thạch Lộc
猛子哥=Mãnh Tử ca
兰花姐=Lan Hoa tỷ
太平=Thái Bình
孙熊诸氏=Tôn Hùng Chư Thị
汶川=Vấn Xuyên
湖北=Hồ Bắc
福堂=Phúc Đường
四川=Tứ Xuyên
红十字会=Hội Chữ Thập Đỏ
兰石=Lan Thạch
明四爷=Minh Tứ Gia
明老六=Minh Lão Lục
明兰石=Minh Lan Thạch
高远静=Cao Viễn Tĩnh
平安=Bình An
羊毛=Lông cừu
吏部尚书=Lại Bộ Thượng Thư
京都守备=Kinh Đô Thủ Bị
颜尚书=Nhan Thượng Thư
颜冰云=Nhan Băng Vân
大江=Đại Giang
西城别院=Biệt viện Tây Thành
回春堂=Hồi Xuân Đường
宗亲=Tông thân
太医=Thái y
颍州=Dĩnh Châu
映秀=Ánh Tú
吉云祥=Cát Vân Tường
北齐圣女=Bắc Tề Thánh Nữ
大魏添子剑=Đại Ngụy Thiêm Tử Kiếm
崔家行=Thôi Gia Hành
镇抚司=Trấn Phủ Tư
长安侯=Trường An Hầu
老崔家=Lão Thôi Gia
沧州路=Thương Châu Lộ
天承县=Thiên Thừa Huyện
辛其物=Tân Kỳ Vật
北蛮=Bắc Man
第518章=Chương 518
北营=Bắc Doanh
大青玉=Đại Thanh Ngọc
令狐醉鬼=Lệnh Hồ Túy Quỷ
黄河=Hoàng Hà
岳不群=Nhạc Bất Quần
钦天监正=Khâm Thiên Giám Chính
大都督=Đại Đô đốc
叶氏=Diệp thị
潘龄老=Phan Linh Lão
秦老将军=Tần Lão Tướng Quân
京都庆庙=Kinh Đô Khánh Miếu
南荒=Nam Hoang
何咏志=Hà Vịnh Chí
西方法术=Pháp thuật phương Tây
汪洋=Uông Dương
夏时=Hạ Thời
钦天监=Khâm Thiên Giám
叶秦二家=Diệp Tần nhị gia
吴格非=Ngô Cách Phi
江北大营=Giang Bắc Đại Dinh
山东路=Sơn Đông Lộ
常昆=Thường Côn
定州叶家=Định Châu Diệp Gia
胶州知州吴格非=Tri châu Giao Châu Ngô Cách Phi
枢密副使秦恒=Xu Mật Phó Sứ Tần Hằng
秦易=Tần Dịch
噬魂=Thệ Hồn
燕慎独=Yến Thận Độc
南原=Nam Nguyên
虹桥=Hồng Kiều
吕思思=Lữ Tư Tư
半闲斋书话=Bán Nhàn Trai Thư Thoại
牛栏山=Ngưu Lan Sơn
胡苏=Hồ Tô
东宫皇后=Đông Cung Hoàng Hậu
晨姐姐=Thần tỷ tỷ
太子李承乾=Thái Tử Lý Thừa Càn
二皇子府=Nhị Hoàng Tử Phủ
王妃叶灵儿=Vương Phi Diệp Linh Nhi
宫坊司=Cung Phường Tư
南诏国=Nam Chiếu Quốc
青园=Thanh Viên
舒府=Phủ Thư
鸿胪寺=Hồng Lư Tự
杀胡=Sát Hồ
谢苏=Tạ Tô
元台=Nguyên Đài
林家=Lâm Gia
范府庄园=Trang Viên Phủ Phạm
秦叶两家=Tần Diệp Lưỡng Gia
和亲王爷=Hòa thân vương gia
秦观=Tần Quan
秦可卿=Tần Khả Khanh
一石居酒楼=Nhất Thạch Cư tửu lâu
京都府丞=Kinh Đô Phủ Thừa
奈何烧我宝玉=Nại hà thiêu ngã Bảo Ngọc
礼部尚书郭攸之=Lễ Bộ Thượng Thư Quách Du Chi
青娃=Thanh Oa
羊葱巷=Dương Thông Hạng
范提司=Phạm Đề Tư
六路总督=Lục Lộ Tổng Đốc
水师=Thủy Sư
大东边=Đại Đông Biên
都水清吏司=Đô Thủy Thanh Lại Tư
吏部=Lại Bộ
水运总督衙门=Thủy Vận Tổng Đốc Nha Môn
柳家=Liễu Gia
彭氏庄园=Trang viên Bành thị
颜行书=Nhan Hành Thư
拿破仑=Napoleon
张昊=Trương Hạo
陈一江=Trần Nhất Giang
秋园小楼=Tiểu lâu Thu Viên
君临广场=Quảng trường Quân Lâm
后宫=Hậu Cung
毛主席=Mao Chủ tịch
霸道真气=Bá Đạo Chân Khí
长刀虎卫=Trường Đao Hổ Vệ
诚王妃=Thành Vương Phi
夷种=Di Chủng
西征军=Tây Chinh Quân
京都守备军方=Kinh Đô Thủ Bị Quân Phương
慕容燕=Mộ Dung Yến
秀儿=Tú Nhi
青云=Thanh Vân
辰廊=Thần Lang
冷宫=Lãnh Cung
洗衣坊=Giặt Y Phường
别府=Biệt Phủ
淡泊公=Đạm Bạc Công
麻黄丸=Ma Hoàng Hoàn
张统领=Trương Thống Lĩnh
秦叶=Tần Diệp
明老太爷=Minh lão thái gia
宝玉=Bảo Ngọc
费大人=Phí đại nhân
柳姨娘=Liễu di nương
张钫=Trương Phỏng
元台大营=Doanh trại Nguyên Đài
扎加洛=Zagallo
皇太后=Hoàng thái hậu
内库三大坊=Nội khố tam đại phường
皇宫=Hoàng Cung
三处=Tam Xứ
云梯=Vân Thê
太平坊=Thái Bình Phường
燕大=Yến Đại
燕大都督=Yến đại đô đốc
京郊=Kinh Giao
小言公子=Tiểu Ngôn công tử
王道=Vương Đạo
魏朝=Ngụy Triều
齐国=Tề Quốc
宋境=Tống Cảnh
泺州=Lạc Châu
侯咏志=Hầu Vịnh Chí
黄毅=Hoàng Nghị
林珙=Lâm Củng
萍萍=Bình Bình
九座=Cửu Tọa
二十八里坡=Nhị Thập Bát Lí Pha
牛人=Ngưu Nhân
大帅=Đại soái
太子承乾=Thái Tử Thừa Càn
平儿=Bình Nhi
膻中=Đản Trung
凤床=Phượng Sàng
荣国府=Vinh Quốc phủ
贾公子=Giả công tử
金陵城=Kim Lăng thành
甄宝玉=Chân Bảo Ngọc
御史=Ngự Sử
京都府尹孙家=Kinh Đô Phủ Doãn Tôn Gia
东宫=Đông Cung
明老爷子=Minh lão gia tử
明青达=Minh Thanh Đạt
沈家姑娘=Cô nương họ Thẩm
范小花儿=Phạm Tiểu Hoa Nhi
虎卫=Hổ Vệ
苦老光头=Khổ Lão Đầu Trọc
小雪谷=Tiểu Tuyết Cốc
苦荷大师=Khổ Hà đại sư
长宁侯=Trường Ninh Hầu
白参=Bạch Tham
京西苍山=Kinh Tây Thương Sơn
逢春=Phùng Xuân
七叶=Thất Diệp
东华门=Đông Hoa Môn
泉州水师=Tuyền Châu thủy sư
庆历八年=Khánh Lịch bát niên
二宝=Nhị Bảo
钓鱼台=Điếu Ngư Đài
伊周=Y Chu
刘阮=Lưu Nguyễn
李杜=Lý Đỗ
酸斋=Toan Trai
墨武=Mặc Vũ
古道=Cổ Đạo
易天行=Dịch Thiên Hành
婉宁=Uyển Ninh
丁蟹=Đinh Giải
师仙子=Sư Tiên Tử
李秀宁=Lý Tú Ninh
四四=Tứ Tứ
朋友特别白=Bằng Hữu Đặc Biệt Bạch
少林武僧=Thiếu Lâm Võ Tăng
恶明=Ác Minh
拳罡=Quyền Cương
崩云乱=Băng Vân Loạn
翠花=Thúy Hoa
凝翠崖=Ngưng Thúy Nhai
王海东=Vương Hải Đông
富嘴=Phú Chủy
郭尚书=Quách Thượng Thư
苏州府=Tô Châu phủ
西凉路总督府=Tây Lương Lộ Tổng Đốc Phủ
西池河子=Tây Trì Hà Tử
金屋藏娇=Kim Ốc Tàng Kiều
松干赞普=Tùng Càn Tán Phổ
小花=Tiểu Hoa
东海=Đông Hải
大祚=Đại Tộ
山东=Sơn Đông
天山=Thiên Sơn
张纪中=Trương Kỷ Trung
大庆朝=Đại Khánh Triều
西大营=Tây Đại Doanh
大通=Đại Thông
左右二贤王=Tả Hữu Nhị Hiền Vương
左右谷益王=Tả Hữu Cốc Ích Vương
范夫人=Phạm phu nhân
小花儿=Tiểu Hoa Nhi
月牙海=Nguyệt Nha Hải
魏无成=Ngụy Vô Thành
喀尔纳=Khách Nhĩ Nạp
松芝王女=Tùng Chi Vương Nữ
西胡王庭=Vương Đình Tây Hồ
西胡部落=Bộ lạc Tây Hồ
西胡单于速必达=Tây Hồ Thiền Vu Tốc Tất Đạt
东夷剑庐=Đông Di Kiếm Lư
征北军=Chinh Bắc Quân
言家=Ngôn Gia
草原=Thảo Nguyên
定州城=Định Châu Thành
铁相=Thiết Tương
叶大将军=Diệp Đại Tướng Quân
庆历九年=Khánh Lịch Cửu Niên
西城门=Tây Thành Môn
新街口=Tân Nhai Khẩu
范氏大宅=Phạm Thị Đại Trạch
皇城=Hoàng Thành
北齐大公主=Bắc Tề Đại Công Chúa
叶家小姐=Diệp Gia Tiểu Thư
王曈=Vương Đồng
王府=Vương phủ
王妃=Vương phi
晨妹妹=Thần muội muội
天脉=Thiên Mạch
许茂才=Hứa Mậu Tài
沈家小姐=Thẩm gia tiểu thư
晨丫头=Thần nha đầu
崔家=Thôi gia
八处=Bát Xử
同福客栈=Đồng Phúc khách sạn
王爷=Vương Gia
华扁鹊=Hoa Biển Thước
风华=Phong Hoa
王家=Vương Gia
贺家=Hạ Gia
四褀=Tứ Kỳ
林大宝=Lâm Đại Bảo
徐佳莹=Từ Giai Oánh
苏芮=Tô Nhụy
范小花=Phạm Tiểu Hoa
荷池坊=Hà Trì Phường
夜殿=Dạ Điện
中书=Trung Thư
陈伯常=Trần Bá Thường
靖王世子=Tĩnh Vương Thế Tử
舒老头儿=Thư Lão Đầu Nhi
柔嘉小郡主=Nhu Gia Tiểu Quận Chúa
城门司=Thành Môn Tư
林相爷=Lâm tướng gia
集贤馆大学士=Tập Hiền Quán đại học sĩ
监察院提司=Giám sát viện đề ty
胶州水师=Giao Châu thủy sư
单于速必达=Đơn Vu Tốc Tất Đạt
左贤王=Tả hiền vương
鲁老夫子=Lỗ lão phu tử
孙大人=Tôn đại nhân
郭保坤=Quách Bảo Khôn
长宁侯爷=Trường Ninh Hầu Gia
王家小姐=Vương Gia Tiểu Thư
卫华兄=Vệ Hoa Huynh
定青二州=Định Thanh Nhị Châu
胡人=Hồ nhân
王侯=Vương Hầu
龙山=Long Sơn
淮上=Hoài Thượng
澹州港=Đạm Châu Cảng
雪蛮=Tuyết Man
西胡左贤王=Tây Hồ Tả Hiền Vương
青州城=Thanh Châu Thành
苏杭=Tô Hàng
沙州客栈=Sa Châu Khách Sạn
梅圃夹院=Mai Phố Giáp Viện
齐帝=Tề Đế
曹雪芹=Tào Tuyết Cần
杨横=Dương Hoành
庆历七年=Khánh Lịch thất niên
武周=Võ Chu
江山=Giang Sơn
遗秘=Di Bí
曹公=Tào Công
天脉者=Thiên Mạch Giả
半闲斋诗话=Bán Nhàn Trai Thi Thoại
北齐朝廷=Triều Đình Bắc Tề
长亭古道=Trường Đình Cổ Đạo
牛栏街=Ngưu Lan Nhai
庆国皇后=Khánh Quốc Hoàng Hậu
之澜=Chi Lan
魏灵王=Ngụy Linh Vương
北齐小皇帝=Bắc Tề Tiểu Hoàng Đế
祝余安=Chúc Dư An
宿语录=Túc Ngữ Lục
潘郎=Phan Lang
小皇帝=Tiểu Hoàng Đế
大青树=Đại Thanh Thụ
江南内库=Giang Nam Nội Khố
苏州城=Tô Châu Thành
费介先生=Phí Giới tiên sinh
天一道门=Thiên Nhất Đạo Môn
秦老爷子=Tần Lão gia tử
木蓬=Mộc Bồng
李家=Lý Gia
何道人=Hà Đạo Nhân
十三=Thập Tam
祝英台=Chúc Anh Đài
木婉清=Mộc Uyển Thanh
堀北真希=Hori Kita Maki
风雷=Phong Lôi
静澄子府=Tĩnh Trừng Tử phủ
沈大小姐=Thẩm Đại Tiểu Thư
沈重=Thẩm Trọng
崤山冲=Hào Sơn Trùng
和亲王=Hòa Thân Vương
范族田庄=Phạm Tộc Điền Trang
司南伯府=Tư Nam Bá Phủ
AC尼尔森=AC Nielsen
jessaphy=jessaphy
任少安=Nhậm Thiếu An
内库转运司=Nội Khố Chuyển Vận Tư
季常=Quý Thường
万里=Vạn Lí
梁赫群=Lương Hách Quần
英明神武的皇帝陛下=Hoàng đế Anh Minh Thần Võ
舒学士=Thư học sĩ
胡学士=Hồ học sĩ
魏东行=Ngụy Đông Hành
郭攸之=Quách Du Chi
太子爷=Thái tử gia
魏尚书=Ngụy Thượng thư
庆国监察院=Giám Sát Viện Khánh Quốc
书局=Thư Cục
医馆=Y Quán
军事院=Quân Sự Viện
兵部=Binh Bộ
同文馆=Đồng Văn Quán
曾文祥=Tằng Văn Tường
舒大学士=Thư Đại Học Sĩ
学正=Học Chính
静思庭=Tĩnh Tư Đình
角房=Giác Phòng
言公子=Ngôn công tử
新槐巷=Tân Hòe Hạng
乱春园=Loạn Xuân Viên
大学士=Đại Học Sĩ
八家将=Bát Gia Tướng
任正卿=Nhậm Chính Khanh
征北营=Chinh Bắc Doanh
吴伯安=Ngô Bá An
袁宏道=Viên Hoành Đạo
孙府=Tôn Phủ
张君宝=Trương Quân Bảo
千金阁=Thiên Kim Các
岭南=Lĩnh Nam
提司=Đề Ty
老五=Lão Ngũ
金庸=Kim Dung
庆余堂=Khánh Dư Đường
叶掌柜=Diệp Chưởng quầy
江南三大坊=Giang Nam Tam Đại Phường
星光三黎础宁=Tinh Quang Tam Lê Sồ Ninh
谢必安=Tạ Tất An
临庐=Lâm Lư
江一草=Giang Nhất Thảo
夜宫=Dạ Cung
宁大姑=Ninh Đại Cô
庆国皇帝陛下=Khánh Quốc Hoàng Đế Bệ Hạ
叶韬=Diệp Thao
武安国=Vũ An Quốc
石越=Thạch Việt
莎士比亚=Shakespeare
庄大家=Trang Đại Gia
庆国皇帝=Hoàng đế Khánh Quốc
礼部侍郎=Lễ bộ Thị lang
礼部尚书=Lễ bộ Thượng thư
监察院八处=Giám Sát Viện Bát Xứ
城主府=Thành Chủ Phủ
剑庐首徒=Kiếm Lư Thủ Đồ
李伯华=Lý Bá Hoa
王羲=Vương Hy
梁国=Lương Quốc
辜先生=Cồ tiên sinh
院长=Viện trưởng
二处=Nhị Xử
孙小姐=Tôn tiểu thư
范族=Phạm Tộc
藤大家=Đằng Đại Gia
淡州=Đạm Châu
皇家虎卫=Hoàng Gia Hổ Vệ
宋长工=Tống Trường Công
猫腻宇宙=Vũ trụ Mèo Lười
江北路=Giang Bắc Lộ
达州城=Đạt Châu Thành
何七=Hà Thất
达州知州=Đạt Châu Tri Châu
叶子=Diệp Tử
小范院长=Viện trưởng Tiểu Phạm
京都监察院=Kinh Đô Giám Sát Viện
老秦家=Lão Tần Gia
门下中书都察院=Môn Hạ Trung Thư Đô Sát Viện
京都回春堂=Kinh Đô Hồi Xuân Đường
丙坊=Bính Phường
雷雨夜=Đêm Mưa Bão
刘叔=Lưu thúc
侯公公=Hầu công công
洪老太监=Hồng lão thái giám
梧州=Ngô Châu
东山路=Đông Sơn Lộ
征北大营=Chinh Bắc Đại Dinh
官雄=Quan Hùng
六处=Lục Xứ
江北=Giang Bắc
哑娘子=Ách Nương Tử
景阳门=Cảnh Dương Môn
门下中书行走大学士=Môn Hạ Trung Thư Hành Tẩu Đại Học Sĩ
云睿=Vân Duệ
何七干=Hà Thất Càn
洪四庠=Hồng Tứ Tường
胡悦=Hồ Duyệt
诚王爷=Thành Vương gia
小陈国=Tiểu Trần Quốc
定山=Định Sơn
王公贵族=Vương công quý tộc
老叶家=Lão Diệp gia
信阳长公主=Tín Dương Trưởng công chúa
左都御史=Tả Đô Ngự Sử
河运总督衙门=Hà Vận Tổng Đốc Nha Môn
老军部=Lão Quân Bộ
教育院=Giáo Dục Viện
同文阁=Đồng Văn Các
转司所=Chuyển Ty Sở
提运司=Đề Vận Ty
黎明=Lê Minh
靖王=Tĩnh Vương
战清风大师=Chiến Thanh Phong đại sư
太子殿下=Thái tử điện hạ
广信宫=Quảng Tín Cung
三大坊=Tam Đại Phường
老二=Lão Nhị
老三=Lão Tam
老大=Lão Đại
老林府=Lão Lâm Phủ
胡舒=Hồ Thư
宁嫔=Ninh Tần
皇帝=Hoàng đế
银面荆戈=Ngân Diện Kinh Qua
朱红=Chu Hồng
黄门=Hoàng Môn
澹泊公=Đạm Bạc Công
张德清=Trương Đức Thanh
南疆=Nam Cương
三石=Tam Thạch
君山会=Quân Sơn Hội
长公主殿下=Trưởng công chúa điện hạ
贺大学=Hạ Đại Học
舒胡=Thư Hồ
李承泽=Lý Thừa Trạch
姚公公=Diêu công công
关山=Quan Sơn
贺大人=Hạ đại nhân
舒芜=Thư Vu
六部=Lục Bộ
三寺=Tam Tự
三院=Tam Viện
小言大人=Tiểu Ngôn đại nhân
流晶河=Lưu Tinh Hà
征西军=Chinh Tây Quân
弘成=Hoằng Thành
盐市口=Diêm Thị Khẩu
南城=Nam Thành
老跛子=Lão quái dị
洪公公=Hồng công công
良子=Lương Tử
宁姨=Ninh di
戴震=Đới Chấn
灯市口检蔬司=Đèn Thị Khẩu Kiểm Sơ Tư
老王头=Lão Vương Đầu
检蔬司=Kiểm Sơ Tư
映秀烧鸡=Ánh Tú Thiêu Kê
夏明记=Hạ Minh Ký
洪常青=Hồng Thường Thanh
豆豆=Đậu Đậu
高达=Cao Đạt
宗追=Tông Truy
七处=Thất Xứ
十家村=Thập Gia Thôn
杭州=Hàng Châu
三石大师=Tam Thạch đại sư
东川=Đông Xuyên
京都府尹=Kinh Đô phủ doãn
西山纸坊=Tây Sơn chỉ phường
舒芜大学士=Thư Vu đại học sĩ
陈院长=Trần viện trưởng
庆律=Khánh Luật
李氏皇族=Lý thị hoàng tộc
礼部=Lễ Bộ
范家=Phạm Gia
柳府=Liễu Phủ
李氏=Lý thị
猫腻=Mèo Nhại
柳氏=Liễu thị
醒儿=Tỉnh Nhi
国公府=Quốc công phủ
陈老院长=Viện trưởng Trần
范家小姐=Tiểu thư Phạm gia
思辙=Tư Triệt
庆历十年=Khánh Lịch Thập Niên
小范大人=Tiểu Phạm đại nhân
小公爷=Tiểu công gia
澹泊医馆=Đạm Bạc Y Quán
太医院=Thái Y Viện
清心池=Thanh Tâm Trì
石清儿=Thạch Thanh Nhi
工部=Công Bộ
宋世仁=Tống Thế Nhân
沐铁=Mộc Thiết
梅执礼=Mai Chấp Lễ
上京=Thượng Kinh
牛头山=Ngưu Đầu Sơn
国师=Quốc sư
燕京大营=Yến Kinh Đại Dinh
合阑亭=Hợp Lan Đình
云之澜=Vân Chi Lan
柳国公=Liễu Quốc Công
沧州城=Thương Châu Thành
柔嘉郡主=Nhu Gia Quận Chúa
靖郡王=Tĩnh Quận Vương
和亲王妃=Hòa Thân Vương Phi
太常寺=Thái Thường Tự
太常寺正卿=Thái Thường Tự Chánh Khanh
三皇子=Tam Hoàng Tử
沐风儿=Mộc Phong Nhi
叶府=Diệp Phủ
工部员外郎=Công Bộ Viên Ngoại Lang
苏州知州=Tri Châu Tô Châu
渭州=Vị Châu
妩媚=Vũ Mị
世子弘成=Thế Tử Hoằng Thành
靖王世子李弘成=Tĩnh Vương Thế Tử Lý Hoằng Thành
红山口=Hồng Sơn Khẩu
庆军=Khánh Quân
什图海草甸=Thập Đồ Hải Thảo Điện
定州军=Định Châu Quân
二王妃=Nhị Vương Phi
李弘=Lý Hoằng
胡歌=Hồ Ca
单于=Đan Vu
洪亦青=Hồng Diệc Thanh
范尚书=Phạm Thượng Thư
杨万里=Dương Vạn Lý
熊家=Hùng Gia
孙家=Tôn Gia
岭南熊家=Lĩnh Nam Hùng Gia
泉州孙家=Tuyền Châu Tôn Gia
启年小组=Khởi Niên Tiểu Tổ
关妩媚=Quan Vũ Mị
沙州=Sa Châu
江南水寨=Giang Nam Thủy Trại
红山=Hồng Sơn
孔曰成仁，孟曰取义=Khổng viết thành nhân, Mạnh viết thủ nghĩa
戴公公=Đới công công
王力宏=Vương Lực Hoành
九孔=Cửu Khổng
孔明=Khổng Minh
东川路=Đông Xuyên Lộ
明七少=Minh Thất Thiếu
新风馆=Tân Phong Quán
胶州=Giao Châu
范门四子=Phạm Môn Tứ Tử
大理寺副卿=Đại Lý Tự Phó Khanh
京都府=Kinh Đô Phủ
信阳=Tín Dương
一石居=Nhất Thạch Cư
刑部侍郎=Hình Bộ Thị Lang
教坊=Giáo Phường
五粮液=Ngũ Lương Dịch
天河大街=Thiên Hà Đại Nhai
沙河街=Sa Hà Nhai
门下中书省=Môn Hạ Trung Thư Tỉnh
第728章 朝天子=Chương 728 Triều Thiên Tử
殿前欢尽须断肠=Điện Tiền Hoan Tận Tu Đoạn Trường
潘龄=Phan Linh
程副卿=Trình Phó Khanh
都察院=Đô Sát Viện
郭铮=Quách Tranh
户部尚书=Hộ Bộ Thượng Thư
侍郎=Thị Lang
西凉=Tây Lương
庆历十一年=Khánh Lịch Thập Nhất Niên
宜贵嫔=Nghi Quý tần
淑贵妃=Thục Quý phi
东山=Đông Sơn
贺大学士=Hạ Đại Học Sĩ
彭大人=Bành Đại Nhân
言院长=Ngôn Viện Trưởng
澹泊书局=Đạm Bạc Thư Cục
闽北=Mân Bắc
西山书坊=Tây Sơn Thư Phường
北齐皇帝=Bắc Tề Hoàng Đế
雪宫=Tuyết Cung
王庭=Vương Đình
西胡=Tây Hồ
杨继美=Dương Kế Mỹ
成佳林=Thành Giai Lâm
任伯安=Nhậm Bá An
明孙熊=Minh Tôn Hùng
招商钱庄=Chiêu Thương Tiền Trang
太平钱庄=Thái Bình Tiền Trang
太学=Thái Học
老范家=Lão Phạm Gia
姆妈=Mụ Mụ
悬空庙=Huyền Không Miếu
小楼=Tiểu Lâu
杭州会=Hàng Châu Hội
内库=Nội Khố
河工衙门=Hà Công Nha Môn
宁儿=Ninh Nhi
大魏天子剑=Đại Ngụy Thiên Tử Kiếm
洪老公公=Hồng Lão công công
雅易安=Nhã Dịch An
界主=Giới Chủ
秦恒=Tần Hằng
小叶子=Tiểu Diệp Tử
诚王府=Thành Vương Phủ
庆历四年=Khánh Lịch Tứ Niên
达州=Đạt Châu
燕小乙=Yến Tiểu Ất
御史台=Ngự Sử Đài
刑部=Hình Bộ
内廷=Nội Đình
十三衙门=Thập Tam Nha Môn
十三城门司=Thập Tam Thành Môn Tư
京都守备师=Kinh Đô Thủ Bị Sư
子澄爵府=Tử Trừng Tước Phủ
靖王爷府=Tĩnh Vương Gia Phủ
雪山气海=Tuyết Sơn Khí Hải
庆人=Người Khánh
陛下=Bệ hạ
天河大道=Thiên Hà Đại Đạo
西凉路=Tây Lương Lộ
沈婉儿=Thẩm Uyển Nhi
狼桃=Lang Đào
澄海子爵府=Trừng Hải Tử Tước Phủ
第741章=Chương 741
朝天子=Triều Thiên Tử
人在旅途=Nhân Tại Lữ Đồ
崤山=Tiêu Sơn
北海=Bắc Hải
言若海=Ngôn Nhược Hải
理贵妃=Lý Quý Phi
红豆饭=Hồng Đậu Phạn
青山木蓬=Thanh Sơn Mộc Bồng
北门天关=Bắc Môn Thiên Quan
西山=Tây Sơn
大齐=Đại Tề
凤辣子=Phượng Lạt Tử
庄墨韩=Trang Mặc Hàn
金茂=Kim Mậu
三峡大坝=Đập Tam Hiệp
庆历五年=Khánh Lịch năm thứ 5
永夜之庙=Vĩnh Dạ Chi Miếu
法网=Pháp Võng
天一道=Thiên Nhất Đạo
伏波=Phục Ba
庆庙=Khánh Miếu
三皇子李承平=Tam hoàng tử Lý Thừa Bình
五竹叔=Ngũ Trúc thúc
大魏朝=Đại Ngụy Triều
阿西莫夫=Asimov
雾渡河=Vụ Độ Hà
神庙=Thần Miếu
东夷=Đông Di
青山一脉=Thanh Sơn Nhất Mạch
剑庐=Kiếm Lư
雪山=Tuyết Sơn
波尔=Ba Nhĩ
伏波娃=Phục Ba Oa
秦业=Tần Nghiệp
洪四痒=Hồng Tứ Dạng
费先生=Phí tiên sinh
吴老二=Ngô Lão Nhị
阿大=A Đại
阿二=A Nhị
宋国州城=Tống Quốc Châu Thành
沧州=Thương Châu
大殿下=Đại điện hạ
黑骑=Hắc Kỵ
孙家小姐=Tôn gia tiểu thư
文茂=Văn Mậu
颖州=Dĩnh Châu
苏文茂=Tô Văn Mậu
明园=Minh Viên
青山天一道=Thanh Sơn Thiên Nhất Đạo
理理=Lý Lý
南陵郡=Nam Lăng Quận
北冲平原=Bắc Xung Bình Nguyên
中书台=Trung Thư Đài
燕京城=Yên Kinh Thành
卫华=Vệ Hoa
萧金华=Tiêu Kim Hoa
南朝=Nam Triều
秦家=Tần Gia
海棠朵要=Hải Đường Đóa Yếu
晨郡主=Thần Quận Chúa
枢密院参谋部=Xu Mật Viện Tham Mưu Bộ
速必达=Tốc Tất Đạt
枢密院正使=Xu Mật Viện Chính Sử
单于王庭=Đan Vu Vương Đình
定州=Định Châu
龙椅=Long ỷ
西胡草原=Tây Hồ Thảo Nguyên
青州=Thanh Châu
江南=Giang Nam
范党=Phạm Đảng
流云散手=Lưu Vân Tán Thủ
叶家=Diệp Gia
大劈棺=Đại Phách Quan
流云世叔=Lưu Vân Thế Thúc
承平=Thừa Bình
二皇子=Nhị Hoàng Tử
潘龄大学士=Phan Linh Đại Học Sĩ
门下中书=Môn Hạ Trung Thư
范家老二=Phạm Gia Lão Nhị
庆历=Khánh Lịch
太子=Thái Tử
漱芳宫=Sấu Phương Cung
范淑宁=Phạm Thục Ninh
石头记=Thạch Đầu Ký
元春=Nguyên Xuân
梅妃=Mai Phi
史飞=Sử Phi
北大营=Bắc Đại Doanh
正阳门=Chính Dương Môn
摘星楼=Trích Tinh Lâu
范府=Phạm Phủ
言府=Ngôn Phủ
大理寺=Đại Lý Tự
午门=Ngọ Môn
南诏=Nam Chiếu
瑯琊郡=Lang Nha Quận
宫典=Cung Điển
庆国=Khánh Quốc
邓子越=Đặng Tử Việt
御书房=Ngự Thư Phòng
浣衣坊=Hoán Y Phường
安之=An Chi
南京=Nam Kinh
上杉破=Thượng Sam Phá
上杉虎=Thượng Sam Hổ
宋国=Tống Quốc
叶帅=Diệp soái
小梁国=Tiểu Lương Quốc
荆戈=Kinh Qua
天河道=Thiên Hà Đạo
贺派=Hạ phái
孙敬修=Tôn Kính Tu
范良=Phạm Lương
青山=Thanh Sơn
苍山=Thương Sơn
太极殿=Thái Cực Điện
大东山=Đại Đông Sơn
小李子=Tiểu Lý Tử
流云=Lưu Vân
费介=Phí Giới
根尘=Căn Trần
婉儿=Uyển Nhi
战清风=Chiến Thanh Phong
胡大学士=Hồ Đại học sĩ
姚太监=Diêu thái giám
承乾=Thừa Càn
承泽=Thừa Trạch
皇后=Hoàng Hậu
长公主=Trưởng công chúa
含光殿=Hàm Quang Điện
太后=Thái Hậu
杭州城=Hàng Châu thành
西湖=Tây Hồ
京都=Kinh Đô
监察院=Giám Sát Viện
南京城=Nam Kinh Thành
战家=Chiến Gia
李承平=Lý Thừa Bình
宜贵妃=Nghi Quý Phi
叶完=Diệp Hoàn
枢密院=Xu Mật Viện
太傅=Thái Phó
柳堤=Liễu Đê
范宅=Phạm Trạch
良哥儿=Lương Ca Nhi
苏州=Tô Châu
华园=Hoa Viên
洪竹=Hồng Trúc
靖王府=Tĩnh Vương Phủ
柳国公府=Liễu Quốc Công Phủ
国公巷=Quốc Công Hạng
江南路=Giang Nam Lộ
薛清=Tiết Thanh
澹州=Đạm Châu
鱼肠=Ngư Tràng
侯季常=Hầu Quý Thường
老戴=Lão Đới
王头=Vương Đầu
子越=Tử Việt
宁妃=Ninh Phi
大王妃=Đại Vương Phi
王大都督=Vương Đại Đô Đốc
大皇子=Đại Hoàng Tử
和亲王府=Hòa Thân Vương Phủ
王志昆=Vương Chí Côn
燕京=Yên Kinh
夏栖飞=Hạ Tê Phi
明家=Minh Gia
范思辙=Phạm Tư Triệt
史阐立=Sử Xiển Lập
桑文=Tang Văn
抱月楼=Bão Nguyệt Lâu
陈园=Trần Viên
范无救=Phạm Vô Cứu
贺宗纬=Hạ Tông Vĩ
桑家=Tang Gia
藤子京=Đằng Tử Kinh
巴陵=Ba Lăng
彩虹之上=Cầu vồng phía trên
海棠=Hải Đường
朵朵=Đóa Đóa
范若若=Phạm Nhược Nhược
柔嘉=Nhu Gia
靖王爷=Tĩnh Vương Gia
十三郎=Thập Tam Lang
范安之=Phạm An Chi
范建=Phạm Kiến
陈萍萍=Trần Bình Bình
格格猪=Cách Cách Trư
林婉儿=Lâm Uyển Nhi
张萌萌=Trương Manh Manh
张无忌=Trương Vô Kỵ
段正淳=Đoạn Chính Thuần
陈平=Trần Bình
林若甫=Lâm Nhược Phủ
若若=Nhược Nhược
李弘成=Lý Hoằng Thành
李承乾=Lý Thừa Càn
王曈儿=Vương Đồng Nhi
玛索索=Mã Tác Tác
言冰云=Ngôn Băng Vân
王启年=Vương Khải Niên
飞将=Phi Tướng
战明月=Chiến Minh Nguyệt
四顾剑=Tứ Cố Kiếm
王十三郎=Vương Thập Tam Lang
叶灵儿=Diệp Linh Nhi
林青霞=Lâm Thanh Hà
周星星=Châu Tinh Tinh
影子=Ảnh Tử
林依晨=Lâm Y Thần
宁才人=Ninh Tài Nhân
清香朵朵=Thanh Hương Đóa Đóa
海棠依旧在=Hải Đường Y Cựu Tại
松芝仙令=Tùng Chi Tiên Lệnh
闪耀=Thiểm Diệu
韩艺瑟=Han Ye Seul
罗桑实=La Tang Thực
大宝=Đại Bảo
小闲闲=Tiểu Nhàn Nhàn
澹州城=Đạm Châu Thành
叶轻眉=Diệp Khinh Mi
思思=Tư Tư
冬儿=Đông Nhi
孙颦儿=Tôn Tần Nhi
上京城=Thượng Kinh Thành
南庆=Nam Khánh
锦衣卫=Cẩm Y Vệ
李云睿=Lý Vân Duệ
殿前欢=Điện Tiền Hoan
威廉姆斯=Williams
孙女儿=Cháu Gái
五竹=Ngũ Trúc
庆帝=Khánh Đế
孙晓=Tôn Hiểu
李世民=Lý Thế Dân
回音=Hồi Âm
老翡翠=Lão Phỉ Thúy
娜娜=Na Na
周行文=Chu Hành Văn
檀郎=Đàn Lang
更俗=Canh Tục
老Ｔ=Lão T
范慎=Phạm Thận
淑宁=Thục Ninh
大庆=Đại Khánh
海子=Hải Tử
肖恩=Tiêu Ân
苦荷=Khổ Hà
大魏=Đại Ngụy
东夷城=Đông Di Thành
叶重=Diệp Trọng
叶流云=Diệp Lưu Vân
司南伯=Tư Nam Bá
泉州=Tuyền Châu
陈五常=Trần Ngũ Thường
太平别院=Thái Bình Biệt Viện
朱雀记=Chu Tước Ký
间客=Gian Khách
庆余年=Khánh Dư Niên
海棠朵朵=Hải Đường Đóa Đóa
战豆豆=Chiến Đậu Đậu
司理理=Tư Lý Lý
王倦=Vương Quyện
范闲=Phạm Nhàn
北齐=Bắc Tề
腾讯视频=Tencent Video
爱奇艺视频=iQiyi Video
起点读书=Khởi Điểm Đọc Sách
QQ阅读=QQ Đọc Sách
刘翔=Lưu Tường
张演员=Diễn viên Trương
