明珠魔法学院=Minh Châu Ma Pháp Học Viện
孙源=Tôn Nguyên
阳新=Dương Tân
天澜魔法魔法高中=Thiên Lan Ma Pháp Ma Pháp Cao Trung
明珠学院=Minh Châu Học Viện
刘晓=Lưu Hiểu
诸葛亮=Gia Cát Lượng
武道古经=Võ Đạo Cổ Kinh
穆家庄园=Mục Gia Trang Viên
王建国=Vương Kiến Quốc
赵坤三=Triệu Khôn Tam
张建国=Trương Kiến Quốc
穆贺=Mục Hạ
星尘魔器=Tinh Trần Ma Khí
柳大师=Liễu đại sư
魔都魔法协会=Hiệp hội Ma pháp Ma Đô
帝都穆氏=Đế Đô Mục Thị
梵墨=Phạn Mặc
彩棠=Thải Đường
宁雪=Ninh Tuyết
周敏=Chu Mẫn
朱校长=Hiệu trưởng Chu
邓凯=Đặng Khải
杨作河=Dương Tác Hà
宇昂=Vũ Ngang
莫家兴=Mạc Gia Hưng
韩老魔=Hàn Lão Ma
银贸大厦=Ngân Mậu Đại Hạ
翼苍狼=Dực Thương Lang
骨刺狰狼=Cốt Thứ Tranh Lang
穆白=Mục Bạch
穆氏庄园=Mục Thị Trang Viên
星海魔器=Tinh Hải Ma Khí
阿杰=A Kiệt
戴衫=Đới Sam
鹿鸣=Lộc Minh
许昭霆=Hứa Chiêu Đình
杭城要塞=Hàng Thành yếu tắc
安界=An Giới
铁臂猿魔=Thiết Tí Viên Ma
朝赫=Triều Hách
戏水镇=Hí Thủy Trấn
东方骏=Đông Phương Tuấn
吸血鬼=Ma cà rồng
狼人=Người sói
上古女巫=Phù thủy thượng cổ
青龙吊坠=Thanh Long điếu trụy
幽狼兽=U Lang thú
陆杰=Lục Kiệt
白阳=Bạch Dương
主校区=Chủ giáo khu
D栋=D Đống
杨坚=Dương Kiên
南大学府=Nam Đại Học Phủ
川大学府=Xuyên Đại Học Phủ
赵阡=Triệu Thiên
白雨=Bạch Vũ
星河魔器=Tinh Hà Ma Khí
星云之脉=Tinh Vân Chi Mạch
东方曜=Đông Phương Diệu
帝都明珠=Đế Đô Minh Châu
岩魔=Nham Ma
独眼刺妖=Độc Nhãn Thứ Yêu
赤色裂妖=Xích Sắc Liệt Yêu
耀辉教官=Giáo quan Diệu Huy
禹彤=Vũ Đồng
耀辉=Diệu Huy
武大学府=Vũ Đại Học Phủ
柳琳=Liễu Lâm
姚文=Diêu Văn
唐雯雯=Đường Văn Văn
洛坤=Lạc Khôn
陆丰=Lục Phong
李武=Lý Vũ
李晓伟=Lý Hiểu Vĩ
白豪=Bạch Hào
袁志龙=Viên Chí Long
钱富=Tiền Phú
兰德里咖啡厅=Quán cà phê Lăng Đức Lí
审判大厅=Sảnh Thẩm Phán
杭城魔法协会大厦=Tòa nhà Hiệp hội Ma pháp Hàng Thành
杭州=Hàng Châu
摩天蛇=Ma Thiên Xà
魔法宫廷=Cung điện Ma pháp
三潭映月=Tam Đàm Ấn Nguyệt
白山=Bạch Sơn
凌爪疫鼠=Lăng Trảo Dịch Thử
武平景=Vũ Bình Cảnh
白山千洞=Bạch Sơn Thiên Động
三潭印月=Tam Đàm Ấn Nguyệt
魏荣=Ngụy Vinh
秦羽儿=Tần Vũ Nhi
北角=Bắc Giác
疾星狼=Tật Tinh Lang
叶心夏=Diệp Tâm Hạ
赵玉林=Triệu Ngọc Lâm
晨颍=Thần Dĩnh
敦煌=Đôn Hoàng
沙啸虎=Sa Khiếu Hổ
华村=Hoa Thôn
方谷=Phương Cốc
神印礼赞=Thần Ấn Lễ Tán
艾图图=Ngải Đồ Đồ
白源=Bạch Nguyên
杨老师=Thầy Dương
北雨山=Bắc Vũ Sơn
严立=Nghiêm Lập
周墨=Chu Mặc
杨燕玲=Dương Yến Linh
澳洲虚空之坛=Đàn tế Hư Không Úc Đại Lợi
茅台=Mao Đài
宫廷=Cung đình
阳萱=Dương Huyên
黄文=Hoàng Văn
冷姐=Lãnh tỷ
牧奴娇=Mục Nô Kiều
徐元=Từ Nguyên
飞鸟市=Thành phố Phi Điểu
林军闲=Lâm Quân Nhàn
闫明寺=Diêm Minh Tự
七海=Thất Hải
宫田=Cung Điền
奈良原空=Nại Lương Nguyên Không
满英山=Mãn Anh Sơn
西熊市=Tây Hùng Thị
老王=Lão Vương
棒子队=Đội Hàn Quốc
冈本嵩=Cương Bản Tung
信子老师=Tín Tử Lão Sư
岛国国馆队=Đội Quốc Quán đảo quốc
军统军司=Quân Thống Quân Tư
金毛冈本嵩=Kim Mao Cương Bản Tung
老江=Lão Giang
桔梗=Cát Cánh
信子=Tín Tử
十九街区=Khu 19
东海要塞城=Đông Hải Yếu Tắc Thành
广濑=Quảng Lại
百年孤独=Bách Niên Cô Độc
蓝谷凶离兽=Lam Cốc Hung Ly Thú
审判会=Thẩm Phán Hội
洞庭湖=Động Đình Hồ
大西洋=Đại Tây Dương
赖恒宝=Lại Hằng Bảo
绿野岛=Lục Dã Đảo
蒋狐狸=Tưởng Hồ Ly
封离导师=Đạo sư Phong Ly
松鹤导师=Đạo sư Tùng Hạc
帝都学府=Đế Đô Học Phủ
棒子国=Hàn Quốc
釜山=Phủ Sơn
国馆队=Quốc Quán Đội
金浩=Kim Hạo
朴成旭=Phác Thành Húc
天山=Thiên Sơn
朴灿=Phác Xán
金固=Kim Cố
汉城=Hán Thành
天旭=Thiên Húc
野狼特战队=Dã Lang Đặc Chiến Đội
韦老七=Vi Lão Thất
雪原魔狼=Tuyết Nguyên Ma Lang
冰铠魔狼=Băng Khải Ma Lang
李议员=Lý Nghị Viên
林若愚=Lâm Nhược Ngu
林军司=Lâm Quân Tư
允熙=Doãn Hy
审判长=Thẩm Phán Trưởng
朴室廉=Phác Thất Liêm
禁咒=Cấm chú
次元之蕊=Thứ Nguyên Chi Nhụy
千熏=Thiên Huân
波罗第=Ba La Đệ
东京海=Biển Tokyo
迷雾群岛=Quần đảo Sương Mù
波罗第小镇=Ba La Đệ tiểu trấn
白冠魔鹰=Bạch Quan Ma Ưng
妖魔南极帝=Yêu Ma Nam Cực Đế
地水之蕊=Địa Thủy Chi Nhụy
空间魔钻=Không Gian Ma Toản
空间魔晶=Không Gian Ma Tinh
马尼拉审判会=Hội Thẩm Phán Manila
国馆勋章=Huân Chương Quốc Quán
雾柳=Vụ Liễu
吕宋岛=Đảo Luzon
刘杰=Lưu Kiệt
蓝壳巨蟹=Cua mai xanh khổng lồ
铁臂魔猿=Thiết Tí Ma Viên
东海城=Đông Hải Thành
大分水岭=Đại Phân Thủy Lĩnh
尖尾魔蝎=Tiêm Vĩ Ma Yết
摩羯角魔=Ma Yết Giác Ma
沙之荆棘=Sa Chi Kinh Cức
流沙魔蟹=Lưu Sa Ma Giải
黑鳞魔蜥=Hắc Lân Ma Tích
将星海天脉=Tướng Tinh Hải Thiên Mạch
黑风=Hắc Phong
沙漠红蚁=Sa mạc Hồng Nghĩ
克鲁小镇=Thị trấn 克鲁
安第斯山脉=Dãy Andes
威尔法师=Pháp sư Will
戈壁谷=Thung lũng Gobi
汉密城=Hán Mật Thành
欧尼=Âu Ni
西葛=Tây Cát
香草小寨=Hương Thảo Tiểu Trại
国府=Quốc Phủ
印度=Ấn Độ
海鸥公园=Công viên Hải Âu
岛国队=Đội tuyển Đảo Quốc
白头港=Cảng Bạch Đầu
美洲最高魔法协会=Hiệp hội Ma Pháp Tối cao Châu Mỹ
邵和谷=Thiệu Hòa Cốc
劳伦=Lao Luân
加勒比海域=Vùng biển Caribbean
暗爵斗篷=Ám Tước Đấu Bồng
邦尔萨城=Bang Nhĩ Tát Thành
北美洲=Bắc Mỹ
蓝石镇=Lam Thạch Trấn
暮光之吻酒店=Khách sạn Nụ Hôn Hoàng Hôn
威尼斯世界国府大赛=Giải Đấu Quốc Phủ Thế Giới Venice
费洛姆=Phí Lạc Mỗ
卡索=Tạp Tác
鲍勃林=Bob Lin
自由岛=Đảo Tự Do
裴历=Bùi Lịch
奥露娜=Áo Lộ Na
国府队=Quốc Phủ Đội
提诺阿亚城=Thành phố Tino Aia
布里兹=Bố Lí Tư
杰克=Kiệt Khắc
凯瑟琳=Khải Sắt Lâm
阿拉伯=Ả Rập
迪拜塔=Dubai Tháp
芬纳参谋=Tham mưu trưởng Fenna
库伦=Khố Luân
白头市=Thành phố Bạch Đầu
红饰公会=Hồng Sức Công Hội
东军统=Đông Quân Thống
旺科斯=Vượng Khoa Tư
圣彼得大圣堂=Đại thánh đường Thánh Peter
圣保罗圣堂=Thánh đường Thánh Paul
国际氏族联盟=Liên minh Thị tộc Quốc tế
东京法师神社=Đền Pháp sư Tokyo
德黑兰魔法岭=Lĩnh ma pháp Tehran
圣彼得大教堂=Nhà thờ Thánh Peter
藤方信子=Fujikata Nobuko
古都钟楼魔法协会=Hiệp hội Pháp thuật Chung Lâu Cổ Đô
宫廷首席法师庞莱=Pháp sư đứng đầu Cung Đình Bàng Lai
妃妃=Phi Phi
明步松=Minh Bộ Tùng
日本国府队=Đội Tuyển Quốc Phủ Nhật Bản
洋介=Dương Giới
绍和谷=Thiệu Hòa Cốc
棒子=Bổng Tử
瑞士队=Đội Thụy Sĩ
印度队=Đội Ấn Độ
葡萄牙队=Đội Bồ Đào Nha
日本队=Đội Nhật Bản
葡萄牙=Bồ Đào Nha
夜罗刹=Dạ La Sát
意大利队=Đội tuyển Ý
澳洲队=Đội tuyển Úc
芬纳=Phân Nạp
托伦托魔法斗场=Đấu trường phép thuật Torrence
龙牙魔法斗场=Đấu trường phép thuật Long Nha
康蒂=Kang Đế
弗朗=Phất Lãng
日本=Nhật Bản
青岚=Thanh Lam
汉娜=Hán Na
亚克=Á Khắc
斐蒙猎王=Phi Mông Liệp Vương
查理=Tra Lý
梅林=Mai Lâm
柏克=Bá Khắc
慕尼黑=Mục Ni Hách
乔森=Kiều Sâm
瑞迪=Thụy Địch
中国=Trung Quốc
加拿大队=Đội Canada
德国队=Đội tuyển Đức
官鱼祖吉明=Quan Ngư Tổ Cát Minh
牧文=Mục Văn
中国队=Đội tuyển Trung Quốc
风聿=Phong Duật
虫领国度=Trùng Lĩnh Quốc Độ
万象皆尽=Vạn Tượng Giai Tẫn
耀庭=Diệu Đình
黄金狮鹫=Sư Thứu Vàng
沙德=Sa Đức
西士顿=Tây Sĩ Đốn
普希尼=Phổ Hi Ni
祖吉明=Tổ Cát Minh
南荣倪=Nam Vinh Nghê
穆婷颖=Mục Đình Dĩnh
官鱼=Quan Ngư
国府大赛=Giải đấu Quốc Phủ
祝铁嘴=Chúc Thiết Chủy
美国队=Đội tuyển Mỹ
大地邪虫=Đại Địa Tà Trùng
法国队=Đội tuyển Pháp
审判长唐忠=Thẩm Phán Trưởng Đường Trung
史瑞夫=Sử Thụy Phu
辛德=Tân Đức
埃及队=Đội tuyển Ai Cập
威尼斯之戒=Nhẫn Venice
英国队=Đội Anh
松鹤=Tùng Hạc
哲罗=Triết La
烈拳九宫=Liệt Quyền Cửu Cung
米塔=Mễ Tháp
伊琳=Y Lâm
天焰葬礼=Thiên Diễm Táng Lễ
焰雨=Diễm Vũ
老狼=Lão Lang
冰川铠狼=Băng Xuyên Khải Lang
伽门侬=Gia Môn Nông
南珏=Nam Giác
希腊队=Đội Hy Lạp
光落漫丈=Quang Lạc Mạn Trượng
图腾印记=Đồ Đằng Ấn Ký
司夜骑士=Tư Dạ Kỵ Sĩ
念控=Niệm Khống
停滞=Đình Trệ
霹雳电灾=Phích Lịch Điện Tai
暴君荒雷=Bạo Quân Hoang Lôi
卡洛欧丝=Tạp Lạc Âu Ti
赵家=Triệu Gia
希腊=Hy Lạp
博城天澜魔法高中=Bác Thành Thiên Lan Ma Pháp Cao Trung
冯州龙=Phùng Châu Long
纳斯卡地画=Địa họa Nazca
虹彩冠羽=Hồng thải quan vũ
胡夫古老王=Vua Cổ Đại Khufu
唐忠审判长=Thẩm phán Đường Trung
黎天审判长=Thẩm phán Lê Thiên
罗素老师=Thầy La Tố
老张=Lão Trương
老薛=Lão Tiết
天澜魔法高中=Thiên Lan Ma Pháp Cao Trung
羽皇琉璃孔雀=Vũ Hoàng Lưu Li Khổng Tước
东方烈=Đông Phương Liệt
秦岭=Tần Lĩnh
百拔山=Bách Bạt Sơn
孙贼儿=Tôn tặc nhi
西要塞=Tây Yếu T塞
西岭=Tây Lĩnh
封离=Phong Ly
威尼斯水城=Thành phố Venice
冷清=Lãnh Thanh
冷青姐=Lãnh Thanh tỷ
圣宫=Thánh Cung
南守白煦=Nam Thủ Bạch Húc
喝忒=Hát Đặc
南守=Nam Thủ
白煦=Bạch Húc
胡夫=Hồ Phu
宫廷议员=Cung Đình Nghị Viên
亡国兽塚=Vong Quốc Thú Trủng
红衣主教九婴=Hồng y giáo chủ Cửu Anh
最高审判会=Tối cao thẩm phán hội
暴君天雷=Bạo Quân Thiên Lôi
裁决天雷=Tài Quyết Thiên Lôi
林城武=Lâm Thành Vũ
景福宫=Cảnh Phúc Cung
宫廷法师团=Cung Đình Pháp Sư Đoàn
三步塔=Tam Bộ Tháp
威尼斯世界学府大赛=Đại Tái Học Phủ Thế Giới Venice
空间系=Hệ Không Gian
罗浩=La Hạo
林志=Lâm Chí
双守阁之西守阁=Song Thủ Các Chi Tây Thủ Các
帝都故宫廷=Đế Đô Cố Cung Đình
华军=Hoa Quân
西军=Tây Quân
林飞历=Lâm Phi Lịch
澳洲妖魔帝国=Đế quốc yêu ma Úc
西军军首=Tây Quân Quân Thủ
黑石山=Hắc Thạch Sơn
暴尘魔蜢首领=Bạo Trần Ma Mãnh Thủ Lĩnh
图腾珠=Đồ Đằng Châu
宫廷议员祝蒙=Cung Đình Nghị Viên Chúc Mông
国内城市重大威胁肃清战略=Chiến lược thanh trừ mối đe dọa lớn ở các thành phố trong nước
图腾守护族群唐氏=Đồ Đằng Thủ Hộ Tộc Quần Đường Thị
北军=Bắc Quân
帝王=Đế Vương
东方魔都=Đông Phương Ma Đô
勺参谋=Thìa Tham Mưu
乌市=Ô Thị
黑石火山=Hắc Thạch Hỏa Sơn
高帝禁区=Cấm khu Cao Đế
蝎尾鬼狼=Bò cạp đuôi quỷ lang
地灵之蕊=Địa Linh Chi Nhụy
心灵之蕊=Tâm Linh Chi Nhụy
夜鹰=Dạ Ưng
凝华邪珠=Ngưng Hoa Tà Châu
黄土平原=Bình nguyên đất vàng
安角镇=Trấn An Giác
常沂=Thường Nghi
艾江图=Ngải Giang Đồ
亡灵君主=Vong Linh Quân Chủ
至尊君主=Chí Tôn Quân Chủ
冥界帝王=Minh Giới Đế Vương
北疆=Bắc Cương
恶魔=Ác Ma
张小侯=Trương Tiểu Hầu
冥界纤夫=Minh Giới Tiêm Phu
英灵=Anh Linh
红衣主教冷爵=Hồng y giáo chủ Lãnh Tước
胡夫金字塔=Kim Tự Tháp Khufu
镇北关=Trấn Bắc Quan
蝎君美杜莎=Hạt Quân Medusa
黑暗剑主=Hắc Ám Kiếm Chủ
法老王胡夫=Pharaon Khufu
邪鳞法老=Tà Lân Pharaoh
彬参谋=Bân Tham mưu
彬蔚=Bân Úy
飞皇市=Phi Hoàng Thị
冥辉界域=Minh Huy Giới Vực
法老泉=Pháp Lão Tuyền
青龙图腾=Thanh Long Đồ Đằng
黑暗位面=Hắc Ám Vị Diện
时光之液=Thời Quang Chi Dịch
冷猎王=Lãnh Liệp Vương
澳洲沙漠红蚁=Úc Châu Sa Mạc Hồng Kiến
暴尘魔蜢=Bạo Trần Ma Mãnh
王腾议员=Vương Đằng Nghị Viên
林氏掌门人=Lâm Thị Chưởng Môn Nhân
林氏公馆=Lâm Thị Công Quán
魔石矿脉=Mỏ Ma Thạch
穆氏家族=Mục thị gia tộc
大君主暴猿金刚=Đại quân chủ Bạo Viên Kim Cương
西守阁=Tây Thủ Các
魔法协会=Hiệp hội Ma pháp
海岸线联盟=Liên minh Đường bờ biển
安德迈克=Ander Mike
自由女神殿=Đền Nữ thần Tự do
岛国双守阁=Song Thủ Các đảo quốc
大连海战城=Đại Liên Hải Chiến Thành
韩寂=Hàn Tịch
亚洲议长苏鹿=Chủ tịch châu Á Tô Lộc
红衣九婴=Hồng Y Cửu Anh
姜夏=Khương Hạ
千岛湖=Hồ Ngàn Đảo
堤石=Đê Thạch
钱塘江=Tiền Đường Giang
海战城=Hải Chiến Thành
东方家=Đông Phương gia
江东大桥=Giang Đông đại kiều
唐氏一族=Đường thị nhất tộc
牧卓=Mục Trác
钱江大桥=Tiền Giang Đại Kiều
唐大雄=Đường Đại Hùng
唐礼=Đường Lễ
阿帕丝=A Phạ Ti
浙大学府=Chiết Giang Đại Học Phủ
牧歌=Mục Ca
洛坚=Lạc Kiên
赤凌妖=Xích Lăng Yêu
青壳锯妖=Thanh Xác Cưa Yêu
锯齿绿妖=Cưa Xỉ Lục Yêu
蓝鳍鲨妖=Lam Kỳ Sa Yêu
剑脊妖=Kiếm Tích Yêu
白魔鹰=Bạch Ma Ưng
北原战场=Chiến trường Bắc Nguyên
钱江流域=Lưu vực Tiền Giang
厦门岛=Đảo Hạ Môn
大黎世家=Đại Lê Thế Gia
陆家=Lục Gia
魔都基地市=Ma Đô Căn Cứ Địa Thị
首席=Thủ Tịch
大阪双守阁=Osaka Song Thủ Các
望岳名剑=Vọng Nhạc Danh Kiếm
钱江=Tiền Giang
秀诚=Tú Thành
望月秀诚=Vọng Nguyệt Tú Thành
杭城湾=Hàng Thành Loan
杭城魔法协会=Hiệp Hội Ma Pháp Hàng Thành
禁卫法师团=Cấm Vệ Pháp Sư Đoàn
驻军法师=Trú Quân Pháp Sư
魔都明珠法师团=Ma Đô Minh Châu Pháp Sư Đoàn
黑鹰=Hắc Ưng
银色穹主=Ngân Sắc Khung Chủ
明珠法师团=Minh Châu Pháp Sư Đoàn
塔克拉玛干沙漠=Sa mạc Taklamakan
囚蚩=Tù Xi
霸下=Bá Hạ
牧军司=Mục Quân Tư
魔都=Ma Đô
杭城海湾=Vịnh Hàng Thành
昆仑之巅=Đỉnh Côn Lôn
北极大陆=Bắc Cực Đại Lục
南极冰陆=Nam Cực Băng Lục
南美大陆=Nam Mỹ Đại Lục
圣裁院=Thánh Tài Viện
老米=Lão Mễ
黎凯风=Lê Khải Phong
湛血异术=Trảm Huyết Dị Thuật
莫勒=Mạc Lặc
黑暗圣魂=Hắc Ám Thánh Hồn
死神骸旯=Tử Thần Hài Lạp
魔都禁咒会=Ma Đô Cấm Chú Hội
骸旯=Hài Lạp
海湾囚眦=Hải Loan Tù Tí
时光小镇=Thị trấn Thời Gian
卫宫切嗣=Emiya Kiritsugu
地狱三头狗=Chó Ba Đầu Địa Ngục
亚洲议长=Nghị Trưởng Châu Á
故宫廷议员=Cố Cung Đình Nghị Viên
华展鸿=Hoa Triển Hồng
古都=Cổ Đô
宋启明=Tống Khải Minh
米迦勒=Mễ Già Lặc
大天使长沙利叶=Đại Thiên sứ trưởng Saliel
暴猿山谷=Bạo Viên Sơn Cốc
长沙利叶=Trường Sa Lợi Diệp
天国悲虹=Thiên Quốc Bi Hồng
雷米尔=雷米尔
莎迦=Sa Già
西哲=Tây Triết
克野=Khắc Dã
异裁院=Dị Tài Viện
安德族长=Tộc trưởng Ande
龙类坐骑=Long loại tọa kỵ
首尔暴猿山谷=Thung lũng Bạo Viên Seoul
暴猿金刚=Bạo Viên Kim Cương
迪拜城=Thành phố Dubai
卢卡会长=Hội trưởng Luca
东守阁=Đông Thủ Các
次元监狱=Thứ Nguyên Giám Ngục
月姐=Nguyệt Tỷ
罗老师=Thầy La
罗素=La Tố
魏主任=Chủ nhiệm Ngụy
魏鸣=Ngụy Minh
青校区=Thanh Giáo Khu
黄星丽=Hoàng Tinh Lệ
灵隐=Linh Ẩn
祖家=Tổ Gia
穆家=Mục Gia
林氏=Lâm Thị
灵隐审判会=Linh Ẩn Thẩm Phán Hội
阿尔卑斯学府=Alps học phủ
埃及=Ai Cập
林氏世家=Lâm thị thế gia
釜山基地市=Phủ Sơn căn cứ thị
神都=Thần Đô
晨曦城堡=Thần Hi Thành Bảo
海妖=Hải Yêu
皇纱枯骨女皇=Hoàng Sa Khô Cốt Nữ Hoàng
金字塔冥界=Kim Tự Tháp Minh Giới
澜阳市=Lan Dương Thị
红皮海妖=Hồng Bì Hải Yêu
黑龙=Hắc Long
石千寿=Thạch Thiên Thọ
魔城魔法协会=Ma Thành Ma Pháp Hiệp Hội
明珠高级审判会=Minh Châu Cao Cấp Thẩm Phán Hội
魔城议员=Ma Thành Nghị Viên
猎者联盟魔城分会=Liệp Giả Liên Minh Ma Thành Phân Hội
海王骷髅=Hải Vương Khô Lâu
尹舟=Doãn Chu
朱雀=Chu Tước
云界天层=Vân Giới Thiên Tầng
重明神鸟=Trọng Minh Thần Điểu
望月九重=Vọng Nguyệt Cửu Trọng
姜凤=Khương Phượng
沙惘河=Sa Võng Hà
宋城=Tống Thành
斩空=Trảm Không
九幽后=Cửu U Hậu
尉缭=Úy Liễu
明珠法师塔=Tháp Pháp sư Minh Châu
南军=Nam Quân
妖都基地市=Thành phố căn cứ Yêu Đô
柳会长=Liễu hội trưởng
灼原北角=Chước Nguyên Bắc Giác
贝加尔湖=Hồ Baikal
黑魔鹰君主=Hắc Ma Ưng Quân Chủ
黑鳞触魔=Hắc Lân Xúc Ma
东欧=Đông Âu
中欧=Trung Âu
西欧=Tây Âu
英国=Nước Anh
海妖帝王=Hải yêu Đế vương
环太平洋国家=Các quốc gia Vành đai Thái Bình Dương
赵氏=Triệu thị
星河之脉=Tinh Hà Chi Mạch
老管家=Quản gia già
巨龙之巢=Sào Huyệt Của Rồng
维多利亚世族=Thế Tộc Victoria
望月家族=Vọng Nguyệt Gia Tộc
双守阁=Song Thủ Các
诅咒之地=Vùng Đất Nguyền Rủa
圣凯之坛=Thánh Khải Chi Đàn
邵郑议长=Thiệu Trịnh Nghị Trưởng
朴氏家族=Phác Thị Gia Tộc
故宫=Cố Cung
青羽魔鹰=Thanh Vũ Ma Ưng
紫禁大军司=Tử Cấm Đại Quân Tư
罗冕=La Miện
蒋少黎=Tưởng Thiếu Lê
杭城审判会=Hàng Thành Thẩm Phán Hội
祝蒙=Chúc Mông
黑羽=Hắc Vũ
紫禁卫=Tử Cấm Vệ
囚眦=Tù Tí
秦皇岛=Tần Hoàng Đảo
猩红之杯=Chén Thánh Đỏ
海神=Hải Thần
茉莉=Mạt Lị
帝王海妖=Đế Vương Hải Yêu
艾琳=Ngải Lâm
黑暗长河=Hắc Ám Trường Hà
冷灵灵=Lãnh Linh Linh
北原=Bắc Nguyên
穆卓云=Mục Trác Vân
西湖景区=Tây Hồ Cảnh Khu
九婴=Cửu Anh
虚空之坛=Hư Không Chi Đàn
时间系=Thời Gian Hệ
时间禁界=Thời Gian Cấm Giới
蓝银戒=Lam Ngân Giới
纳晶储魔器=Nạp Tinh Trữ Ma Khí
天使魂胎=Thiên Sứ Hồn Thai
蓝银金属=Lam Ngân Kim Loại
千族精灵塔=Thiên Tộc Tinh Linh Tháp
万龙谷=Vạn Long Cốc
亡国兽冢=Vong Quốc Thú Trủng
阿尔卑斯山脉=Dãy Alps
唐氏=Đường thị
西湖=Tây Hồ
月雨小筑庄园=Nguyệt Vũ Tiểu Trúc trang viên
撒朗=Tát Lãng
法老王=Pháp Lão Vương
神女=Thần Nữ
奥斯丁=Áo Tư Đinh
黑暗王文泰=Hắc Ám Vương Văn Thái
迪拜法师塔=Tháp Pháp Sư Dubai
沙利叶=沙利叶
自由女神像=Tượng Nữ Thần Tự Do
北极=Bắc Cực
冷爵=Lãnh Tước
红魔=Hồng Ma
环太平洋=Vành đai Thái Bình Dương
九头蛇=Cửu Đầu Xà
东京海战场=Chiến trường biển Tokyo
耀阳游记=Diệu Dương Du Ký
琳娜=Lâm Na
美洲自由神殿=Thần điện Tự do Châu Mỹ
非洲好望角魔堡=Ma Bảo Mũi Hảo Vọng Châu Phi
罪恶法师公会=Hội Pháp sư Tội ác
独角兽=Kỳ Lân
大地之蕊=Đại Địa Chi Nhụy
圣子文泰=Thánh Tử Văn Thái
伊之纱=Y Chi Sa
教皇=Giáo Hoàng
黑龙大帝=Hắc Long Đại Đế
林氏家族=Lâm Thị Gia Tộc
苏鹿=Tô Lộc
非洲大陆=Lục địa Châu Phi
地中海=Địa Trung Hải
博城=Bác Thành
韦尔=Vi Nhĩ
圣女=Thánh Nữ
唐氏世家=Đường Thị Thế Gia
西班牙=Tây Ban Nha
渤海=Bột Hải
东海=Đông Hải
唐忠=Đường Trung
东方武=Đông Phương Võ
牧家=Mục Gia
白家=Bạch Gia
江昱=Giang Dục
赵满延=Triệu Mãn Diên
月雨小筑=Nguyệt Vũ Tiểu Trúc
黎天=Lê Thiên
林氏财阀=Lâm Thị Tài Phiệt
邵郑都=Thiệu Trịnh Đô
昆仑山脉=Côn Lôn Sơn Mạch
北方海域=Bắc Phương Hải Vực
图腾玄蛇=Đồ Đằng Huyền Xà
冷大眼=Lãnh Đại Nhãn
庞莱=Bàng Lai
冥君蛙=Minh Quân Oa
深海妖主=Thâm Hải Yêu Chủ
凛咒地狱犬=Lẫm Chú Địa Ngục Khuyển
红衣主教=Hồng Y Giáo Chủ
纽约=New York
非洲魔法协会=Hiệp Hội Pháp Thuật Châu Phi
沿海基地市=Căn Cứ Địa Ven Biển
英灵法师=Pháp Sư Anh Linh
英国维多利亚世族=Thế Tộc Victoria Anh Quốc
太平洋海洋神族=Thần Tộc Đại Dương Thái Bình Dương
东京天守阁=Thiên Thủ Các Tokyo
大阪天守阁=Lâu đài Osaka
织田彻也=Oda Tetsuya
杭城=Hàng Thành
闵萱=Mẫn Huyên
富士山=Phú Sĩ Sơn
望月名剑=Vọng Nguyệt Danh Kiếm
杭城西湖=Hàng Châu Tây Hồ
熔岩秘境=Mật Cảnh Dung Nham
西湖小筑=Tây Hồ Tiểu Trúc
非洲南部=Nam Phi
南美洲大陆=Lục địa Nam Mỹ
五大洲=Năm châu lục
猎者联盟=Liên minh Thợ săn
神殿法师=Pháp sư Thần điện
雨眠=Vũ Miên
八岐大蛇=Bát Kỳ Đại Xà
深蓝妖主=Thâm Lam Yêu Chủ
北非=Bắc Phi
南极帝王=Nam Cực Đế Vương
澳洲=Úc Châu
星海天脉=Tinh Hải Thiên Mạch
青龙=Thanh Long
东方世家=Đông Phương Thế Gia
南海海域=Vùng biển Nam Hải
妖都=Yêu Đô
南海=Nam Hải
黄海=Hoàng Hải
望月世族=Vọng Nguyệt thế tộc
岛国=Đảo quốc
穆氏=Mục Thị
帝都=Đế Đô
大连=Đại Liên
圣城=Thánh Thành
五大洲魔法协会=Hiệp hội Ma pháp Ngũ Đại Châu
帕特农神庙圣女峰=Đỉnh Thánh Nữ Đền Parthenon
鲨人=Người Cá Mập
极贝妖主=Cực Bối Yêu Chủ
蝾魔天皇=Nhung Ma Thiên Hoàng
白蛛帝=Bạch Chu Đế
澜恶龙=Lan Ác Long
黑章妖主=Hắc Chương Yêu Chủ
皇纱枯骨女王=Hoàng Sa Khô Cốt Nữ Vương
龙王蚁母=Long Vương Kiến Mẫu
冷月妖神=Lãnh Nguyệt Yêu Thần
古老王=Cổ Lão Vương
中帝=Trung Đế
黄纱枯骨女王=Hoàng Sa Khô Cốt Nữ Vương
阿莎蕊雅=A Sa Nhụy Nhã
飞鸟基地市=Phi Điểu Căn Cứ Địa Thị
穆宁雪=Mục Ninh Tuyết
凡雪山=Phàm Tuyết Sơn
包老头=Bao lão đầu
明珠学府=Minh Châu Học Phủ
萧院长=Tiêu viện trưởng
闵午=Mẫn Ngọ
魔城基地市=Ma Thành căn cứ thị
邵郑=Thiệu Trịnh
亚洲魔法协会=Hiệp hội Ma Pháp Châu Á
故宫廷=Cố Cung Đình
大连海战场=Đại Liên Hải chiến trường
华月竹=Hoa Nguyệt Trúc
炎姬=Viêm Cơ
林军首=Lâm quân thủ
朴会长=Hội trưởng Phác
李议长=Nghị trưởng Lý
小黑=Tiểu Hắc
林允熙=Lâm Duẫn Hi
唐月=Đường Nguyệt
丁雨眠=Đinh Vũ Miên
南美洲=Nam Mỹ
非洲=Châu Phi
好望角魔堡=Ảo Bảo Hảo Vọng Giác
南极圈=Vòng Nam Cực
英灵殿堂=Anh Linh Điện Đường
澳洲大陆=Lục Địa Úc
欧洲=Châu Âu
撒哈拉沙漠=Sa Mạc Sahara
亚洲=Châu Á
首尔基地市=Thủ Nhĩ Cơ Địa Thị
学府联盟=Học Phủ Liên Minh
帕特农神魂=Parthenon Thần Hồn
帕特农神女=Parthenon Thần Nữ
世家联盟=Thế Gia Liên Minh
玄蛇=Huyền Xà
天父=Thiên Phụ
煞渊=Sát Uyên
永生妖莲=Vĩnh Sinh Yêu Liên
高帝=Cao Đế
冷月眸妖神=Lãnh Nguyệt Mâu Yêu Thần
蒋少絮=Tưởng Thiếu Tự
小炎姬=Tiểu Viêm Cơ
吸血鬼妖国=Hút Máu Quỷ Yêu Quốc
黑教廷=Hắc Giáo Đình
魔城青天猎所=Ma Thành Thanh Thiên Liệp Sở
海洋神族=Hải Dương Thần Tộc
图腾=Đồ Đằng
吸血鬼博拉=Hấp Huyết Quỷ Bác Lạp
柳茹=Liễu Như
次元魔女=Thứ Nguyên Ma Nữ
耀阳城堡=Diệu Dương Thành Bảo
灵灵=Linh Linh
美洲=Châu Mỹ
太平洋=Thái Bình Dương
魔城=Ma Thành
黑暗王=Hắc Ám Vương
天守阁=Thiên Thủ Các
青天猎所=Thanh Thiên Liệp Sở
自由神殿=Điện Tự do
纽约自由女神像=Tượng Nữ thần Tự do New York
王腾=Vương Đằng
文泰=Văn Thái
南极帝=Nam Cực Đế
撒哈拉之主=Chúa Tể Sahara
莫凡=Mạc Phàm
亚伯=Á Bá
墨西哥城=Thành phố Mexico
耀阳城=Diệu Dương Thành
海洋帝王=Hải Dương Đế Vương
澳洲魔法协会=Hiệp hội Pháp thuật Úc
冷青=Lãnh Thanh
帕特农神庙=Đền Parthenon
心夏=Tâm Hạ
海隆=Hải Long
华军首=Hoa Quân Thủ
望月千熏=Vọng Nguyệt Thiên Huân
自由神像=Tượng Nữ thần Tự do
美洲魔法协会=Hiệp hội Pháp thuật Châu Mỹ
诸界之深渊恶魔=Chư Giới Chi Thâm Uyên Ác Ma
为所欲为者=Vi Sở Dục Vi Giả
黑市城=Hắc Thị Thành
白鸦镇=Bạch Nha Trấn
冯书云=Phùng Thư Vân
冯长老=Phùng trưởng lão
李主管=Lý chủ quản
吴胜96=Ngô Thắng 96
蛮牛劲=Man Ngưu Kình
虎骨壮体功——锻骨篇=Hổ Cốt Tráng Thể Công - Đoán Cốt Thiên
虎骨壮体功——炼体篇=Hổ Cốt Tráng Thể Công - Luyện Thể Thiên
基础身法=Thân pháp cơ sở
八极拳=Bát Cực Quyền
太极拳=Thái Cực Quyền
五行拳=Ngũ Hành Quyền
通背拳=Thông Bối Quyền
基础拳法=Cơ Sở Quyền Pháp
意志=Ý chí
自我意志=Tự ngã ý chí
帝释天=Đế Thích Thiên
武无敌=Võ Vô Địch
绿伞菇=Nấm dù xanh
绿纹蝰蛇=Lục Văn Xà
文长裕=Văn Trường Dụ
追风化雨剑=Truy Phong Hóa Vũ Kiếm
月影无声刀=Nguyệt Ảnh Vô Thanh Đao
残影螺旋步=Tàn Ảnh Loa Toàn Bộ
六合指=Lục Hợp Chỉ
内视能力=Nội Thị Năng Lực
胡为=Hồ Vi
大夏=Đại Hạ
殷商=Ân Thương
大周=Đại Chu
段启东=Đoạn Khải Đông
行云流水拳=Hành Vân Lưu Thủy Quyền
炼体篇=Luyện Thể Thiên
锻骨篇=Đoán Cốt Thiên
壮血篇=Tráng Huyết Thiên
强脏篇=Cường Tạng Thiên
纳源篇=Nạp Nguyên Thiên
蕴神篇=Uẩn Thần Thiên
罗田=La Điền
张成=Trương Thành
黑石城朱家=Chu gia Hắc Thạch Thành
江武=Giang Vũ
李长老=Lý trưởng lão
气血=Khí Huyết
基本剑术=Cơ Bản Kiếm Thuật
成山镇=Thành Sơn Trấn
朱启成=Chu Khải Thành
高培山=Cao Bồi Sơn
下品基础功法=Hạ phẩm cơ sở công pháp
中品基础功法=Trung phẩm cơ sở công pháp
上品基础功法=Thượng phẩm cơ sở công pháp
养气境下品功法=Dưỡng khí cảnh hạ phẩm công pháp
晶币=Tinh tệ
下品晶币=Hạ phẩm tinh tệ
白鸦山=Bạch Nha Sơn
赵老师=Triệu lão sư
黑落山=Hắc Lạc Sơn
祖涛=Tổ Đào
赵元瑜=Triệu Nguyên Du
冲天大将军=Xung Thiên Đại Tướng Quân
紫血人参=Tử Huyết Nhân Sâm
养气篇=Dưỡng Khí Thiên
赵家杂货铺=Cửa hàng tạp hóa Triệu Gia
孙队长=Đội trưởng Tôn
黄记药铺=Hoàng Ký Dược Phố
黄云楼=Hoàng Vân Lâu
小越=Tiểu Việt
城奇=Thành Kỳ
车显伟=Xa Hiển Vĩ
强脏境修行者=Cường Tạng Cảnh Tu Hành Giả
白鹿州=Bạch Lộc Châu
张老三=Trương Lão Tam
雪鹿州降妖司=Tuyết Lộc Châu Hàng Yêu Tư
副司长=Phó Tư Trưởng
南湖帮少帮主=Thiếu Bang Chủ Nam Hồ Bang
雪鹿州人杰榜=Tuyết Lộc Châu Nhân Kiệt Bảng
水中雪叶=Thủy Trung Tuyết Diệp
南湖帮=Nam Hồ Bang
张镇长=Trương trấn trưởng
陈将军=Trần tướng quân
罗家=La gia
孙家=Tôn gia
飞燕回旋步=Phi Yến Hồi Toàn Bộ
黄掌柜=Hoàng Chưởng Quỹ
燕林德=Yến Lâm Đức
王坚=Vương Kiên
黑月雪纹铁=Hắc Nguyệt Tuyết Văn Thiết
火毒溶液=Hỏa Độc Dung Dịch
白雾国悬赏所=Bạch Vụ Quốc Huyền Thưởng Sở
黄云酒楼=Hoàng Vân tửu lâu
李云尘=Lý Vân Trần
总报=Tổng Báo
蒋家=Tưởng Gia
张堂=Trương Đường
蒋家老祖=Tưởng Gia Lão Tổ
陈立=Trần Lập
太霞镇=Thái Hà Trấn
李光=Lý Quang
排榜人=Bài Bảng Nhân
见闻报——雪鹿州.州报=Kiến Văn Báo - Tuyết Lộc Châu. Châu Báo
张少侠=Trương Thiếu Hiệp
陈添=Trần Thiêm
云岭州人杰榜=Bảng Anh Kiệt Vân Lĩnh Châu
风属性真气=Chân Khí Thuộc Tính Phong
养气境修行者=Người Tu Hành Dưỡng Khí Cảnh
基础剑法=Cơ Sở Kiếm Pháp
张家=Trương gia
张耀=Trương Diệu
会林城区域=Khu vực Hội Lâm Thành
李召=Lý Triệu
司长=Tư Trưởng
赵长老=Triệu trưởng lão
王长老=Vương trưởng lão
大司长=Đại Tư Trưởng
降妖司=Hàng Yêu Tư
除魔司=Trừ Ma Tư
黄沙镇=Hoàng Sa Trấn
龙峰城——城防军——左城门偏将=Long Phong Thành - Thành phòng quân - Tả thành môn thiên tướng
会林城=Hội Lâm Thành
报亭=Báo Đình
梦蝶州=Mộng Điệp Châu
长云宗=Trường Vân Tông
潜影司=Tiềm Ảnh Tư
石田森林=Thạch Điền Sâm Lâm
上品晶币=Thượng Phẩm Tinh Tệ
兴少爷=Hưng thiếu gia
狂流风域=Cuồng Lưu Phong Vực
孔嘉麟=Khổng Gia Lân
李管事=Lý quản sự
成家=Thành gia
成行端=Thành Hành Đoan
中央比武场=Trung Ương Tỉ Võ Tràng
江家=Giang gia
黑血殿=Hắc Huyết Điện
云岭州——人杰榜——第十二位=Vân Lĩnh Châu - Nhân Kiệt Bảng - Vị trí thứ 12
塔灵=Tháp Linh
珍宝阁=Trân Bảo Các
罗望=La Vọng
张越=Trương Việt
玄宝阁=Huyền Bảo Các
戴汝龄=Đới Nhữ Linh
罡云铁=Cương Vân Thiết
精金=Tinh Kim
丁端智=Đinh Đoan Trí
极品晶币=Cực Phẩm Tinh Tệ
蕴神境功法=Uẩn Thần Cảnh Công Pháp
燃血秘法=Nhiên Huyết Bí Pháp
疾风快剑=Tật Phong Khoái Kiếm
张天让=Trương Thiên Nhượng
成书德=Thành Thư Đức
喻金亮=Dụ Kim Lượng
杨腾=Dương Đằng
赵无路=Triệu Vô Lộ
陈腾=Trần Đằng
莫桑比克拳法=Quyền pháp Mozambique
中央演武场=Trung Ương Diễn Võ Trường
单慧娴=Đan Tuệ Nhàn
孙庭=Tôn Đình
项之栋=Hạng Chi Đống
王庭=Vương Đình
地底秘库=Địa Để Bí Khố
苍云湖=Thương Vân Hồ
目击之术=Mục Kích Chi Thuật
大宫主=Đại Cung Chủ
神识留影令牌=Thần Thức Lưu Ảnh Bài Lệnh
留影石=Lưu Ảnh Thạch
苍湖白流宫——第十九代大宫主=Thương Hồ Bạch Lưu Cung - Đại cung chủ đời thứ mười chín
见闻报——云岭州.州报=Kiến Văn Báo - Vân Lĩnh Châu. Châu Báo
玄风流云体=Huyền Phong Lưu Vân Thể
传影玉佩=Truyền Ảnh Ngọc Bội
明意境修行法=Minh Ý Cảnh Tu Hành Pháp
蕴神境修行法=Uẩn Thần Cảnh Tu Hành Pháp
苍湖白流宫最终遗产=Di sản cuối cùng của Thương Hồ Bạch Lưu Cung
左周=Tả Chu
左致恩=Tả Trí Ân
苍湖白流宫遗民=Thương Hồ Bạch Lưu Cung di dân
孔行感=Khổng Hành Cảm
神意=Thần Ý
聚气阶段=Tụ Khí Giai Đoạn
谷蓝城=Cốc Lam Thành
左家=Tả Gia
赵山=Triệu Sơn
虎骨壮体功=Hổ Cốt Tráng Thể Công
戚行检=Thích Hành Kiểm
凌正飞=Lăng Chính Phi
裴治宗=Bùi Trị Tông
五茶镇=Ngũ Trà Trấn
大润发=Đại Nhuận Phát
苗家宅院=Trạch viện Miêu gia
苗段弘=Miêu Đoạn Hoằng
炙浪烈火剑=Sí Lãng Liệt Hỏa Kiếm
五行转龙剑=Ngũ Hành Chuyển Long Kiếm
极意=Cực Ý
黄家=Hoàng gia
苗家=Miêu gia
自我再生力=Tự Ngã Tái Sinh Lực
环境适应性=Hoàn Cảnh Thích Ứng Tính
朱家=Chu gia
大西王=Đại Tây Vương
冲天将军=Xung Thiên Tướng Quân
阵法=Trận Pháp
阵法院=Trận Pháp Viện
地脉院=Địa Mạch Viện
书画院=Thư Họa Viện
占卜院=Chiêm Bốc Viện
食补院=Thực Bổ Viện
苗忠=Miêu Trung
苍湖白流宫遗产=Di sản Thương Hồ Bạch Lưu Cung
州报=Châu Báo
国报=Quốc Báo
潘金莲=Phan Kim Liên
关羽=Quan Vũ
人杰榜——国榜=Nhân Kiệt Bảng - Quốc Bảng
妖核=Yêu Hạch
炼丹师=Luyện Đan Sư
行军丹=Hành Quân Đan
苏锦雯=Tô Cẩm Văn
符装=Phù Trang
三体人=Tam Thể Nhân
唯我涛哥=Duy Ngã Đào Ca
莲儿=Liên Nhi
合欢宗=Hợp Hoan Tông
雪月云天阁旗帜=Cờ Tuyết Nguyệt Vân Thiên Các
游文书塔=Du Văn Thư Tháp
船灵=Thuyền Linh
雪鹿州——州牧=Tuyết Lộc Châu - Châu Mục
阁主大人=Các chủ đại nhân
雪月云天阁国都驻地=Tuyết Nguyệt Vân Thiên Các Quốc Đô Trú Địa
阁主宝座=Ngôi vị Các chủ
南雾国=Nam Vụ Quốc
国都护城大阵=Quốc Đô Hộ Thành Đại Trận
修行=Tu Hành
修行院管事长老=Tu Hành Viện Quản Sự Trưởng Lão
炼器大师=Luyện Khí Đại Sư
阵法结界大师=Trận Pháp Kết Giới Đại Sư
现任主事长老=Hiện nhậm chủ sự trưởng lão
明意境巅峰=Minh Ý Cảnh đỉnh phong
张长老=Trương trưởng lão
主事长老=Chủ Sự Trưởng Lão
张某=Trương mỗ
南宫家=Nam Cung Gia
国榜=Quốc Bảng
白雾国国都=Bạch Vụ Quốc Quốc Đô
国都=Quốc Đô
白雾国皇宫=Bạch Vụ Quốc Hoàng Cung
苍湖白流宫传承=Thừa Kế Thương Hồ Bạch Lưu Cung
赤火匪=Xích Hỏa Phỉ
寒月宫=Hàn Nguyệt Cung
火金国=Hỏa Kim Quốc
徐淑仪=Từ Thục Nghi
南宫云=Nam Cung Vân
墨玉国=Mặc Ngọc Quốc
丹阳国=Đan Dương Quốc
会主=Hội Chủ
青松府=Thanh Tùng Phủ
金翼会=Kim Dực Hội
南宫家族=Nam Cung Gia Tộc
明意境极品修行法——天罡白流金身=Minh Ý Cảnh Cực Phẩm Tu Hành Pháp - Thiên Cương Bạch Lưu Kim Thân
张文涛=Trương Văn Đào
韩忠波=Hàn Trung Ba
南宫木=Nam Cung Mộc
苏虎=Tô Hổ
猛鹫城=Mãnh Thứu Thành
蒲南国=Bồ Nam Quốc
轻风白流体=Khinh Phong Bạch Lưu Thể
松涛国=Tùng Đào Quốc
萧广孝=Tiêu Quảng Hiếu
傅丕绪=Phó Phi Tự
白雾国四皇子=Tứ hoàng tử Bạch Vụ Quốc
白雾国—人杰榜—第一位=Bạch Vụ Quốc - Nhân Kiệt Bảng - Vị trí thứ nhất
白雾国——人杰榜=Bạch Vụ Quốc - Nhân Kiệt Bảng
四皇子=Tứ hoàng tử
分部长职位=Phân bộ trưởng chức vị
牧峰镇=Trấn Mục Phong
白雾国当期见闻报=Bạch Vụ Quốc Đương Kỳ Kiến Văn Báo
真正意义上的同辈无敌者！？=Người vô địch thực sự trong thế hệ!?
虹雾城=Hồng Vụ Thành
孙远生=Tôn Viễn Sinh
南旺国=Nam Vượng Quốc
兰彦海=Lan Ngạn Hải
姜文举=Khương Văn Cử
白雾国分部=Chi nhánh Bạch Vụ Quốc
见闻报——总部=Kiến Văn Báo - Trụ Sở Chính
见闻报分部=Chi nhánh Kiến Văn Báo
国家=Quốc Gia
艳莲=Diễm Liên
仙兰=Tiên Lan
婧姝=Tịnh Xu
花雨织云纺=Hoa Vũ Chức Vân Phưởng
花雨织云宗=Hoa Vũ Chức Vân Tông
炼丹=Luyện Đan
炼器=Luyện Khí
傀儡=Khôi Lỗi
金刚白流体=Kim Cương Bạch Lưu Thể
皇朝之主=Hoàng Triều chi chủ
人杰榜成员=Nhân Kiệt Bảng thành viên
培昌=Bồi Xương
聂培昌=Nhiếp Bồi Xương
赤林皇朝=Xích Lâm hoàng triều
聂庆道=Nhiếp Khánh Đạo
伊嫚=Y Man
管事长老=Quản Sự Trưởng Lão
炼丹大师=Luyện Đan Đại Sư
傀儡大师=Khôi Lỗi Đại Sư
占卜大师=Chiêm Bốc Đại Sư
易成凌=Dịch Thành Lăng
宗主=Tông Chủ
秘境时空=Bí Cảnh Thời Không
现实时空=Hiện Thực Thời Không
彩虹连环屁=Cầu Vồng Liên Hoàn Pí
御兽秘术=Ngự Thú Bí Thuật
龙兽=Long thú
六师妹=Lục Sư Muội
白雾国人杰榜=Bảng Anh Hùng Bạch Vụ Quốc
傀儡院=Khôi Lỗi Viện
土著异类文明=Văn Minh Dị Loại Bản Địa
心灵秘术=Tâm Linh Bí Thuật
托恩=Tuo Ân
基因层面=Cấp độ gen
心灵层面=Cấp độ tâm linh
可遗传性思想钢印=Dấu ấn tư tưởng di truyền
记忆掠夺之种=Hạt giống cướp đoạt ký ức
九头虫=Cửu Đầu Trùng
奔波儿灞=Bôn Ba Nhi Bá
孙悟空=Tôn Ngộ Không
驯兽院=Thuần Thú Viện
修行院=Tu Hành Viện
福格.科特塞.尤利=Fogg. Kotse. Yuli
权限等级临时上调=Điều Chỉnh Tạm Thời Cấp Bậc Quyền Hạn
紧急事态应急方案=Phương Án Ứng Phó Tình Huống Khẩn Cấp
水雾幻蝶=Thủy Vụ Huyễn Điệp
星球中央控制室=Tinh Cầu Trung Ương Khống Chế Thất
明意级=Minh Ý cấp
某某王爷=Mỗ Mỗ Vương Gia
托恩人=Thoen Nhân
修行者文明=Tu Hành Giả Văn Minh
致命节奏=Trí Mệnh Tiết Tấu
福格=Phúc Cách
天变=Thiên Biến
渡域符文=Độ Vực Phù Văn
请假条=Đơn xin nghỉ phép
次级权限=Thứ Cấp Quyền Hạn
石源国=Thạch Nguyên Quốc
太阴=Thái Âm
太阳=Thái Dương
藏书阁=Tàng Thư Các
完颜绣瑾=Hoàn Nhan Tú Cẩn
雾海森林=Vụ Hải Sâm Lâm
东乌尘州=Đông Ô Trần Châu
南乌尘州=Nam Ô Trần Châu
乌尘=Ô Trần
血锋城=Huyết Phong Thành
白雾国各年代大事记=Bạch Vụ Quốc các niên đại đại sự ký
乌尘州的起源=Ô Trần Châu đích khởi nguyên
血锋城之祸=Huyết Phong Thành chi họa
地底凶兽种类目录=Địa Để hung thú chủng loại mục lục
地底遗毒的清理手段=Địa Để di độc đích thanh lý thủ đoạn
地底食材处理指南=Địa Để thực tài xử lý chỉ nam
地底凶兽杂交实验记录=Địa Để hung thú tạp giao thực nghiệm ký lục
死妈的血锋城=Tử má đích Huyết Phong Thành
经典采矿事故案例=Kinh điển thải khoáng sự cố án lệ
安兴国=An Hưng Quốc
慧剑会=Tuệ Kiếm Hội
黑鳞蝠兽=Hắc Lân Bức Thú
北乌尘州=Bắc Ô Trần Châu
镇北城=Trấn Bắc Thành
易希舟=Dịch Hy Chu
西乌尘州=Tây Ô Trần Châu
铁凉国=Thiết Lương Quốc
镇南城=Trấn Nam Thành
望鲸国=Vọng Kình Quốc
远流国=Viễn Lưu Quốc
刻海国=Khắc Hải Quốc
蓝舟国=Lam Chu Quốc
海花国=Hải Hoa Quốc
乌尘州=Ô Trần Châu
炼器院=Luyện Khí Viện
雪鹿州=Tuyết Lộc Châu
岳朝翰=Nhạc Triều Hàn
岳淑芸=Nhạc Thục Vân
启灵仪式=Khải Linh Nghi Thức
金峰皇朝=Kim Phong hoàng triều
玉夜楼船=Ngọc Dạ Lâu Thuyền
现任阁主=Hiện Nhậm Các Chủ
岳博方=Nhạc Bác Phương
玄木皇朝=Huyền Mộc Hoàng Triều
岳修铭=Nhạc Tu Minh
岳修然=Nhạc Tu Nhiên
喻齐卿=Dụ Tề Khanh
朝离国=Triều Ly Quốc
巨岩国=Cự Nham Quốc
笑莲国=Tiếu Liên Quốc
碧芙国=Bích Phù Quốc
金樽国=Kim Tôn Quốc
白雾国国主=Quốc chủ Bạch Vụ Quốc
易光瑞=Dịch Quang Thụy
海洋异族联军=Hải Dương Dị Tộc Liên Quân
太师叔=Thái sư thúc
青幽玄重光=Thanh U Huyền Trọng Quang
伯伊=Bá Y
海族=Hải tộc
岳以龙=Nhạc Dĩ Long
安湾海族=Hải tộc An Loan
张管事=Trương quản sự
李队长=Đội trưởng Lý
东域=Đông Vực
西域=Tây Vực
中域=Trung Vực
锻体境=Đoán Thể Cảnh
纳源境修行者=Nạp Nguyên cảnh tu hành giả
郑仲诚=Trịnh Trọng Thành
州级分部=Châu Cấp Phân Bộ
国级分部=Quốc Cấp Phân Bộ
国家级分部=Quốc Gia Cấp Phân Bộ
文章编撰者=Người biên soạn văn chương
中央域=Trung Ương Vực
老陈=Lão Trần
黑相皇朝=Hắc Tướng Hoàng Triều
闻影阁=Văn Ảnh Các
耀武军=Diệu Võ Quân
神通境宝物=Thần Thông Cảnh Bảo Vật
自我恢复力=Tự Ngã Khôi Phục Lực
环境适应力=Hoàn Cảnh Thích Ứng Lực
豺狼虎豹铸体功=Sài Lang Hổ Báo Chú Thể Công
铁像锻体功=Thiết Tượng Đoán Thể Công
华岩城=Hoa Nham Thành
孙破云=Tôn Phá Vân
郑赛娟=Trịnh Tái Quyên
旧尘国国都=Cựu Trần Quốc Quốc Đô
第十一级临时权限=Đệ Thập Nhất Cấp Tạm Thời Quyền Hạn
第十级临时权限=Đệ Thập Cấp Tạm Thời Quyền Hạn
区域级临时管理权限=Khu Vực Cấp Tạm Thời Quản Lý Quyền Hạn
云鹤=Vân Hạc
照岳国=Chiếu Nhạc Quốc
江顺国=Giang Thuận Quốc
流云谷=Lưu Vân Cốc
风鹰城=Phong Ưng Thành
碧月会=Bích Nguyệt Hội
蓝蛇会=Lam Xà Hội
青云州=Thanh Vân Châu
戚振豪=Thích Chấn Hào
茶香鹅楼=Trà Hương Nga Lâu
纳源境符装=Nạp Nguyên Cảnh Phù Trang
玄空万象戒=Huyền Không Vạn Tượng Giới
千毒蚀骨手=Thiên Độc Thực Cốt Thủ
食毒炼血功=Thực Độc Luyện Huyết Công
万毒锻体诀=Vạn Độc Đoán Thể Quyết
申云青=Thân Vân Thanh
旧尘国=Cựu Trần Quốc
蕴神境修行者=Uẩn Thần Cảnh tu hành giả
游云宝阁=Du Vân Bảo Các
噬魂怨念焰=Phệ Hồn Oán Niệm Diễm
伊家=Y Gia
滕生虎=Đằng Sinh Hổ
《唯我道》=《Duy Ngã Đạo》
宗主国=Tông chủ quốc
宋杰=Tống Kiệt
黄叶州事件=Sự kiện Hoàng Diệp Châu
赤血鬼宗=Xích Huyết Quỷ Tông
黄叶州=Hoàng Diệp Châu
金岚大陆讨海洋异族联军=Kim Lam Đại Lục Thảo Hải Dương Dị Tộc Liên Quân
第六感=Lục Giác Quan
宋长老=Tống trưởng lão
观宇星罗盘=Quan Vũ tinh la bàn
明意境地底凶兽=Quái thú dưới lòng đất Minh Ý Cảnh
逐枫皇朝——灵隐司=Trục Phong Hoàng Triều - Linh Ẩn Tư
马其诺防线=Phòng tuyến Maginot
灵隐司=Linh Ẩn Tư
听风望星阁=Thính Phong Vọng Tinh Các
神念阶段=Thần Niệm Giai Đoạn
楚迎蕾=Sở Nghênh Lôi
殷飞雪=Ân Phi Tuyết
晋级=Tấn cấp
华历舒=Hoa Lịch Thư
海族心域境=Hải Tộc Tâm Vực Cảnh
诸国通告栏=Chư Quốc Thông Cáo Lan
灵魂坐标=Tọa độ Linh hồn
本相境符文武器=Bản Tướng Cảnh Phù Văn Vũ Khí
千龙出海剑=Thiên Long Xuất Hải Kiếm
千烟锁=Thiên Yên Tỏa
第684章=Chương 684
霜骨冻魂风=Sương Cốt Đống Hồn Phong
神速最优化=Thần Tốc Tối Ưu Hóa
爱因斯坦=Albert Einstein
托恩文明遗产=Di sản Văn minh Thác Ân
伊云鹤=Y Vân Hạc
旧尘国遗土=Cựu Trần Quốc Di Thổ
妖罗树海=Yêu La Thụ Hải
本相境妖兽=Bản Tướng Cảnh Yêu Thú
地底凶兽=Địa Để Hung Thú
神通境妖兽=Thần Thông Cảnh Yêu Thú
地底凶兽潮=Địa Để Hung Thú Triều
本部=Bản Bộ
细胞意志力场=Tế bào ý chí lực tràng
心灵类神通=Tâm linh loại thần thông
灭魂阶段=Diệt Hồn giai đoạn
依嫚=Y Mạn
康星城=Khang Tinh Thành
康万树=Khang Vạn Thụ
白鼎寒=Bạch Đỉnh Hàn
逐枫皇朝皇室=Trục Phong Hoàng Triều Hoàng Thất
大陆传送阵=Đại Lục Truyền Tống Trận
雪月云天阁——本部=Tuyết Nguyệt Vân Thiên Các - Bản bộ
朱丹凤=Chu Đan Phượng
灰雾印记=Hôi Vụ Ấn Ký
苑前辈=Uyển tiền bối
慕容妍=Mộ Dung Nghiên
水烟银海=Thủy Yên Ngân Hải
冰雾雪岛=Băng Vụ Tuyết Đảo
本章完=Hết chương này
康苍岚=Khang Thương Lam
闻影楼楼主=Lâu chủ Văn Ảnh Lâu
邓永=Đặng Vĩnh
唐树诚=Đường Thụ Thành
当代楼主=Đương đại Lâu chủ
锦萱=Cẩm Huyên
阳正宇=Dương Chính Vũ
侯锦萱=Hầu Cẩm Huyên
现任楼主=Hiện Nhậm Lâu Chủ
太上长老=Thái thượng trưởng lão
藏问国=Tàng Vấn Quốc
池天佑=Trì Thiên Hữu
逐枫皇朝=Trục Phong Hoàng Triều
庞启辰=Bàng Khải Thần
狄子轩=Địch Tử Hiên
风鹰皇朝=Phong Ưng Hoàng Triều
玄金铸体剂=Huyền Kim Chú Thể Tề
炼丹院=Luyện Đan Viện
星象院=Tinh Tượng Viện
苍湖白流宫藏宝图=Tàng bảo đồ Thương Hồ Bạch Lưu Cung
相境=Tướng Cảnh
索岚山脉=Tác Lan Sơn Mạch
国主=Quốc chủ
建水城=Kiến Thủy Thành
游宽宏=Du Khoan Hoành
炼体四境=Luyện Thể Tứ Cảnh
真气=Chân khí
真元=Chân nguyên
秘境——龙兽海岭=Bí Cảnh - Long Thú Hải Lĩnh
天赋神通——无间神速=Thiên Phú Thần Thông - Vô Gian Thần Tốc
古代遗迹=Di Tích Cổ Đại
目之所及=Mục Chi Sở Cập
本相=Bản Tướng
神通=Thần Thông
本相境修行者=Bản Tướng Cảnh Tu Hành Giả
六9书吧=Lục 9 Thư Ba
杭州西湖=Hàng Châu Tây Hồ
魏彦辰=Ngụy Ngạn Thần
仲云轩=Trọng Vân Hiên
闻影楼=Văn Ảnh Lâu
楼主=Lâu chủ
屈逸尘=Khuất Dật Trần
灵魂道标=Linh hồn Đạo tiêu
孵化控制塔=Phụ hóa Khống chế Tháp
托恩文明=Thoan Văn Minh
生物兵器制造基地=Sinh vật Binh khí Chế tạo Căn cứ
天星金石=Thiên Tinh Kim Thạch
颜绣瑾=Nhan Tú Cẩn
阁主=Các chủ
黑石城=Hắc Thạch Thành
洞虚境修行者=Động Hư Cảnh Tu Hành Giả
武艳莲=Võ Diễm Liên
姚月嫣=Diêu Nguyệt Yên
白婧姝=Bạch Tịnh Xu
龙峰城=Long Phong Thành
州城=Châu Thành
人杰榜=Nhân Kiệt Bảng
扰灵阶段=Nhiễu Linh Giai Đoạn
席仙兰=Tịch Tiên Lan
蕴神境=Uẩn Thần Cảnh
御前大比=Ngự Tiền Đại Tỉ
心域境修行者=Tâm Vực Cảnh Tu Hành Giả
傅长老=Phó trưởng lão
苏阁主=Tô Các chủ
云岭州=Vân Lĩnh Châu
白雾国皇室=Hoàng thất Bạch Vụ Quốc
玉夜雪城=Ngọc Dạ Tuyết Thành
无间神速=Vô Gian Thần Tốc
死兆降劫=Tử Triệu Giáng Kiếp
无漏之圆=Vô Lậu Chi Viên
佩素霞=Bội Tố Hà
江形=Giang Hình
明意境修行者=Minh Ý Cảnh tu hành giả
皇城=Hoàng Thành
易光祥=Dịch Quang Tường
官向非=Quan Hướng Phi
雪月云天阁总部=Tổng bộ Tuyết Nguyệt Vân Thiên Các
明意境=Minh Ý Cảnh
天赋神通=Thiên Phú Thần Thông
心域境=Tâm Vực Cảnh
傅梦雪=Phó Mộng Tuyết
无怨=Vô Oán
虞珺=Ngu Quân
本相境=Bản Tướng Cảnh
帮主=Bang chủ
炼体四境——壮血境=Luyện Thể Tứ Cảnh - Tráng Huyết Cảnh
养气境=Dưỡng Khí Cảnh
神通境修行者=Thần Thông Cảnh tu hành giả
炼体境=Luyện Thể Cảnh
锻骨境=Đoán Cốt Cảnh
壮血境=Tráng Huyết Cảnh
强脏境=Cường Tạng Cảnh
黑落山矿山营寨=Hắc Lạc Sơn quặng mỏ doanh trại
穿云帮=Xuyên Vân Bang
裴家=Bùi Gia
龙兽海岭=Long Thú Hải Lĩnh
移动古代遗迹=Di Động Cổ Đại Di Tích
白鸦帮=Bạch Nha Bang
见闻报=Kiến Văn Báo
阳罗=Dương La
阳祖涛=Dương Tổ Đào
玉夜雪山=Ngọc Dạ Tuyết Sơn
洞虚境=Động Hư Cảnh
地底世界=Địa Để Thế Giới
纳源境=Nạp Nguyên Cảnh
神通境=Thần Thông Cảnh
明意境修行法——天罡白流金身=Minh Ý Cảnh Tu Hành Pháp - Thiên Cương Bạch Lưu Kim Thân
苑虞珺=Uyển Ngu Quân
新岭国=Tân Lĩnh Quốc
辰月州=Thần Nguyệt Châu
山岚城=Sơn Lam Thành
枯山镇=Khô Sơn Trấn
殷枕书=Ân Chẩm Thư
天罡白流金身=Thiên Cương Bạch Lưu Kim Thân
苍湖白流宫=Thương Hồ Bạch Lưu Cung
白雾国=Bạch Vụ Quốc
南域=Nam Vực
北域=Bắc Vực
裴伊嫚=Bùi Y Mạn
唯我道=Duy Ngã Đạo
雪月云天阁=Tuyết Nguyệt Vân Thiên Các
冰蚀寒舟=Băng Thực Hàn Chu
金岚大陆=Kim Lam Đại Lục
苏清月=Tô Thanh Nguyệt
令无怨=Lệnh Vô Oán
天命洪流=Thiên Mệnh Hồng Lưu
