伯公庙=Miếu Bá Công
菩萨=Bồ Tát
糜花鹿=My Hoa Lộc
四合村=Tứ Hợp thôn
项羽=Hạng Vũ
安仁坊=An Nhân phường
长兴坊=Trường Hưng phường
宋二小姐=Tống nhị tiểu thư
永宁坊=Phường Vĩnh Ninh
铁手帮=Thiết Thủ Bang
搬山门=Bàn Sơn Môn
异血=Dị Huyết
易筋=Dịch Cân
锻骨=Đoán Cốt
单臂擎天=Đan Tí Kình Thiên
钟素=Chung Tố
上阳城主=Thượng Dương Thành chủ
虎面鱼肉=Thịt cá mặt hổ
椒仔肉=Thịt tiêu tử
李红素=Lý Hồng Tố
何三喜=Hà Tam Hỉ
朱仙镇=Chu Tiên trấn
王志=Vương Chí
黄谷村=Hoàng Cốc thôn
赵人熊=Triệu Nhân Hùng
孙山=Tôn Sơn
连环穿心脚=Liên Hoàn Xuyên Tâm Cước
悦来客栈=Khách sạn Duyệt Lai
于二娘=Vu Nhị Nương
九曲十弯八尽头=Cửu Khúc Thập Loan Bát Tẫn Đầu
东龙西凤南虎北豹=Đông Long Tây Phượng Nam Hổ Bắc Báo
小燕子=Tiểu Yến Tử
段三=Đoạn Tam
蛇形刁手=Xà Hình Điêu Thủ
聚味阁=Tụ Vị Các
刘大厨=Lưu Đại Trù
曾少安=Tằng Thiếu An
黄富贵=Hoàng Phú Quý
王老虎=Vương Lão Hổ
严江=Nghiêm Giang
苏少久=Tô Thiếu Cửu
萧岿=Tiêu Khôi
徐威=Từ Uy
白眉鹰侠=Bạch Mi Ưng Hiệp
东龙西凤北豹=Đông Long Tây Phượng Bắc Báo
十三太保=Thập Tam Thái Bảo
土地公=Thổ Địa Công
梧桐巷=Ngô Đồng Hạng
徐伯=Từ Bá
南虎=Nam Hổ
朱春宝=Chu Xuân Bảo
北豹=Bắc Báo
蛇骨剑=Xà Cốt Kiếm
黑水玄蛇=Hắc Thủy Huyền Xà
刁蛇功=Điêu Xà Công
升平坊=Thăng Bình phường
海府=Hải phủ
西凤=Tây Phượng
海焕光=Hải Hoán Quang
赵人杰=Triệu Nhân Kiệt
荣然=Vinh Nhiên
陈通=Trần Thông
高冠=Cao Quan
李玉成=Lý Ngọc Thành
周松=Chu Tùng
林康=Lâm Khang
天香=Thiên Hương
素英=Tố Anh
映蓉=Ánh Dung
泰塔尼克号=Titanic
杰克=Jack
露丝=Rose
林肖=Lâm Tiêu
降香=Giáng hương
安息香=An tức hương
橙花=Hoa cam
丁香=Đinh hương
蔷薇=Tường vi
茉莉=Mạt lị
庞全安=Bàng Toàn An
王巧巧=Vương Xảo Xảo
狼骨帮=Lang Cốt Bang
百拳会=Bách Quyền Hội
碎骨帮=Toái Cốt Bang
寒鹰帮=Hàn Ưng Bang
太郎帮=Thái Lang Bang
杜十三=Đỗ Thập Tam
清乐坊=Thanh Nhạc Phường
上阳=Thượng Dương
赫连=Hách Liên
流苏坊=Lưu Tô Phường
江家=Giang gia
江达聪=Giang Đạt Thông
江景山=Giang Cảnh Sơn
江景行=Giang Cảnh Hành
黄立峰=Hoàng Lập Phong
马主簿=Mã Chủ Bạ
田大泽=Điền Đại Trạch
残影盗=Tàn Ảnh Đạo
晏家=Yến Gia
江老太爷=Giang lão thái gia
元敬=Nguyên Kính
关宗才=Quan Tông Tài
江府一案=Vụ án Giang phủ
李阔=Lý Khoát
魏秀芝=Ngụy Tú Chi
三岔口=Tam Xá Khẩu
小娄巷=Tiểu Lâu Hạng
夜叉=Dạ Xoa
鲁迅=Lỗ Tấn
八尺宣花板斧=Bát Xích Tuyên Hoa Bản Phủ
夜魈=Dạ Tiêu
铜川街=Đồng Xuyên Nhai
五绝斧法=Ngũ Tuyệt Phủ Pháp
春香楼=Xuân Hương lâu
夏荷院=Hạ Hà viện
秋风阁=Thu Phong các
冬暖轩=Đông Noãn hiên
金盆赌坊=Kim Bồn đổ phường
银山赌坊=Ngân Sơn đổ phường
老书斋=Lão thư trai
齐星河=Tề Tinh Hà
莫无言=Mạc Vô Ngôn
李棋师=Lý Kỳ Sư
行万里见闻录=Hành Vạn Lý Kiến Văn Lục
冷霜掌=Lãnh Sương Chưởng
寒鸦=Hàn Nha
静坐经=Tĩnh Tọa Kinh
苦行记=Khổ Hành Ký
美人游=Mỹ Nhân Du
卷气书斋=Quyển Khí Thư Trai
土地庙=Thổ Địa Miếu
铜川=Đồng Xuyên
暗香虫=Ám Hương Trùng
铜石街=Đồng Thạch Nhai
李氏=Lý Thị
上阳焌=Thượng Dương Tuấn
上阳久=Thượng Dương Cửu
上阳芸=Thượng Dương Vân
如意书斋=Như Ý Thư Trai
妙华=Diệu Hoa
于寿先=Vu Thọ Tiên
寒冰刀=Hàn Băng Đao
曹之达=Tào Chi Đạt
赵宗胜=Triệu Tông Thắng
猎园=Liệp Viên
小五=Tiểu Ngũ
甲区=Giáp Khu
岭南=Lĩnh Nam
池家=Trì Gia
上阳潮=Thượng Dương Triều
净心白莲露=Tịnh Tâm Bạch Liên Lộ
古明真=Cổ Minh Chân
金虎客栈=Kim Hổ Khách Sạn
四方客栈=Tứ Phương Khách Sạn
镜湖=Kính Hồ
三岔口驿站=Tam Xá Khẩu Dịch Trạm
云姥=Vân Mụ
祁连=Kỳ Liên
宋锦成=Tống Cẩm Thành
宋府=Tống Phủ
紫云阁=Tử Vân Các
柳茹=Liễu Như
黑斑肉=Hắc Ban nhục
须龙肉=Tu Long nhục
翁花狼肉=Ông Hoa lang nhục
全蝎肉=Toàn Hạt nhục
苦玄肉=Khổ Huyền nhục
钱通=Tiền Thông
归阳功=Quy Dương Công
归阳劲=Quy Dương Kính
三江=Tam Giang
千羽阁=Thiên Vũ Các
上阳雪=Thượng Dương Tuyết
秦氏=Tần thị
上阳詹=Thượng Dương Chiêm
上阳宇=Thượng Dương Vũ
上阳礼=Thượng Dương Lễ
雪婆婆=Tuyết bà bà
云姑=Vân Cô
上阳烈=Thượng Dương Liệt
江府=Giang phủ
长寿坊=Trường Thọ Phường
长荣街=Trường Vinh Nhai
义庄=Nghĩa Trang
鲁教头=Lỗ Giáo Đầu
郑教头=Trịnh Giáo Đầu
王啸林府邸=Vương Khiếu Lâm Phủ Để
鼎香坊=Đỉnh Hương Phường
王府=Vương phủ
王教头=Vương giáo đầu
宝鹃=Bảo Quyên
老范=Lão Phạm
留宿谷=Lưu Túc Cốc
搬山=Bàn Sơn
搬山异血=Bàn Sơn Dị Huyết
玄冥花=Huyền Minh Hoa
上阳血脉=Thượng Dương Huyết Mạch
李瀚=Lý Hãn
正气诀=Chính Khí Quyết
千浪诀=Thiên Lãng Quyết
千浪异血=Thiên Lãng Dị Huyết
正气异血=Chính Khí Dị Huyết
墨香斋=Mặc Hương Trai
三山镇=Tam Sơn Trấn
平安镇=Bình An Trấn
墨香阁=Mặc Hương Các
金海功=Kim Hải Công
大壮=Đại Tráng
第122章=Chương 122
药阁=Dược Các
宝血树=Bảo Huyết Thụ
七情宝树=Thất Tình Bảo Thụ
火炬奇树=Hỏa Cự Kỳ Thụ
速生柳树=Tốc Sinh Liễu Thụ
三角枫树=Tam Giác Phong Thụ
玄蛇藤=Huyền Xà Đằng
人面果=Nhân Diện Quả
山甲肉=Sơn Giáp Nhục
一级浮屠=Nhất Cấp Phù Đồ
回天功=Hồi Thiên Công
白玉君子树=Bạch Ngọc Quân Tử Thụ
赶蝉追风步=Cản Thiền Truy Phong Bộ
蝉鸟=Thiền Điểu
血劲=Huyết Kình
大湖城=Đại Hồ Thành
花雨晴=Hoa Vũ Tình
浮屠=Phù Đồ
苦竹苑=Khổ Trúc Uyển
荷竹苑=Hà Trúc Uyển
玄蛇藤浆液=Huyền Xà Đằng Tương Dịch
花琼=Hoa Quỳnh
焦阳镇=Tiêu Dương Trấn
影竹苑=Ảnh Trúc Uyển
花玉莹=Hoa Ngọc Oánh
花语=Hoa Ngữ
花蝶梦=Hoa Điệp Mộng
韦小宝=Vi Tiểu Bảo
花素清=Hoa Tố Thanh
青芒剑诀=Thanh Mang Kiếm Quyết
书友20180603231310894=Bạn đọc 20180603231310894
梦vl红尘=Mộng vl Hồng Trần
黑山羊957=Hắc Sơn Dương 957
涩咪咪的小猪=Sắc Mị Mị Tiểu Trư
留胡渣的南人=Lưu Hồ Tra Đích Nam Nhân
黑衣人=Hắc y nhân
顾府=Cố phủ
黄四郎=Hoàng Tứ Lang
小蛮王=Tiểu Man Vương
铁蒺藜骨朵=Thiết Tật Lê Cốt Đóa
十大凶人=Thập Đại Hung Nhân
陆行风=Lục Hành Phong
疯人剑=Phong Nhân Kiếm
紫轩仙帝=Tử Hiên Tiên Đế
邱师兄=Khâu sư huynh
典师弟=Điển sư đệ
三级浮屠=Tam Cấp Phù Đồ
蜉蝣=Phù Du
花无缺=Hoa Vô Khuyết
李治=Lý Trị
刽子王=Quái Tử Vương
白狗=Bạch Cẩu
十里亭=Thập Lý Đình
黑铁剑=Hắc Thiết Kiếm
尚盈盈=Thượng Doanh Doanh
夺魂镖=Đoạt Hồn Tiêu
周玉婷=Chu Ngọc Đình
齐教头=Tề giáo đầu
唐僧=Đường Tăng
女儿国=Nữ Nhi Quốc
谷主=Cốc chủ
花南星=Hoa Nam Tinh
花燕荣=Hoa Yến Vinh
梦蝶=Mộng Điệp
天秀弧光剑法=Thiên Tú Hồ Quang Kiếm Pháp
花慕容=Hoa Mộ Dung
花蝶舞=Hoa Điệp Vũ
黑白双煞=Hắc Bạch Song Sát
韩大哥=Hàn đại ca
倩女幽魂=Thiện Nữ U Hồn
邱家=Khưu Gia
西涂六指怪=Tây Đồ Lục Chỉ Quái
西涂山=Tây Đồ Sơn
凶人谷=Hung Nhân Cốc
青冥剑=Thanh Minh kiếm
吕炎玉=Lữ Viêm Ngọc
双峰镇=Song Phong trấn
女飞侠=Nữ Phi Hiệp
梦蝶师姐=Mộng Điệp sư tỷ
花梦蝶=Hoa Mộng Điệp
无缺=Vô Khuyết
姥姥=Lão Lão
邱草长=Khâu Thảo Trường
花茗薇=Hoa Mính Vi
邱广诚=Khâu Quảng Thành
韩敖启=Hàn Ngao Khải
李良平=Lý Lương Bình
花慕云=Hoa Mộ Vân
花芬=Hoa Phân
花梦舞=Hoa Mộng Vũ
许渊=Hứa Uyên
高考=Cao Khảo
顾广雄=Cố Quảng Hùng
曹胡=Tào Hồ
楠竹苑=Nam Trúc Uyển
曹在邦=Tào Tại Bang
胡二娘=Hồ Nhị Nương
花盼容=Hoa Phán Dung
花蕊芳=Hoa Nhụy Phương
花玲珑=Hoa Linh Lung
顾家=Cố Gia
茗薇=Mính Vi
苗东岩=Miêu Đông Nham
顾天金=Cố Thiên Kim
花枝=Hoa Chi
横断山=Hoành Đoạn Sơn
茅家寨=Mao Gia Trại
孟大哥=Mạnh đại ca
小红=Tiểu Hồng
白水镇=Bạch Thủy Trấn
雁翎刀=Nhạn Linh Đao
风来客栈=Phong Lai Khách Sạn
燕红凤=Yến Hồng Phượng
苗人蛮=Miêu Nhân Man
葵水=Quỳ Thủy
银兰=Ngân Lan
齐木清=Tề Mộc Thanh
虎煞帮=Hổ Sát Bang
毒蛇帮=Độc Xà Bang
鲁庆余=Lỗ Khánh Dư
东龙=Đông Long
孟棣=Mạnh Đệ
黄一昌=Hoàng Nhất Xương
王啸林=Vương Khiếu Lâm
李长志=Lý Trường Chí
虎煞功=Hổ Sát Công
齐家=Tề gia
郑府=Trịnh phủ
宣花板斧=Tuyên Hoa Bản Phủ
秦明=Tần Minh
傅长春=Phó Trường Xuân
秦府=Tần Phủ
锤法·扫烈风=Chuy pháp · Tảo Liệt Phong
锤法·奔雷袭=Chuy pháp · Bôn Lôi Tập
锤法·千重浪=Chuy pháp · Thiên Trọng Lãng
池音=Trì Âm
玉山城=Ngọc Sơn Thành
赫连无恨=Hách Liên Vô Hận
上阳鞅=Thượng Dương Ưởng
谢容儿=Tạ Dung Nhi
爆血丹=Bạo Huyết Đan
千羽山=Thiên Vũ Sơn
曹雪芹=Tào Tuyết Cần
曹寅=Tào Dần
康熙皇帝=Khang Hy Hoàng Đế
江宁织造=Giang Ninh Chức Tạo
虞竹青=Ngu Trúc Thanh
齐云杰=Tề Vân Kiệt
云海城=Vân Hải Thành
齐家老祖=Tề Gia Lão Tổ
齐任平=Tề Nhậm Bình
铁兴城=Thiết Hưng Thành
一指帮=Nhất Chỉ Bang
刀剑镇=Đao Kiếm Trấn
小通河=Tiểu Thông Hà
五里峡=Ngũ Lí Hạp
修巳=Tu Tị
荆采菽=Kinh Thái Thục
水天楼=Thủy Thiên Lâu
浮木居士=Phù Mộc Cư Sĩ
宁修巳=Ninh Tu Tị
宋教头=Tống giáo đầu
火神幻影=Hỏa Thần Huyễn Ảnh
林湛恩=Lâm Trạm Ân
林家=Lâm gia
蔡家=Thái gia
朱门=Chu Môn
小韦=Tiểu Vi
朱荃=Chu Thuyên
翠红=Thúy Hồng
玄冥毒=Huyền Minh Độc
莲花池=Liên Hoa Trì
沐氏寒派=Mộc Thị Hàn Phái
丹菊=Đan Cúc
玺印=Tỉ Ấn
公子=Công tử
绿竹别院=Lục Trúc Biệt Viện
李老头=Lý Lão Đầu
李进=Lý Tiến
练筋篇=Luyện Cân Thiên
易筋境=Dịch Cân Cảnh
锻骨境=Đoán Cốt Cảnh
风骨=Phong Cốt
火神丹=Hỏa Thần Đan
无相异血=Vô Tướng Dị Huyết
火莲子=Hỏa liên tử
流星锁链锤=Lưu tinh tỏa liên chùy
风骨圆满=Phong Cốt Viên Mãn
黑夜刀法=Hắc Dạ Đao Pháp
李乾=Lý Càn
黑夜堂=Hắc Dạ Đường
向士高=Hướng Sĩ Cao
火云邪神=Hỏa Vân Tà Thần
黄谷镇=Hoàng Cốc Trấn
百叶镇=Bách Diệp Trấn
铁手会=Thiết Thủ Hội
刘家=Lưu Gia
松林镇=Tùng Lâm Trấn
伏虎帮=Phục Hổ Bang
云雀镇=Vân Tước Trấn
黑原镇=Hắc Nguyên Trấn
贾宝玉=Giả Bảo Ngọc
狄宏图=Địch Hoành Đồ
千羽风魔劲=Thiên Vũ Phong Ma Kính
风魔剑法=Phong Ma Kiếm Pháp
疤虎包三爷=Sẹo Hổ Bao Tam Gia
黑煞宗=Hắc Sát Tông
忠骨=Trung Cốt
反骨=Phản Cốt
奴骨=Nô Cốt
艳骨=Diễm Cốt
媚骨=Mị Cốt
柔骨=Nhu Cốt
贱骨头=Tiện Cốt Đầu
硬骨头=Ngạnh Cốt Đầu
颧骨=Gò Má
驿马骨=Dịch Mã Cốt
将军骨=Tướng Quân Cốt
日角骨=Nhật Giác Cốt
月角骨=Nguyệt Giác Cốt
龙宫骨=Long Cung Cốt
伏犀骨=Phục Tê Cốt
巨鳌骨=Cự Ngao Cốt
龙角骨=Long Giác Cốt
通宝钱庄=Thông Bảo Tiền Trang
金毛犼=Kim Mao Hống
土地神张文德=Thổ Địa Thần Trương Văn Đức
巧儿=Xảo Nhi
二夫人=Nhị phu nhân
吴三两=Ngô Tam Lưỡng
八方楼=Bát Phương Lâu
八方风雨=Bát Phương Phong Vũ
黎宝鼎=Lê Bảo Đỉnh
白桦巷=Bạch Hoa Hạng
朱占彪=Chu Chiêm Bưu
胡大爷=Hồ Đại Gia
丁香巷=Hẻm Đinh Hương
王麻子=Vương Ma Tử
小莲=Tiểu Liên
菊儿胡同=Cúc Nhi Hồ Đồng
郁观石=Úc Quan Thạch
齐念生=Tề Niệm Sinh
十方天地=Thập Phương Thiên Địa
鹰爪神功=Ưng Trảo Thần Công
花香楼=Hoa Hương Lâu
老鸨=Má mì
如烟=Như Yên
疾风螳螂刀=Tật Phong Đường Lang Đao
柳池=Liễu Trì
寒冰手=Hàn Băng Thủ
无明烈焰掌=Vô Minh Liệt Diễm Chưởng
凝霜宝录=Ngưng Sương Bảo Lục
张家=Trương gia
冰煞魔功=Băng Sát Ma Công
张定远=Trương Định Viễn
凝霜寒劲=Ngưng Sương Hàn Kính
张忘尘=Trương Vong Trần
张妙玉=Trương Diệu Ngọc
鹿茸肉=Lộc Nhung Nhục
苏远江=Tô Viễn Giang
爷爷=Ông nội
奶奶=Bà nội
典韋=Điển Vi
蘇婉晴=Tô Uyển Tình
郁觀石=Úc Quan Thạch
搬山勁=Bàn Sơn Kình
蚩木勁=Si Mộc Kình
無明火勁=Vô Minh Hỏa Kình
苏家宅院=Tô Gia Trạch Viện
周家小姐=Tiểu thư Chu
何中群=Hà Trung Quần
匡广荣=Khuông Quảng Vinh
冷面判官=Lãnh Diện Phán Quan
同福客栈=Đồng Phúc Khách Sạn
林竹镇=Lâm Trúc Trấn
卷云府=Quyển Vân Phủ
大胡子=Đại Hồ Tử
镜湖女妖=Kính Hồ nữ yêu
左六房=Phòng số sáu bên trái
左五房=Phòng số năm bên trái
无招剑书=Vô Chiêu Kiếm Thư
沐昆山=Mộc Côn Sơn
沐三琊=Mộc Tam Gia
万宝阁=Vạn Bảo Các
茶女=Trà Nữ
霹雳剑=Phích Lịch Kiếm
风雨剑法=Phong Vũ Kiếm Pháp
七旋真斩=Thất Toàn Chân Trảm
白虹贯日=Bạch Hồng Quán Nhật
真佛=Chân Phật
白英=Bạch Anh
席风山=Tịch Phong Sơn
庞九平=Bàng Cửu Bình
苏府=Tô phủ
苏瑜=Tô Du
沐重=Mộc Trọng
沐氏水派=Mộc Thị Thủy Phái
蓝先生=Lam tiên sinh
朱逵=Chu Quỳ
朱本渊=Chu Bản Uyên
朱府=Chu phủ
朱开雄=Chu Khai Hùng
朱又玄=Chu Hựu Huyền
朱贵生=Chu Quý Sinh
安翠=An Thúy
寒派=Hàn Phái
邓莉=Đặng Lị
邓正=Đặng Chính
红衣少女=Hồng Y Thiếu Nữ
漠河=Mạc Hà
左手刀=Tả Thủ Đao
沐尚千=Mộc Thượng Thiên
极火老人=Cực Hỏa Lão Nhân
极火邪功=Cực Hỏa Tà Công
极火鸟=Cực Hỏa Điểu
沙一策=Sa Nhất Sách
九花客栈=Cửu Hoa Khách Sạn
黑莲=Hắc Liên
桑威=Tang Uy
上阳乾坤功=Thượng Dương Càn Khôn Công
郑老=Trịnh Lão
上善若水=Thượng Thiện Nhược Thủy
周家=Chu Gia
玄水龟=Huyền Thủy Quy
黄金骰子=Hoàng Kim Xúc Xắc
尹叔华=Doãn Thúc Hoa
浮光七色鹿=Phù Quang Thất Sắc Lộc
包自守=Bao Tự Thủ
五级浮屠=Ngũ Cấp Phù Đồ
神兵魔刃=Thần Binh Ma Nhận
平江=Bình Giang
上阳城=Thượng Dương Thành
荆氏=Kinh thị
朱氏=Chu thị
孔老三=Khổng Lão Tam
大宁坊=Đại Ninh Phường
邵氏=Thiệu Thị
苏氏=Tô Thị
沐全安=Mộc Toàn An
朱本宗=Chu Bản Tông
大宁府=Đại Ninh Phủ
赫连世家=Hách Liên Thế Gia
沐府=Mộc Phủ
沐渺远=Mộc Diểu Viễn
蓝东玉=Lam Đông Ngọc
沐氏=Mộc Thị
朱家=Chu Gia
苏家=Tô gia
沐家=Mộc gia
沐尚白=Mộc Thượng Bạch
邵以辰=Thiệu Dĩ Thần
荆家=Kinh gia
荆怡红=Kinh Di Hồng
高飞=Cao Phi
黑铁掌=Hắc Thiết Chưởng
红月蜂=Hồng Nguyệt Phong
二道村=Nhị Đạo Thôn
胡三=Hồ Tam
一号老者=Lão giả số một
二号=Số hai
三号=Số ba
太乙分光=Thái Ất Phân Quang
一号=Nhất Hào
六号红唇妇人=Lục Hào Hồng Thần phụ nhân
五号披发中年=Ngũ Hào Phi Phát Trung Niên
九号青年=Cửu Hào thanh niên
十号=Số 10
六号=Số 6
红唇妇人=Người phụ nữ môi đỏ
八号丑女=Người phụ nữ xấu số 8
七号书生=Thư sinh số 7
四号=Số 4
七号=Số Bảy
蛔虫妖=Giun yêu
九号=Số Chín
五号=Số Năm
八号=Số Tám
乾州=Càn Châu
千钧重斧=Thiên Quân Trọng Phủ
丈八骨矛=Trượng Bát Cốt Mâu
火炮=Hỏa Pháo
绿光珠=Lục Quang Châu
沉睡者=Người ngủ say
三十三重天=Tam Thập Tam Trọng Thiên
罗元俊=La Nguyên Tuấn
伍爷=Ngũ Gia
周夫人=Phu nhân Chu
万剑归一=Vạn Kiếm Quy Nhất
周府=Chu phủ
绝命镇=Tuyệt Mệnh Trấn
紫铜宝镜=Tử Đồng Bảo Kính
白眉老者=Bạch Mi Lão Giả
祝万里=Chúc Vạn Lý
周士南=Chu Sĩ Nam
宇文公子=Vũ Văn công tử
三生=Tam Sinh
酒中仙=Tửu Trung Tiên
蚩木功=Xi Mộc Công
化木神功=Hóa Mộc Thần Công
孽畜=Nghiệt Súc
宇文=Vũ Văn
化木老祖=Hóa Mộc Lão Tổ
宇文屁股=Vũ Văn mông
蚩木骨劲=Xi Vưu Cốt Kình
寒香派=Hàn Hương Phái
九天甘露=Cửu Thiên Cam Lộ
EDG=EDG
宇文家=Vũ Văn Gia
阴虎山=Âm Hổ Sơn
邓茂=Đặng Mậu
元善镇=Nguyên Thiện Trấn
黑夜叉=Hắc Dạ Xoa
金爷=Kim Gia
牛家岭=Ngưu Gia Lĩnh
牛堡主=Ngưu bảo chủ
无了=Vô Liễu
一拜大年=Nhất Bái Đại Niên
二龙戏珠=Nhị Long Hí Châu
三位一体=Tam Vị Nhất Thể
斩钉刀法=Trảm Đinh Đao Pháp
火烛杖=Hỏa Chúc Trượng
金管家=Kim quản gia
元以中=Nguyên Dĩ Trung
银牛=Ngân Ngưu
大郎=Đại Lang
牛氏=Ngưu Thị
娟儿=Quyên Nhi
岳父大人=Nhạc Phụ Đại Nhân
蝙蝠妖=Biên Bức Yêu
拜大年=Bái Đại Niên
搬山骨劲=Bàn Sơn Cốt Kính
化生之术=Hóa Sinh Chi Thuật
孽种=Nghiệt Chủng
牛娟儿=Ngưu Quyên Nhi
牛兴鸿=Ngưu Hưng Hồng
冬虫夏草=Đông Trùng Hạ Thảo
牛敬武=Ngưu Kính Vũ
鼠大郎=Thử Đại Lang
牛家堡=Ngưu Gia Bảo
鹿角镇=Lộc Giác Trấn
阿玲=A Linh
玲婆婆=Linh bà bà
土地神=Thổ Địa Thần
刘章=Lưu Chương
夜天明=Dạ Thiên Minh
白发虬髯老者夜子羽=Bạch Phát Cù Nhiêm Lão Giả Dạ Tử Vũ
龙神青年=Long Thần Thanh Niên
蓝玉石床=Lam Ngọc Thạch Sàng
碧焰酒=Bích Diễm Tửu
河神=Hà Thần
一线香=Nhất Tuyến Hương
黑沙河神=Hắc Sa Hà Thần
宇文世家=Vũ Văn Thế Gia
无相老祖=Vô Tướng Lão Tổ
嗜血老魔=Thị Huyết Lão Ma
隋炀帝杨广=Tùy Dạng Đế Dương Quảng
无相功=Vô Tướng Công
赤金真功=Xích Kim Chân Công
金光霸功=Kim Quang Bá Công
周流真水=Chu Lưu Chân Thủy
云水宫=Vân Thủy Cung
无上大力杵法=Vô Thượng Đại Lực Xử Pháp
卓春华=Trác Xuân Hoa
蛮妃=Man Phi
黑莲寺=Hắc Liên Tự
泰山=Thái Sơn
曹操=Tào Tháo
花开=Hoa Khai
王妃=Vương Phi
屠呦呦=Đồ U U
二级浮屠=Nhị Cấp Phù Đồ
六级浮屠=Lục Cấp Phù Đồ
九级浮屠=Cửu Cấp Phù Đồ
黄级锻骨=Hoàng Cấp Đoán Cốt
玄级锻骨=Huyền Cấp Đoán Cốt
地级初期锻骨=Địa Cấp Sơ Kỳ Đoán Cốt
曾缘=Tằng Duyên
天级=Thiên Cấp
蕴脏境=Uẩn Tạng Cảnh
蛇眉铜鱼=Xà Mi Đồng Ngư
苏家小姐=Tô Gia Tiểu Thư
凤珠姑娘=Phượng Châu Cô Nương
苏小姐=Tô Tiểu Thư
风雨斋=Phong Vũ Trai
张言之=Trương Ngôn Chi
双锏无情=Song Giản Vô Tình
沐冰清=Mộc Băng Thanh
玉环=Ngọc Hoàn
宁玉环=Ninh Ngọc Hoàn
方连昌=Phương Liên Xương
宁府=Ninh Phủ
邵以仁=Thiệu Dĩ Nhân
邵三洞=Thiệu Tam Động
邵仲文=Thiệu Trọng Văn
苏敬贤=Tô Kính Hiền
风无流=Phong Vô Lưu
山阳冲=Sơn Dương Trùng
无相劲=Vô Tướng Kính
搬山劲=Bàn Sơn Kính
无明火劲=Vô Minh Hỏa Kính
邵家=Thiệu Gia
宁行空=Ninh Hành Không
宁行之=Ninh Hành Chi
宁行云=Ninh Hành Vân
曹山川=Tào Sơn Xuyên
十方拳=Thập Phương Quyền
上阳虎=Thượng Dương Hổ
冰火城=Băng Hỏa Thành
温若玉=Ôn Nhược Ngọc
宁氏=Ninh Thị
幽花=U Hoa
梵圣金劲=Phạn Thánh Kim Kính
五色骨=Ngũ Sắc Cốt
百草养骨丹=Bách Thảo Dưỡng Cốt Đan
绿液池=Lục Dịch Trì
阴虎妖王=Âm Hổ Yêu Vương
秦玉春=Tần Ngọc Xuân
商友平=Thương Hữu Bình
穿云箭=Xuyên Vân Tiễn
古玉宝=Cổ Ngọc Bảo
虎象=Hổ Tượng
玲珑棋子=Cờ Linh Lung
柳锦玉=Liễu Cẩm Ngọc
梵圣门=Phạn Thánh Môn
朱师弟=Chu sư đệ
徐管事=Từ quản sự
朱彦秀=Chu Ngạn Tú
盘州=Bàn Châu
孟守先=Mạnh Thủ Tiên
含巧=Hàm Xảo
虹英=Hồng Anh
雪曼=Tuyết Mạn
搬山魔猿=Bàn Sơn Ma Viên
嫁衣诀=Giá Y Quyết
钟玉晶=Chung Ngọc Tinh
日轮石=Đá Nhật Luân
九樱果=Quả Cửu Anh
蚩木神功=Xi Vưu Thần Công
梵圣金功=Phạn Thánh Kim Công
无相神功=Vô Tướng Thần Công
天脊山=Thiên Tích Sơn
蚩木劲=Xi Vưu Mộc Kính
九阴归元功=Cửu Âm Quy Nguyên Công
四照神功=Tứ Chiếu Thần Công
九阳无量=Cửu Dương Vô Lượng
天地交征阴阳大悲赋=Thiên Địa Giao Chinh Âm Dương Đại Bi Phú
明玉功=Minh Ngọc Công
浑天真阳功=Hồn Thiên Chân Dương Công
王戎=Vương Nhung
杜峰=Đỗ Phong
上官家族=Thượng Quan Gia Tộc
崔天虎=Thôi Thiên Hổ
崔天豹=Thôi Thiên Báo
杏云=Hạnh Vân
苏凤=Tô Phượng
小仙=Tiểu Tiên
钟灵毓秀=Chung Linh Dục Tú
池太问=Trì Thái Vấn
关杰=Quan Kiệt
龚亲王=Cung Thân Vương
王管事=Vương quản sự
荣九昌=Vinh Cửu Xương
孤云山=Cô Vân Sơn
刘元冲=Lưu Nguyên Xung
许明净=Hứa Minh Tịnh
王师姐=Vương sư tỷ
飞雪山庄=Phi Tuyết Sơn Trang
卢师兄=Lư sư huynh
天元玄指=Thiên Nguyên Huyền Chỉ
并连山=Tịnh Liên Sơn
左丘一之=Tả Khâu Nhất Chi
玄羽门=Huyền Vũ Môn
青光剑派=Thanh Quang Kiếm Phái
天兵=Thiên Binh
殷正行=Ân Chính Hành
傅季风=Phó Quý Phong
高玉洁=Cao Ngọc Khiết
高冰清=Cao Băng Thanh
灵鹤门=Linh Hạc Môn
宋师弟=Tống sư đệ
碧涛门=Bích Đào Môn
白阳宗=Bạch Dương Tông
高氏姐妹=Cao Thị tỷ muội
顾长春=Cố Trường Xuân
李浩源=Lý Hạo Nguyên
裴元=Bùi Nguyên
刘忠俊=Lưu Trung Tuấn
溷元四杰=Hỗn Nguyên Tứ Kiệt
溷元功=Hỗn Nguyên Công
极上山庄=Cực Thượng Sơn Trang
天火宗=Thiên Hỏa Tông
周流水劲=Chu Lưu Thủy Kình
莫师兄=Mạc sư huynh
万雷阁=Vạn Lôi Các
太刀门=Thái Đao Môn
溷元书院=Hỗn Nguyên Thư Viện
卫青阳=Vệ Thanh Dương
晚晚=Vãn Vãn
许晶晶=Hứa Tinh Tinh
尹家小姐=Doãn Gia Tiểu thư
潘天飞=Phan Thiên Phi
五蕴宗=Ngũ Uẩn Tông
秦阳=Tần Dương
尹玉娥=Doãn Ngọc Nga
天庭=Thiên Đình
不死秘境=Bất Tử Bí Cảnh
遮合岛=Già Hợp Đảo
海神=Hải Thần
白骨岛=Đảo Bạch Cốt
巴塞=Ba Tắc
罗汉果=La Hán Quả
罗田岛=La Điền Đảo
夹落岛=Giáp Lạc Đảo
了欲=Liễu Dục
玄春海神=Huyền Xuân Hải Thần
欲罗汉=Dục La Hán
天界=Thiên Giới
牢州=Lao Châu
明丘=Minh Khâu
紫阳之气=Tử Dương Chi Khí
明玉诀=Minh Ngọc Quyết
瞿伯庄=Cù Bá Trang
鲍大同=Bào Đại Đồng
沐长老=Mộc trưởng lão
梦如花=Mộng Như Hoa
苍桐镇=Thương Đồng Trấn
郑茂=Trịnh Mậu
秦先生=Tần tiên sinh
上阳冲=Thượng Dương Xung
荥江城=Huỳnh Giang Thành
上阳世家=Thượng Dương Thế Gia
上阳胤=Thượng Dương Dận
张文德=Trương Văn Đức
重军=Trọng Quân
郑老头=Trịnh lão đầu
乐兴贤=Nhạc Hưng Hiền
汗郯城=Hãn Đàm Thành
张乾坤=Trương Càn Khôn
杜刚=Đỗ Cương
汗阳城=Hãn Dương Thành
桃桃=Đào Đào
苏姚=Tô Diêu
西赫森林=Tây Hách Sâm Lâm
紫莲肉=Tử Liên Nhục
元鼎山=Nguyên Đỉnh Sơn
裴文碧=Bùi Văn Bích
紫兆国=Tử Triệu Quốc
象郡=Tượng Quận
搬山功=Bàn Sơn Công
年兽=Niên Thú
无明神功=Vô Minh Thần Công
黑沙河=Hắc Sa Hà
赵长老=Triệu trưởng lão
吕麒麟=Lữ Kỳ Lân
莫问天=Mạc Vấn Thiên
上官祥云=Thượng Quan Tường Vân
苗万涛=Miêu Vạn Đào
阎龟山=Diêm Quy Sơn
段黑虎=Đoạn Hắc Hổ
化木门=Hóa Mộc Môn
齐长老=Tề trưởng lão
白姐姐=Bạch tỷ tỷ
金鹰国=Kim Ưng Quốc
昌运城=Xương Vận Thành
吴雪宁=Ngô Tuyết Ninh
齐勇=Tề Dũng
白名媛=Bạch Danh Viện
宇文阔=Vũ Văn Khoát
李洪松=Lý Hồng Tùng
徐明=Từ Minh
宇文家族=Vũ Văn Gia Tộc
厉英武=Lệ Anh Vũ
吕长生=Lữ Trường Sinh
宁赤练=Ninh Xích Luyện
苏凤二女=Tô Phượng nhị nữ
七宝玄丹=Thất Bảo Huyền Đan
庄贤公=Trang Hiền Công
太史明月=Thái Sử Minh Nguyệt
凤珠=Phượng Châu
苏婉晴=Tô Uyển Tình
沐恩重=Mộc Ân Trọng
奉州=Phụng Châu
寒香谷=Hàn Hương Cốc
树妖姥姥=Thụ Yêu Lão Lão
天元山=Thiên Nguyên Sơn
岑月娇=Sầm Nguyệt Kiều
倪冬月=Nghê Đông Nguyệt
孤云山庄=Cô Vân Sơn Trang
夜子羽=Dạ Tử Vũ
沐水生=Mộc Thủy Sinh
虞雪婷=Ngu Tuyết Đình
纯阳诀=Thuần Dương Quyết
徐崖主=Từ Nhai Chủ
隐州=Ẩn Châu
宇文定=Vũ Văn Định
黄牙=Hoàng Nha
暗影堂=Ám Ảnh Đường
钱老爷=Tiền Lão gia
鲁堂主=Lỗ Đường Chủ
黑虎帮=Hắc Hổ Bang
白鹤门=Bạch Hạc Môn
牛背山=Ngưu Bối Sơn
邗江水匪=Hàn Giang Thủy Phỉ
斗战神=Đấu Chiến Thần
姹女映月神功=Xá Nữ Ánh Nguyệt Thần Công
刘朝海=Lưu Triều Hải
华玲玲=Hoa Linh Linh
傅彩娥=Phó Thải Nga
七星轩=Thất Tinh Hiên
尹家=Doãn Gia
上官家=Thượng Quan Gia
秦淑莲=Tần Thục Liên
东方敬=Đông Phương Kính
袁北坡=Viên Bắc Pha
卓大长老=Trác Đại trưởng lão
天元门=Thiên Nguyên Môn
聚沙门=Tụ Sa Môn
寇梅=Khấu Mai
顾萍=Cố Bình
丁春茹=Đinh Xuân Như
娄琪美=Lâu Kỳ Mỹ
余月红=Dư Nguyệt Hồng
无锋=Vô Phong
赵日天=Triệu Nhật Thiên
四象教=Tứ Tượng Giáo
冥药师=Minh Dược Sư
步千军=Bộ Thiên Quân
游天行=Du Thiên Hành
晋州=Tấn Châu
徐水英=Từ Thủy Anh
乔仙仙=Kiều Tiên Tiên
乔玲玉=Kiều Linh Ngọc
纪姬=Kỷ Cơ
郁巧=Úc Xảo
典韦=Điển Vi
赤月崖=Xích Nguyệt Nhai
苏晨=Tô Thần
阴影之王=Âm Ảnh Chi Vương
柳河清=Liễu Hà Thanh
搬山派=Ban Sơn Phái
冰珺=Băng Quận
万物模拟：开局铜皮铁骨=Vạn Vật Mô Phỏng: Khởi Đầu Đồng Bì Thiết Cốt
佛不度=Phật Bất Độ
