黑科技=Công nghệ hắc ám
气功=Khí công
月球=Mặt Trăng/Mặt trăng
王宫=Vương Cung/Cung điện
飞行器=Phi thuyền
鸟山明=Akira Toriyama
精神=tinh thần
储物空间=Không Gian Trữ Vật
妖魂=Yêu Hồn
神器=Thần Khí
法器=Pháp Khí
宇宙飞船=Phi thuyền vũ trụ
星球=Hành tinh
重力室=Phòng Trọng Lực
神庙=Thần Miếu/đền thờ
中学=Trung học
阿索=A Tác
普通战士=Chiến Binh Thường
精英战士=Chiến Binh Tinh Nhuệ
柯伊伯带=Vành đai Kuiper
亲卫队=Đội Cận Vệ
太阳神=Thần Mặt Trời/Thái Dương Thần
奥尔特云=Đám mây Oort
虾饺=Há Cảo
太阳星=Hành Tinh Mặt Trời
乌龙=Ô Long
江洋大盗=đại đạo chích
二世=Đệ Nhị
极西=Cực Tây
圣地=Thánh Địa
天堂=Thiên Đàng/Thiên Đường
第190章=Chương 190
神界=Thần Giới
如意棒=Gậy Như Ý
虎头人=Người Hổ
煎锅山=Chảo Lửa Sơn
巨龙=Rồng khổng lồ
天界=Thiên Giới
翼龙=Thằn Lằn Bay
大毁灭=Đại Huỷ Diệt
决赛=Trận chung kết
第269章=Chương 269
女王大人=Nữ Vương Điện Hạ
空金=Không Kim
王都=Vương Đô
赤瞳=Xích Nhãn
超越=Vượt Trội
炼狱之门=Cổng Luyện Ngục
炼狱空间=Không Gian Luyện Ngục
精神术=Tâm Linh Thuật
第345章=Chương 345
智脑=Trí Não
特战部队=Đội đặc nhiệm
阿天=Thiên
天星=Thiên Tinh
超级龟派气功=Siêu Kamehameha
气元波=Genki Dama
第374章=Chương 374
西南=Tây Nam
木星=Sao Mộc
13号=Android 13
14号=Android 14
15号=Android 15
武术=Võ thuật
金属星球=Hành Tinh Kim Loại
第410章=Chương 410
战斗服=Áo Giáp Chiến Đấu
水晶=tinh thể/Thủy Tinh
埃及=Ai Cập
异次元空间=Không Gian Dị Chiều
元气弹=Bom Nguyên Khí
西侧=phía Tây
南侧=phía Nam
次元空间=Không gian chiều thứ nguyên
印加文化=Văn hóa Inca
元气=Nguyên khí
白星=Bạch Tinh
银河中心=Trung Tâm Ngân Hà
第457章=Chương 457
北半球=Bắc bán cầu
杏眉=Hạnh Mi
特战小队=Đội đặc nhiệm
特战队=Đội đặc nhiệm
银星=Ngân Tinh
龙珠雷达=Máy dò Dragon Ball
古代赛亚人=Người Saiyan Cổ Đại
人间=Nhân Gian/Trần Gian/Nhân gian
卫星城=Thành phố vệ tinh
第515章=Chương 515
凯琳仙人=Tiên nhân Karin
东海=Biển Đông/Đông Hải
界王拳=Giới Vương Quyền
安宁=An Ninh
第538章=Chương 538
神龙波仑伽=Rồng Thần Porunga
旭日=Ánh bình minh
冰雪星=Hành Tinh Băng Tuyết
克鲁德=King Cold
龟仙岛=Đảo Kame
南半球=Nam Bán Cầu
第571章=Chương 571
五月十二日=Ngày 12 tháng 5
克林=Krillin
19号=Android 19
火星=Sao Hỏa/Hỏa Tinh
第578章=Chương 578
盖洛=Tiến sĩ Gero
8号=Android 8
第593章=Chương 593
RR=RR
戈壁=Sa mạc Gobi
筋斗云=Cân Đẩu Vân
第五区=Khu Vực Số 5
乌木=Ô Mộc
魔贯光杀炮=Ma Quán Quang Sát Pháo
牛魔王=Ngưu Ma Vương
老海龟=Lão Rùa
太阳拳=Thái Dương Hạ San
魔封波=Ma Phong Ba
桃白白=Tao Pai Pai
第633章=Chương 633
春雨=Xuân Vũ
青山=Thanh Sơn
终极形态=Hình thái cuối cùng
龙珠世界=Thế giới Dragon Ball
神级=Cấp Thần
金瞳=Kim Đồng
女王=Nữ hoàng
兰芳=Lan Fang
瞬间移动=Dịch chuyển tức thời
16号=Android 16
炼狱=Luyện Ngục
银河系=Ngân Hà
第688章=Chương 688
神灵境=Cảnh giới Thần Linh
贝吉特=Vegeta
龟派气功=Kamehameha
第709章=Chương 709
比武场=Võ Đài
交换=Hoán đổi
第718章=Chương 718
第719章=Chương 719
空击=Không Kích
猎食=Săn mồi
白魔法=Bạch ma pháp
黑魔法=Hắc ma pháp
武道=Võ đạo
恶魔一族=Ác ma tộc
库尔德王=King Cold
意境=Ý Cảnh
气圆斩=Khí Viên Trảm
气功炮=Khí Công Pháo
超能力=Siêu Năng Lực
银河战士=Chiến binh Ngân Hà
基纽特战队=Đội Đặc Nhiệm Ginyu
魔族=Ma tộc
仙人=Tiên nhân
宇宙海盗=Hải tặc vũ trụ
红鱼=Hồng Ngư
龙域=Long Vực
南部大陆=Nam Bộ Đại Lục
第760章=Chương 760
内域=Nội Vực
龙纹=Long Văn
下界=Hạ Giới
悬空岛=Hòn Đảo Lơ Lửng
神历=Thần Lịch
南方大陆=Nam Phương Đại Lục
龙城=Long Thành
吴下阿蒙=Ngô Hạ A Mông
时光机=Cỗ Máy Thời Gian
武天老师=Quy Lão Tiên Sinh
大雪山=Đại Tuyết Sơn
天津饭=Tien Shinhan
龟壳=Mai rùa
狼牙风风拳=Nanh Sói Phong Phong Quyền
审判之力=Thẩm Phán Lực
红缎带军团=Hồng Mộc Sát Thủ
第783章=Chương 783
藤族=Đằng Tộc
巨猿=Khỉ đột khổng lồ
阳间=Dương Gian
王族=Hoàng Tộc/Vương tộc
界王=Giới Vương
银河=Ngân Hà
魔人=Majin
黄泉=Hoàng Tuyền
龙族=Long tộc
天女=Thiên Nữ
大长老=Đại Trưởng Lão
极境=Cực Cảnh
无限龙神=Rồng Thần Vô Cực
丰神=Phong Thần
王神=Vương Thần
赛亚人=người Saiyan
仙豆=Đậu Thần
天神殿=Điện Kami
第三形态=Dạng Biến Hình Thứ Ba
恶魔之心=Trái Tim Quỷ Dữ
外域=Ngoại Vực
破坏=Hủy Diệt
杰青=Kiệt Thanh
黑龙=Hắc Long
气功波=Khí Công Ba
蛇道=Xà Đạo
地狱=Địa Ngục/Địa ngục
苏诺=Sono
五行山=Ngũ Hành Sơn
艾玛=Emma
南极大陆=Nam Cực
神灵=Thần Linh
阴间=Âm Phủ
龙拳=Long Quyền
第859章=Chương 859
天击=Thiên Kích
万能胶囊=Capsule Corp.
布里夫斯=Tiến sĩ Brief
菲娅=Phỉ Nhã
天使=Thiên Sứ/Thiên thần
旧神=Cựu Thần
第三十六区=Khu 36
主脑=Bộ não chính
阿尔塔=Aruta
武道家=Võ đạo gia
魔神=Ma Thần
盖洛博士=Tiến sĩ Gero
波波=Mr. Popo
太上老君=Thái Thượng Lão Quân
孙悟天=Son Goten
龟仙流=phái Quy Lão
格瓦斯=Không rõ
天神=Thượng Đế/Thiên Thần
武道会=Giải đấu Võ Thuật
撒旦=Mr. Satan/Sa Đát/Sa Tăng
联合王国=Vương Quốc Liên Hiệp
老伯=Lão bá
破坏神=Thần Hủy Diệt
第一宇宙=Vũ trụ thứ 1
神谱=Thần Phổ
神殿=Điện Kami
琪琪=Chi Chi
水晶球=Quả cầu pha lê
魔界=Ma Giới
大神官=Đại Thiên Sứ
界王神=Giới Vương Thần
人造人=Android/Người Nhân Tạo
天下第一武道会=Giải đấu Thiên Hạ Đệ Nhất Võ Thuật
卡卡罗特=Kakarot
比克大魔王=Đại Ma Vương Piccolo
精神时光屋=Phòng Tập Tinh Thần Thời Gian
娜美克星=Hành Tinh Namek
神之力=Thần Lực
宇宙=Vũ Trụ
龙珠=Ngọc Rồng/Long Châu
神龙=Rồng Thần/Thần Long
大界王=Đại Giới Vương
阎王=Diêm Vương
龟仙人=Quy Lão Tiên Sinh/Quy Tiên Nhân
猫仙人=Mèo Karin
老界王神=Lão Kaioshin
17号=Android 17
地球人=Người Trái Đất
第923章=Chương 923
贝吉塔星=Vegeta tinh
天国=Thiên Giới/Thiên Quốc
赛亚人之神=Super Saiyan God
第930章=Chương 930
大界王神=Đại Kaio-shin
魔物=Ma vật
孙悟饭=Son Gohan
魔人布欧=Majin Buu
罗飞=Ro Fei
魔窟=Ma Quật
龙神=Thần Rồng/Long Thần
第七宇宙=Vũ trụ thứ 7
超级赛亚人=Super Saiyan
18号=Android 18
超级赛亚人之神=Super Saiyan God
太阳系=Hệ Mặt Trời
地球=Trái Đất/Địa Cầu
包子山=Núi Paozu
孙悟空=Son Goku/Tôn Ngộ Không
kuuga=Kuuga
Henshin=Henshin
渡海=Độ Hải
超古代=Thượng Cổ Đại
村长=Trưởng làng
长老=Trưởng lão
小仁=Kojin
灵石=Linh thạch
方尖碑=Obelisk
文言文=Văn ngôn văn
白话文=Bạch thoại văn
桃井=Momoi
龟山=Kameyama
富士山=Núi Phú Sĩ
東京=Tokyo
关东地区=Vùng Kanto
荒川=Arakawa
埼玉县=Tỉnh Saitama
東京都=Tokyo
神门=Shinmon
池袋=Ikebukuro
神奈川县=Kanagawa Prefecture
东京塔=Tháp Tokyo
神崎=Kanzaki
3号=Số 3
足立区=Quận Adachi
江户川区=Quận Edogawa
西部=Phía Tây
东部=Phía Đông
本州岛=Đảo Honshu
墨田区=Sumida
37号=Số 37
新宿区=Quận Shinjuku
天马=Thiên Mã
加布=Gavu
大田区=Ota-ku
肖邦=Chopin
杉并区=Suginami-ku
新宿=Shinjuku
骑士=Rider/Hiệp Sĩ
电王=Den-O
G2=G2
千代田区=Chiyoda
43号=Số 43
山梨县=Tỉnh Yamanashi
玫瑰=Hoa Hồng
池袋站=Ga Ikebukuro
警署=Sở cảnh sát
西多摩市=Thành phố Tây Tama
三万人=Ba vạn người
红目=Mắt đỏ
将军=Tướng quân
港口=Cảng
盖茨=Geiz
沃兹=Woz
月读=Tsukuyomi
伊拉克=Iraq
古巴=Guba
异虫=Worm
第140章=Chương 140
不死生物=Bất Tử Sinh Vật
圣甲虫=Bọ hung
AgitΩ=AgitΩ
逢魔时王=Ohma Zi-O
白神=Bạch Thần
京都大学=Đại học Kyoto
美杜莎=Medusa/Mỹ Đỗ Toa
真由美=Mayumi
蛇尊者=Xà Tôn Giả
部长=Trưởng ban
本部长=Tổng trưởng
龟尊者=Turtle Lord/Quy Tôn Giả
东京铁塔=Tháp Tokyo
理事会=Lý sự hội
港区=Cảng Khu
警备部=Phòng Cảnh bị
怪物=Quái vật
46号=Số 46
4号=Số 4
台东区=Quận Taitō
0号=Số 0
樱井=Sakurai
深海=Shin Kai
红心=Cơ
黑桃=Pích
方块=Rô
梅花=Chuồn
统治者=Người Thống Trị
梅花8=Tép 8
毒蝎=Bò Cạp
变色龙=Tắc Kè Hoa
泰坦=Titan
地狱三头犬=Cerberus
卡利斯=Kalis
天音=Amane
雪菜=Yukina
贤者之石=Hòn đá Hiền triết
搜查一课=Phòng Điều tra Số 1
自卫队=Lực lượng Phòng vệ
里克=Riku
米欧=Mio
奥丁=Odin
雅人=Masato
多摩川=Sông Tama
东京湾=Vịnh Tokyo
水城=Mizuki
加鲁鲁=Garuru
冈村=Okamura
泽渡=Sawatari
冰川=Hikawa
八王子=Hachioji
圣域=Thánh Vực
青木原=Aokigahara
小雷=Tiểu Lôi
柏林=Berlin
劫掠者=Raider
阿原=A Hara
文京区=Quận Bunkyo
大润发=Đại Nhuận Phát
小夜=Sayo
猫头鹰法庭=Court of Owls/Tòa án Cú
九头蛇=Hydra/Cửu Đầu Xà
哥谭=Gotham
漫威=Marvel
利维坦=Leviathan
黑暗之王=Dark King
死神=Thần Chết
伊丽莎白=Elizabeth
章鱼小丸子=Takoyaki
亚玛达姆=Amadam
龙骑=Ryuki
夜骑=Knight
王牌=Át chủ bài
纳斯卡=Nazca
年糕=mochi
青龙=Thanh Long
盖亚=Gaia
恐惧=Khủng Bố
第318章=Chương 318
Kuuga=Kuuga
獠牙=Fang
红心2=Trái Tim Đỏ 2
千叶县=Tỉnh Chiba
五代=Godai
一条=Ichijo
吉恩=Jean
樱子=Sakurako
东京都=Tokyo
警视厅=Sở Cảnh sát
黑神=Hắc Thần
骑士学院=Học viện Hiệp sĩ
东京=Tokyo
宇宙能量=Năng lượng vũ trụ
天高=Trường Tenko
星徒=Starters
冴子=Saeko
若菜=Wak菜
刹那=Setsuna
泥娃娃=Bùn oa oa
达古巴=Daguva
鲨鱼=Cá mập
鲸鱼=Cá voi
索鲁=Solu
Arcle=Arcle
疾风剑=Hayate Sword
影月=Kagemoon
凯普敦·玛贝拉斯=Thuyền trưởng Marvelous
古朗基=Gurongi
米克=Mik
博物馆=Bảo tàng
海东大树=Kaito Daiki
菲利普=Philip
镜世界=Thế giới Gương
海拉=Hela
伊甸园=Vườn Địa Đàng
夏娃=Eva
亚当=Adam
黑影=Kurokage/Hắc Ảnh
假面骑士=Kamen Rider
巴隆=Baron
葡萄=Grape
皮卡=Pika
鸣泷=Narutaki
世界树=Yggdrasil/Thế Giới Thụ/Cây Thế Giới
空我=Kuuga
天守阁=Tenshukaku
家康=Ieyasu
亚古鲁=Agul
操真晴人=Souma Haruto
芒果=Mango
奇异果=Kiwi
香蕉=Banana
柠檬=Lemon
凤梨=Pine
火龙果=Dragon
黄金果实=Hoàng Kim Quả Thực
西德=Tây Đức
斩月=Trảm Nguyệt
大西瓜=Dưa hấu lớn
相良=Sagara
龙玄=Ryugen
海姆冥界=Heim Helheim
学生会长=Hội trưởng hội sinh viên
火狱=Hỏa Ngục
食梦=Thực Mộng
镜花水月=Kính Hoa Thủy Nguyệt
典狱长=Điển Ngục Trưởng
方云=Phương Vân
溪流=Khe suối
老秦=Lão Tần
真理之门=Chân Lý Chi Môn
迷雾森林=Mê Vụ Sâm Lâm
灵界=Linh Giới
夜王=Dạ Vương
鬼灭之刃=Thanh Gươm Diệt Quỷ
长老之眼=Trưởng Lão Chi Nhãn
死亡凝视=Tử Vong Ngưng Thị
生命古树=Sinh Mệnh Cổ Thụ
城西=Thành Tây
华夏=Hoa Hạ
木灵=Mộc Linh
小仓鼠=Tiểu Thương Thử
刘姥姥=Lưu Lão Lão
大观园=Đại Quan Viên
小猫=Tiểu Miêu
血骷髅=Huyết Khô Lâu
向阳花=Hướng Dương Hoa
起点=Khởi Điểm
绿豆=Đậu Xanh
王宇=Vương Vũ
老张=Lão Trương
王雨=Vương Vũ
老徐=Lão Từ
十冠王=Thập Quán Vương
仙人掌=Tiên Nhân Chưởng
阿鱼=A Ngư
九指=Cửu Chỉ
自然之心=Tự Nhiên Chi Tâm
血狼=Huyết Lang
鼠帝=Thử Đế
唐僧肉=Thịt Đường Tăng
大地之母=Đại Địa Chi Mẫu
梦魇=Mộng Yểm/Ác Mộng
幽海=U Hải
织女=Chức Nữ
李芸=Lý Vân
方瑶=Phương Dao
貂蝉=Điêu Thuyền
许乐=Hứa Lạc
王罕=Vương Hãn
纯白教会=Thuần Bạch Giáo Hội
龙王=Long Vương
齐云=Tề Vân
鬼灭=Quỷ Diệt
魔云=Ma Vân
司徒=Tư Đồ
刘贤=Lưu Hiền
张牧=Trương Mục
邪眼暴君=Tà Nhãn Bạo Quân
表演者=Biểu Diễn Giả
八指=Bát Chỉ
秦大爷=Tần đại gia
桃花林=Đào Hoa Lâm
吕布=Lữ Bố
兰花螳螂=Lan Hoa Đường Lang
神话时代=Thần Thoại Thời Đại
轮回之地=Luân Hồi Chi Địa
轮回=Luân Hồi
黄泉地狱=Hoàng Tuyền Địa Ngục
绿毛虫=Lục Mao Trùng
桃桃=Đào Đào
山妖=Sơn Yêu
美人鱼=Mỹ Nhân Ngư
巨头级=Cự Đầu Cấp
塞壬=Tây Ren
洞玄子=Động Huyền Tử
极乐天国=Cực Lạc Thiên Quốc
高鸿=Cao Hồng
兽人=Thú Nhân
倍化=Bội Hóa
彦祖=Ngạn Tổ
易先生=Tiên Sinh Dịch
看门人=Người Gác Cổng
创造者=Người Sáng Tạo
奇迹=Kỳ Tích
精灵圣女=Tinh Linh Thánh Nữ
吉星高照=Cát Tinh Cao Chiếu
齐天=Tề Thiên
蛛丝=Chu Tư
黄泉水=Hoàng Tuyền Thủy
灵灯=Linh Đăng
青金色=Thanh Kim Sắc
杨凯=Dương Khải
黑石城=Hắc Thạch Thành
汤谷=Thang Cốc
食客=Thực Khách
蜂后=Phong Hậu
赵斌=Triệu Bân
地狱火=Địa Ngục Hỏa
超凡入圣=Siêu Phàm Nhập Thánh
君主=Quân Chủ
精灵公主=Tinh Linh Công Chúa
阳春面=Dương Xuân Diện
祸福相依=Hoạ Phúc Tương Y
清月=Thanh Nguyệt
辛家=Tân gia
饱食=Bão Thực
骨龙=Cốt Long
月露=Nguyệt Lộ
猿猴=Viên Hầu
大主教=Đại Chủ Giáo
缩小=Thu Nhỏ
上位者=Thượng Vị Giả
清蒸=Thanh Chưng
红烧=Hồng Thiêu
摄魂=Nhiếp Hồn
王主管=Vương Chủ Quản
绿龙=Lục Long
龙鹰=Long Ưng
幽魂=U Hồn
赵文=Triệu Văn
星辰=Tinh Thần
大域=Đại vực
白丝=Tất trắng
尸鬼=Thi Quỷ
小曦=Tiểu Hi
弱水=Nhược Thủy
韩琼=Hàn Quỳnh
林家=Lâm Gia/Lâm gia
张喜=Trương Hỉ
冥河=Minh Hà
圣母=Thánh Mẫu
活阎王=Hoạt Diêm Vương
勾魂使者=Câu Hồn Sứ Giả
曹贼=Tào Tặc
圣光=Thánh Quang
冥府=Minh Phủ/Địa phủ
刘爷爷=Lưu gia gia
血魔=Huyết Ma
极北之地=Cực Bắc Chi Địa
李派太极=Lý Phái Thái Cực
血羽=Huyết Vũ
雷牛=Lôi Ngưu
藏剑=Tàng Kiếm
云鲸=Vân Kình
徐老爷子=Từ Lão gia tử
考古系=Hệ Khảo Cổ
董大爷=Đổng đại gia
茅家=Mao gia
重庆=Trùng Khánh
月落星沉=Nguyệt Lạc Tinh Trầm
月亮=Nguyệt Lượng
星神=Tinh Thần
死星=Tử Tinh
奴兽=Nô Thú
边境=Biên Cảnh
文明=Văn Minh
律法=Luật Pháp
安海=An Hải
骑士王=Kỵ Sĩ Vương
眼魔=Nhãn Ma
深渊魔神=Thâm Uyên Ma Thần
大占星师=Đại Chiêm Tinh Sư
圣城=Thánh Thành
新人王=Tân Nhân Vương
腐朽=Decay
丰收=Harvest
圣子=Holy Son
教宗=Pope
恒定=Constancy
邵家=Thiệu Gia
虚剑=Hư Kiếm
纸墙=Chỉ Tường
黑潮=Hắc Triều
冯玉=Phùng Ngọc
韦天=Vi Vĩ Thiên
洛家=Lạc Gia
韩家=Hàn Gia
黑暗金字塔=Hắc Ám Kim Tự Tháp
王境=Vương Cảnh
校长=Hiệu Trưởng
五行=Ngũ Hành
风雷雨电=Phong Lôi Vũ Điện
恒沙世界=Hằng Sa Thế Giới
黄庭道经=Hoàng Đình Đạo Kinh
黑月=Hắc Nguyệt
御兽师=Ngự Thú Sư
灰飞烟灭=Hôi Phi Yên Diệt
黄金=Hoàng Kim
韩宁=Hàn Ninh
食人古树=Cây Cổ Thụ Ăn Thịt Người
江家=Giang gia/Giang Gia
马甲=Mã Giáp
第303章=Chương 303
黑莲=Hắc Liên
月魔=Nguyệt Ma
月兽=Nguyệt Thú
审判庭=Thẩm Phán Đình
庆典=Khánh Điển
精灵一族=Tinh Linh Nhất Tộc
炎帝=Viêm Đế
黑市=Hắc Thị
道德天尊=Đạo Đức Thiên Tôn
星辰系=Tinh Thần Hệ
冥土=Minh Thổ
霸道=Bá Đạo
薯片=Khoai Tây Chiên
雷音=Lôi Âm
雷纹=Lôi Văn
九重天=Cửu Trọng Thiên
卜算=Bốc Toán
虚化=Hư Hóa
秘银=Mật Ngân
黎家=Lê Gia
圣甲=Thánh Giáp
齿轮=Xỉ Luân
高宇=Cao Vũ
春日=Xuân Nhật
夏季=Hạ Quý
机械系=Cơ Giới Hệ
陈述句=Trần Thuật Cú
虚无=Hư Vô
编织=Biên Chức
悦悦=Duyệt Duyệt
帝都=Đế Đô
小吴=Tiểu Ngô
阿修罗=A Tu La/Asura
龙蚁=Long Nghĩ
神威=Thần Uy
灵姬=Linh Cơ
永不放弃=Vĩnh Bất Phóng Khí
世界小姐=Thế Giới Tiểu Thư
吴老头=Ngô Lão Đầu
圣王=Thánh Vương
地皇=Địa Hoàng
圣诞节=Lễ Giáng Sinh
春节=Tết Xuân
浊火=Trọc Hỏa
冷焰=Lãnh Diệm
时光=Thời Quang
秩序=Trật Tự/Trật tự
阴阳=Âm Dương
永恒=Vĩnh Hằng
智慧=Trí Tuệ
殿下=Điện hạ
苍石=Thương Thạch
星辰果树=Tinh Thần Quả Thụ
古王=Cổ Vương
厄运=Ách Vận
旱灾=Hạn Tai
枯木逢春=Khô Mộc Phùng Xuân
秋收冬藏=Thu Thu Đông Tàng
佛祖=Phật Tổ
金刚藏菩萨=Kim Cang Tạng Bồ Tát
周叔=Chu Thúc
黑夜=Hắc Dạ
杨文泉=Dương Văn Tuyền
杨家=Dương Gia
役鬼=Dịch Quỷ
孙仲=Tôn Trọng
风暴之眼=Phong Bạo Chi Nhãn
万古=Vạn Cổ
虚空之门=Cổng Hư Không
真言=Chân Ngôn
渡厄=Độ Ách
因果之力=Nhân Quả Chi Lực
希望之灯=Hy Vọng Chi Đăng
置之死地而后生=Đặt vào chỗ chết rồi hồi sinh
魂丝=Hồn Ti
衰老=Suy Lão
历史=Lịch Sử
迟缓=Trì Hoãn
血虎=Huyết Hổ
暗日=Ám Nhật
禁忌=Cấm Kỵ
心猿=Tâm Viên
苍龙=Thương Long
东方家=Đông Phương Gia
屠夫=Đồ Phu
慈父=Từ Phụ
梦幻泡影=Mộng Ảo Bào Ảnh
人族联盟=Nhân Tộc Liên Minh
世界=Thế Giới
秩序之剑=Trật Tự Chi Kiếm
太阳国度=Thái Dương Quốc Độ
荆棘=Kinh Cức
苍云=Thương Vân
青鸟=Thanh Điểu
赤神=Xích Thần
晨星=Thần Tinh
辉月=Huy Nguyệt
轮回之眼=Luân Hồi Chi Nhãn
灰烬=Hôi Tẫn
兽王=Thú Vương
高等生命=Cao Đẳng Sinh Mệnh
三相世界=Tam Tướng Thế Giới
回头是岸=Quay Đầu Là Bờ
善尸=Thiện Thi
黄昏=Hoàng Hôn
布丁=Bánh pudding
主宰=Chúa Tể
天人五衰=Thiên Nhân Ngũ Suy
饿鬼道=Ngạ Quỷ Đạo
联盟总部=Liên Minh Tổng Bộ
元家=Nguyên Gia
第三指=Đệ Tam Chỉ
云狮=Vân Sư
蚀日=Thực Nhật
救赎蔷薇=Cứu Thục Tường Vi
风暴城=Phong Bạo Thành
法眼=Pháp Nhãn
老洛=Lão Lạc
天理教=Thiên Lý Giáo
洛阳=Lạc Dương
桥山=Kiều Sơn
黄帝=Hoàng Đế
司天监=Tư Thiên Giám
武曌=Võ Chiếu
太上=Thái Thượng
鬼车=Quỷ Xa
大周皇朝=Đại Chu hoàng triều
武家=Võ gia
黎山=Lê Sơn
斗姆元君=Đẩu Mỗ Nguyên Quân/Đẩu Mẫu Nguyên Quân
北斗七星=Bắc Đẩu Thất Tinh
无当圣母=Vô Đương Thánh Mẫu
元始天尊=Nguyên Thủy Thiên Tôn
西游记=Tây Du Ký
秦始皇=Tần Thủy Hoàng
骊山=Ly Sơn
女娲=Nữ Oa
华胥氏=Hoa Tư Thị
伏羲氏=Phục Hy Thị
黑山老妖=Hắc Sơn Lão Yêu
燕赤霞=Yến Xích Hà
哮天犬=Hao Thiên Khuyển
吞日神君=Thôn Nhật Thần Quân
二郎神=Nhị Lang Thần
五庄观=Ngũ Trang Quan
镇元子=Trấn Nguyên Tử
道尊=Đạo Tôn
骊山老母=Ly Sơn Lão Mẫu
大羿=Đại Nghệ
西王母=Tây Vương Mẫu
吴刚=Ngô Cương
大唐=Đại Đường
太平公主=Thái Bình công chúa
上官婉儿=Thượng Quan Uyển Nhi
晋朝=Tấn triều
天师道=Thiên Sư Đạo
大母=Đại Mẫu
女帝=Nữ Đế
太岁=Thái Tuế
天界之光=Thiên Giới Chi Quang
精灵族=Tinh Linh Tộc
黑暗之血=Hắc Ám Chi Huyết
熔岩巨人=Dung Nham Cự Nhân
莉莉丝=Lệ Lệ Ti
狂战=Cuồng Chiến
极速=Cực Tốc
赤月=Xích Nguyệt
天凰=Thiên Hoàng
魅魔=Mị Ma
圣经=Thánh Kinh
大天使=Đại Thiên Sứ
九曲黄河阵=Cửu Khúc Hoàng Hà Trận
大罗金仙=Đại La Kim Tiên
三霄娘娘=Tam Tiêu Nương Nương
圣人=Thánh Nhân/Thánh nhân
黑暗时代=Hắc Ám Thời Đại
百臂魔神=Bách T臂 Ma Thần
洪福=Hồng Phúc
冥界=Minh Giới/Minh giới
古凰族=Cổ Hoàng Tộc
真理之主=Chân Lý Chi Chủ
胚胎=Phôi Thai
深渊炎魔=Thâm Uyên Viêm Ma
深渊领主=Thâm Uyên Lãnh Chúa
深渊意志=Ý Chí Vực Sâu
七环=Thất Hoàn
亚龙=Á Long
深渊=Vực Sâu/Vực Thẳm
古魔=Cổ Ma
轮回之主=Luân Hồi Chi Chủ
大蟾气=Đại Thiềm Khí
死亡=Tử Vong
混沌=Hỗn Độn
谬论=Mâu Luận
昌盛=Xương Thịnh
神子=Thần Tử
大黑天=Đại Hắc Thiên
尘世=Trần Thế
雾海=Vụ Hải
小赤兔=Tiểu Xích Thố
圣女=Thánh Nữ/Thánh nữ
人类联盟=Nhân Loại Liên Minh
天顶=Thiên Đỉnh
赤王=Xích Vương
会长=Hội trưởng
嘉兰诺德=Gia Lan Nặc Đức
米娅=Mễ Á
自然之绿=Tự Nhiên Chi Lục
伊普吉尔=Y Purgil
苦海=Khổ Hải
力天使=Lực Thiên Sứ
智天使=Trí Thiên Sứ
权天使=Quyền Thiên Sứ
座天使=Tọa Thiên Sứ
能天使=Năng Thiên Sứ
尘土=Trần Thổ
深红=Thâm Hồng
腐败=Hủ Bại
丰饶=Phong Nhiêu
奥义=Áo Nghĩa
灵神=Linh Thần
墨勒忒=Mặc Lặc Đặc
太阳=Thái Dương
太阳王=Thái Dương Vương
旧日=Cựu Nhật
精灵女皇=Tinh linh nữ hoàng
天尊=Thiên tôn
赫连家=Hách Liên Gia
花里胡哨的=Hoa Lý Hồ Thiếu Đích
逐日=Trục Nhật
月乌=Nguyệt Ô
月主=Nguyệt Chủ
成龙历险记=Câu Chuyện Về Thành Long
咒蓝=Chú Lam
门徒=Môn Đồ/Môn đồ
古龙=Cổ Long
牧场=Mục Trường
黄粱一梦=Hoàng Lương Nhất Mộng
真理=Chân Lý
天昼=Thiên Trú
万古巨头=Vạn Cổ Cự Đầu
叶家=Diệp gia
伪王=Ngụy Vương
真王=Chân Vương
王国=Vương quốc
联盟=Liên minh
黑山羊=Hắc Sơn Dương
诸王=Chư Vương
王庭=Vương Đình
星界=Tinh Giới
雪灾=Tuyết Tai
饥荒=Cơ Hoang
白塔=Bạch Tháp
王家=Vương gia/Vương Gia
苗峰=Miêu Phong
童家=Đồng gia
渊姬=Uyên Cơ
沐家=Mộc gia
王辉=Vương Huy
方青=Phương Thanh
大主母=Đại Chủ Mẫu
人族=Nhân tộc/Nhân Tộc
大渊=Đại Uyên
万族=Vạn tộc
主世界=Chủ Thế Giới
母河=Mẫu Hà
半神=Bán Thần
诸界=Chư Giới/Chư giới
破界石=Phá Giới Thạch
天主=Chúa Trời
炽天使=Thiên Sứ Rực Lửa
至高天=Chí Cao Thiên
基路伯=Cơ Lộ Bá
冥神=Minh Thần
象主=Tượng Chủ
地王=Địa Vương
象神=Tượng Thần
童叶=Đồng Diệp
械神=Giới Thần
上帝=Thượng Đế
赵婉=Triệu Uyển
司徒空=Tư Đồ Không
陆羽=Lục Vũ
小蜘蛛=Tiểu Tri Chu
蛋蛋=Đản Đản
赤兔=Xích Thố
小玉=Tiểu Ngọc
白狐=Bạch Hồ
收藏家=Sưu Tàng Gia/The Collector
伐楼拿=Phạt Lâu Na
灵鱼马特斯亚=Linh Ngư Matsya
夜叉=Dạ Xoa
阿周那=Arjuna
金翅大鹏=Kim Sí Đại Bằng
须弥芥子=Tu Di Giới Tử
眉心轮=Mi Tâm Luân
顶轮=Đỉnh Luân
梵我合一=Phạm Ngã Hợp Nhất
摩诃婆罗多=Mahabharata
摩诃=Ma Ha
太阳神殿=Đền Thần Mặt Trời
狮鹫=Sư Ưng
蓝光=Lam Quang
陈云=Trần Vân
吴明=Ngô Minh
山羊=Dê
羚羊=Linh Dương
圣餐=Thánh thiện
海螺=Ốc xà cừ
月宫=Nguyệt Cung
神马=Thần Mã
青狮=Thanh Sư
妙相=Diệu Tướng
阿修罗界=A Tu La Giới
月神殿=Nguyệt Thần Điện
塔拉=Tháp Lạp
甘露=Amrita
第259章=Chương 259
神甲=Thần Giáp
第275章=Chương 275
蛇族=Tộc rắn
斗宿=Đẩu Túc
六月=Tháng Sáu
美娜=Mina
群山=Quần Sơn
阎浮提=Jambudvipa
婆稚=Vamana
希雅=Hi Á
神矛=Thần mâu
梵仙=Phạn Tiên
阿达=Ada
五色孔雀=Khổng Tước Ngũ Sắc
金眼=Kim Nhãn
宽阔=Khoan Khoát
激流=Kích Lưu
财神=Thần Tài/Tài Thần
力主=Lực Chủ
卡库=Kaku
须弥=Tu Di
水神=Thần Nước/Thủy Thần
火神=Thần Lửa
巴图克=Batuque
步摇=Bộ Dao
多福=Đa Phúc
姜黄粉=Bột nghệ
迷醉=Mê Túy
战神=Chiến Thần
舞王=Vũ Vương
辉煌=Huy Hoàng
高丽=Gauri
阿特曼=Atman
神杵=Thần Xử
摩利=Malli
主母=Chủ Mẫu
迦娜=Gana
提婆达多=Devadatta
正法=Chánh Pháp
五识=Ngũ Thức
五体=Ngũ Thể
取胜=Thắng Lợi
繁荣=Phồn Vinh
王冠=Vương miện
永劫回归=Vĩnh Kiếp Quy Hồi
青天=Thanh Thiên
仙人们=Các vị Tiên
苦行者=Khổ hạnh giả
日轮=Nhật Luân
万相=Vạn Tướng
计都=Ketu
计都星=Sao Kế Đô
迦罗=Kala
第511章=Chương 511
黄金之城=Thành phố vàng
莲花落=Liên Hoa Lạc
罗摩衍那=Luómóyǎnà
焚烬=Phần Tẫn
大地女神=Đại Địa Nữ Thần
三叉戟=Tam Xoa Kích
金刚=Kim Cang/King Kong
雪山=Tuyết Sơn
鸠摩罗=Kumara
第564章=Chương 564
昌德=Chanda
蒙德=Munda
宇智波=Uchiha
摩羯=Ma Yết
由旬=Do Tuần
大地=Đại Địa
五指山=Ngũ Chỉ Sơn
孔雀=Khổng Tước
石像=Tượng đá
阿修罗王=A Tu La Vương
马首=Mã Thủ
曼陀罗花=Hoa Mạn Đà La
九曜星=Cửu Diệu Tinh
摩图=Ma Đồ
黑天=Hắc Thiên
伽罗=Kala
金星=Kim Tinh
菩提叶=Bồ Đề Diệp
奎师那=Khuê Sư Na
吠陀经=Phệ Đà Kinh
大梵天=Đại Phạm Thiên
光辉之城=Quang Huy Chi Thành
九龙=Cửu Long
巴利=Bali
萨蒂=Sati
三相神=Trimurti
伊拉=Y Lạp
恶鬼=Ác Quỷ
迦那=Già Na
吠陀=Veda
菩提老祖=Bồ Đề Lão Tổ
风神=Thần Gió
宝贤=Ratnagarbha
老师=Lão sư
转轮圣王=Chuyển Luân Thánh Vương
人界=Nhân Giới
楞伽=Lăng Già
白马=Bạch Mã
蛇界=Xà Giới
婆苏吉=Vasuki
妙颜=Diệu Nhan
星目=Tinh Mục
金刚身=Kim Cang Thân
狮头=Sư Đầu
蛇女=Xà Nữ
班达=Ban Đạt
神光=Thần Quang
广袤=Quảng Mậu
伽罗尼弥=Già La Ni Di
金目=Kim Mục
天日=Thiên Nhật
美发=Mỹ Phát
独目=Độc Mục
乳海=Nhũ Hải
月神=Nguyệt Thần
黑面=Hắc Diện
持斧罗摩=Trì Phủ La Ma
血种=Huyết Chủng
天帝=Thiên Đế
苏摩=Tô Ma
血城=Huyết Thành
毗卢遮那=Tỳ Lô Già Na
罗睺=La Hầu
乾达婆=Càn-thát-bà
康巴哈那=Kumbhakarna
弥迦那陀=Mê Già Na Đà
俱毗罗=Câu Tỳ La
迦楼罗=Già Lâu La/Ca Lâu La
里拉=Lila
千眼=Thiên Nhãn
四大部洲=Tứ Đại Bộ Châu
彩虹桥=Cầu vồng/Cầu Vồng
波林=Ba Lâm
时轮=thời luân
哈奴曼=Hanuman
娑罗树=cây Sa La
曼陀罗=Mạn Đà La
迦尔纳=Karna
三界=Tam Giới
地界=Địa Giới
罗什曼那=La Thập Mạn Na
摩罗=Ma La
金刚杵=Kim Cang Chử
三十三天=Tam Thập Tam Thiên
娑罗室伐底=Sarasvati
娜迦=Naga
摩耶=Maya
罗刹=La sát/La Sát
药叉=Dược Xoa
恒河=Hằng Hà
罗波那=La Bà Na
迦摩=Ca Ma
阎摩=Diêm Ma
因陀罗=Nhân Đà La
梵天=Phạm Thiên
毗湿奴=Tỳ Thấp Nô
苏利耶=Tô Lợi Gia
迦梨=Già Lê
罗摩=La Ma
悉多=Tất Đa
帕尔瓦蒂=Ba Lạp Ngõa Đề
湿婆=Thấp Bà
七星门=Thất Tinh Môn
七皇子=Thất Hoàng Tử
万法殿=Vạn Pháp Điện
万魂幡=Vạn Hồn Phiên
三一门=Tam Nhất Môn
三公主=Tam Công Chúa
三眼=Tam Nhãn
东天门=Đông Thiên Môn
东山=Đông Sơn
东市=Đông Thị
东海城=Đông Hải Thành
丹药殿=Đan Dược Điện
丹阳子=Đan Dương Tử
九号=Cửu Hào
云州=Vân Châu
五皇子=Ngũ hoàng tử
京城=Kinh Thành
京都=Kinh Đô
仙宗=Tiên Tông
仙尊=Tiên Tôn
仙庭=Tiên Đình
伏波将军=Phục Ba Tướng Quân
伏长老=Phục trưởng lão
会阴=Hội Âm
传法殿=Truyền Pháp Điện
何将军=Hà Tướng Quân
何阳=Hà Dương
佛陀=Phật Đà
侯爷=Hầu gia
先帝=Tiên Đế
六皇子=Lục Hoàng Tử
兵部=Binh Bộ
兽神=Thú Thần
兽血=Thú Huyết
冬梅=Đông Mai
冯京=Phùng Kinh
冯先生=Phùng tiên sinh
刀大人=Đao Đại Nhân
刀舵主=Đao Đà Chủ
刘兄=Lưu huynh
刘全=Lưu Toàn
刘公子=Lưu công tử
刘大人=Lưu đại nhân
刘家=Lưu Gia/Lưu gia
刘师兄=Lưu sư huynh
刘彪=Lưu Bưu
刘捕头=Lưu Bộ Đầu
刘杨=Lưu Dương
刘福=Lưu Phúc
刘芳=Lưu Phương
刘通=Lưu Thông
刘镇=Lưu Trấn
刘震=Lưu Chấn
剑南=Kiếm Nam
剑圣=Kiếm Thánh
北原=Bắc Nguyên
北国=Bắc Quốc
北天门=Bắc Thiên Môn
北漠=Bắc Mạc
北蛮=Bắc Man
十万大山=Thập Vạn Đại Sơn
十三皇子=Thập Tam hoàng tử
午门=Ngọ Môn
南地=Nam Địa
南境=Nam Cảnh
南天门=Nam Thiên Môn
南山寺=chùa Nam Sơn
南巫=Nam Vu
南海=Nam Hải
南海仙翁=Nam Hải Tiên Ông
南疆=Nam Cương
卢大人=Lư đại nhân
卫国公=Vệ Quốc Công
县衙=Huyện Nha
司命星君=Tư Mệnh Tinh Quân
司礼监=Tư Lễ Giám
吏部侍郎=Lại Bộ Thị Lang
吴掌柜=Ngô chưởng quỹ
周副舵主=Chu Phó Đà Chủ
周定海=Chu Định Hải
周瑞=Chu Thụy
周虎=Chu Hổ
周长老=Chu trưởng lão
呼延灼=Hô Diên Chước
唐副盟主=Đường phó minh chủ
唐姑娘=Đường cô nương
唐盟主=Đường minh chủ
国主=Quốc chủ
国师=Quốc Sư
圣主=Thánh Chủ
圣师=Thánh Sư
圣旨=Thánh chỉ
圣皇=Thánh Hoàng
城主府=Thành Chủ Phủ
夏姑娘=Hạ cô nương
多宝道人=Đa Bảo đạo nhân
大宛马=Đại Uyển mã
大巫=Đại Vu
大巫师=Đại Vu Sư
大玄=Đại Huyền
大理寺=Đại Lý Tự
大红=Đại Hồng
大虞=Đại Ngu
天一=Thiên Nhất
天南=Thiên Nam
天地盟=Thiên Địa Minh
天机阁=Thiên Cơ Các
天武=Thiên Võ
天门=Thiên Môn
天香阁=Thiên Hương Các
太后=Thái Hậu/Thái hậu
太子=Thái Tử/Thái tử
太监=Thái Giám
太祖=Thái Tổ
太祖皇帝=Thái Tổ Hoàng đế
夹脊=Giáp Tích
夺魂剑=Đoạt Hồn Kiếm
奉天殿=Phụng Thiên Điện
妖潮=Yêu triều
姚雪=Diêu Tuyết
姜大人=Khương đại nhân
姜老弟=Khương Lão Đệ
姜长老=Khương trưởng lão
孔师兄=Khổng sư huynh
孔明=Khổng Minh
孙明=Tôn Minh
孙萱=Tôn Huyên
孙长老=Tôn trưởng lão
宁盟主=Ninh Minh Chủ
安南=An Nam
安南侯=An Nam Hầu
宋初=Tống Sơ
宋大人=Tống đại nhân
宋家=Tống Gia
宋时=Tống Thời
宋明=Tống Minh
定远侯=Định Viễn Hầu
将军府=Tướng Quân Phủ
小世子=Tiểu Thế Tử
小旗=Tiểu kỳ
小河沟=Tiểu Hà Câu
小白=Tiểu Bạch
小翠=Tiểu Thúy
小雪=Tiểu Tuyết
小马=Tiểu Mã
尾闾=Vĩ Lư
崔家=Thôi gia/Thôi Gia
崔氏=Thôi Thị/Thôi thị
崖州=Nhai Châu
工部=Công Bộ
巨门=Cự Môn
巫国=Vu Quốc
巫庭=Vu Đình
巫族=Vu Tộc
巫皇=Vu Hoàng
市舶司=Thị Bạc Tư
幕僚=Mạc Liêu
平远伯=Bá tước Bình Viễn
幻眼=Huyễn Nhãn
庄家=Trang gia
庄知县=Trang Tri Huyện
应龙=Ứng Long
府衙=Phủ nha
张兄=Trương huynh
张先生=Trương tiên sinh
张凡=Trương Phàm
张副舵主=Trương phó đà chủ
张合=Trương Hợp
张大人=Trương đại nhân
张宗主=Trương Tông chủ
张家=Trương gia/Trương Gia
张府=Trương phủ
张扬=Trương Dương
张知县=Trương Tri Huyện
张老道=Trương lão đạo
张记=Trương Ký
张豪=Trương Hào
张首辅=Trương Thủ Phụ
彭虎=Bành Hổ
徐前辈=Từ tiền bối
徐大人=Từ đại nhân
徐玄=Từ Huyền
徐翔=Từ Tường
徐道长=Từ Đạo Trưởng
徐问=Từ Vấn
忠义堂=Trung Nghĩa Đường
慕容=Mộ Dung
慧眼=Tuệ Nhãn
戒律堂=Giới Luật Đường
户部=Hộ Bộ
提督=Đề đốc
教坊司=Giáo Phường Tư
文渊阁=Văn Uyên Các
方华=Phương Hoa
明光宗=Minh Quang Tông
春暖=Xuân Noãn
春风=Xuân Phong
春风堂=Xuân Phong Đường
暗卫=Ám Vệ
曹大人=Tào đại nhân
曹威=Tào Uy
曹将军=Tào tướng quân
曾江=Tằng Giang
朝廷=Triều đình/Triều Đình
朱宅=Chu Trạch
朱家=Chu Gia
朱师兄=Chu sư huynh
朱师弟=Chu sư đệ
朱平=Chu Bình
朱灵=Chu Linh
朱烈=Chu Liệt
朱管事=Chu Quản Sự
朱管家=Chu Quản Gia
朱道友=Chu đạo hữu
李县丞=Lý huyện thừa
李大人=Lý đại nhân
李头儿=Lý đầu nhi
李宅=Lý Trạch
李府=Lý phủ
李老哥=Lý Lão Ca
李锐=Lý Duệ
杨三=Dương Tam
杨勇=Dương Dũng
杨叔=Chú Dương
杨恒=Dương Hằng
杨统领=Thống lĩnh Dương/Dương Thống lĩnh
林副会长=Lâm Phó Hội Trưởng
林姑娘=Lâm cô nương
林婉=Lâm Uyển
林海=Lâm Hải
林老爷子=Lâm lão gia tử
柳先生=Liễu tiên sinh
柳叶刀=Liễu Diệp Đao
柳青=Liễu Thanh
柴大人=Sài đại nhân
柴帮=Sài Bang
桂山=Quế Sơn
桑大人=Tang đại nhân
梁师兄=Lương sư huynh
梁河=Lương Hà
梁老弟=Lâm lão đệ
楚道友=Sở đạo hữu
武库=Vũ Khố
武曲=Vũ Khúc
武清=Võ Thanh
武长老=Võ trưởng lão
段玉=Đoạn Ngọc
水之大道=Thủy chi đại đạo
江东=Giang Đông
江南=Giang Nam
江州=Giang Châu
洪公公=Hồng công công
洪晃=Hồng Hoảng
洪蒙=Hồng Mông
海州=Hải Châu
清微宗=Thanh Vi Tông
清水河=Thanh Thủy Hà
清河=Thanh Hà
清风道长=Thanh Phong Đạo Trưởng
游击将军=Du kích Tướng quân
潜龙勿用=Tiềm Long Vật Dụng
烈焰丹=Liệt Diệm Đan
狴犴=Bệ Ngạn
玄儿=Huyền Nhi
玄元观=Huyền Nguyên Quan
玄微=Huyền Vi
玄甲军=Huyền Giáp Quân
玄诚=Huyền Thành
玄诚道人=Huyền Thành đạo nhân
玄诚道长=Huyền Thành đạo trưởng
玉枕=Ngọc Chẩm
王侍郎=Vương Thị Lang
王大人=Vương đại nhân
王将军=Vương tướng quân
王朴=Vương Phác
王福=Vương Phúc
玖月=Cửu Nguyệt
玲珑心窍=Linh Lung Tâm Khiếu
白家=Bạch Gia
白蛟=Bạch Giao
白长老=Bạch trưởng lão
白鹤楼=Bạch Hạc Lâu
百战门=Bách Chiến Môn
皇城=Hoàng Thành
皇帝=Hoàng đế
盐帮=Diêm Bang
盛道友=Thịnh Đạo Hữu
盟主=Minh chủ
直隶=Trực Lệ
真龙之气=Chân Long Chi Khí
知府大人=Tri phủ đại nhân
石碑=Thạch Bi
石舟=Thạch Chu
破军=Phá Quân
碧水金睛兽=Bích Thủy Kim Tinh Thú
礼部=Lễ Bộ
礼部侍郎=Lễ Bộ Thị Lang
祁氏=Kỳ Thị
祁贵妃=Kỳ Quý Phi
祁锋=Kỳ Phong
神兵山庄=Thần Binh sơn trang
神武门=Thần Võ Môn
神魂丹=Thần Hồn Đan
秦火=Tần Hỏa
积水潭=Tích Thủy Đàm
符箓=Phù Lục
紫阳=Tử Dương
紫阳真人=Tử Dương Chân Nhân
紫阳道人=Tử Dương Đạo Nhân
红梅=Hồng Mai
终日乾乾=Chung Nhật Càn Càn
绫罗=Lăng La
绿珠儿=Lục Châu Nhi
罗天大醮=La Thiên Đại Tiếu
老刘=Lão Lưu
老杨=Lão Dương
老段=Lão Đoạn
老猿=Lão Viên
老祖=Lão Tổ
老蛟=Lão Giao
老郑=Lão Trịnh
聂将军=Nhiếp tướng quân
聚义堂=Tụ Nghĩa Đường
胡六=Hồ Lục
胡长老=Hồ trưởng lão
苏萱=Tô Huyên
药堂=Dược Đường
萧羽=Tiêu Vũ
葛洪=Cát Hồng
蒙冲=Mông Xung
薛大将军=Tiết Đại tướng quân
薛贵=Tiết Quý
薛阳=Tiết Dương
藏锋=Tàng Phong
虎儿=Hổ Nhi
虎贲将军=Hổ Bí tướng quân
虞国=Ngu Quốc
虞朝=Triều đại Ngu
蛮族=Man Tộc
蜀中=Thục Trung
蜀地=Thục Địa
蜀山=Thục Sơn
蜀州=Thục Châu
螭龙=Xi Long
袁安=Viên An
袁雄=Viên Hùng
裘千丈=Cừu Thiên Trượng
裴大哥=裴 đại ca
西北=Tây Bắc
西天门=Tây Thiên Môn
西漠=Tây Mạc
见龙在田=Kiến Long Tại Điền
观海=Quan Hải
许舟=Hứa Chu
许风=Hứa Phong
谪仙人=Trích Tiên Nhân
贡院=Cống Viện
贪狼=Tham Lang
费明=Phí Minh
费老三=Fei Laosan
贺兰=Hạ Lan
贺大人=Hạ đại nhân
贺老弟=Hạ lão đệ
贾大人=Giả đại nhân
贾知县=Giả Tri Huyện
赤县神州=Xích Huyện Thần Châu
赵三=Triệu Tam
赵副舵主=Triệu phó đà chủ
赵大人=Triệu đại nhân
赵威=Triệu Uy
越王=Việt Vương
车船店脚牙=Xa thuyền điếm cước nha
道祖=Đạo Tổ
邓捕头=Đặng bộ đầu
郑公公=Trịnh công công
郭堂主=Quách đường chủ
都察院=Đô Sát Viện
醉仙楼=Túy Tiên Lâu
金光上人=Kim Quang Thượng Nhân
金虎=Kim Hổ
金骨=Kim Cốt
钟县丞=Chung Huyện Thừa
钟正=Chung Chính
钦天监=Khâm Thiên Giám
钦差=Khâm Sai/Khâm sai
钱副舵主=Tiền Phó Đà Chủ
钱瑞=Tiền Thụy
钱财=Tiền Tài
铁匠铺子=Tiệm rèn
铁柱=Thiết Trụ
铁狂=Thiết Cuồng
铁老头=Thiết Lão Đầu
锦衣卫=Cẩm Y Vệ
阳顶天=Dương Đỉnh Thiên
阿华=A Hoa
阿虎=A Hổ
阿青=A Thanh
陈先生=Trần tiên sinh
陈大人=Trần đại nhân
陈明=Trần Minh
陛下=Bệ hạ/Bệ Hạ
青州=Thanh Châu
青帝=Thanh Đế
青玄=Thanh Huyền
韓先生=Hàn tiên sinh
韩真=Hàn Chân
韩鹏=Hàn Bằng
顾先生=Cố Tiên Sinh
顾小子=Cố tiểu tử
顾楼主=Cố lâu chủ
顾长生=Cố Trường Sinh
颜大人=Nhan đại nhân
马兄=Mã huynh
马将军=Mã tướng quân
马师=Mã Sư
马师伯=Mã sư bá
马帮=Mã Bang
马烈=Mã Liệt
马玄=Mã Huyền
马西=Mã Tây
马长老=Mã trưởng lão
马阳=Mã Dương
高城主=Cao Thành Chủ
高天下=Cao Thiên Hạ
鬼妖=Quỷ Yêu
魏明=Ngụy Minh
魏王=Ngụy Vương
魏王府=Ngụy Vương Phủ
鲁大师=Lỗ đại sư
鲛人=Giao Nhân
鸿胪寺=Hồng Lô Tự
鹤前辈=Hạc tiền bối
鹤大人=Hạc Đại Nhân
鹰钩鼻=Ưng Câu Tị
黄盟主=Hoàng minh chủ
黄花梨木=Hoàng Hoa Lê Mộc
黑牢=Hắc Lao
黑白双煞=Hắc Bạch Song Sát
齐王=Tề Vương
龙庭=Long Đình
龙涎草=Long Diên Thảo
龙虎宗=Long Hổ Tông
龙门=Long Môn
龙骧将军=Long Tương tướng quân
孟公子=Mạnh công tử
黄府=Hoàng Phủ
狗尾巴草=Cẩu Vĩ Ba Thảo
王维=Vương Duy
何师兄=Hà sư huynh
鸡血石=Kê Huyết Thạch
方丈=Phương Trượng
梅超风=Mai Siêu Phong
仙树=Tiên Thụ
八珍鸡=Bát Trân Kê
高家庄=Cao Gia Trang
唐家堡=Đường Gia Bảo
净天地神咒=Tịnh Thiên Địa Thần Chú
王大=Vương Đại
王二=Vương Nhị
杨兴=Dương Hưng
避水珠=Tị Thủy Châu
法符=Pháp Phù
道法=Đạo Pháp
明光符=Minh Quang Phù
特殊物品=Vật phẩm đặc biệt
阴阳石=Âm Dương Thạch
齐律=Tề Luật
神女=Thần Nữ
张老板=Trương lão bản
火焰刀=Hỏa Diệm đao
贾兄=Giả huynh
城南=Thành Nam
县令=Huyện Lệnh
彭府=Bành phủ
王浩=Vương Hạo
素儿=Tố Nhi
夜游=Dạ Du
天母=Thiên Mẫu
千风=Thiên Phong
方天戟法=Phương Thiên Kích Pháp
银精=Ngân Tinh
姆士=Mỗ Sĩ
江畔=Giang Bạn
陈博=Trần Bác
沈大哥=Thẩm đại ca
斜月三星洞=Tà Nguyệt Tam Tinh Động
云岚宗=Vân Lam Tông
云山=Vân Sơn
赵光=Triệu Quang
派大星=Phái Đại Tinh
清泉兄=Thanh Tuyền Huynh
紫霄=Tử Tiêu
周老爷=Chu Lão Gia
太阴之力=Thái Âm chi lực
虾兵=Hà Binh
蟹将=Giải Tướng
血兽=Huyết Thú
明视=Minh Thị
蚌女=Bạng Nữ
虾兵蟹将=Hà binh Giải tướng
云家人=Vân Gia Nhân
太白金星=Thái Bạch Kim Tinh
高风=Cao Phong
高木=Cao Mộc
高宏=Cao Hoành
玄空子=Huyền Không Tử
长安=Trường An
方儿=Phương Nhi
小雪山=Tiểu Tuyết Sơn
蛟珠=Giao Châu
跃龙门=Dược Long Môn
杜甫=Đỗ Phủ
林冲=Lâm Xung
紫衣青年=Thanh niên áo tím
牛家村=Ngưu Gia Thôn
风花雪月=Phong Hoa Tuyết Nguyệt
山鬼=Sơn Quỷ
连城=Liên Thành
大楚=Đại Sở
陈胜=Trần Thắng
张伟=Trương Vĩ
李长老=Lý trưởng lão
云家家主=Vân Gia Gia Chủ
牛魔=Ngưu Ma
蛟魔=Giao Ma
阿莲=A Liên
黄天霸=Hoàng Thiên Bá
高元=Cao Nguyên
齐朝=Tề triều
小石=Tiểu Thạch
林主管=Lâm chủ quản
大师姐=Đại sư tỷ
三国=Tam quốc
方雪=Phương Tuyết
落雨=Lạc Vũ
圆月=Viên Nguyệt
寒石=Hàn Thạch
金龙=Kim Long
风鸣=Phong Minh
灵玄=Linh Huyền
梦境=Mộng Cảnh
阎罗=Diêm La
交州=Giao Châu
金光咒=Kim Quang Chú
大乾=Đại Càn
西山=Tây Sơn
福伯=Phúc Bá
气经=Khí Kinh
气圣=Khí Thánh
铜矿=Mỏ Đồng
方圆=Phương Viên
覆海大圣=Phúc Hải Đại Thánh
九阳湖=Hồ Cửu Dương
三太子=Tam Thái Tử
冰蛟=Băng Giao
英吉利=Anh Cát Lợi
小桃=Tiểu Đào
焚诀=Phần Quyết
日游=Nhật Du
张元=Trương Nguyên
敖殿下=Ngao điện hạ
云峰=Vân Phong
天阳=Thiên Dương
云宗主=Vân Tông chủ
方家=Phương gia
大夏=Đại Hạ
水帘洞=Thủy Liêm Động
九阴丹=Cửu Âm Đan
天魔丹=Thiên Ma Đan
天魔虎=Thiên Ma Hổ
古娜拉黑暗之神=Cổ Na Lạp Hắc Ám Chi Thần
水域=Thủy Vực
夏花=Hạ Hoa
白氏=Bạch Thị
齐白=Tề Bạch
周武=Chu Vũ
武氏=Võ Thị
八部天龙=Bát Bộ Thiên Long
天龙变=Thiên Long Biến
源气=Nguyên khí
源石=Nguyên thạch
方师兄=Phương sư huynh
李师兄=Lý sư huynh
于师兄=Vu sư huynh
太上道=Thái Thượng Đạo
四海龙族=Tứ Hải Long Tộc
李奶奶=Lý nãi nãi
国师大人=Quốc Sư đại nhân
皇室=Hoàng Thất
龙鳞=Long Lân
袁华=Viên Hoa
高通=Cao Thông
四海=Tứ Hải
郡城=Quận Thành
李师姐=Lý sư tỷ
张师兄=Trương sư huynh
青铜门=Thanh Đồng Môn
真传弟子=Chân Truyền Đệ Tử
金水=Kim Thủy
李海=Lý Hải
七宝妙树=Thất Bảo Diệu Thụ
大地神石=Đại Địa Thần Thạch
韵儿=Vận Nhi
地窟=Địa quật
司马氏=Tư Mã thị
乘龙快婿=Thừa long khoái tế
显圣境=Hiển Thánh Cảnh
申家=Thân Gia
黄枫谷=Hoàng Phong Cốc
望月峰=Vọng Nguyệt Phong
闵行=Mẫn Hành
闵长老=Mẫn trưởng lão
镇守府=Trấn Thủ Phủ
燕嫣然=Yến Yên Nhiên
李师=Lý Sư
木伯=Mộc Bá
卫家=Vệ Gia
贾明=Giả Minh
麒麟=Kỳ Lân
光狐=Quang Hồ
金刚镯=Kim Cương Trạc
神山=Thần Sơn
陆姐姐=Lục tỷ tỷ
天音谷=Thiên Âm Cốc
金公子=Kim Công Tử
金展=Kim Triển
清河郡=Thanh Hà Quận
周公子=Chu công tử
周兄=Chu huynh
红尘仙经=Hồng Trần Tiên Kinh
白老=Bạch lão
日魔=Nhật Ma
飞云剑法=Phi Vân Kiếm Pháp
暴雨术=Bạo Vũ Thuật
炼骨境=Luyện Cốt Cảnh
宫主=Cung chủ
真传=Chân Truyền
太阴真火=Thái Âm Chân Hỏa
道州=Đạo Châu
姜姐姐=Khương tỷ tỷ
莫家=Mạc Gia
炼丹术=Luyện Đan Thuật
制符术=Chế Phù Thuật
回血丹=Hồi Huyết Đan
太阴炼神法=Thái Âm Luyện Thần Pháp
葵花宝典=Quỳ Hoa Bảo Điển
宁采臣=Ninh Thái Thần
花果山=Hoa Quả Sơn
翻江倒海=Phiên Giang Đảo Hải
白姑娘=Bạch cô nương
蜗牛=Ốc Sên
形神俱灭=Hình Thần Câu Diệt
餐霞食气=Xan Hà Thực Khí
州城=Châu Thành
秦尊者=Tần Tôn Giả
李武=Lý Vũ
苏师兄=Tô sư huynh
玉真=Ngọc Chân
禺狨=Ngu Nhung
中天=Trung Thiên
甲申=Giáp Thân
甲午=Giáp Ngọ
甲辰=Giáp Thìn
道术=Đạo Thuật
山海关=Sơn Hải Quan
凤凰族=Phượng Hoàng Tộc
小花=Tiểu Hoa
沈师弟=Thẩm sư đệ
小草=Tiểu Thảo
龚家=Cung gia
杨阳=Dương Dương
天龙武馆=Thiên Long Võ Quán
叶副会长=Diệp Phó hội trưởng
秦都=Tần Đô
天圆地方=Thiên Viên Địa Phương
戴林=Đái Lâm
孟家=Mạnh Gia
灵兽袋=Linh Thú Đại
紫僵=Tử Cương
叶叔叔=Diệp thúc thúc
海洋之心=Hải Dương chi Tâm
齐人=Tề Nhân
钱多多=Tiền Đa Đa
山海珠=Sơn Hải Châu
陇云=Lũng Vân
林凡=Lâm Phàm
清明上河图=Thanh Minh Thượng Hà Đồ
龙女=Long Nữ
生死劫=Sinh Tử Kiếp
龟丞相=Quy Thừa Tướng
黑熊=Hắc Hùng
龙皇=Long Hoàng
黑火尊者=Hắc Hỏa Tôn Giả
余家=Dư gia
阿宾=A Tân
刘进=Lưu Tiến
刘府=Lưu phủ
袁通=Viên Thông
青华=Thanh Hoa
魂魔=Hồn Ma
齐皇=Tề Hoàng
凌竹=Lăng Trúc
狂刀=Cuồng Đao
腾龙=Đằng Long
黄文=Hoàng Văn
青城派=Thanh Thành Phái
余沧海=Dư Thương Hải
西海龙宫=Tây Hải Long Cung
仙姑=Tiên Cô
慕道友=Mộ Đạo hữu
宁会长=Ninh Hội Trưởng
天龙峰=Thiên Long Phong
龙后=Long Hậu
天龙=Thiên Long
陆师妹=Lục sư muội
小风=Tiểu Phong
小鱼儿=Tiểu Ngư Nhi
大草原=Đại Thảo Nguyên
叶老=Diệp lão
凌月=Lăng Nguyệt
黑云=Hắc Vân
蒋前辈=Tưởng tiền bối
凌家=Lăng Gia
彩云仙子=Thải Vân Tiên Tử
袁方=Viên Phương
天成=Thiên Thành
陈郡=Trần Quận
袁家家主=Viên Gia Gia Chủ
袁家=Viên Gia
武馆=Võ quán
狂刀武馆=Cuồng Đao Võ Quán
官府=Quan Phủ
山神=Sơn Thần
云天河=Vân Thiên Hà
云龙湖=Hồ Vân Long
蚌精=Bạng Tinh
天火=Thiên Hỏa
天月=Thiên Nguyệt
安府=An phủ
碧落=Bích Lạc
离骚=Ly Tao
李管事=Lý quản sự
阿大=A Đại
阿二=A Nhị
天海=Thiên Hải
天墟=Thiên Khư
周郎=Chu Lang
鱼师姐=Ngư Sư Tỷ
九阳=Cửu Dương
闻字=Văn Tự
赤阳尊者=Xích Dương Tôn Giả
鬼宝=Quỷ Bảo
彻地=Triệt Địa
高家=Cao Gia
许仙=Hứa Tiên
铜锤=Đồng Chuy
九阳城=Cửu Dương Thành
西晋=Tây Tấn
素真=Tố Chân
朱姑娘=Cô Chu
圣女峰=Thánh Nữ Phong
陀舍古帝=Đà Xá Cổ Đế
雍州=Ung Châu
显圣=Hiển Thánh
雷刀狂僧=Lôi Đao Cuồng Tăng
莽金刚=Mãng Kim Cương
雪龙=Tuyết Long
崔老=Thôi lão
沧澜宗=Thương Lan Tông
祝融=Chúc Dung
清河崔氏=Thanh Hà Thôi Thị
元州=Nguyên Châu
黄家=Hoàng Gia
林师弟=Lâm Sư Đệ
韩姓=Hàn Tính
林师姐=Lâm Sư Tỷ
王媛=Vương Viện
云韵=Vân Vận
仙境=Tiên Cảnh
忘忧殿=Vong Ưu Điện
药峰=Dược Phong
齐师兄=Tề sư huynh
诸葛=Gia Cát
李文=Lý Văn
李家=Lý Gia
方成=Phương Thành
第九峰=Đệ Cửu Phong
海老=Hải Lão
江副殿主=Giang Phó Điện Chủ
云家=Vân Gia
摘星峰=Trích Tinh Phong
文道友=Văn đạo hữu
姬道友=Cơ đạo hữu
孟道友=Mạnh đạo hữu
天雷子=Thiên Lôi Tử
草原=Thảo Nguyên/Đồng cỏ
张白=Trương Bạch
张岩=Trương Nham
张威=Trương Uy
蛮族部落=Man Tộc Bộ Lạc
天坑=Thiên Hố
韩姑娘=Hàn cô nương
张波=Trương Ba
董家=Đổng Gia
江长老=Giang trưởng lão
韩家家主=Hàn gia gia chủ
珠穆朗玛峰=Đỉnh Everest
道丹=Đạo Đan
天级=Thiên Cấp
七窍玲珑心=Thất Khiếu Linh Lung Tâm
龚长老=Cung Trưởng Lão
小七=Tiểu Thất
紫电峰=Tử Điện Phong
郭家=Quách Gia
尊者=Tôn Giả
唐天=Đường Thiên
郭义=Quách Nghĩa
谢东流=Tạ Đông Lưu
王明阳=Vương Minh Dương
牧野=Mục Dã
火龙=Hỏa Long
大师兄=Đại Sư Huynh
林怡=Lâm Di
林间=Trong rừng
郑重=Trịnh Trọng
朱兄=Chu huynh
道友=Đạo hữu
步姓=Họ Bộ
朱大叔=Chu đại thúc
朱三=Chu Tam
步家=Bộ Gia
古殿主=Cổ Điện Chủ
天罡星=Thiên Cương Tinh
紫薇星=Tử Vi Tinh
太阴星=Thái Âm Tinh
太阴=Thái Âm
江北=Giang Bắc
方师弟=Phương sư đệ
树哥=Thụ ca
星峰=Tinh Phong
紫薇=Tử Vi
蒋横川=Tưởng Hoành Xuyên
独孤师兄=Độc Cô sư huynh
东家=Đông Gia
万魔塔=Vạn Ma Tháp
天龙钟=Thiên Long Chung
冰熊=Băng Hùng
冰原=Băng Nguyên
妖族=Yêu tộc
谢家=Tạ gia
仇师兄=Cừu sư huynh
蒋家=Tưởng gia
功德殿=Công Đức Điện
蛮妖=Man Yêu
唐长老=Đường Trưởng Lão
筑基丹=Trúc Cơ Đan
血莲丹=Huyết Liên Đan
禁法符=Cấm Pháp Phù
朝天椒=Triều Thiên Tiêu
虎榜=Hổ Bảng
道榜=Đạo Bảng
万兽鼎=Vạn Thú Đỉnh
万魂林=Vạn Hồn Lâm
古风=Cổ Phong
吕师姐=Lữ sư tỷ
蒋师兄=Tưởng sư huynh
齐师弟=Tề sư đệ
韩雅=Hàn Nhã
西海=Tây Hải
圣龙=Thánh Long
神凤=Thần Phượng
龙魂=Long Hồn
龙血=Long Huyết
凤血=Phượng Huyết
九窍金丹=Cửu Khiếu Kim Đan
洛师姐=Lạc Sư Tỷ
桃林=Đào Lâm
圣灵=Thánh Linh
王载=Vương Tái
苏玉=Tô Ngọc
龙榜=Long Bảng
气血丹=Khí Huyết Đan
冰神宫=Băng Thần Cung
玄法=Huyền Pháp
薇薇=Vi Vy
龙宫=Long Cung
宋师叔=Tống sư thúc
化神池=Hóa Thần Trì
戮仙剑=Lục Tiên Kiếm
真血境=Chân Huyết Cảnh
宝山=Bảo Sơn
地鬼=Địa Quỷ
古神宫=Cổ Thần Cung
凰翼=Hoàng Dực
北海=Bắc Hải
苍梧=Thương Ngô
龙君=Long Quân
西海龙族=Tây Hải Long Tộc
庆家=Khánh Gia
杨道友=Dương đạo hữu
白虎门=Bạch Hổ Môn
双头犬=Song Đầu Khuyển
天尸宗=Thiên Thi Tông
庆阳=Khánh Dương
五圣=Ngũ Thánh
李缘=Lý Duyên
真龙=Chân Long
白虎=Bạch Hổ
玄龟=Huyền Quy
金甲=Kim Giáp
五灵=Ngũ Linh
石家=Thạch Gia
无常殿=Vô Thường Điện
苏望=Tô Vọng
宋师弟=Tống sư đệ
器阁=Khí Các
中天城=Trung Thiên Thành
吕师妹=Lữ sư muội
曹家=Tào Gia
齐土=Tề Thổ
蛮王=Man Vương
云伯伯=Vân bá bá
玉液丹=Ngọc Dịch Đan
慕容师姐=Mộ Dung sư tỷ
趋吉避凶=Khu Cát Tị Hung
雪族=Tuyết Tộc
萧腾=Tiêu Đằng
雪山派=Tuyết Sơn Phái
萧战=Tiêu Chiến
白大人=Bạch đại nhân
江道友=Giang đạo hữu
吴将军=Ngô tướng quân
焚寂=焚 Tịch
七杀剑=Thất Sát Kiếm
玉门关=Ngọc Môn Quan
文圣=Văn Thánh
魏长老=Ngụy trưởng lão
高长老=Cao trưởng lão
钟馗=Chung Quỳ
终南山=Chung Nam Sơn
摩云洞=Ma Vân Động
积雷山=Tích Lôi Sơn
昆仑=Côn Lôn
四海龙宫=Tứ Hải Long Cung
兽尊=Thú Tôn
大周=Đại Chu
武明空=Võ Minh Không
武周=Võ Chu
高将军=Cao tướng quân
神都=Thần Đô
北原郡=Bắc Nguyên Quận
阴神=Âm Thần
明空=Minh Không
童长老=Đồng trưởng lão
血牙=Huyết Nha
定远将军=Định Viễn Tướng Quân
凤凰一族=Phượng Hoàng Nhất Tộc
十万雪山=Thập Vạn Tuyết Sơn
叶重=Diệp Trọng
天月城=Thiên Nguyệt Thành
玉某=Ngọc mỗ
凤凰=Phượng Hoàng
真魔=Chân Ma
摘星拿月=Trích Tinh Nã Nguyệt
心界=Tâm Giới
尊者境=Tôn Giả Cảnh
幽冥地府=U Minh Địa Phủ
梦中证道=Mộng Trung Chứng Đạo
青蛇=Thanh Xà
雷峰塔=Lôi Phong Tháp
觉远=Giác Viễn
白天=Bạch Thiên
秦明=Tần Minh
王寨主=Vương Trại Chủ
周老头=Chu Lão Đầu
齐云霄=Tề Vân Tiêu
齐云海=Tề Vân Hải
大梦心经=Đại Mộng Tâm Kinh
斩妖除魔=Trảm Yêu Trừ Ma
剑君=Kiếm Quân
紫气东来=Tử Khí Đông Lai
祖师=Tổ Sư
观主=Quan Chủ
戮仙剑经=Lục Tiên Kiếm Kinh
一气化三清=Nhất Khí Hóa Tam Thanh
妙树=Diệu Thụ
星辰砂=Tinh Thần Sa
孟浩=Mạnh Hạo
太极图=Thái Cực Đồ
云朵=Vân Đóa
清虚殿=Thanh Hư Điện
天州=Thiên Châu
沈龙=Thẩm Long
天龙门=Thiên Long Môn
小青=Tiểu Thanh
上帝视角=Góc nhìn của Thượng Đế
黄金树=Hoàng Kim Thụ
净土=Tịnh Thổ
福地=Phúc Địa
南晋=Nam Tấn
恒心=Hằng Tâm
心圣=Tâm Thánh
琉璃=Lưu Ly
玄都=Huyền Đô
西湖=Tây Hồ
大罗天境=Đại La Thiên Cảnh
燕师姐=Yến sư tỷ
周师弟=Chu sư đệ
昆仑山=Côn Lôn Sơn
苏家=Tô Gia
通天境=Thông Thiên Cảnh
慕容嫣然=Mộ Dung Yên Nhiên
寒州=Hàn Châu
独孤=Độc Cô
通州=Thông Châu
玉京=Ngọc Kinh
东周=Đông Chu
黑山=Hắc Sơn
辽州=Liêu Châu
五行珠=Ngũ Hành Châu
太白=Thái Bạch
胡家=Hồ Gia
六道轮回=Lục Đạo Luân Hồi
阴阳生死轮=Âm Dương Sinh Tử Luân
周清=Chu Thanh
燕狂徒=Yến Cuồng Đồ
境州=Cảnh Châu
玄都观=Huyền Đô Quan
觉真=Giác Chân
天龙寺=Thiên Long Tự
大齐=Đại Tề
**=**
51区=Khu vực 51
76=Soldier: 76
CIA=Cục Tình báo Trung ương
HP=HP
X教授=Giáo sư X
七宗罪=Seven Deadly Sins
万磁王=Vạn Từ Vương
三叉戟总部=Trụ sở Trident
三宫=Tam Cung
上古之神=Thượng Cổ Chi Thần
上帝之杖=Thanh gươm của Chúa
世界之树=Cây Thế Giới
东亚=Đông Á
东南亚=Đông Nam Á
东方古国=Cổ quốc phương Đông
东方巨龙=Rồng phương Đông
东欧=Đông Âu
东瀛=Đông Doanh
东非=Đông Phi
丧钟=Deathstroke
中东=Trung Đông
中亚=Trung Á
中央公园=Công viên Trung tâm
中央情报局=Cục Tình báo Trung ương
丹尼尔.怀特霍尔=Daniel Whitehall
丹麦=Đan Mạch
丽亚娜=丽亚娜
丽痕书店=Flourish and Blotts
丽芙=Lệ Phu
乌托邦=Ô Thác Bang
乔治博士=Tiến sĩ George
九层地狱=Cửu tầng địa ngục
九界=Cửu Giới
二战=Thế chiến II
五角大楼=Lầu Năm Góc
亚历山大大帝=Alexander Đại đế
亚洲=Châu Á
亚瑟王=Vua Arthur
亚登法印=Ấn Arden
人工智能=Trí tuệ nhân tạo
人类=Loài người
伊卡洛斯=伊卡洛斯
伊格尼法印=Ấn Ignii
伦敦=Luân Đôn
佛教=Phật giáo
佛罗里达州=bang Florida
侏儒=Người lùn
俄亥俄州=Bang Ohio
保护伞公司=Công ty Umbrella
修女=Nữ tu
兄弟会=Hội huynh đệ
先知教=Tiên tri giáo
先行者=Tiền nhân
先锋科技=Advanced Idea Mechanics
克拉克=Khắc Lạp Khắc
克拉克.肯特=Clark Kent
克里=克里
克里人=Người Kree
克里帝国=Đế chế Kree
内华达州=Nội Hoa Đạt Châu
冥狱深渊=Địa ngục Thâm Uyên
冬日战士=Winter Soldier
冰人=Người Băng
冲锋=Xung Phong
冷战=Cold War
凤凰之力=Phoenix Force
凤凰女=Phoenix Woman
凤凰社=Order of the Phoenix
凯尔特人=Người Celt
凶兆=Điềm Xấu
击倒=Knock Out
刀锋=Dao Phong
利爪=Vuốt Sắc
刺客兄弟会=Hội Anh em Sát thủ
刺客联盟=Liên minh Sát thủ
前苏联=Liên Xô cũ
力场=Trường lực
力量之石=Đá Sức Mạnh
加利福尼亚州=Tiểu bang California
加勒比海=Biển Caribbean
加州=California
加特勒=Gia Đặc Lặc
勇.罗格=Yon-Rogg
匈牙利树蜂=Ong bắp cày Hungary
匕首=Dao găm
北冰洋=Bắc Băng Dương
北方领域=Northern Realms
北极圈=Vòng Bắc Cực
北欧=Bắc Âu
北欧神话=Thần thoại Bắc Âu
北爱尔兰=Northern Ireland
北美=Bắc Mỹ
北美大陆=Lục địa Bắc Mỹ
北翼=Cánh Bắc
北非=Bắc Phi
十字军=Thập Tự Quân
千里眼=Thiên Lý Nhãn
午夜老爹=Midnight Daddy
华尔街=Phố Wall
华盛顿=Washington D.C.
华盛顿特区=Đặc khu Washington
南太平洋=Nam Thái Bình Dương
南朝鲜=Hàn Quốc
南极=Nam Cực
南极洲=Nam Cực
南欧=Nam Âu
南美=Nam Mỹ
南美洲=Nam Mỹ
南达尔巴特=Nam Darbat
南银河=Ngân Hà Nam
南非=Nam Phi
博士=Tiến sĩ
博派=Autobots
卡罗尔=卡罗尔
印度=Ấn Độ
印度洋=Ấn Độ Dương
印第安人=Người da đỏ
反监视者=Phản Giám Sát Giả
古一=Ancient One
古一法师=Pháp sư Gu Yi
古希腊=Ancient Greece
古波斯=Ba Tư cổ đại
吉塔=Cát Tháp
吸血鬼=ma cà rồng
咆哮突击队=Đội Commando Gầm Thét
咕咕=Gu Gu
哈德逊河=Hudson River
哈拉=哈拉
哥伦比亚大学=Đại học Columbia
哥谭市=Thành phố Gotham
哨兵机器人=Người máy Sentinel
唐人街=Chinatown
喜马拉雅山=Dãy Himalaya
喜马拉雅山脉=Dãy Himalaya
国家安全局=Cục An Ninh Quốc Gia
国防部=Bộ Quốc phòng
土耳其=Thổ Nhĩ Kỳ
圣凡冈萨=San Venganza
圣殿骑士=Hiệp sĩ dòng Đền
圣水=Nước Thánh
圣者=Thánh Giả
圣芒戈=St. Mungo's
圣虎=Thánh Hổ
圣诞老人=Ông già Noel
圣遗物=Thánh vật
圣银=Thánh Ngân
地狱七君=Thất Đại Địa Ngục Quân Chủ
地狱之火=Địa Ngục Chi Hỏa
地狱之王=Địa Ngục Chi Vương
地狱之门=Địa Ngục Chi Môn
地狱厨房=Hell's Kitchen
地狱火俱乐部=Câu lạc bộ Hỏa ngục
地狱边境=Biên giới địa ngục
埃及神系=Thần hệ Ai Cập
埃里克=埃里克
基督教=Cơ đốc giáo
堡垒=Pháo Đài
堪萨斯州=Kham Tát Tư Châu
塔利亚=Talia al Ghul
塞伯坦=Tái Bá Thản
墨西哥湾=Vịnh Mexico
声波=Thanh Ba
复仇=Báo Thù
复仇者=Biệt đội Báo thù
复仇者联盟=Biệt đội báo thù
多比=多比
多玛姆=Đa Mã Mỗ
大家伙=Gã to lớn
大洋洲=Châu Đại Dương
大蛇=Đại Xà
大西洋=Đại Tây Dương
大陆酒店=Continental Hotel
大黄蜂=Đại Hoàng Phong
大黑暗天=Đại Hắc Ám Thiên
天国降临=Thiên Quốc Giáng Lâm
天堂岛=Thiên đường đảo
天庭=Thiên đình/Thiên Đình
天灾=Thiên Tai
天父=Thiên Phụ
太平洋=Thái Bình Dương
太阳风=Phong Thái Dương
夺魂咒=Bùa Imperius
奥托博士=Tiến sĩ Otto
奥斯曼帝国=Đế chế Ottoman
奥林匹斯山=Núi Olympus
奥里西斯=奥里西斯
女皇=Nữ hoàng
女骑士=Nữ kỵ sĩ
妖刀村正=Yêu Đao Muramasa
威尔士=Xứ Wales
威尔士绿龙=Rồng Xanh xứ Wales
威斯康星=威斯康星
威震天=Uy Chấn Thiên
娜塔莎=Na Tháp Sa
宇宙立方=Khối Lập Phương Vũ Trụ
宇宙魔方=Khối lập phương vũ trụ
守望=Đội Thủ Vọng
安第斯山脉=Dãy Andes
对角巷=Diagon Alley
小丑=Tiểu Sửu
小丑女=Harley Quinn
小巫师=Phù thủy nhỏ
小彼得=Tiểu Peter
小惠金区=Little Whinging
小王子=Hoàng Tử Bé
小矮妖=Tiểu Ái Yêu
小辣椒波兹=Pepper Potts
尼克·弗瑞=Nick Fury
尼斯=Loch Ness
屠杀=Carnage
山丘巨人=Người khổng lồ đồi
山达尔星=Hành tinh Xandar
峡谷=Hẻm núi
巴克斯特大厦=Tòa Nhà Baxter
巴斯特=巴斯特
巴顿=Ba Đốn
布利克街=Phố Bleecker
布鲁克林区=Khu Brooklyn
布鲁斯.韦恩=Bruce Wayne
布鲁斯·班纳=Bruce Banner
希尔=希尔
希尔特工=Đặc vụ Hill
希腊=Hy Lạp
希腊诸神=Các vị thần Hy Lạp
帕伽索斯=帕伽索斯
帕特农神庙=Đền Parthenon
帝国大厦=Empire State Building
帝王组织=Tổ chức Đế Vương
幽灵=U Linh
幽鬼=U Quỷ
废土=Vùng đất hoang
康奈尔大学=Đại học Cornell
康斯坦丁=康斯坦丁
建筑师=Kiến Trúc Sư
弗拉德=Phất Lạp Đức
弗拉德三世=Vlad III
弗斯=弗斯
弗瑞=Phất Thụy
张衡=Trương Hành
强尼=强尼
影武者联盟=League of Assassins/Shadow Clan
彼得=彼得
德克萨斯州=Tiểu bang Texas
德古拉=Đức Cổ Lạp
德古拉伯爵=Bá tước Dracula
德雷克海峡=Eo biển Drake
心灵之石=Đá Tâm Trí
忍者大师=Ninja Master
快银=Quick Silver
总统=Tổng thống
恐惧之王=Vua Sợ Hãi
恶灵骑士=Ghost Rider
惊奇女士=Nữ Thần Kỳ
惊奇队长=Đội trưởng Marvel
意大利面=mì Ý
戈登=戈登
成吉思汗=Thành Cát Tư Hãn
战彪=Chiến Bưu
战略科学军团=Strategic Scientific Reserve
戴安娜=Đới An Na
戴蒙=Đái Mông
手合会=The Hand
托尼·斯塔克=Tony Stark
拉斯维加斯=Las Vegas
指控者罗南=Ronan the Accuser
挪威=Na Uy
挪威脊背龙=Rồng gai lưng Na Uy
挽歌=Ai Ca
捍卫者=Người Bảo Vệ
摄魂怪=Giám ngục
摩根勒菲=Morgan le Fay
摩金夫人=Madam Malkin
撒哈拉沙漠=Sa mạc Sahara
擎天柱=Optimus Prime
救护车=Cứu Hộ Xa
教授=Giáo sư
教皇=Giáo hoàng
斑点狗=Đốm Chó
斗篷=Áo choàng
斯塔克工业=Stark Industries
新墨西哥=New Mexico
新墨西哥州=New Mexico
新大陆=Tân Thế Giới
新泽西=New Jersey
新西兰=New Zealand
方舟=Phương Chu
方舟反应炉=Lò phản ứng Ark
无上至尊=Đấng Tối cao
无尽轮回=Vô Tận Luân Hồi
无限宝石=Đá Vô Cực
旧金山=San Francisco
时代广场=Quảng trường Thời Đại
时间之石=Đá Thời Gian
旺达=Vượng Đạt
昆仑山脉=dãy núi Côn Luân
昆恩法印=Dấu hiệu Quen
星元=Nguyên Tinh
星城=Tinh Thành
星港=Cảng Sao
星球大战计划=Chương trình Chiến tranh giữa các vì sao
普利策奖=Giải Pulitzer
智械=Trí giới
智械危机=Khủng hoảng Omnic
暗精灵=Dark Elves
曼哈顿区=Quận Manhattan
曼哈顿计划=Dự án Manhattan
曼德拉草=Cây Mandrake
曼达林=Mạn Đà La
最高智慧=Trí Tuệ Tối Cao
末日火山=Núi Lửa Ngày Tận Thế
本·格瑞姆=Ben Grimm
本叔=chú Ben
机械神教=Thần Giáo Cơ Giới
机魂=Cơ Hồn
杀手鳄=Killer Croc
杂音=Tạp Âm
李斯特博士=Tiến sĩ List
杜姆=Doom
来世=Kiếp sau
柏林墙=Bức tường Berlin
查尔斯教授=Giáo sư Charles
查斯=Tra Tư
查莉=查莉
树人=Tree Man
格兰特.沃德=Grant Ward
格林威治村=Greenwich Village
格鲁特=格鲁特
梅姨=dì May
梅家=Mai gia
梅林=梅林
梅琳达=梅琳达
梅菲斯特=Mai Phỉ Tư Đặc
梅阿姨=dì May
梦境世界=Mộng Cảnh Thế Giới
梦神=Dreaming God
梦魇兽=Mộng Yểm Thú
梵文=Văn Phạn
欧洲=Châu Âu
欧洲杯=Euro Cup
正义联盟=Liên minh Công lý
武士=Võ sĩ
武汉=Vũ Hán
死亡一指=Cú chạm chết
死亡之书=Book of the Dead
死侍=Deadpool
毁灭者=Kẻ Hủy Diệt
毒液=Venom
比利·巴特森=Billy Batson
氪星人=Người Krypton
水晶公主=Công chúa Crystal
水银=Quicksilver
永恒之书=Sách Vĩnh Hằng
永恒之枪=Vĩnh Hằng Chi Thương
沙尘天使=Thiên Thần Cát Bụi
沙暴=Sa Bạo
沙箱=Sand Box
波兰=Ba Lan
波兰特=Ba Lan
波斯帝国=Đế chế Ba Tư
泥鳅=Nê Thu
泰国=Thái Lan
泰国曼谷=Bangkok, Thái Lan
泰瑞根水晶=Terrigen Crystal
洛娜=洛娜
洛拉=Lạc Lạp
洛杉矶=Los Angeles
洞察计划=Dự án Insight
浣熊市=Raccoon City
海皇=Hải Hoàng
海神三叉戟=Đinh ba của Poseidon
涨潮=Thủy Triều
深渊之神=Thần vực thẳm
深红主宰=Chúa Tể Đỏ Thẫm
渡鸦=Raven
温斯顿=Ôn Tư Đốn
火焰杯=Goblet of Fire
火狮=Sư tử lửa
火种源=Nguồn Lửa
灭霸=Diệt Bá
灵丹=Linh Đan
灵蝶=Linh Điệp
灵魂之石=Đá Linh Hồn
炎魔=Viêm ma
烈火=Lửa thiêng
热砂财团=Tập đoàn Hot Sands
爱尔兰=Ái Nhĩ Lan
爵士=Tước Sĩ
父王=Phụ vương
特勤局=Mật Vụ Cục
特查拉=特查拉
特训=Huấn luyện đặc biệt
犹太人=Người Do Thái
狂攻=Cuồng Công
猎手=Thợ Săn
猎魔人=Thợ săn quỷ
环球日报=Nhật báo Hoàn cầu
现实之石=Đá Thực Tại
瑞典=Thụy Điển
瑞士=Thụy Sĩ
瑞雯=瑞雯
瓦坎达=瓦坎达
田纳西州=Tiểu bang Tennessee
白女巫=White Witch
白宫=Nhà Trắng
白狼=Bạch Lang
白皇后=White Queen
白金汉宫=Điện Buckingham
白霜=Bạch Sương
皇冠=Vương Miện
皇后区=Quận Queens
皇家方舟=Royal Talon Fighter
皇家方舟号=Royal Ark
皮奥特=Bì Áo Đặc
皮特罗=Bì Đặc La
睡神=Thần ngủ
睡魔=Thụy Ma
矮人=Người lùn
石头人=Người Đá
石头人本=Ben Grimm/Người đá
神域=Thần vực
神奇四侠=Bộ Tứ Siêu Đẳng
神奇女侠=Wonder Woman
神王=Thần Vương
神盾=Khiên Thần
神盾局=Thần Thuẫn Cục
神道教=Thần đạo giáo
福特猛禽=Ford Raptor
科勒=科勒
科尔森=科尔森
科罗拉多大峡谷=Grand Canyon Colorado
科罗拉多州=Tiểu bang Colorado
空间之石=Đá Không Gian
第七区=Khu vực 7
第二次世界大战=Thế chiến thứ hai
第五大道=Đại lộ số 5
简.福斯特=Jane Foster
米德加尔特=米德加尔特
粉碎=Phấn Toái
红后=Red Queen
红房子=Red Room
红蜘蛛=Red Spider
纽约=New York
纽约州立大学=Đại học Bang New York
纽约市=Thành phố New York
纽约市长=Thị trưởng thành phố New York
绯红女巫=Scarlet Witch
维克特=维克特
维山帝之书=Sách Vishanti
绿灯军团=Green Lantern Corps
罗刹女=Rōshā nǚ
罗南=罗南
罗宾汉=Robin Hood
罗斯将军=Tướng Ross
罗马=La Mã
罗马人=Người La Mã
罗马教廷=Tòa thánh La Mã
罪恶之城=Sin City
羊皮纸=Da dê
美军=Quân đội Mỹ
美国队长=Captain America
群岛=Quần đảo
群星=Quần Tinh
群星域=Quần Tinh Vực
老狮子=Sư tử già
老约翰=John già
联合国=Liên Hợp Quốc
联邦调查局=Cục Điều tra Liên bang
自杀小队=Biệt đội cảm tử
自由=Tự do
自由女神像=Statue of Liberty
至高=Tối Cao
艾什=Ngải Thập
艾娃=艾娃
艾森豪威尔=Dwight D. Eisenhower
芭比=芭比
苏美=Liên Xô và Mỹ
苏联=Liên Xô
英伦三岛=British Isles
英国=Anh Quốc
英格兰=Anh Cát Lan
英灵=Anh linh
英灵殿=Anh Linh Điện
英雄协会=Hiệp hội Anh hùng
范海辛=Van Helsing
荷兰=Hà Lan
荷鲁斯=Hồ Lỗ Tư
莫伊拉=Mạc Y Lạp
莫西干头=Mohican head
莱利=莱利
莱茵河=Sông Rhine
萨克=Tát Khắc
萨塔娜=萨塔娜
蒙古帝国=Đế quốc Mông Cổ
蒙大拿州=bang Montana
蕾拉=Lôi Lạp
蛇发女妖=Xà Phát Nữ Yêu
蜂巢=Tổ Ong
蝙蝠人=Người Dơi
蝙蝠侠=Người Dơi
蝙蝠洞=Hang Dơi
血田=Cánh đồng máu
血石=Huyết Thạch
血神=Blood God
西海岸=Bờ Tây
西班牙=Tây Ban Nha
角魔=Ác ma sừng
誓约胜利之剑=Kiếm Thề Ước Thắng Lợi
警局=Sở cảnh sát
诺曼.奥斯本=Norman Osborn
诺贝尔文学奖=Giải Nobel Văn học
谜语人=Người Giải đố
贝拉斯科=Bối Lạp Tư Khoa
贝拉科斯=Bối Lạp Khoa Tư
赛托拉克=Tái Thác Lạp Khắc
赫敏.简.格兰杰=Hermione. Jane. Granger
超人=Siêu Nhân
超人克拉克=Superman Clark
超级士兵血清=Huyết thanh Siêu Chiến Binh
越南=Việt Nam
路易十四=Louis XIV
路西法=Lộ Tây Pháp
达.芬奇=Da Vinci
达芬奇=Da Vinci
迈尔斯=Mại Nhĩ Tư
远东地区=Viễn Đông
远古泰坦=Titan cổ đại
远星计划=Kế hoạch Viễn Tinh
迷乱=Mê Loạn
通用=General Motors
道教=Đạo giáo
酋长=Tù trưởng
里德·理查兹=Reed Richards
里约热内卢=Rio de Janeiro
野兽=Beast
金刚狼=Người Sói
金宫=Kim Cung
金苹果=Táo Vàng
钢力士=Cương Lực Sĩ
钢铁侠=Iron Man
铁人=Iron Man
银弹=Silver Bullet
银行家=Nhà ngân hàng
银轮=Ngân Luân
镭射枪=Súng laser
镭射眼=Laser Eye
长岛=Đảo Dài
长滩=Long Beach
长老会=Hội đồng Trưởng lão
闹翻天=Náo Phiên Thiên
队长=Đội trưởng
阴影=Âm Ảnh
阿兹卡班=阿兹卡班
阿尔兹海默症=Bệnh Alzheimer
阿尔德之印=Ấn Aard
阿尔德法印=Dấu hiệu Aard
阿尔茜=Arcee
阿斯加德=阿斯加德
阿波罗登月计划=Chương trình Apollo
阿瓦达索命=Avada Kedavra
阿瓦达索命咒=Lời nguyền Avada Kedavra
陋居=Hang Sóc
雷人=Lôi Nhân
雷神=Thần Sấm
雷神之锤=Búa Thần Sấm
雷神托尔=Thor, Thần Sấm
雷霆=Lôi Đình
震荡波=Chấn Động Ba
霍华德·斯塔克=Howard Stark
霍尔博士=Tiến sĩ Hall
霍格莫德村=Hogsmade Village
霜巨人=Người khổng lồ băng
露易丝=Lộ Dịch Tư
霸天虎=Bá Thiên Hổ
霸王=Bá Vương
霸王龙=Khủng long bạo chúa
霹雳火=Human Torch
非洲=Châu Phi
鞭挞=Tiên Thát
韦德=Vi Đức
预言家日报=Nhật báo Tiên tri
领导模块=Mô-đun Lãnh Đạo
风暴女=Storm/Phong Bạo Nữ
飞狮=Phi Sư
食死徒=Death Eaters
香港=Hồng Kông
马尔杜克=马尔杜克
马特=马特
马萨诸塞州=Tiểu bang Massachusetts
魔怪=Ma quái
魔术师=Ảo thuật gia
魔法部=Bộ Pháp Thuật
魔瞳=Magic Eye
鲁索=Lỗ Tác
鲍勃=Bảo Bách
鹰巢=Tổ chim ưng
鹰眼=Mắt diều hâu
麦克=Mạch Khắc
麦克雷=Mạch Khắc Lôi
麦格教授=Giáo sư McGonagall
麻省理工学院=MIT
黎明之刃=Lưỡi Dao Bình Minh
黑兰=Black Orchid
黑凤凰=Dark Phoenix
黑寡妇=Góa phụ đen
黑巫师=Phù thủy đen
黑心=Hắc Tâm
黑手=Hắc Thủ
黑暗空间=Không Gian Tối
黑暗精灵=Dark Elf
黑爪=Hắc Trảo
黑石=Black Stone
黑血=Black Blood
黑豹=Black Panther
黑门监狱=Nhà tù Blackgate
黑雾=Hắc Vụ
黑魔王=Chúa Tể Hắc Ám
龙骑士=Long Kỵ Sĩ
张屠夫=Trương Đồ Phu
宋秀才=Tống Tú Tài
大虎=Đại Hổ
二牛=Nhị Ngưu
金鸡=Kim Kê
雄鸡=Hùng Kê
小三子=Tiểu Tam Tử
刘捕快=Lưu bộ khoái
陈师爷=Trần Sư Gia
孙将军=Tôn Tướng Quân
大老爷=Đại lão gia
桃红=Đào Hồng
周老三=Chu Lão Tam
货郎=Người bán hàng rong
书生=Thư sinh
树妖姥姥=Thụ Yêu Lão Lão
倩女幽魂=Thiện Nữ U Hồn
兰若寺=Lan Nhược Tự
郭北县=Quách Bắc Huyện
老夫人=Lão phu nhân
大公子=Đại công tử
赵员外=Triệu viên ngoại
二公子=Nhị công tử
姜家=Khương Gia
姜老爷=Khương lão gia
小云=Tiểu Vân
福宝=Phúc Bảo
孙老头=Tôn lão đầu
李寡妇=Lý Quả Phụ
神火飞鸦=Thần Hỏa Phi Nha
耳报神=Nhĩ Báo Thần
大青=Đại Thanh
乔峰=Kiều Phong
虎骨酒=Hổ Cốt Tửu
张三丰=Trương Tam Phong
监院=Giam Viện
比丘=Tỳ Kheo
唐夫人=Đường phu nhân
张员外=Trương viên ngoại
唐小姐=Đường tiểu thư
首座=Thủ Tọa
梅园=Mai Viên
唐老爷=Đường lão gia
龙子=Long Tử
戒念=Giới Niệm
山越=Sơn Việt
三大殿=Tam Đại Điện
地藏=Địa Tạng
昙花一现=Đàm Hoa Nhất Hiện
坛经=Đàn Kinh
心宗=Tâm Tông
金丹=Kim đan
千手观音=Thiên Thủ Quan Âm
太上道君=Thái Thượng Đạo Quân
贾队长=Giả đội trưởng
培根=Bacon
黑犬=Hắc Khuyển
红药=Hồng Dược
豆兵=Đậu Binh
蔡伯=Thái Bá
县城=Huyện thành
六道=Lục Đạo
儒圣=Nho Thánh
閻尊者=Diêm tôn giả
玉兔=Ngọc Thỏ
秦岭=Tần Lĩnh
小乙=Tiểu Ất
慧能=Huệ Năng
神秀=Thần Tú
岭南=Lĩnh Nam
郭德纲=Quách Đức Cương
雅诗兰黛=Estée Lauder
天山雪莲=Thiên Sơn Tuyết Liên
四方=Tứ Phương
至圣先师=Chí Thánh Tiên Sư
李二=Lý Nhị
张二狗=Trương Nhị Cẩu
牛鬼=Ngưu Quỷ
狗子=Cẩu Tử
观音大士=Quán Âm Đại Sĩ
观音=Quán Âm
送子观音=Tống Tử Quan Âm
张老三=Trương Lão Tam
孔子=Khổng Tử
少正卯=Thiếu Chính Mão
青蚨=Thanh Phù
百步飞剑=Bách Bộ Phi Kiếm
汉武帝=Hán Vũ Đế
御使=Ngự Sử
驿站=Dịch Trạm
白沙=Bạch Sa
国朝=Quốc Triều
虞婆婆=Ngu Bà Bà
雄鸡一唱天下白=Hùng Kê Nhất Xướng Thiên Hạ Bạch
掌心雷=Chưởng Tâm Lôi
撒豆成兵=Tát Đậu Thành Binh
战阵=Chiến Trận
飞剑术=Phi Kiếm Thuật
道袍=Đạo bào
郡治=Quận Trị
子清=Tử Thanh
天问=Thiên Vấn
赖夫人=Lại Phu Nhân
庙祝=Miếu Chúc
五通庙=Miếu Ngũ Thông
桃木剑=Đào Mộc Kiếm
玉玦=Ngọc Quyết
食指大动=Thực Chỉ Đại Động
皇太后=Hoàng Thái Hậu
渤海郡=Bột Hải quận
清明=Thanh Minh
普洱=Phổ Nhĩ
茶博士=Trà bác sĩ
山东=Sơn Đông
鲁家=Lỗ gia
极西之地=Cực Tây Chi Địa
湘西=Tương Tây
淮南=Hoài Nam
田忌赛马=Điền Kỵ Tái Mã
西域=Tây Vực
兰陵=Lan Lăng
杨戬=Dương Tiễn
梅山=Mai Sơn
綦毋=Cơ Vô
常昊=Thường Hạo
戒嗔=Giới Sân
川西=Xuyên Tây
本县=Bản Huyện
嫁衣=Giá Y
裁云=Tài Vân
巴雷特=Ba-ret
郭三=Quách Tam
星石=Tinh Thạch
茱萸=Thù Du
阿塔=A Tháp
阿叔=A Thúc
白老三=Bạch Lão Tam
莲花冠=Liên Hoa Quan
九天雷神=Cửu Thiên Lôi Thần
窦娥=Đậu Nga
孙大圣=Tôn Đại Thánh
天池=Thiên Trì
狮子山=Sư Tử Sơn
吃货=Ngật Hóa
坛主=Đàn chủ
天池山=Thiên Trì Sơn
北邙=Bắc Mang
阎尊者=Diêm Tôn Giả
章老鬼=Chương Lão Quỷ
姜家庄=Khương Gia Trang
江宁郡=Giang Ninh quận
老刘头=Lão Lưu Đầu
江氏=Giang Thị
江老爷=Giang Lão gia
廖氏=Liêu thị
青丘狐族=Thanh Khâu Hồ Tộc
纯狐=Thuần Hồ
天王寺=Thiên Vương Tự
太常寺=Thái Thường Tự
余老三=Dư Lão Tam
太白星=Sao Thái Bạch
刀公公=Đao công công
刑部=Hình Bộ
吏部=Lại Bộ
木德=Mộc Đức
太阴炼形=Thái Âm Luyện Hình
飞僵=Phi Cương
镇魔=Trấn Ma
拜神=Bái Thần
五通神=Ngũ Thông Thần
祁连=Kỳ Liên
皇宫=Hoàng cung
道士=Đạo sĩ
瞌睡虫=Khạp Thụy Trùng
晋地=Tấn Địa
神农=Thần Nông
神农氏=Thần Nông Thị
獬豸=Giải Trãi
黄巾力士=Hoàng Cân Lực Sĩ
牵牛星=Sao Ngưu Lang
织女星=Sao Chức Nữ
王母=Vương Mẫu
无量天尊=Vô Lượng Thiên Tôn
萧师侄=Tiêu sư điệt
天子=Thiên Tử
牛郎=Ngưu Lang
方天画戟=Phương Thiên Họa Kích
大叔=Đại thúc
大运河=Đại Vận Hà
神农鞭=Thần Nông roi
酆都鬼城=Phong Đô Quỷ Thành
鬼门关=Quỷ Môn Quan
幽冥鬼界=U Minh Quỷ Giới
大将军=Đại Tướng Quân
墨家=Mặc gia
法家=Pháp gia
清江=Thanh Giang
畜生道=Súc Sinh Đạo
六神=Lục Thần
右长老=Hữu Trưởng Lão
五色=Ngũ Sắc
五音=Ngũ Âm
药王殿=Dược Vương Điện
北邙山=Bắc Mang Sơn
导师=Đạo sư
八公山=Bát Công Sơn
五行遁术=Ngũ Hành Độn Thuật
白鹿=Bạch Lộc
青檀=Thanh Đàn
桃花瘴气=Đào Hoa chướng khí
胡僧=Hồ Tăng
桃符=Đào Phù
真箓=Chân Lục
掌教师兄=Chưởng giáo sư huynh
朱聪=Chu Thông
鹿公子=Lộc công tử
玉钱=Ngọc Tiền
尤贤弟=Vưu hiền đệ
太守大人=Thái thú đại nhân
招贤令=Chiêu Hiền Lệnh
井口=Tỉnh Khẩu
三姐=Tam Tỷ
宝剑=Bảo Kiếm
狐妖=Hồ yêu
桑老儿=Tang Lão Nhi
青丘=Thanh Khâu
鹿妖=Lộc Yêu
桑村=Tang Thôn
丹阳太守=Đan Dương thái thú
少冲=Thiếu Xung
白云观=Bạch Vân Quan
乾元观=Càn Nguyên Quan
飞天夜叉=Phi Thiên Dạ Xoa
三昧火=Tam Muội Hỏa
农家=Nông Gia
农老头=Nông Lão Đầu
石山=Thạch Sơn
珠峰=Châu Phong
天河之水=Thiên Hà chi thủy
法师=Pháp Sư
丰神俊朗=Phong Thần Tuấn Lãng
真人=Chân Nhân
桂林=Quế Lâm
洞庭湖=Động Đình Hồ
雷马=Lôi Mã
石青=Thạch Thanh
岳阳=Nhạc Dương
恶虎=Ác Hổ
三清=Tam Thanh
桃山=Đào Sơn
陶家=Đào gia
京官=Kinh quan
鸡鸣寺=Chùa Kê Minh
蔡捕头=Thái bổ đầu
钱员外=Tiền viên ngoại
阿姆=A Mỗ
阿月=A Nguyệt
苗寨=Miêu Trại
苗疆=Miêu Cương
左长老=Tả Trưởng Lão
碧血丹心=Bích Huyết Đan Tâm
师叔=Sư thúc
金钱豹=Kim Tiền Báo
苏醒=Tô Tỉnh
小方=Tiểu Phương
太守府=Thái thú phủ
红衣少女=Thiếu nữ áo đỏ
凤髓=Phượng Tủy
恶蛟=Ác Giao
白象=Bạch Tượng
菩萨=Bồ Tát
四海龙王=Tứ Hải Long Vương
天龙八部=Thiên Long Bát Bộ
封神之战=Phong Thần chi chiến
通天教主=Thông Thiên giáo chủ
金光仙=Kim Quang Tiên
金毛犼=Kim Mao Hống
小白龙=Tiểu Bạch Long
无量寿佛=Vô Lượng Thọ Phật
正气歌=Chính Khí Ca
玉蝉=Ngọc Thiền
步步生莲=Bộ Bộ Sinh Liên
神足通=Thần Túc Thông
阿芬=A Phân
维扬=Dương Châu
太守=Thái thú
袁先生=Viên tiên sinh
闻先生=Văn tiên sinh
妖界=Yêu Giới
小狐狸=Tiểu Hồ Ly
七九=Thất Cửu
真龙大人=Chân Long đại nhân
羽衣=Vũ y
运河=Vận Hà
吴钩=Ngô Câu
聂小倩=Nhiếp Tiểu Thiện
张默=Trương Mặc
川蜀=Xuyên Thục
剑阁=Kiếm Các
南宁=Nam Ninh
青城山=Thanh Thành Sơn
凌霄山=Lăng Tiêu Sơn
慧剑=Tuệ Kiếm
飞天=Phi Thiên
毒鸠=Độc Cưu
巨鳄=Cự Ngạc
飞天罗刹=Phi Thiên La Sát
元神=Nguyên Thần
百里=Bách Lí
骑将=Kỵ Tướng
腾蛇=Đằng Xà
血葡萄=Huyết Bồ Đào
天台山=Thiên Thai Sơn
天府之国=Thiên Phủ Chi Quốc
蔺师兄=Lận sư huynh
钧天=Quân Thiên
夜冥=Dạ Minh
孤山=Cô Sơn
莲花山=Liên Hoa Sơn
眉山=Mi Sơn
甲木=Giáp Mộc
丙火=Bính Hỏa
戊土=Mậu Thổ
庚金=Canh Kim
壬水=Nhâm Thủy
乙木=Ất Mộc
丁火=Đinh Hỏa
辛金=Tân Kim
癸水=Quý Thủy
佛子=Phật Tử
鬼王=Quỷ vương
鬼都=Quỷ Đô
鬼尊=Quỷ Tôn
黑池=Hắc Trì
鬼王令=Quỷ Vương Lệnh
鳄龙=Ngạc Long
钩沉=Câu Trầm
望帝=Vọng Đế
杜鹃=Đỗ Quyên
开明=Khai Minh
玺印=Ấn Tín
勾陈=Câu Trần
青城剑法=Thanh Thành kiếm pháp
蛟龙=Giao Long
狗儿=Cẩu Nhi
鬼节=Quỷ Tiết
刘老汉=Lưu Lão Hán
高师=Cao Sư
功曹=Công Tào
盘古=Bàn Cổ
十二祖巫=Thập Nhị Tổ Vu
蜀道=Thục Đạo
邙山=Mang Sơn
巫王=Vu Vương
巫师=Vu Sư
长江=Trường Giang
六丁六甲=Lục Đinh Lục Giáp
巫经=Vu kinh
天王殿=Thiên Vương điện
红袍=Hồng Bào
灰袍=Hôi Bào
小沙弥=Tiểu Sa Di
观音殿=Quán Âm Điện
弥勒佛=Phật Di Lặc
戒空=Giới Không
方正=Phương Chính
第591章=Chương 591
袈裟=Ca sa
剑修=Kiếm tu
知客僧=Tri khách tăng
金蚕=Kim tằm
血蚕=Huyết tằm
金蚕丝=Kim Tàm Ti
天蚕丝=Thiên Tàm Ti
卧虎藏龙=Ngọa Hổ Tàng Long
三花聚顶=Tam Hoa Tụ Đỉnh
陆地真仙=Lục Địa Chân Tiên
扫地僧=Tảo Địa Tăng
癸水神雷=Quý Thủy Thần Lôi
赵师叔=Triệu sư thúc
第598章=Chương 598
药师殿=Dược Sư Điện
药师王佛=Dược Sư Vương Phật
观音菩萨=Quan Âm Bồ Tát
云山雾罩=Vân Sơn Vụ Tráo
白帝城=Bạch Đế Thành
普照=Phổ Chiếu
河洛神算=Hà Lạc Thần Toán
蜀锦=Thục Cẩm
符钱=Phù Tiền
清风谷=Thanh Phong Cốc
本源=Bản Nguyên
素因=Tố Nhân
海渊=Hải Uyên
唐僧=Đường Tăng
中原=Trung Nguyên
伏波=Phục Ba
泰山=Thái Sơn
漓江=Li Giang
上京=Thượng Kinh
尉迟道友=Úy Trì đạo hữu
尉迟=Úy Trì
罗汉=La Hán
明子=Minh Tử
光明佛=Quang Minh Phật
封神=Phong Thần
西游=Tây Du
十绝阵=Thập Tuyệt Trận
先天易数=Tiên Thiên Dịch Số
大儒=Đại Nho
北斗=Bắc Đẩu
五德=Ngũ Đức
真空=Chân Không
阿修罗道=A Tu La Đạo
天眼=Thiên Nhãn
东玄=Đông Huyền
北河=Bắc Hà
炉火纯青=Lô Hỏa Thuần Thanh
会稽=Hội Kê
大念=Đại Niệm
乌光=Ô Quang
天方=Thiên Phương
荆楚=Kinh Sở
淮北=Hoài Bắc
六合大阵=Lục Hợp Đại Trận
天罡=Thiên Cương
仙剑=Tiên Kiếm
地煞=Địa Sát
北方=Phương Bắc
江南地区=Khu vực Giang Nam
道宗=Đạo Tông
南明离火=Nam Minh Ly Hỏa
火德星君=Hỏa Đức tinh quân
观星台=Đài Quan Tinh
阴阳家=Âm Dương Gia
风尘=Phong Trần
火德=Hỏa Đức
白骨观=Bạch Cốt Quán
丽妃=Lệ phi
童心=Đồng Tâm
黄冠=Hoàng Quan
大江=Đại Giang
钢尺=Thước Thép
定风珠=Định Phong Châu
黄石=Hoàng Thạch
老三=Lão Tam
老五=Lão Ngũ
景玉=Cảnh Ngọc
张三哥=Trương Tam ca
九子鬼母=Cửu Tử Quỷ Mẫu
天行=Thiên Hành
地行=Địa Hành
水行=Thủy Hành
族长=Tộc trưởng
九娘=Cửu Nương
罗将军=La tướng quân
九天=Cửu Thiên
老天爷=Lão Thiên Gia
苍天=Thương Thiên
青冥=Thanh Minh
苍穹=Thương Khung
帝释天=Đế Thích Thiên
诺亚方舟=Nô-ê Phương Chu
明王=Minh Vương
老僧=Lão Tăng
会稽山=Hội Kê Sơn
雪莲=Tuyết Liên
胡前辈=Hồ tiền bối
白前辈=Bạch tiền bối
车迟=Xa Trì
北凉王=Bắc Lương Vương
襄樊=Tương Phàn
汉水=Hán Thủy
方某=Phương Mỗ
天赐=Thiên Tứ
诛仙=Tru Tiên
祖老爷=Tổ gia
剑门关=Kiếm Môn Quan
水府=Thủy Phủ
鲶鱼=Niêm Ngư
西疆=Tây Cương
关老爷=Quan Lão Gia
白老爷子=Bạch lão gia tử
妖王=Yêu Vương
黑衣青年=Thanh niên áo đen
戒严=Giới Nghiêm
阿弥陀佛=A Di Đà Phật
金枝=Kim Chi
凌霄城=Lăng Tiêu thành
关中=Quan Trung
盛家=Thịnh Gia
晋南=Tấn Nam
锦妃=Cẩm Phi
百家=Bách Gia
朱雀=Chu Tước
仙界=Tiên Giới
白玉蟾=Bạch Ngọc Thiềm
老君=Lão Quân
水火道袍=Thủy Hỏa Đạo Bào
星官=Tinh Quan
桂树=Quế Thụ
三足金蟾=Tam túc Kim Thiềm
钱家=Tiền gia
谭家=Đàm gia
谭副教主=Đàm Phó Giáo chủ
元磁神光=Nguyên Từ Thần Quang
剑仙=Kiếm Tiên
太湖=Thái Hồ
大越=Đại Việt
巫道=Vu Đạo
无明=Vô Minh
米巫=Mễ Vu
九头鸟=Cửu Đầu Điểu
玄武=Huyền Vũ
孤星=Cô Tinh
五气朝元=Ngũ Khí Triều Nguyên
明觉=Minh Giác
延寿丹=Diên Thọ Đan
天河=Thiên Hà
始祖=Thủy tổ
凌霄=Lăng Tiêu
羽毛=Vũ Mao
梁山=Lương Sơn
千叶=Thiên Diệp
白帝=Bạch Đế
青城=Thanh Thành
渔翁=Ngư Ông
释门=Thích Môn
道家=Đạo gia
名教=Danh Giáo
黔中=Kiềm Trung
兵家=Binh Gia
兵圣=Binh Thánh
正统=Chính Thống
新生=Tân Sinh
枯木真人=Khô Mộc chân nhân
小洞天=Tiểu Động Thiên
圣僧=Thánh tăng
红鸾=Hồng Loan
净角=Tịnh Giác
九华寺=Cửu Hoa Tự
明净=Minh Tịnh
松竹=Tùng Trúc
百丈=Bách Trượng
黄山=Hoàng Sơn
圆通=Viên Thông
枯木=Khô Mộc
丹阳=Đan Dương
