乐厚=Nhạc Hậu
剑圣=Kiếm Thánh
剑神=Kiếm Thần
加文=Garvin
勇度=Yondu
勇气=Dũng Khí
吕义=Lữ Nghĩa
圣姑=Thánh Cô
塔南=Tarnum
天书=Thiên Thư
女娲=Nữ Oa
孙晨=Tôn Thần
孙逵=Tôn Quỳ
孟晋=Mạnh Tấn
小黑=Tiểu Hắc
左亭=Tả Đình
巫王=Vu Vương
张唐=Trương Đường
心经=Tâm Kinh
拜月=Bái Nguyệt
掌门=Chưởng môn
文化=Văn Hóa
方生=Phương Sinh
无名=Vô Danh
星爵=Star Lord
李沐=Lý Mộc
河阳=Hà Dương
法师=Pháp sư
灭霸=thanos
牧师=Mục sư
玉天=Ngọc Thiên
王府=Vương Phủ
秦霜=Tần Sương
老苗=Lão Miêu
苏汤=Tô Thang
苗壮=Miêu Tráng
菊豆=Cúc Đậu
虞二=Ngu Nhị
虱蛊=Sắt Cổ
蛊术=Cổ thuật
蜀山=Thục Sơn
赵桐=Triệu Đồng
达蒙=Damon
道家=Đạo gia
钟眉=Chung Mi
陆柏=Lục Bách
陈哥=Trần ca
青儿=Thanh Nhi
麒麟=Kỳ Lân
一线牵=Nhất Tuyến Khiên
万剑诀=Vạn Kiếm Quyết
万大平=Vạn Đại Bình
仙学院=Tiên viện
仙灵岛=Tiên Linh Đảo
令师妹=Lệnh Sư Muội
令狐冲=Lệnh Hồ Xung
任教主=Nhậm giáo chủ
余杭镇=Dư Hàng Trấn
克里根=Kreegans
兴云庄=Hưng Vân Trang
凤舞箭=Phượng Vũ Tiễn
刘晋元=Lưu Tấn Nguyên
南诏国=Nam Chiếu Quốc
唐若悠=Đường Nhược Du
圣心诀=Thánh Tâm Quyết
大老爸=Đại Lão Ba
天音寺=Thiên Âm Tự
太极剑=Thái Cực Kiếm
孙小红=Tôn Tiểu Hồng
张小凡=Trương Tiểu Phàm
张金鰲=Trương Kim Ngao
拉瑟尔=Russell
易筋经=Dịch Cân Kinh
李二侠=Lý Nhị Hiệp
李大婶=Lý Đại Thẩm
李寻欢=Lý Tầm Hoan
李少爷=Lý Thiếu Gia
李逍遥=Lý Tiêu Dao
林天南=Lâm Thiên Nam
林诗音=Lâm Thi Âm
桑三娘=Tang Tam Nương
江湖客=Giang Hồ Khách
汤陈义=Thang Trần Nghĩa
活血散=Hoạt Huyết Tán
游公子=Du Công Tử
火灵珠=Hỏa Linh Châu
王小虎=Vương Tiểu Hổ
田伯光=Điền Bá Quang
白石城=Bạch Thạch Thành
皮卡丘=Pikachu
祝君豪=Chúc Quân Hào
程先生=Trình tiên sinh
紫金丹=Tử Kim Đan
胡晓彤=Hồ Hiểu Đồng
草上飞=Thảo Thượng Phi
莫一兮=Mạc Nhất Hề
蜀山派=Thục Sơn Phái
血剑堂=Huyết Kiếm Đường
血菩提=Huyết Bồ Đề
诸葛刚=Gia Cát Cương
诸葛雷=Gia Cát Lôi
越女剑=Việt Nữ Kiếm
道德经=Đạo Đức Kinh
酒剑仙=Tửu Kiếm Tiên
防御术=Defense
阿维利=Arvil
青云门=Thanh Vân Môn
青魔手=Thanh Ma Thủ
领导术=Leadership
风神腿=Phong Thần Thối
魔法书=Magic book
鲍大楚=Bảo Đại Sở
龙四爷=Long tứ gia
上善若水=Thượng Thiện Nhược Thủy
九天玄经=Cửu Thiên Huyền Kinh
亚历山大=Alexander
倩女幽魂=Thiến Nữ U Hồn
傲寒六诀=Ngạo Hàn Lục Quyết
先天道体=Tiên Thiên Đạo Thể
千叶禅师=Thiên Diệp Thiền Sư
吸星大法=Hấp Tinh Đại Pháp
地狱骑士=Địa Ngục Kỵ Sĩ
多情剑客=Đa Tình Kiếm Khách
大雄宝殿=Đại Hùng Bảo Điện
小无相功=Tiểu Vô Tương Công
巫术启蒙=Vu Thuật Khải Mông
开山剑法=Khai Sơn Kiếm Pháp
御剑飞行=Ngự Kiếm Phi Hành
恩格塔瑞=Engtari
护体神盾=Body Shield
掠夺之王=Tước Đoạt Chi Vương
攻击加速=Attack Acceleration
明镜姥姥=Minh Kính Mỗ Mỗ
暮光之城=Mộ Quang Chi Thành
清净心经=Thanh Tịnh Tâm Kinh
爱乐之城=Ái Nhạc Chi Thành
玛格努斯=Magnus
生化危机=Sinh Hóa Nguy Cơ
神行百变=Thần Hành Bách Biến
莫大掌门=Mạc Đại Chưởng Môn
蚀日剑法=Thực Nhật Kiếm Pháp
轩辕飞剑=Hiên Viên Phi Kiếm
迟缓大法=Slow Dafa
金翅凤凰=Kim Sí Phượng Hoàng
魔力源泉=Source of Magic
魔法神箭=Magic Arrow
太极玄清道=Thái Cực Huyền Thanh Đạo
异次元之门=The Gate of Another Dimension
易经锻骨篇=Dịch Kinh Đoán Cốt Thiên
法师终结者=Pháp Sư Chung Kết Giả
蜀山仙学院=Thục Sơn Tiên Viện
飞龙探云手=Phi Long Tham Vân Thủ
安迪卡普恩特=Andy Capuente
仈 Jiǔ 不离十了=tám chín phần mười
卢大大水克可达路利达皮=Luda Dasu Keda Luli Dapi
Tả Chưởng Môn=Tả Chưởng Môn