MD！=MD
NMD=NMD
byd=byd
lv=lv
‘前’字秘=‘ Tiền ’ Tự Bí
一只小血鸦=một cái tiểu huyết nha
一条长生=một đầu trường sinh
一鹤=một hạc
丁铁柱=Đinh Thiết Trụ
丁鼎=Đinh Đỉnh
七十级=70 cấp
七曜魔剑=Thất Diệu Ma Kiếm
万妞不当之勇=Vạn Nữu Bất Đương Chi Dũng
万泉圣河=Vạn Tuyền Thánh Hà
万花涧=Vạn Hoa Giản
三十万伏特=300000 volt
三品官身=tam phẩm quan thân
三哥身上=Tam ca trên thân
三大钱庄=Tam Đại Tiền Trang
三级=ba cấp¦ba bậc¦Tam cấp¦tam cấp
三茅峰=Tam Mao Phong
三里巷=Tam Lý Hạng
三镇=Tam Trấn
三镇连营=Tam Trấn Liên Doanh
三镇连营将=Tam Trấn Liên Doanh Tướng
上三品=thượng tam phẩm
上弦三=Thượng Huyền Tam
上疏处=Thượng Sớ Xứ
下骁骑校=Hạ Kiêu Kỵ Hiệu
不偏不倚地=không nghiên không lệch
丘寒山=Khâu Hàn Sơn
丘晓铃=Khâu Hiểu Linh
东乱=Đông Loạn
东兰谷=Đông Lan Cốc
东境流寇=Đông Cảnh Lưu Khấu
东景=Đông Cảnh
东景城=Đông Cảnh Thành
东景陵=Đông Cảnh Lăng
东林叶家=Đông Lâm Diệp Gia
东林省=Đông Lâm Tỉnh
东林行省=Đông Lâm Hành Tỉnh
东港镇=Đông Cảng Trấn
东港镇镇督=Đổng Cảng Trấn trấn đốc
东渺参=Đông Miểu Sâm
东渺海=Đông Miểu Hải
东瓦当要塞=Pháo đài Đông Ngõa Đương
东郊庶人城=Đông Giao Thứ Dân Thành
东陵之乱=Đông Lăng chi loạn
东陵陵督=Đông Lăng Lăng Đốc
东麓书院=Đông Lộc thư viện
两个美女=hai cô gái đẹp
两人的心境=hai người tâm cảnh
两党=lưỡng đảng
两回=hai lần
两抹=hai vệt
两条大道=hai đầu Đại Đạo
两道目光=hai đạo ánh mắt
严剑师=Nghiêm Kiếm Sư
中州军=Trung Châu Quân
中州卫=Trung Châu Vệ
中州城=Trung Châu Thành
中州皇城=Trung Châu Hoàng Thành
中州皇城军部=Trung Châu Hoàng Thành Quân Bộ
中州皇宫=Trung Châu Hoàng Cung
中野悠太=Yuta Nakano
临川行省=Lâm Xuyên Hành Tỉnh
临川黑牛=Lâm Xuyên Hắc Ngưu
临来前=trước khi đến
临江小楼=Lâm Giang Tiểu Lâu
为生魂=là sinh hồn
丽水香=Lệ Thủy Hương
乌如拖拉曼=Ultraman
乌拉唦=Ô Lạp Sa
乌金丝=Ô Kim Ty
乌金禅杖=Ô Kim Thiền Trượng
乌锁镇=Ô Tỏa Trấn
乐平江=Nhạc Bình Giang
乐江平=Nhạc Giang Bình
乔纳·詹姆森=Jonah Jameson
九元老=Cửu Nguyên Lão
九安陵=Cửu An Lăng
乱世狂刀01=Loạn Thế Cuồng Đao 01
乱古时期=Loạn Cổ Thời Kì
乳白光芒=ánh sáng trắng đục
乳白的光=ánh sáng trắng đục
乳白的光芒=ánh sáng trắng đục
了一般=đồng dạng
二十万伏特=200000 volt
二级=hai cấp¦nhị cấp
二茅峰=Nhị Mao Phong
云卢战马=Vân Lô chiến mã
云梦裙老江团=Vân Mộng Quần Lão Giang Đoàn
云祭司=Vân Tế Tự
云秦人=Vân Tần Nhân
云秦先皇=Tiên Hoàng Vân Tần
云秦八大司=Vân Tần Bát Đại Ty
云秦凤凰=Vân Tần Phượng Hoàng
云秦剑=Vân Tần Kiếm
云秦北仓洞边贸集镇=Vân Tần Bắc Thương Động Biên Mậu Tập Trấn
云秦周家=Vân Tần Chu gia
云秦国=Vân Tần quốc
云秦城=Vân Tần Thành
云秦天凤=Vân Tần Thiên Phượng
云秦将领=Vân Tần Tướng Lĩnh
云秦帝国=Vân Tần đế quốc
云秦律=Vân Tần luật
云秦律法=Vân Tần Luật Pháp
云秦朝=Triều Vân Tần
云秦朝堂=Vân Tần Triều Đường
云秦王城=Vân Tần vương thành
云秦疆域=Vân Tần cương vực
云秦皇宫=Vân Tần Hoàng Cung
云秦皇帝=Vân Tần Hoàng Đế
云秦皇帝长孙锦瑟=Vân Tần Hoàng đế Trường Tôn Cẩm Sắt
云秦皇庭=Vân Tần Hoàng Đình
云秦皇庭大供奉=Vân Tần Hoàng Đình Đại Cung Phụng
云秦皇族=Vân Tần hoàng tộc
云英镇=Vân Anh Trấn
五柳滩=Ngũ Liễu Than
五级=năm cấp
亚楠=Á Nh楠
京城许三少=Kinh Thành Hứa Tam Thiếu
京辅陵=Kinh Phụ Lăng
人人得儿诛之=người người có thể tru diệt
人族帝兵=Nhân Tộc Đế Binh
人王剑=Nhân Vương Kiếm
仇正虎=Cừu Chính Hổ
仙一学院=Tiên Nhất Học Viện
仙一山=Tiên Nhất Sơn
仙蝶花=Tiên Điệp Hoa
仙魔变=Tiên Ma Biến
任发=Nhậm Phát
任天堂=Nhậm Thiên Đường
传道之恩=truyền đạo chi ân
何九轩=Hà Cửu Hiên
何杰=Hà Kiệt
何浪=Hà Lãng
何竹葵=Hà Trúc Quỳ
余铁柱=Dư Thiết Trụ
佟讲师=Đồng giảng sư
佟韦=Đồng Vi
侯雀城=Hầu Tước Thành
修仙界之人=người của Tu Tiên giới
修史=tu sử
修士的手段=tu sĩ thủ đoạn
倒尾=đảo vĩ
候雀城=Hậu Tước Thành
倚天小剑=Ỷ Thiên tiểu kiếm
倪大供奉=Nghê Đại Cung Phụng
倪鹤年=Nghê Hạc Niên
傲凰=Ngạo Hoàng
儿子江=Nhi Tử Giang
元昊方=Nguyên Hạo Phương
元流=Nguyên Lưu
克林特·巴顿=Clint Barton
全都白费=toàn đều vô ích
八司=Bát Tư
八瓣仙兰=Tám Cánh Tiên Lan
八鉴灭音=Bát Giám Diệt Âm
公孙景=Công Tôn Cảnh
公孙泉=Công Tôn Tuyền
公瑾将军=Công Cẩn tướng quân
公瑾战王=Công Cẩn Chiến Vương
六角井=Lục Giác Tỉnh
关勇=Quan Dũng
养仙池=dưỡng tiên trì
内务司=Nội Vụ Tư
内德=Ned
内德·利兹=Ned Leeds
内相系=Nội Tướng Hệ
军监处=Quân Giám Xử
冯征明=Phùng Chinh Minh
冯泽意=Phùng Trạch Ý
冯税官=Phùng thuế quan
冰晶谷=Băng Tinh Cốc
冰雪古城=Băng Tuyết Cổ Thành
冰雪神原=Băng Tuyết Thần Nguyên
冰雪神域=Băng Tuyết Thần Vực
冰魄晶黄铜鹰眼=Băng Phách Tinh Hoàng Đồng Ưng Nhãn
况修贤=Huống Tu Hiền
冷家千金=Lãnh Gia Thiên Kim
冷月银杏=Lãnh Nguyệt Ngân Hạnh
冷狼=Lãnh Lang
冷秋=Lãnh Thu
冷秋语=Lãnh Thu Ngữ
冷镇南=Lãnh Trấn Nam
凄辰『吟』雪=Thê Thần Ngâm Tuyết
凄辰吟雪=Thê Thần Ngâm Tuyết
凌涵=Lăng Hàm
凝香丸=Ngưng Hương Hoàn
凤轩=Phượng Hiên
凤轩皇帝=Phượng Hiên Hoàng Đế
凰火笑=Hoàng Hỏa Tiếu
出龙蛇边关=Xuất Long Xà Biên Quan
刑司=Hình Tư
刑司许家=Hình Tư Hứa gia
刑天养=Hình Thiên Dưỡng
刑德荣=Hình Đức Vinh
刘七爷=Lưu Thất Gia
刘丈青=Lưu Trượng Thanh
刘乘恩=Lưu Thừa Ân
刘五月=Lưu Ngũ Nguyệt
刘北望=Lưu Bắc Vọng
刘华君=Lưu Hoa Quân
刘孝=Lưu Hiếu
刘柔=Lưu Nhu
刘玉祥=Lưu Ngọc Tường
刘玉翔=Lưu Ngọc Tường
刘种田=Lưu Chủng Điền
刘英霆=Lưu Anh Đình
刘造泽=Lưu Tạo Trạch
刘铜=Lưu Đồng
刚羊尖田山巡牧军=Cương Dương Tiêm Điền Sơn Tuần Mục Quân
刺枣丘=Thứ Táo Khâu
剑痴道若素=Kiếm Si Đạo Nhược Tố
加库玛·贝塔=Gakumar Beta
加库玛·阿尔法=Gakuma Alpha
劫黑牢=cướp hắc lao
化字诀=Hóa Tự Quyết
北仓洞=Bắc Thương Động
北冰海冰雪巨人=Người khổng lồ băng tuyết Bắc Băng Hải
北冰海域=Bắc Băng Hải Vực
北府行省=Bắc Phủ Hành Tỉnh
北海水獭=Rái cá biển Bắc Hải
北清山=Bắc Thanh Sơn
北潮陵=Bắc Triều Lăng
北苗行省=Bắc Miêu Hành Tỉnh
北陇=Bắc Lũng
北陇行省=Bắc Lũng Hành Tỉnh
北陇青牛=Bắc Lũng Thanh Ngưu
十七巷一港三大市=Thập Thất Hạng Nhất Cảng Tam Đại Thị
十万伏特=100000 volt
十三坞=Thập Tam Ổ
十三城门楼=Thập Tam thành môn lâu
十指岭=Thập Chỉ Lĩnh
千仓洞=Thiên Thương Động
千叶关=Thiên Diệp Quan
千椿镇=Thiên Xuân trấn
千裕=Thiên Dụ
千钧门=Thiên Quân Môn
千霞=Thiên Hà
千霞关=Thiên Hà Quan
千霞军=Thiên Hà Quân
千霞山=Thiên Hà Sơn
千霞边关=Thiên Hà Biên Quan
千霞边军=Thiên Hà Biên Quân
千霞边境=Thiên Hà Biên Cảnh
午马=Ngọ Mã
半雪苍原=Bán Tuyết Thương Nguyên
华固郡=Hoa Cố Quận
卓贺之=Trác Hạ Chi
卓青盈=Trác Thanh Doanh
南临行省=Nam Lâm Hành Tỉnh
南令=Nam Lệnh
南令行省=Nam Lệnh Hành Tỉnh
南伐=Nam Phạt
南伐战场=Nam Phạt chiến trường
南宫苍月=Nam Cung Thương Nguyệt
南宫陌=Nam Cung Mạch
南将军=Nam tướng quân
南山将军=Nam Sơn tướng quân
南山暮=Nam Sơn Mộ
南平陵=Nam Bình Lăng
南忠杰=Nam Trung Kiệt
南摩国=Nam Ma Quốc
南星坡=Nam Tinh Pha
南星花=Nam Tinh Hoa
南歧岢=Nam Kỳ Khả
南路大将军=Nam Lộ Đại Tướng Quân
南陵=Nam Lăng
南陵行省=Nam Lăng Hành Tỉnh
南鱼山=Nam Ngư Sơn
卡波卡=Tạp Ba Tạp
卢天福=Lư Thiên Phúc
卢福记=Lư Phúc Ký
卢肇吉=Lư Triệu Cát
发小=bạn thân
发小知道=bạn thân biết
取信陵=Thủ Tín Lăng
变成人傀=biến thành nhân khôi
古妖林=Cổ Yêu Lâm
古藤纹=Cổ Đằng Văn
叫老奴=bảo lão nô
可人手=nhưng nhân thủ
可奈何=nhưng làm sao
可笑=buồn cười¦vui vẻ¦nực cười¦tức cười¦mắc cười¦tiếu lâm¦hài hước¦hài
史秋刀=Sử Thu Đao
叶凝=Diệp Ngưng
叶子沁=Diệp Tử Thấm
叶少枫=Diệp Thiếu Phong
叶忘情=Diệp Vong Tình
叶骨衣=Diệp Cốt Y
司徒言鼎=Tư Đồ Ngôn Đỉnh
司耕=Tư Canh
司风师叔=Tư Phong sư thúc
各族血食=các tộc huyết thực
合子巷=Hợp Tử Hạng
后世人族=hậu thế nhân tộc
吏司=Lại Tư
吏治腐败=Lại Trị Hủ Bại
向林=Hướng Lâm
吕凤娘=Lữ Phượng Nương
吕启=Lữ Khải
吕启明=Lữ Khải Minh
吕灭敌=Lữ Diệt Địch
吕秋刀=Lữ Thu Đao
君先生=Quân tiên sinh
听松学院=Thính Tùng học viện
听风细雨楼=Thính Phong Tế Vũ Lâu
吴天祥=Ngô Thiên Tường
吴念娇=Ngô Niệm Kiều
吴秋田=Ngô Thu Điền
吴羡=Ngô Tiện
周七绝=Chu Thất Tuyệt
周伏龙=Chu Phục Long
周大公=Chu Đại Công
周天水=Chu Thiên Thủy
周年山=Chu Niên Sơn
周广平=Chu Quảng Bình
周康安=Chu Khang An
周池=Chu Trì
周游帝国=Chu Du Đế Quốc
周漪=Chu Y
周用贤=Chu Dụng Hiền
周由简=Chu Do Giản
周若海=Chu Nhược Hải
周雪峰=Chu Tuyết Phong
周首辅=Chu Thủ Phụ
哀牢后山=Ai Lao Hậu Sơn
哀牢峰=Ai Lao Phong
响马集=Hưởng Mã Tập
唐仁=Đường Nhân
唐初晴=Đường Sơ Tình
唐可=Đường Khả
唐牛=Đường Ngưu
唐离人=Đường Ly Nhân
唐藏=Đường Tạng
唐藏京城=Đường Tạng Kinh Thành
唐藏人=Đường Tàng Nhân
唐藏凤轩皇帝=Đường Tạng Phượng Hiên Hoàng Đế
唐藏古国=Đường Tạng Cổ Quốc
唐藏圣城=Đường Tạng Thánh Thành
唐藏圣母皇太后=Đường Tạng Thánh Mẫu Hoàng Thái Hậu
唐藏小皇帝=Đường Tạng Tiểu hoàng đế
唐藏帝国=Đường Tạng Đế Quốc
唐藏慧光帝=Đường Tàng Tuệ Quang Đế
唐藏流沙城=Đường Tàng Lưu Sa Thành
唐藏皇叔=Đường Tạng hoàng thúc
唐藏皇叔萧湘=Tiêu Tương hoàng thúc Đường Tạng
唐藏皇后=Đường Tạng Hoàng Hậu
唐藏皇太后=Đường Tạng Hoàng thái hậu
唐藏皇帝=Đường Tạng Hoàng Đế
唐雨人=Đường Vũ Nhân
唐青山=Đường Thanh Sơn
商永=Thương Vĩnh
商音=Thương Âm
嘉叶关=Gia Diệp Quan
器灵小人=Khí Linh tiểu nhân
四十级=40 cấp
四季坡=Tứ Quý Pha
四季平原=Tứ Quý Bình Nguyên
回天帝=hồi Thiên Đế
囤树围=Đồn Thụ Vi
土断土狂雷=Thổ Đoạn Thổ Cuồng Lôi
土狼邓收成=Thổ Lang Đặng Thu Thành
土著=thổ dân
土跋部=Thổ Bạt bộ
圣师夜莺=Thánh Sư Dạ Oanh
圣母皇太后=Thánh Mẫu Hoàng Thái Hậu
圣皇来贺=Thánh Hoàng đến chúc
地藏教=Địa Tàng Giáo
地龙子=Địa Long Tử
坛怪=Đàn Quái
坠星=Truy Tinh
坠星城=Truy Tinh thành
坠星天凤=Truy Tinh Thiên Phượng
坠星湖=Truy Tinh Hồ
坠星边军=Truy Tinh Biên Quân
坠星陵=Truy Tinh Lăng
坠星陵城=Truy Tinh Lăng Thành
坠月=Truỵ Nguyệt
基兰勃=Ki Lambo
基里·艾洛德=Kiri Elrod
堕落崖=Đọa Lạc Nhai
墨晶丛林=Mặc Tinh Tùng Lâm
墨绿色眼眸=màu xanh sẫm tròng mắt
墨绿色瞳孔=con ngươi màu xanh sẫm
墨虹=Mặc Hồng
墨轻颜=Mặc Khinh Nhan
墨青锋=Mặc Thanh Phong
复仇者=Avenger
夏知秋=Hạ Tri Thu
夏言冰=Hạ Ngôn Băng
夕可死也=tối chết cũng được
多人脉=nhiều nhân mạch
夜恶=Dạ Ác
夜枭重甲=Dạ Kiêu Trọng Giáp
夜梦红枕=Dạ Mộng Hồng Chẩm
夜魔重铠=Dạ Ma Trọng Khải
夜魔铠=Dạ Ma Khải
夜鸭=Dạ Áp
大原城=Đại Nguyên Thành
大司陵=Đại Tư Lăng
大同号=Đại Đồng hiệu
大同号商行=Đại Đồng Hiệu Thương Hàng
大圣师=Đại Thánh Sư
大宁河=Đại Ninh Hà
大德祥=Đại Đức Tường
大德集镇=Đại Đức Tập Trấn
大枫巷=Đại Phong Hạng
大梦万古=đại mộng vạn cổ
大泰富=Đại Thái Phú
大济城=Đại Tế Thành
大浮镇=Đại Phù Trấn
大浮集镇=Đại Phù Tập Trấn
大盛行省=Đại Thịnh Hành Tỉnh
大盛高=Đại Thịnh Cao
大盛高钱庄=Đại Thịnh Cao Tiền Trang
大磁泽=Đại Từ Trạch
大莽=Đại Mãng
大莽人=Đại Mãng nhân
大莽军=Đại Mãng Quân
大莽千魔窟=Đại Mãng Thiên Ma Quật
大莽圣地=Đại Mãng Thánh Địa
大莽天龙库=Đại Mãng Thiên Long khố
大莽女修行者=Đại Mãng Nữ Tu Hành Giả
大莽密禄院=Đại Mãng Mật Lộc viện
大莽帝国=Đại Mãng Đế Quốc
大莽炼狱山=Đại Mãng Luyện Ngục Sơn
大莽王城=Đại Mãng vương thành
大莽王朝=Đại Mãng vương triều
大莽皇城=Đại Mãng hoàng thành
大莽皇宫=Đại Mãng Hoàng Cung
大莽皇帝=Đại Mãng Hoàng Đế
大莽老皇帝=Đại Mãng lão hoàng đế
大顺通钱庄=Đại Thuận Thông Tiền Trang
天人剑=Thiên Nhân Kiếm
天元奎=Thiên Nguyên Khuê
天光云影=Thiên Quang Vân Ảnh
天凤玉珠行=Thiên Phượng Ngọc Châu Hành
天命峰=Thiên Mệnh Phong
天命者=Thiên Mệnh Giả
天国统领=thiên quốc thống lĩnh
天安陵=Thiên An Lăng
天工系=Thiên Công hệ
天平遥=Thiên Bình Dao
天心破碎=Thiên Tâm phá toái
天枢峰=Thiên Xu Phong
天枢级=Thiên Xu cấp
天梦=Thiên Mộng
天武公主=Thiên Vũ Công Chúa
天河学院=Thiên Hà Học Viện
天烛氏=Thiên Chúc Thị
天狼卫=Thiên Lang Vệ
天玉蜂=Thiên Ngọc Phong
天玑峰=Thiên Cơ Phong
天竹=thiên trúc
天耀=Thiên Diệu
天芒精金=Thiên Mang Tinh Kim
天茯獭=Thiên Phục Thử
天莽王朝=Thiên Mãng vương triều
天落=Thiên Lạc
天落行省=Thiên Lạc Hành Tỉnh
天落陵=Thiên Lạc Lăng
天贞坊=Thiên Trinh Phường
天魔狱原=Thiên Ma Ngục Nguyên
天魔重铠=Thiên Ma Trọng Khải
天鸦洞=Thiên Nha Động
天麒大道=Thiên Kỳ đại đạo
天麒巷=Thiên Kỳ Hạng
天龙军统领=Thiên Long Quân Thống Lĩnh
太子长孙无疆=Thái tử Trưởng Tôn Vô Cương
太平令=Thái Bình Lệnh
太极守势=Thái Cực thủ thế
太白酒楼=Thái Bạch Tửu Lâu
头茅峰=Đầu Mao Phong
夺月城=Đoạt Nguyệt Thành
奇异的力量波动=kỳ dị lực lượng ba động
奥加=Ogga
她小姐=nàng tiểu thư
她漠然=nàng hờ hững
如东陵=Như Đông Lăng
如日中天=như mặt trời ban trưa¦cực kì hưng thịnh
姜瑞=Khương Thụy
姜瑞连=Khương Thụy Liên
姜言官=Khương Ngôn Quan
姜钰儿=Khương Ngọc Nhi
婀娜的=thướt tha
嫁接了=giá tiếp
嫁接了过来=ghép lại
子母箭=Tử Mẫu Tiễn
子鹿=Tử Lộc
孔雀箭=Khổng Tước Tiễn
孙养韬=Tôn Dưỡng Thao
孙德新=Tôn Đức Tân
孙某人=Tôn mỗ nhân
孙翠绣=Tôn Thúy Tú
孟肃=Mạnh Túc
孟长歌=Mạnh Trường Ca
宁百鸣=Ninh Bách Minh
宇化=Vũ Hóa
宇化世家=Vũ Hóa Thế Gia
宇化天极=Vũ Hóa Thiên Cực
宇化家=Vũ Hóa Gia
宇化山河=Vũ Hóa Sơn Hà
宇化教授=Giáo sư Vũ Hóa
宇化无极=Vũ Hóa Vô Cực
宇化灵毓=Vũ Hóa Linh Dục
宇化灵毓大祭司=Vũ Hóa Linh Dục Đại Tế Tư
宇将军=Vũ tướng quân
安副教授=Phó giáo sư An
安可依=An Khả Y
安可疑=An Khả Nghi
安观影=An Quan Ảnh
安逸府=An Dật Phủ
宋叙苦=Tống Tự Khổ
宋成=Tống Thành
宋成鹏=Tống Thành Bằng
宋管带=Tống quản đới
完颜师兄=Hoàn Nhan sư huynh
完颜暮烨=Hoàn Nhan Mộ Diệp
定尘道友=Định Trần đạo hữu
宫亭绝=Cung Đình Tuyệt
家兄长=gia huynh trưởng
容大祭司=Dung Đại Tế Tư
容天一=Dung Thiên Nhất
宿青衣=Túc Thanh Y
宿龙疏=Túc Long Sơ
密禄院=Mật Lộc viện
对标=so sánh với¦đối chiếu
对练武看似=đối luyện võ xem như
寻山司=Tầm Sơn Ty
封千寒=Phong Thiên Hàn
封林军=Phong Lâm Quân
将军大人=tướng quân đại nhân
将军巷=Tướng quân hạng
将神=Tướng Thần
小lulu=Tiểu Lulu
小先天=tiểu tiên thiên
小无罪=Tiểu Vô Tội
小林大人=Tiểu Lâm đại nhân
小紫姑娘=Tiểu Tử cô nương
小范闲=Tiểu Phạm Nhàn
小血鸦=tiểu huyết nha
小西京=Tiểu Tây Kinh
小许老板=Tiểu Hứa Lão Bản
小说作家=tiểu thuyết tác giả
小说改编=tiểu thuyết cải biên
小陈记=Tiểu Trần Ký
小震子=Tiểu Chấn Tử
小须弥壁=Tiểu Tu Di Bích
小黄鸭=Tiểu Hoàng Áp
尸体内的能量=thi thể bên trong năng lượng
居留云颦=Cư Lưu Vân Tần
居留手=Cư Lưu Thủ
居留氏=Cư Lưu Thị
屠黑虎=Đồ Hắc Hổ
山海丁香丸=Sơn Hải Đinh Hương Hoàn
山海主脉=Sơn Hải Chủ Mạch
山海山脉=Sơn Hải Sơn Mạch
山阳道=Sơn Dương Đạo
山阴军=Sơn Âm Quân
山阴省督=Sơn Âm Tỉnh Đốc
山阴行省=Sơn Âm Hành Tỉnh
山阴财神=Sơn Âm Tài Thần
山鲁行省=Sơn Lỗ Hành Tỉnh
岁寒临江楼=Tuế Hàn Lâm Giang Lâu
巡牧军=Tuần Mục Quân
工司=Công Tư
工司周家=Công Tư Chu gia
左青丘=Tả Thanh Khâu
巨人的速度=cự nhân tốc độ
巨大溶洞=cự đại động đá
巴顿=Barton
师、志、贤=Sư, Chí, Hiền
师老学士=Sư Lão Học Sĩ
师虫鸣=Sư Trùng Minh
师长的=sư trưởng
帝临青鸾=Đế Lâm Thanh Loan
常净香=Thường Tịnh Hương
常继=Thường Kế
平波大将军=Bình Ba Đại Tướng Quân
平野军=Bình Dã Quân
年卿城=Niên Khanh Thành
年卿晨=Niên Khanh Thần
年辰景=Niên Thần Cảnh
广智=Quảng Trí
广裕=Quảng Dụ
广裕行省=Quảng Dụ Hành Tỉnh
庄聚安=Trang Tụ An
庞问=Bàng Vấn
庶人城=Thứ Nhân thành
康千绝=Khang Thiên Tuyệt
康将军=Khang tướng quân
廉政署=Liêm Chính Thự
建德门=Kiến Đức Môn
张三两=Trương Tam Lưỡng
张二明=Trương Nhị Minh
张供奉=Trương cung phụ
张大长老=Trương đại trưởng lão
张宫山=Trương Cung Sơn
张提捕=Trương Đề Bộ
张棋=Trương Kỳ
张灵运=Trương Linh Vận
张秋玄=Trương Thu Huyền
张算盘=Trương Toán Bàn
张路斩=Trương Lộ Trảm
张镇东=Trương Trấn Đông
张龙王=Trương Long Vương
强大的心灵=cường đại tâm linh
彭晓风=Bành Hiểu Phong
彭颖=Bành Dĩnh
影刺虫毒=Ảnh Thứ Trùng Độc
影子圣师=Ảnh Tử Thánh Sư
影诛=Ảnh Tru
彼此的手法=thủ pháp của nhau
徐乘风=Từ Thừa Phong
徐可持=Từ Khả Trì
徐子青=Từ Tử Thanh
徐宁申=Từ Ninh Thân
徐布衣=Từ Bố Y
徐生沫=Từ Sinh Mạt
徐笙=Từ Sanh
徐讲师=Giảng sư Từ
御剑圣师=Ngự Kiếm Thánh Sư
御火吞天=Ngự Hỏa Thôn Thiên
御药=Ngự Dược
御药系=Ngự Dược Hệ
御都科=Ngự Đô Khoa
心悸的=tim đập nhanh
念英=Niệm Anh
怀空师兄=Hoài Không sư huynh
怀空师弟=Hoài Không sư đệ
怀空施主=Hoài Không thí chủ
恭和谦让=lịch sự khiêm tốn
息子江=Tức Tử Giang
息子江龙王=Tức Tử Giang Long Vương
惠古镇=Huệ Cổ Trấn
惠灵丹=Huệ Linh Đan
惶惶大日=hoàng hoàng đại nhật
惶惶天道=hoàng hoàng thiên đạo
慈平宫=Từ Bình Cung
慌慌张张地=hoang mang rối loạn
慕信离=Mộ Tín Ly
慕宗离=Mộ Tông Ly
慧尾箭=Tuệ Vĩ Tiễn
慧灵丹=Tuệ Linh Đan
懂懂懂=hiểu hiểu hiểu
戊人城=Mậu Nhân Thành
戊城河=Mậu Thành Hà
成道之前=thành đạo trước đó
我两击=ta hai kích
我省的=ta biết rồi
我等你=ta chờ ngươi
户司=Hộ Tư
扈归朴=Hỗ Quy Phác
手底下的=thủ hạ
披毛戴角=khoác lông mang sừng
拂风岛=Phất Phong đảo
拂风真人=Phất Phong chân nhân
拦下一件=ngăn lại một cái
拦江坝=Lan Giang Bá
拱北观=Củng Bắc Quán
挥出的=vung ra
掌控的=chưởng khống
提捕=Đề bộ
提捕房=Đề Bộ Phòng
揽月灼星=Lãm Nguyệt Chước Tinh
摩柯剑=Ma Kha Kiếm
擎天巨人=Kình Thiên Cự Nhân
敕勒川=Sắc Lặc Xuyên
文司首=Văn Tư Thủ
文昌剑阁=Văn Xương Kiếm Các
文治系=Văn Trị hệ
文玄枢=Văn Huyền Xu
文轩宇=Văn Hiên Vũ
文首辅=Văn Thủ Phụ
斋宫=Trai Cung
断土狂雷=Đoạn Thổ Cuồng Lôi
新生殿=Tân Sinh Điện
新生试炼山谷=Tân sinh Thí luyện sơn cốc
方池未=Phương Trì Vị
方竺=Phương Trúc
旅人芋林=Lữ Nhân Dụ Lâm
无为观=Vô Vi Quán
无亲无戚=không có người thân
无尽黄沙=Vô Tận Hoàng Sa
无惨=không thảm¦Muzan
无畏无怖=Vô Úy Vô Bố
无疆大殿=Vô Cương Đại Điện
无疆殿=Vô Cương Điện
无罪本尊=Vô Tội Bản Tôn
时谦=Thời Khiêm
明嵚=Minh Khâm
明教授=Minh Giáo Sư
明王破狱=Minh Vương Phá Ngục
明真丹=Minh Chân Đan
明秋池=Minh Thu Trì
易字秘=Dịch Tự Bí
易字诀=Dịch Tự Quyết
星光笼罩=tinh quang bao phủ
春剑南=Xuân Kiếm Nam
是他的手下=là hắn thủ hạ
是姓顾=là họ Cố
是灵石=là Linh Thạch
是谁家=là nhà ai
晋乘云=Tấn Thừa Vân
晋将军=Tấn tướng quân
晋承云=Tấn Thừa Vân
晨光长剑=Thần Quang trường kiếm
晨曦长剑=Thần Hi Trường Kiếm
暗侯=Ám Hầu
暗祭司慕信离=Ám tế tư Mộ Tín Ly
暮光剑=Mộ Quang Kiếm
暮山紫=Mộ Sơn Tử
暮良铮=Mộ Lương Tranh
暮道人=Mộ Đạo Nhân
曜月晶=Diệu Nguyệt Tinh
曲凡=Khúc Phàm
曹征=Tào Chinh
月秀=Nguyệt Tú
望霞关=Vọng Hà Quan
木绝木乾罡=Mộc Tuyệt Mộc Càng Cương
木青讲师=Mộc Thanh giảng sư
未成道之前=chưa thành đạo trước đó
本体之上=bản thể phía dưới
朱二爷=Chu Nhị Gia
朱北=Chu Bắc
朱四=Chu Tứ
朱四爷=Chu Tứ Gia
朱墨筠=Chu Mặc Quân
朱正隶=Chu Chính Lệ
朱铃儿=Chu Linh Nhi
朱鸦=Chu Nha
朴峰=Phác Phong
杀了我的=giết ta
杀鲸霸拳=Sát Kình Bá Quyền
李五=Lý Ngũ
李安霆=Lý An Đình
李庄记=Lý Trang Ký
李应星=Lý Ứng Tinh
李开云=Lý Khai Vân
李成隅=Lý Thành Ngụ
李沫如=Lý Mạt Như
李真石=Lý Chân Thạch
李符龙=Lý Phù Long
李舟寒=Lý Chu Hàn
李苦=Lý Khổ
李苦大师=Lý Khổ đại sư
李西平=Lý Tây Bình
李观虾=Lý Quan Hà
李陵督=Lý Lăng Đốc
李骑珑=Lý Kỵ Lung
李骑陇=Lý Kỵ Lũng
杜占叶=Đỗ Chiêm Diệp
杜卫青=Đỗ Vệ Thanh
杜大祭司=Đỗ Đại Tế Tư
杜思国=Đỗ Tư Quốc
松柏居=Tùng Bách Cư
松竹阁=Tùng Trúc Các
极致之冰=cực hạn băng
极致之火=cực hạn hoả
林家铺子=Lâm Gia Phô Tử
林惠群=Lâm Huệ Quần
林慧群=Lâm Tuệ Quần
柳初音=Liễu Sơ Âm
柳子羽=Liễu Tử Vũ
柳宣威=Liễu Tuyên Uy
柳省督=Liễu tỉnh đốc
柳秀女=Liễu Tú Nữ
柳笙记=Liễu Sanh Ký
柳羽=Liễu Vũ
栖霞行省=Tê Hà Hành Tỉnh
根本功法=căn bản công pháp
桂柏草甸=Quế Bách Thảo Điền
桂花鱼=Cá quế hoa
桃花江=Đào Hoa Giang
桐教授=Giáo sư Đồng
桐木镇=Đồng Mộc trấn
桐林镇=Đồng Lâm Trấn
桑榆围=Tang Du Vi
桔山=Cật Sơn
梁三思=Lương Tam Tư
梁延昭=Lương Diên Chiêu
梵少篁=Phạn Thiếu Hoang
梵明宁=Phạn Minh Ninh
楚夜晗=Sở Dạ Hàm
欧阳云藏=Âu Dương Vân Tàng
欧阳伤=Âu Dương Thương
歇马湖=Hiết Mã Hồ
止戈新生殿=Chỉ Qua Tân Sinh Điện
止戈系=Chỉ Qua Hệ
正午司=Chính Ngọ Tư
正将星=Chính Tướng Tinh
正武司=Chính Vũ Tư
正武司令=Chánh Võ Tư Lệnh
正营将=Chính Doanh Tướng
此等=loại này
毒不死=Độc Bất Tử
毒药谷=Độc Dược Cốc
水云纹=Thủy Vân Văn
水千辰=Thủy Thiên Thần
水灭水空燄=Thủy Diệt Thủy Không Diễm
水龙陵=Thủy Long Lăng
江坝=Giang Bá
江大祭司=Giang Đại Tế Tư
江家夜莺=Giang Gia Dạ Oanh
江某人=Giang mỗ nhân
江烟炽=Giang Yên Sí
江烟织=Giang Yên Chức
江问鹤=Giang Vấn Hạc
江龙王=Giang Long Vương
池夜=Trì Dạ
池小夜=Trì Tiểu Dạ
池暴力=Trì Bạo Lực
池未=Trì Vị
池珊=Trì San
池禾=Trì Hòa
池竹=Trì Trúc
池粟=Trì Túc
池芒=Trì Mang
池花=Trì Hoa
池荆=Trì Kinh
池蒲=Trì Bồ
池蒲智者=Trí giả Trì Bồ
池谷=Trì Cốc
池豌=Trì Oản
池雨音=Trì Vũ Âm
汪不平=Uông Bất Bình
汪震胥=Uông Chấn Tư
沈昊天=Thẩm Hạo Thiên
沈雨楼=Thẩm Vũ Lâu
沐沉允=Mộc Trầm Duẫn
沙荆毒=Sa Kinh Độc
沙蝎毒=Sa Hạt Độc
河洛行省=Hà Lạc Hành Tỉnh
油黑子=Du Hắc Tử
法藤精=Pháp Đằng Tinh
泗水集=Tứ Thủy Tập
泥傀=Nê Khôi
泥湖=Nê Hồ
泰坦雪魔=Thái Thản Tuyết Ma
泽台陵=Trạch Đài Lăng
洗魂珠=Tẩy Hồn Châu
洛云灵=Lạc Vân Linh
洛五=Lạc Ngũ
洛器坊=Lạc Khí Phường
洛神玉=Lạc Thần Ngọc
洛神草=Lạc Thần Thảo
洛野陵=Lạc Dã Lăng
洪六度=Hồng Lục Độ
洪四爷=Hồng Tứ Gia
洪神武=Hồng Thần Võ
洪绣女=Hồng Tú Nữ
洪鲜花=Hồng Tiên Hoa
流寇军=Lưu Khấu Quân
流氓高手=Lưu Manh Cao Thủ
流氓高手ii=Lưu Manh Cao Thủ II
流沙剧毒=Lưu Sa Kịch Độc
流沙城=Lưu Sa Thành
浦东山=Phổ Đông Sơn
海碗居=Hải Oản Cư
海神的使者=Hải Thần sứ giả
海行省=Hải Hành Tỉnh
涂晓梦=Đồ Hiểu Mộng
淡定很多=bình tĩnh rất nhiều
淡红色的光芒=ánh sáng màu đỏ nhạt
深春短剑=Thâm Xuân Đoản Kiếm
混乱之际=hỗn loạn lúc
清楚了=rõ ràng
清河学院=Thanh Hà Học Viện
清河镇=Thanh Hà Trấn
清远城=Thanh Viễn Thành
清远郡=Thanh Viễn Quận
清远郡守府=Thanh Viễn quận thủ phủ
清远镇守军=Thanh Viễn trấn thủ quân
渠本翘=Cừ Bản Kiều
温岭=Ôn Lĩnh
游牧尉=Du Mục Úy
湘水行省=Tương Thủy Hành Tỉnh
湛台=Trạm Đài
湛台凌=Trạm Đài Lăng
湛台守=Trạm Đài Thủ
湛台守持=Trạm Đài Thủ Trì
湛台律己=Trạm Đài Luật Kỷ
湛台浅唐=Trạm Đài Thiển Đường
湛台莽=Trạm Đài Mãng
湛台齐律=Trạm Đài Tề Luật
滚珠湖=Cổn Châu Hồ
潇湘行省=Tiêu Tương Hành Tỉnh
火凤凰血脉=hỏa phượng hoàng huyết mạch
火御火吞天=Hỏa Ngự Hỏa Thôn Thiên
火狱原=Hỏa Ngục Nguyên
火衍鸟=Hỏa Diễn Điểu
灭水空燄=Diệt Thủy Không Diễm
灵夏湖=Linh Hạ Hồ
灵夏湖畔=Linh Hạ Hồ Bạn
灵婴参=Linh Anh Sâm
灵祭=Linh Tế
灵祭祭司=Linh Tế Tế Tư
灵祭系=Linh Tế hệ
灶门家=nhà Kamado
灶门炭十郎=Kamado Tanjuro
灶门葵枝=Kamado Kie
炭十郎=Tanjuro
炭治郎=Tanjiro
点石成金手段=hoá đá thành vàng thủ đoạn
炼心余=Luyện Tâm Dư
炼狱原=Luyện Ngục Nguyên
炼狱山=Luyện Ngục Sơn
炼狱山圣师=Luyện Ngục Sơn Thánh Sư
炼狱山大长老=Luyện Ngục Sơn Đại Trưởng Lão
炼狱山掌教=Luyện Ngục Sơn Chưởng Giáo
炼狱山神官=Luyện Ngục Sơn Thần Quan
焦尾文=Tiêu Vĩ Văn
熔岩湖泊=hồ dung nham
燎城=Liêu Thành
燕来=Yến Lai
燕来坝=Yến Lai Bá
燕来江=Yến Lai Giang
燕来镇=Yến Lai Trấn
燕玄一=Yến Huyền Nhất
牛徒子=Ngưu Đồ Tử
特利迦=Tiga
狂刀门=Cuồng Đao Môn
狄愁飞=Địch Sầu Phi
独孤虹=Độc Cô Hồng
独孤雪亭=Độc Cô Tuyết Đình
狱火魔弩=Ngục Hỏa Ma Nỗ
猎鬼人的速度=người săn quỷ tốc độ
猗窝座=Akane
猛洞镇=Mãnh Động Trấn
猛虎军=Mãnh Hổ Quân
猩红色的光芒=tinh quang màu đỏ
獠城=Liêu Thành
玉启陵=Ngọc Khải Lăng
玉面狼=Ngọc Diện Lang
王亚杰=Vương Á Kiệt
王亦客=Vương Diệc Khách
王健裕=Vương Kiện Dụ
王兴伦=Vương Hưng Luân
王宗渭=Vương Tông Vị
王小泉=Vương Tiểu Tuyền
王庭大供奉=Vương Đình Đại Cung Phụng
王朝雨=Vương Triều Vũ
王莽王朝=Vương Mãng vương triều
玲珑舫=Linh Lung Phường
琉璃碧玺=Lưu Li Bích Tỉ
瑞瑞=Thụy Thụy
瓦铛山=Ngõa Đang Sơn
甄五爷=Chân Ngũ Gia
甄快=Chân Khoái
生的=sinh
田墨石=Điền Mặc Thạch
申屠大师=Thân Đồ Đại Sư
申屠宗辛=Thân Đồ Tông Tân
申屠念=Thân Đồ Niệm
申屠铜=Thân Đồ Đồng
畔梁河=Bạn Lương Hà
留园=Lưu Viên
病人身体=bệnh nhân thân thể
瘦俏=khẳng khiu
登天山脉=Đăng Thiên Sơn Mạch
登山山脉=Đăng Sơn Sơn Mạch
白『色』玉盒=Hộp ngọc trắng
白子厚=Bạch Tử Hậu
白次男=Bạch Thứ Nam
白沙陵=Bạch Sa Lăng
白灼花=Bạch Chước Hoa
白玉阶前=trước bậc thềm ngọc trắng
白衫剑师=Bạch Sam Kiếm Sư
白雪黑雪=Bạch Tuyết Hắc Tuyết
白首男=Bạch Thủ Nam
百世书=Bách Thế Thư
百川通=Bách Xuyên Thông
百盟=Bách Minh
皂膏=Tạo Cao
的事业=sự nghiệp
皇普南=Hoàng Phủ Nam
皇普殊=Hoàng Phổ Thù
皇普语奇=Hoàng Phổ Ngữ Kỳ
盐霜巨猿=Diêm Sương Cự Viên
盛大发=Thịnh Đại Phát
盛满盈=Thịnh Mãn Doanh
盛高=Thịnh Cao
省城天吉卫=Tỉnh Thành Thiên Cát Vệ
省督=Tỉnh Đốc
省督安序庭=Tỉnh Đốc An Tự Đình
省督府=Tỉnh Đốc Phủ
真剑关=Chân Kiếm quan
真师父=chân sư phụ
真武养兵决=Chân Võ Dưỡng Binh Quyết
真武养兵诀=Chân Võ Dưỡng Binh Quyết
真毗卢=Chân Tỳ Lô
真菰=Makomo
真龙宝石=Chân Long Bảo Thạch
真龙宝衣=Chân Long Bảo Y
真龙山=Chân Long Sơn
真龙雷金=Chân Long Lôi Kim
眼光不准=ánh mắt không chuẩn
督江问鹤=Đốc Giang Vấn Hạc
瞳岸=Đồng Ngạn
瞳岸关=Đồng Ngạn quan
知徵=Tri Chưng
知礼陵=Tri Lễ Lăng
知鹿郡=Tri Lộc Quận
矮脚狼=Ải Cước Lang
矮脚狼扈归朴=Ải Cước Lang Hỗ Quy Phác
石老鼠=Thạch Lão Thử
破风营=Phá Phong Doanh
碧水行省=Bích Thủy Hành Tỉnh
碧玉茯苓=Bích Ngọc Phục Linh
碧绿色光点=xanh biếc điểm sáng
碧绿色的光点=điểm sáng màu xanh biếc
碧落不死将军=Bích Lạc Bất Tử Tướng Quân
碧落东郊=Bích Lạc Đông Giao
碧落东郊军=Bích Lạc Đông Giao Quân
碧落东郊逐鹿军=Bích Lạc Đông Giao Trục Lộc Quân
碧落聚宝盆=Bích Lạc Tụ Bảo Bồn
碧落行省=Bích Lạc Hành Tỉnh
碧落边关=Bích Lạc Biên Quan
碧落边军=Bích Lạc Biên Quân
碧落陵=Bích Lạc Lăng
碧蓝大海=Bích Lam Đại Hải
碧蔻毒=Bích Khấu Độc
碳十郎=Tanjuro
磁泽=Từ Trạch
礼天监=Lễ Thiên Giam
祁太牢=Kỳ Thái Lao
祁连宇=Kỳ Liên Vũ
祁连豹=Kỳ Liên Báo
祝薰=Chúc Huân
神威大将军=Thần Uy Đại tướng quân
神情一振=thần sắc chấn động
神木飞鹤=Thần Mộc Phi Hạc
神梨=Thần Lê
神梨木弓=Thần Lê Mộc Cung
神级=Thần cấp¦thần cấp¦cấp thần
神象军=Thần Tượng Quân
神鸳=Thần Uyên
祭司殿=Tế Tư Điện
祭司院=Tế Tư Viện
禁区之中=cấm khu bên trong
禅云临海=Thiền Vân Lâm Hải
秃狼屠黑虎=Ngốc Lang Đồ Hắc Hổ
秋吉泽=Thu Cát Trạch
秋墨池=Thu Mặc Trì
秋山军=Thu Sơn quân
秋山大树巷=Thu Sơn Đại Thụ hạng
秋山镇=Thu Sơn trấn
秋祭=Thu Tế
秋落沙=Thu Lạc Sa
科文=Khoa Văn
秦叶威=Tần Diệp Uy
秦执言=Tần Chấp Ngôn
秦擎黄=Tần Kình Hoàng
秦潇雨=Tần Tiêu Vũ
程乡伊=Trình Hương Y
程子静=Trình Tử Tĩnh
程玉=Trình Ngọc
程礼数=Trình Lễ Sổ
稻花坊=Đạo Hoa Phường
稽调史=Kê Điều Sử
穴居蛮人=huyệt cư man nhân
穴蛮=Huyệt Man
穿山弩=Xuyên Sơn Nỗ
穿山弩车=Xuyên Sơn Nỗ Xa
突兀=đột ngột¦cao ngất¦cao vút¦cao chót vót¦bỗng nhiên¦bất ngờ¦chót vót
立加德隆=Lijadelon
立帐尉=Lập Trướng Úy
童敏敏=Đồng Mẫn Mẫn
竹兰巷=Hẻm Trúc Lan
笑依=Tiếu Y
第三、第六=thứ ba, thứ sáu
简庸=Giản Dung
类主=giống chủ
紫色光晕=vầng sáng màu tím
红狼陆菁=Hồng Lang Lục Tinh
红莲庇佑=Hồng Liên che chở
红衫女琴师=Nữ cầm sư áo đỏ
红袍大祭司=Hồng bào đại tế tư
红雀舌=Hồng Tước Thiệt
红雷圣师=Hồng Lôi Thánh Sư
纪月轮=Kỷ Nguyệt Luân
绝木乾罡=Tuyệt Mộc Càn Cương
绿瞳少女=Thiếu nữ mắt xanh
绿萝精=Lục La Tinh
绿野城=Lục Dã Thành
缘一=Yoriichi
缦胡缨=Mạn Hồ Anh
罗侯渊=La Hầu Uyên
罗守护=La Thủ Hộ
罗神幡=La Thần Phiên
罗镇督=La Trấn Đốc
罪迷=Tội Mê
羊尖田=Dương Tiêm Điền
羊尖田三营=Dương Tiêm Điền Tam Doanh
羊尖田军部=Dương Tiêm Điền Quân Bộ
羊尖田山=Dương Tiêm Điền Sơn
羊尖田山巡牧军=Dương Tiêm Điền Sơn Tuần Mục Quân
美尔巴=Melba
翎长=Linh Trưởng
翰林院司库=Hàn Lâm Viện Tư Khố
翰神官=Hàn Thần Quan
老夫人的面前=lão phu nhân trước mặt
老江团=Lão Giang Đoàn
耿大将军=Cảnh Đại Tướng Quân
聆风客栈=Lắng Nghe Gió Khách Điếm
肖川=Tiếu Xuyên
肖沁=Tiếu Thấm
肥狼=Phì Lang
肩挑日月=vai gánh Nhật Nguyệt
胡千军=Hồ Thiên Quân
胡沉浮=Hồ Trầm Phù
胡辙=Hồ Triệt
胡辟易=Hồ Tích Dịch
胥安陵=Tư An Lăng
胥秋白=Tư Thu Bạch
膳补=Thiện Bổ
至天院=Chí Thiên Viện
至尊会=Chí Tôn Hội
至尊战神=Chí Tôn Chiến Thần
般若圣女=Bát Nhã Thánh Nữ
般若大佛=Đại Phật Bát Nhã
般若寺=Bát Nhã Tự
般若走廊=Bát Nhã Tẩu Lang
般若金刚=Bát Nhã Kim Cương
艾绮兰=Ngải Kỳ Lan
芍药居=Thược dược cư
花寂月=Hoa Tịch Nguyệt
花盘山=Hoa Bàn Sơn
苏仲文=Tô Trọng Văn
苏友记=Tô Hữu Ký
苏小龙=Tô Tiểu Long
苗妞=Miêu Nữu
若水堂=Nhược Thủy Đường
范金牙=Phạm Kim Nha
范问=Phạm Vấn
荆刺酒=Kinh Thứ Tửu
荆花陵=Kinh Hoa Lăng
荣沈记=Vinh Thẩm Ký
荷花湖畔=Hồ sen
莫姓老人=Mạc tính lão nhân
莫家老人=Mạc Gia Lão Nhân
莫寻花=Mạc Tầm Hoa
莫明奇=Mạc Minh Kỳ
莫老人=Mạc lão nhân
莫老伯=Mạc Lão Bá
莫飞云=Mạc Phi Vân
莺柳栖=Oanh Liễu Tê
营务=Doanh Vụ
萧惠海=Tiêu Huệ Hải
萧明轩=Tiêu Minh Hiên
萧铁冷=Tiêu Thiết Lãnh
落日丘陵=Lạc Nhật Khâu Lăng
落日马场=Lạc Nhật Mã Trường
葛英朗=Cát Anh Lãng
董翰良=Đổng Hàn Lương
董镇督=Đổng Trấn Đốc
葵枝=Kie
蒙任=Mông Nhậm
蒙白=Mông Bạch
蓝杏=Lam Hạnh
蓝栖凤=Lam Tê Phượng
蓝道天武=Lam Đạo Thiên Vũ
蓝魔陨金=Lam Ma Vẫn Kim
蓝鳅箭=Lam Thu Tiễn
蔺城=Lận Thành
蔺祝=Lận Chúc
蔺祝和=Lận Chúc Hòa
蕴脏=uẩn tạng
蕴芳宫=Uẩn Phương Cung
薛万涛=Tiết Vạn Đào
薛京尹=Tiết Kinh Doãn
薛成涛=Tiết Thành Đào
藏青雄=Tàng Thanh Hùng
虞七夜=Ngu Thất Dạ
虞国强者=Ngu Quốc cường giả
虫鸣巷=Hẻm Trùng Minh
蛙兄=ếch huynh
螯角山=Ngao Giác Sơn
蟹壳黄=Giải Xác Hoàng
血影道友=Huyết Ảnh đạo hữu
行省监军处=Hành tỉnh Giám quân xứ
衡安陵=Hành An Lăng
衡荣昌=Hành Vinh Xương
表忠心=bày tỏ lòng trung thành¦biểu lộ trung thành
袁天谕=Viên Thiên Dụ
裂金黑鹫=Liệt Kim Hắc Thứu
裕州城=Dụ Châu Thành
裘路=Cừu Lộ
西侯=Tây Hầu
西利赞=Silizan
西域流寇=Tây Vực Lưu Khấu
西夷人=Tây Di Nhân
西夷十五部=Tây Di Thập Ngũ Bộ
西夷流寇=Tây Di Lưu Khấu
见面之礼=quà gặp mặt
观想图=quan tưởng đồ
观自在降魔=Quan Tự Tại Hàng Ma
觉醒力量=giác tỉnh lực lượng
解还真=Giải Hoàn Chân
詹道名=Chiêm Đạo Danh
警务局=Cảnh Vụ Cục
议政殿=Nghị Chính Điện
许三少=Hứa Tam Thiếu
许天望=Hứa Thiên Vọng
许笙=Hứa Sanh
许箴言=Hứa Châm Ngôn
许胖子=Hứa Bàn Tử
许舒城=Hứa Thư Thành
许舒成=Hứa Thư Thành
许荐灵=Hứa Tiến Linh
诗画社=Thi Họa Xã
请远城=Thỉnh Viễn Thành
诸葛千山=Gia Cát Thiên Sơn
谢凝柯=Tạ Ngưng Kha
谢无为=Tạ Vô Vi
谢洗剑=Tạ Tẩy Kiếm
谢赢=Tạ Doanh
谢远山=Tạ Viễn Sơn
谭文杰=Đàm Văn Kiệt
谷心音=Cốc Tâm Âm
贯月弩=Quán Nguyệt Nỗ
贯月弩车=Quán Nguyệt Nỗ Xa
贱客=Tiện Khách
贵云行省=Quý Vân hành tỉnh
贵掌柜=Quý Chưởng Quỹ
贺兰师兄=Hạ Lan sư huynh
贺兰悦汐=Hạ Lan Duyệt Tịch
贺叶军=Hạ Diệp Quân
贺叶山区=Hạ Diệp Sơn Khu
贺子敬=Hạ Tử Kính
贺白荷=Hạ Bạch Hà
贺青=Hạ Thanh
贾君鹏=Giả Quân Bằng
赏宝会=thưởng bảo hội
赛木大会=Tái Mộc đại hội
赤凰=Xích Hoàng
赤蝎沙漠=Xích Hạt Sa Mạc
赤铁=Xích Thiết
赤麻芝=Xích Ma Chi
赤龙焦尾=Xích Long Tiêu Vĩ
赵可安=Triệu Khả An
赵寅卯=Triệu Dần Mão
赵弥伦=Triệu Di Luân
赵红雷=Triệu Hồng Lôi
超标的=vượt tiêu chuẩn
路明逸=Lộ Minh Dật
车蔚海=Xa Úy Hải
车驾局=Xa Giá Cục
轮回祖师=Luân Hồi tổ sư
轱辘市=Cù Lục Thị
辛微芥=Tân Vi Giới
辛阳城=Tân Dương Thành
边凌涵=Biên Lăng Hàm
这么个身份=như thế thân phận
连战山=Liên Chiến Sơn
连铁手=Liên Thiết Thủ
迦蓝匕=Già Lam Chủy
迪拉休姆=Dilla Hume
迷踪林=Mê Tung Lâm
通商处=Thông Thương Xứ
道若素=Đạo Nhược Tố
道边李苦=Đạo Biên Lý Khổ
道边李苦观虾=Đạo Biên Lý Khổ Quan Hà
邓心=Đặng Tâm
邓收成=Đặng Thu Thành
那么多=như vậy nhiều
邬守严=Ổ Thủ Nghiêm
邬晨罡=Ổ Thần Cương
邬泉=Ổ Tuyền
邱寒影=Khâu Hàn Ảnh
邹一石=Trâu Nhất Thạch
郑三路=Trịnh Tam Lộ
郑城=Trịnh Thành
郑屠户=Trịnh Đồ Hộ
郑老家伙=Trịnh Lão gia hỏa
郑青珊=Trịnh Thanh San
郭东神=Quách Đông Thần
郭放鹰=Quách Phóng Ưng
郭石钦=Quách Thạch Khâm
郭秋冬=Quách Thu Đông
重建工作=công việc tái thiết
重生殿=Trọng Sinh Điện
重看了=trọng nhìn
重铠军=Trọng Khải Quân
野陵十狼=Dã Lăng Thập Lang
金『色』的云秦小凤凰=Tiểu phượng hoàng Vân Tần màu vàng
金丝蜜柚茶=Trà Bưởi Mật Tơ Vàng
金光就是=kim quang liền là
金光罩=Kim Quang Tráo
金养神=Kim Dưỡng Thần
金冥=Kim Minh
金凰纹=Kim Hoàng Văn
金勺=Kim Thiêu
金化金元诀=Kim Hóa Kim Nguyên Quyết
金枫谷=Kim Phong Cốc
金柚=Kim Dữu
金神怒=Kim Thần Nộ
金铛=chuông vàng
金风巷=Kim Phong Hạng
钟城=Chung Thành
钟大祭司=Chung Đại Tế Tư
钟天阔=Chung Thiên Khoát
钟暮邻=Chung Mộ Lân
钟迟归=Chung Trì Quy
钱唐行省=Tiền Đường Hành Tỉnh
钱塘行省=Tiền Đường Hành Tỉnh
钱师傅=Tiền sư phụ
钱开=Tiền Khai
钱港生=Tiền Cảng Sinh
钱飞=Tiền Phi
铁头狗鱼=Thiết Đầu Cẩu Ngư
铁涵青=Thiết Hàm Thanh
铁策军=Thiết Sách Quân
铁算子=Thiết toán tử
铁翎军=Thiết Linh Quân
铁鬼鱼=Thiết Quỷ Ngư
银婆龙=Ngân Bà Long
银江猪=Ngân Giang Trư
银江豚=Ngân Giang Đồn
银河亿次大厅=Đại sảnh Ngân Hà Ức Thứ
银甲中州卫=Ngân Giáp Trung Châu Vệ
银耀金=Ngân Diệu Kim
银苍狼=Ngân Thương Lang
银钩坊=Ngân Câu Phường
银鞍=Ngân Yên
锋獠军=Phong Liêu Quân
锖兔=Sabito
锦州陵=Cẩm Châu Lăng
锦旗镇=Cẩm Kỳ trấn
锦绣坊=Cẩm Tú phường
镇古草场=Trấn Cổ Thảo Trường
镇旗=Trấn Kỳ
镇西大将军=Trấn Tây Đại Tướng Quân
镇警局=Trấn Cảnh Cục
镇警督=Trấn Cảnh Đốc
镜天人鱼=Kính Thiên Nhân Ngư
镜天后军=Kính Thiên Hậu Quân
镜天湖=Kính Thiên Hồ
长公主长孙慕月=Trưởng công chúa Trưởng Tôn Mộ Nguyệt
长孙恭如=Trưởng Tôn Cung Như
长孙慕月=Trường Tôn Mộ Nguyệt
长孙拓疆=Trường Tôn Thác Cương
长孙无疆=Trưởng Tôn Vô Cương
长孙锦瑟=Trường Tôn Cẩm Sắt
长老弟子=trưởng lão đệ tử
长老眼=Trưởng lão mắt
长青纹=Trường Thanh Văn
门神乐=môn thần nhạc
闻人大元帅=Văn Nhân Đại Nguyên Soái
闻人大将军=Văn Nhân Đại Tướng Quân
闻人旧部=Văn Nhân Cựu Bộ
闻人老首辅=Văn Nhân Lão Thủ Phụ
闻人苍岳=Văn Nhân Thương Nhạc
闻人苍月=Văn Nhân Thương Nguyệt
闻人首辅=Văn Nhân Thủ Phụ
闻迦晨=Văn Già Thần
阳关陵=Dương Quan Lăng
阳春巷=Dương Xuân Hạng
阿孜岢=A Tư Khắc
陆登道=Lục Đăng Đạo
陈一成=Trần Nhất Thành
陈兆吉=Trần Triệu Cát
陈养之=Trần Dưỡng Chi
陈冬=Trần Đông
陈吟袖=Trần Ngâm Tụ
陈墨青=Trần Mặc Thanh
陈妃蓉=Trần Phi Dung
陈州军=Trần Châu Quân
陈村脆皮香猪=Trần Thôn Thúy Bì Hương Trư
陈浩之=Trần Hạo Chi
陈落雁=Trần Lạc Nhạn
陈铜=Trần Đồng
陈长成=Trần Trường Thành
陕晋行省=Thiểm Tấn Hành Tỉnh
陕露行省=Thiểm Lộ Hành Tỉnh
陵督=Lăng đốc
陵督卓贺之=Lăng đốc Trác Hạ Chi
陵督府=Lăng Đốc Phủ
陵镜天湖=Lăng Kính Thiên Hồ
陵骑卫=Lăng Kỵ Vệ
陶醉激动=say mê kích động
陶醉激动的=say mê kích động
雪帝=Tuyết Đế
雪浪镇=Tuyết Lãng Trấn
雷公嘴=miệng Lôi Công
雷静=Lôi Tĩnh
雷鸣刀=Lôi Minh Đao
霓裳玉人=Nê Thường Ngọc Nhân
霜雪明=Sương Tuyết Minh
霞光镇=Hà Quang Trấn
霞落镇=Hà Lạc trấn
青丘雪=Thanh Khâu Tuyết
青果镇=Thanh Quả Trấn
青濯吟=Thanh Trạc Ngâm
青狼重铠=Thanh Lang Trọng Khải
青狼重铠军=Thanh Lang Trọng Khải Quân
青玉竹=Thanh Ngọc Trúc
青王重铠=Thanh Vương Trọng Khải
青王魂兵重铠军=Thanh Vương Hồn Binh Trọng Khải Quân
青祁山=Thanh Kỳ Sơn
青竹花=Thanh Trúc Hoa
青色轮盘=Thanh Sắc Luân Bàn
青蜂针=Thanh Phong Châm
青鸾二十四式=Thanh Loan Nhị Thập Tứ Thức
青鸾兵殿=Binh điện Thanh Loan
青鸾剑师=Thanh Loan Kiếm Sư
青鸾天选=Thanh Loan Thiên Tuyển
青鸾学院=Học viện Thanh Loan
青鸾宫=Thanh Loan Cung
青鸾战神甲=Thanh Loan Chiến Thần Giáp
青鸾战神铠=Thanh Loan Chiến Thần Khải
青鸾止戈系=Hệ Thanh Loan Chỉ Qua
青鸾食补册子=Thanh Loan Thực Bổ Sách Tử
青鸾黑袍讲师=Giảng sư Hắc bào Thanh Loan
青龙峡=Thanh Long Hạp
面过圣=diện thánh rồi
靳九龄=Cận Cửu Linh
靳特镇=Cận Đặc Trấn
靳铁镇=Cận Thiết Trấn
韩半尺=Hàn Bán Xích
韩玉池=Hàn Ngọc Trì
韩胥子=Hàn Tư Tử
韶华陵=Thiều Hoa Lăng
顺天易=thuận thiên dễ
顺安客栈=Thuận An Khách Sạn
顾云隅=Cố Vân Ngung
顾云静=Cố Vân Tĩnh
顾道友=Cố đạo hữu
顾难=Cố Nan
颜少卿=Nhan Thiếu Khanh
风沐白=Phong Mộc Bạch
风津渡=Phong Tân Độ
飒沓如流星=Táp đạp như lưu tinh
飘叶=Phiêu Diệp
飞=bay¦phi
飞翼虎=Phi Dực Hổ
马上散发=lập tức tán phát
马云长老=Mã Vân trưởng lão
马红骏=Mã Hồng Tuấn
驻世=trú thế
驻世的=trú thế
骁骑将=Kiêu Kỵ Tướng
高亚楠=Cao Á Nam
高拱月=Cao Củng Nguyệt
高离人=Cao Ly Nhân
高辙=Cao Triệt
鬼军师=Quỷ Quân Sư
鬼头王=Quỷ Đầu Vương
鬼杨涧=Quỷ Dương Giản
鬼油木=Quỷ Du Mộc
鬼脸鸠=Quỷ Diện Cưu
鬼骑军=Quỷ Kỵ quân
鬼鸣山=Quỷ Minh Sơn
魏贤武=Ngụy Hiền Vũ
魔光窟=Ma Quang Quật
魔原=Ma Nguyên
魔变药晶=Ma Biến Dược Tinh
魔坛城=Ma Đàn Thành
魔月山=Ma Nguyệt Sơn
魔海眼=Ma Hải Nhãn
魔海眼之中=Ma Hải Nhãn bên trong
魔火死域=Ma Hỏa Tử Vực
魔焰窟=Ma Diễm Quật
魔狱原=Ma Ngục Nguyên
魔眼花=Ma Nhãn Hoa
鱼暨镇=Ngư Ký trấn
鳌角山=Ngao Giác Sơn
鸟禽=điểu cầm
鸟禽特征=điểu cầm đắc thù
鸬鹚翁=Lô Từ Ông
鸿升镇=Hồng Thăng Trấn
鹤山要塞=Hạc Sơn Yếu Tắc
鹿东=Lộc Đông
鹿东陵=Lộc Đông Lăng
鹿东陵广源镇=Lộc Đông Lăng Quảng Nguyên trấn
鹿东陵府=Lộc Đông Lăng phủ
鹿郡=Lộc Quận
麟玉米行=Lân Ngọc Mễ Hành
黄中侍=Hoàng Trung Thị
黄中臣=Hoàng Trung Thần
黄中郎=Hoàng Trung Lang
黄姓老人=Hoàng Tính Lão Nhân
黄家老人=Hoàng Gia lão nhân
黄沙沙漠=Sa mạc Hoàng Sa
黄沙荒原=Hoang nguyên Hoàng Sa
黄盏=Hoàng Trản
黄眉剑师=Hoàng Mi Kiếm Sư
黄羚羊=Hoàng Linh Dương
黄袍老人=Ông lão áo bào vàng
黄袍道人=Hoàng bào đạo nhân
黄铜鹰眼=Hoàng Đồng Ưng Nhãn
黄陂=Hoàng Bi
黄雀楼=Hoàng Tước Lâu
黄雀观=Hoàng Tước Quan
黄霆迟=Hoàng Đình Trì
黑地峡谷=Hắc Địa Hạp Cốc
黑暗宝石=Hắc Ám Bảo Thạch
黑水沼泽=Hắc Thủy Chiểu Trạch
黑水泽=Hắc Thủy Trạch
黑水渡=Hắc Thủy Độ
黑水金=Hắc Thủy Kim
黑狐猫=Hắc Hồ Miêu
黑王铁=Hắc Vương Thiết
黑珀石=Hắc Phách Thạch
黑石强弓=Hắc Thạch Cường Cung
黑磷=Hắc Lân
黑纱山区=Hắc Sa Sơn Khu
黑色=đen
黑色乌鸦=quạ đen
黑色血鸦=màu đen huyết nha
黑蔷薇=Hắc Tường Vi
黑蛇军=Hắc Xà quân
黑蛇山=Hắc Xà Sơn
黑蜂=Hắc Phong
黑蝠=Hắc Bức
黑角劲弓=Hắc Giác Kính Cung
黑角弓=Hắc Giác Cung
黑金破甲箭=Hắc Kim Phá Giáp Tiễn
黑鲟=Hắc Tầm
黑龙军=Hắc Long quân
齐光武=Tề Quang Vũ
齐启云=Tề Khải Vân
齐王殿下=Tề Vương điện hạ
龙光塔=Long Quang Tháp
龙光采石窟=Long Quang Thải Thạch Quật
龙兰谷=Long Lan Cốc
龙脊崖=Long Tích Nhai
龙蛇东部军=Long Xà Đông Bộ Quân
龙蛇中军=Long Xà Trung Quân
龙蛇云骑=Long Xà Vân Kỵ
龙蛇会战=Long Xà Hội Chiến
龙蛇军=Long Xà Quân
龙蛇军方=Long Xà Quân Phương
龙蛇北仓洞边贸集镇=Long Xà Bắc Thương Động Biên Mậu Tập Trấn
龙蛇南路军=Long Xà Nam Lộ Quân
龙蛇山=Long Xà Sơn
龙蛇山脉=Long Xà Sơn Mạch
龙蛇方面军=Long Xà Phương Diện Quân
龙蛇监军处=Long Xà giám quân xứ
龙蛇羊尖田山=Long Xà Dương Tiêm Điền Sơn
龙蛇赤楼洞粮仓=Long Xà Xích Lâu Động Lương Thương
龙蛇边关=Long Xà Biên Quan
龙蛇边军=Long Xà Biên Quân
龙蛇黑旗军=Long Xà Hắc Kỳ Quân
龙醒=Long Tỉnh
龙须瀑=Long Tu Bộc
龙须瀑布=Long Tu Thác Bố
龚坤=Cung Khôn
龟尾屿=Quy Vĩ Đảo
龟裘部=Quy Cừu bộ