300年内力=300 năm nội lực
700年内力=700 năm nội lực
America=America
Britain=Britain
Duang=Duang
France=France
OAA=OAA
Yellow =Yellow
ooxx=ooxx
x教授的=Giáo sư X
一个学生=một cái học sinh
一个男子=một nam tử
一个男孩=một nam hài
一天=một ngày
一年内力=một năm nội lực
一百年内力=một trăm năm nội lực
三年=ba năm
三百年内力=ba trăm năm nội lực
不好吃的=ăn không ngon/không thể ăn
丛大人=Tùng Đại Nhân
丛林雨=Tùng Lâm Vũ
两个时期=hai thời kỳ
两位小兄弟=hai vị tiểu huynh đệ
两位小弟弟=hai vị tiểu đệ đệ
两天=hai ngày
两张票子=hai tấm vé
两缕=hai sợi
主角光环=hào quang nhân vật chính
乌帕=Upa
乌龙=Ô Long/số đen rồi/Oolong
二十年内力=hai mươi năm nội lực
二星球=ngọc 2 sao/Ngọc Nhị Tinh
云中羽=Vân Trung Vũ
亚历山大·皮尔斯=Alexander Pearce
亚裔=người Châu Á
亨利·乔纳森·皮姆=Henry Jonathan Pym
人大脑=người đầu óc
人造人的=người nhân tạo
今天=hôm nay
他们俩的=hai bọn hắn
以直破巧=lấy trực phá xảo
件重要的事情=chuyện trọng yếu
伏的电压=Volt điện áp
余光中=dư quang trung
你妈的=mẹ ngươi
佩珀=Pepper Potts
俏皮地道=hoạt bát mà nói
先找到=trước tìm được
全王=Zeno/Toàn Vương
全身的内力=toàn thân nội lực
全集中=toàn tập trung
八段摔=Bát Đoạn Suất
再传=lại truyền
击毙了=đánh chết
刚刚好=vừa vặn
别人休息=người khác nghỉ ngơi
力气的锻炼=rèn luyện lực khí
勃拉=Bora
化身=hóa thân
北界王星=Bắc Giới Vương Tinh
十八降龙=Thập Bát Giáng Long
十天的=mười ngày
十年内力=mười năm nội lực
十足十的=mười phần mười
午安=buổi trưa tốt lành
卡贝基=Cabeki
卢子华=Lô Tử Hoa
厚礼蟹=Holy shit
发了急件=phát văn kiện khẩn cấp
发售会=hội tiêu thụ
变异武魂=Biến Dị Võ Hồn
古一=Ancient One
君岛加奈=Kana Kimishima
和先生=cùng tiên sinh/Hòa Tiên Sinh
和州长=và châu trưởng
咯咯咯地笑=cười hahaha
哦里谢=Oh my god
喜马拉雅=Himalaya
在先生=tại tiên sinh
在吸血鬼=tại Ma cà rồng
在里德=tại Reed/tại Lý Đức
地都没提=đều không đề cập
塔布尔=Tarble
塔班=Taban
多了=hơn/nhiều/có thêm/nhiều hơn/hơn nhiều/sinh ra
太结实=quá chắc chắn
女娇娥=nữ kiều nga
好胜要强=hiếu thắng
威尔逊·格兰特·菲斯克=Wilson Grant Fisk
完全没法=hoàn toàn vô pháp
对社会有用=đối với xã hội hữu dụng
对社会有用的=đối xã hội hữu dụng
小悟定=Tiểu Ngộ Định
小淘气=Tiểu Đào Khí/Rogue
小舞=Tiểu Vũ/tiểu Vũ/Mai
小范云=Tiểu Phạm Vân
小范老师=Tiểu Phạm lão sư
小高思=Tiểu Cao Tư
尼克福瑞=Nick Fury
崔斯克=Trisk
嵌套=khảm vào
巫师姐=Vu sư tỷ
布尔玛小姐=Bulma tiểu thư
帕拉加斯=Paragas
年份的=năm
强壮的多=cường tráng nhiều
强大的心性=cường đại tâm tính
很纯粹=rất thuần túy
怎么老爷子=thế nào lão gia tử
悟定=Ngộ Định
您的内力=ngài nội lực
想做的=muốn làm
我想做的=ta muốn làm
或死=hoặc tử
或生=hoặc sinh
戴氏=Đái thị
所有人痛苦=mọi người thống khổ
手下的= thủ hạ
扎马斯=Zamasu
托罗斯=Thác La Tư/Toros
抓一送一=bắt một tặng một
抢劫案=án cướp bóc
拉蒂丝=Raditz
振金=Vibranium
摇啊摇=lắc rồi lắc
改三千幻身=Cải Tam Thiên Huyễn Thân
断了后=đoạn hậu
是一个人才对=là một người mới đúng
曼谷=Bangkok
最靓的=đẹp nhất
本叔=chú Ben
林雾=lâm vụ
柔技=Nhu Kĩ
桃白白=Tao Pai Pai
梅姨=dì Mai
欺妇幼=lấn phụ ấu
此举=cử chỉ này
此刻=bây giờ
此刻的=hiện tại
比特=bit
沃德发=What the fuck
没水的问题=vấn đề không có nước
深蓝前辈=Thâm Lam tiền bối
片天际=phiến chân trời
狄肯=Deacon
玉大师=Ngọc đại sư
王德发=WTF
玻利瓦尔·崔斯克=Bolívar Trisk
琴格蕾=Jean Grey
男人内力=nam nhân nội lực
疯狂攻击=điên cuồng công kích
的肚子上=trên bụng
的那个人=người kia
盖洛博士=Tiến sĩ Gero
盗版书籍=sách lậu
看人渣=xem người cặn bã
看人渣的=xem người cặn bã
看着入侵的=nhìn xâm lấn
看着女人=nhìn nữ nhân
硫酸=axit sunfuric/a- xít sun-phu-rit/H2S04/h2s04
碎颅=nát sọ
磕了药的=đập qua thuốc
神=Thần/thần diệu/thần kì/Kami
秦慎行=Tần Thận Hành
童姥=Đồng Mỗ
等于明牌=tương đương minh bài
等觉得=chờ cảm giác đến
签售会=hội ký bán
紫色云彩=mây tím
红缎带军团= Red Ribbon quân đoàn
纽约市长=New York thị trưởng
罗得里克=Roderick
罗德里格斯=Rodriguez
美克星=Namek tinh
美克星人=người Namek
美因斯=Mainz
美金=đô la mỹ
群人大脑=đám người đầu óc
老版本=phiên bản cũ
而不知=mà không biết
职业素养=chức nghiệp tố dưỡng
肯尼迪机场=sân bay Kennedy
脂类=chất béo
脱缰野马=ngựa hoang mất cương
良好的=tốt đẹp
范云=Phạm Vân
范老师=Phạm lão sư
莫度=Mạc Độ/Mordo
莫德=Hammond
莹莹的=oánh oánh
菲斯克=Fisk
落日大森林=Lạc Nhật đại sâm lâm
行云流水=hành vân lưu thủy
被抽干=bị hút khô
被抽干的=bị hút khô
被黑夜=đêm tối
西奥夫=Sioff
要考察=muốn khảo sát
警察的能力=cảnh sát năng lực
说明栏=thanh mô tả
说明栏上的=trên thanh mô tả
诸天交流群=Chư Thiên Giao Lưu Quần
超圣水=Siêu Thánh Thủy
超级神龙=Siêu Cấp Thần Long/Super Shenron
路口的=giao lộ
轻语=khẽ nói/nhẹ ngữ/khinh ngữ/nói nhỏ
还是没法=vẫn là vô pháp
还没有好好=còn chưa thật tốt
追寻的=truy tìm
那帕=Napa
都没提=đều không đề cập
里德·理查兹=Reed Richards
野比饭=cơm chùa như Nobita
金并=Kingpin
锐雯=Rivien
门步法=môn bộ pháp
阿修=A Tu/Shu
霍华德·斯塔克=Howard Stark
霍华德斯塔克=Howard Stark
青紫色的身影=thân ảnh màu xanh tím
飞翔的小鸟=bay lượn chim nhỏ
首先就是=đầu tiên là
高思=Cao Tư
鸣动九霄=minh động cửu tiêu
黄金三角=Hoàng Kim Tam Giác/tam giác hoàng kim
黑帮人物=nhân vật xã hội đen
黑粉=antifan
龟派气功波=Kamehameha
丁亮=Đinh Lượng
丁字号武库贺大人=Đinh Tự Hào Vũ Khố Hạ đại nhân
万古长青功=Vạn Cổ Trường Thanh Công
万妖魔主=Vạn Yêu Ma Chủ
万宝商行=Vạn Bảo Thương Hành
万寿真君=Vạn Thọ chân quân
万寿道君=Vạn Thọ Đạo Quân
万毒鬼=Vạn Độc Quỷ
万法寺=Vạn Pháp Tự
万界浑天仪=Vạn Giới Hỗn Thiên Nghi
万福客栈=Vạn Phúc Khách Sạn
万邪道人=Vạn Tà Đạo Nhân
万鬼老母=Vạn Quỷ Lão Mẫu
万鬼道人=Vạn Quỷ đạo nhân
三公主夏韵=Tam công chúa Hạ Vận
三清至尊=Tam Thanh Chí Tôn
三界官属=Tam Giới Quan Thuộc
三眼白虎=Tam Nhãn Bạch Hổ
三眼鬼象=Tam Nhãn Quỷ Tượng
东城张家=Đông Thành Trương Gia
东宝居=Đông Bảo Cư
东巫=Đông Vu
东巫皇庭=Đông Vu Hoàng Đình
东海仙宗=Đông Hải Tiên Tông
东海仙岛=Đông Hải Tiên Đảo
东海城主=Đông Hải Thành Chủ
东海海族=Đông Hải Hải Tộc
丹王坊=Đan Vương Phường
丹鼎阁=Đan Đỉnh Các
乔麦=Kiều Mạch
九刀门=Cửu Đao Môn
九尾银蜥=Cửu Vĩ Ngân Tích
九幽寒铁=Cửu U Hàn Thiết
九玄灵霄图=Cửu Huyền Linh Tiêu Đồ
九真峰=Cửu Chân Phong
九真道人=Cửu Chân Đạo Nhân
九角银蜥=Cửu Giác Ngân Tích
九邪老怪=Cửu Tà Lão Quái
九阴蛟=Cửu Âm Giao
九魂法王=Cửu Hồn Pháp Vương
云州卫=Vân Châu Vệ
云州城=Vân Châu Thành
云州女侠录=Vân Châu Nữ Hiệp Lục
云州林家=Vân Châu Lâm Gia
云霄峰=Vân Tiêu Phong
五灵体=Ngũ Linh Thể
五灵炼体诀=Ngũ Linh Luyện Thể Quyết
京城黑牢=Kinh Thành Hắc Lao
付波将军=Phó Ba tướng quân
仙人抚顶=Tiên Nhân Phủ Đỉnh
仙刀=Tiên Đao
仙刀斩蛟=Tiên Đao Trảm Giao
仙灵凤=Tiên Linh Phượng
仙玄气=Tiên Huyền Khí
仲闻风=Trọng Văn Phong
伏槐=Phục Hòe
传法堂=Truyền Pháp Đường
伯阳高氏=Bá Dương Cao Thị
何万春=Hà Vạn Xuân
何文轩=Hà Văn Hiên
余知秋=Dư Tri Thu
侯爷府=Hầu Gia Phủ
侯田=Hầu Điền
傅涛=Phó Đào
傅环=Phó Hoàn
先天仙武道胎=Tiên Thiên Tiên Võ Đạo Thai
內閣=Nội các
全清宗=Toàn Thanh Tông
八大妖主=Bát Đại Yêu Chủ
八大宗=Bát Đại Tông
公羊寒=Công Dương Hàn
六部五寺=Lục Bộ Ngũ Tự
兰道人=Lan Đạo Nhân
关新荣=Quan Tân Vinh
兵圣=Binh Thánh
典客署=Điển Khách Thự
冯喜=Phùng Hỉ
冯守备=Phùng Thủ Bị
冯羽=Phùng Vũ
刀猛=Đao Mãnh
刀陌=Đao Mạch
刀雄=Đao Hùng
刑部清吏司=Hình bộ Thanh lại tư
刘上使=Lưu thượng sứ
刘学士=Lưu Học Sĩ
刘铁柱=Lưu Thiết Trụ
剑南镇=Kiếm Nam Trấn
剑川镇=Kiếm Xuyên trấn
副将府=Phó Tướng Phủ
北定河=Bắc Định Hà
北岳宗=Bắc Nhạc Tông
北极仙宗=Bắc Cực Tiên Tông
北极魔宗=Bắc Cực Ma Tông
十万山=Thập Vạn Sơn
十万泽=Thập Vạn Trạch
十二血徒=Thập Nhị Huyết Đồ
十方上圣=Thập Phương Thượng Thánh
十方师尊圣众=Thập Phương Sư Tôn Thánh Chúng
千步廊=Thiên Bộ Lang
千面罗刹=Thiên Diện La Sát
千魂幡=Thiên Hồn Phiên
千鹤武馆=Thiên Hạc Võ Quán
升明月=Thăng Minh Nguyệt
升灵书=Thăng Linh Thư
升灵法=Thăng Linh Pháp
华彩居=Hoa Thái Cư
华彩楼=Hoa Thải Lâu
华清宗=Hoa Thanh Tông
华阴府=Hoa Âm Phủ
南华仙君=Nam Hoa Tiên Quân
南华宗=Nam Hoa Tông
南华真解=Nam Hoa Chân Giải
南境三州=Nam Cảnh Tam Châu
南曼城=Nam Mạn Thành
南村群童=Nam Thôn Quần Đồng
南海仙市=Nam Hải Tiên Thị
南海紫玉=Nam Hải Tử Ngọc
南海鲛人一族=Nam Hải Giao Nhân Nhất Tộc
南疆巫国=Nam Cương Vu Quốc
南疆祁氏=Nam Cương Kỳ Thị
南镇山使=Nam Trấn Sơn Sứ
卢俊=Lư Tuấn
卢骏=Lư Tuấn
卫冲=Vệ Xung
卫国公府=Vệ Quốc Công Phủ
卫黄=Vệ Hoàng
厚土体=Hậu Thổ Thể
参军府=Tham quân phủ
參將=Tham tướng
口諭=Khẩu dụ
古仙庭=Cổ Tiên Đình
右云卫=Hữu Vân Vệ
右副都御史=Hữu Phó Đô Ngự Sử
司禮監掌印太監=Tư Lễ Giám Chưởng Ấn Thái Giám
司贸校尉=Tư Mậu Hiệu Úy
司风=Tư Phong
吏部天官=Lại Bộ Thiên Quan
听风刀神=Thính Phong Đao Thần
吴屠=Ngô Đồ
吴德=Ngô Đức
吴执事=Ngô chấp sự
吴把头=Ngô Bả Đầu
吴瓢把子=Ngô Phiếu Bả Tử
周仝=Chu Đồng
周典史=Chu Điển Sử
周姓弟子=Chu Tính đệ tử
周提督=Chu Đề Đốc
周树林=Chu Thụ Lâm
周钱=Chu Tiền
周霆=Chu Đình
呼延苦=Hô Diên Khổ
唐小夏=Đường Tiểu Hạ
唐海=Đường Hải
唐胜=Đường Thắng
器灵小老头=Khí Linh tiểu lão đầu
四皇子府=Tứ Hoàng Tử Phủ
四臂妖鬼=Tứ Tí Yêu Quỷ
固远军=Cố Viễn quân
土行妖=Thổ Hành Yêu
地灵珠沙=Địa Linh Châu Sa
培灵大丹=Bồi Linh Đại Đan
夏小棠=Hạ Tiểu Đường
夏舟=Hạ Chu
夏韵=Hạ Vận
大梦游仙=Đại Mộng Du Tiên
大横练=Đại Hoành Luyện
大河剑意=Đại Hà Kiếm Ý
大洞真经=Đại Động Chân Kinh
天一堂=Thiên Nhất Đường
天一阁=Thiên Nhất Các
天下第三=Thiên Hạ Đệ Tam
天元商=Thiên Nguyên Thương
天元商会=Thiên Nguyên Thương Hội
天南勇士=Thiên Nam Dũng Sĩ
天南围场=Thiên Nam Vi Trường
天南老魔=Thiên Nam Lão Ma
天宝商行=Thiên Bảo Thương Hành
天山神鹰=Thiên Sơn Thần Ưng
天水阁=Thiên Thủy Các
天灵紫髓=Thiên Linh Tử Tủy
天牛朱蛤=Thiên Ngưu Chu Cáp
天猫超市=Siêu thị Thiên Miêu
天香坊=Thiên Hương Phường
天香谷=Thiên Hương Cốc
太虚道场=Thái Hư đạo tràng
奔虎营=Bôn Hổ Doanh
奔虎骑=Bôn Hổ Kỵ
妖主赤金神虎=Yêu chủ Xích Kim Thần Hổ
妖栏=Yêu Lan
妙灵枝=Diệu Linh Chi
姚重=Diêu Trọng
姜临仙=Khương Lâm Tiên
姜参军=Khương Tham Quân
姜嫣=Khương Yên
姜定=Khương Định
姜海涛=Khương Hải Đào
姜白川=Khương Bạch Xuyên
孔先年=Khổng Tiên Niên
孙厨子=Tôn trù tử
季磊=Quý Lỗi
宁中天=Ninh Trung Thiên
守備官=Thủ bị quan
安南世子=An Nam Thế Tử
安南侯府=An Nam Hầu phủ
安南侯爷=An Nam Hầu Gia
安南侯袁定庭=An Nam Hầu Viên Định Đình
安南军=An Nam Quân
安南府=An Nam Phủ
安南總兵=An Nam Tổng Binh
安南鎮=An Nam trấn
安南镇=An Nam Trấn
安南镇御马监=An Nam Trấn Ngự Mã Giám
安宁卫=An Ninh Vệ
安宁卫所=An Ninh Vệ Sở
安宁府=An Ninh Phủ
安寧府=An Ninh phủ
安寧衛=An Ninh vệ
宋尚书=Tống Thượng Thư
宋巡按=Tống Tuần Án
宋真云=Tống Chân Vân
宋真元=Tống Chân Nguyên
宋郎中=Tống Lang Trung
定山使=Định Sơn Sứ
宝华灵果=Bảo Hoa Linh Quả
密咒神隐决=Mật Chú Thần Ẩn Quyết
寒冰门=Hàn Băng Môn
寒魄紫晶=Hàn Phách Tử Tinh
寧中天=Ninh Trung Thiên
寻山司=Tầm Sơn Tư
小棠=Tiểu Đường
小法殿=Tiểu Pháp Điện
小白蛟=Tiểu Bạch Giao
屠宣=Đồ Tuyên
岩雾山=Nham Vụ Sơn
岳儿=Nhạc Nhi
崔初雪=Thôi Sơ Tuyết
左掖门=Tả Dịch Môn
巨石城=Cự Thạch Thành
巨石城城主祁和=Cự Thạch Thành Thành Chủ Kỳ Hòa
巫北城=Vu Bắc Thành
巫国使团=Vu Quốc Sứ Đoàn
巫国国主=Vu Quốc Quốc chủ
巫国大巫=Vu Quốc Đại Vu
巫庭城=Vu Đình Thành
巫庭春风堂=Vu Đình Xuân Phong Đường
市贸司=Thị Mậu Tư
帝听鼓=Đế Thính Cổ
常七=Thường Thất
常和=Thường Hòa
常玄=Thường Huyền
平江卫=Bình Giang Vệ
平等会=Bình Đẳng Hội
庄仁和=Trang Nhân Hòa
庄达=Trang Đạt
庆婶=Khánh thẩm
应颜中行=Ứng Nhan Trung Hành
应龙之气=Ứng Long Chi Khí
廖武=Liêu Vũ
廖齐=Liêu Tề
引见堂=Dẫn Kiến Đường
张三富=Trương Tam Phú
张临康=Trương Lâm Khang
张二爷=Trương Nhị Gia
张二狗子=Trương Nhị Cẩu Tử
张元昌=Trương Nguyên Xương
张子鹿=Trương Tử Lộc
张家老太爷=Trương Gia Lão Thái Gia
张王赵=Trương Vương Triệu
张首傅=Trương Thủ Phó
弱水灵石=Nhược Thủy Linh Thạch
强体丹=Cường Thể Đan
归云宗=Quy Vân Tông
徐泰=Từ Thái
徐玄老道=Từ Huyền lão đạo
怀东=Hoài Đông
怀东镇=Hoài Đông trấn
怀南府=Hoài Nam Phủ
惠山铁=Huệ Sơn Thiết
成非=Thành Phi
戴煜=Đới Dục
手諭=Thủ dụ
承天门=Thừa Thiên Môn
折羽=Chiết Vũ
挑血将=Thiêu Huyết Tướng
搬山猿猴=Bàn Sơn Viên Hầu
搬山神猿袁高=Bàn Sơn Thần Viên Viên Cao
文武堂=Văn Võ Đường
斩蛟=Trảm Giao
断刀帮=Đoạn Đao Bang
断刀门=Đoạn Đao Môn
断头奴=Đoạn Đầu Nô
昆玉县=Côn Ngọc Huyện
春风大道=Xuân Phong Đại Đạo
普新=Phổ Tân
普达=Phổ Đạt
暗八门=Ám Bát Môn
曲成风=Khúc Thành Phong
曹参将=Tào Tham tướng
曾香主=Tằng Hương Chủ
朱乾=Chu Càn
朱家二爷=Nhị gia Chu gia
朱家大公子=Chu gia đại công tử
朱家大少爷=Chu gia đại thiếu gia
朱家老家主=Chu gia lão gia chủ
朱岳=Chu Nhạc
朱琦=Chu Kỳ
朱重福=Chu Trọng Phúc
朱雀大道=Đại lộ Chu Tước
朱韵=Chu Vận
李寻山=Lý Tầm Sơn
李教头=Lý giáo đầu
李校尉=Lý hiệu úy
李銳=Lý Duệ
杨德留=Dương Đức Lưu
杨炳=Dương Bỉnh
林党=Lâm Đảng
林琅=Lâm Lang
柯川=Kha Xuyên
柯起=Kha Khởi
柳太白=Liễu Thái Bạch
柳娇娘=Liễu Kiều Nương
柳条巷=Liễu Điều Hạng
柳筋=Liễu Cân
柴彦=Sài Ngạn
柴进恭=Sài Tiến Cung
桑空=Tang Không
横门=Hoành Môn
檀城之盟=Đàn Thành chi minh
武榜=Võ Bảng
武评=Võ Bình
武评司=Vũ Bình Tư
毛凯=Mao Khải
气泽=Khí Trạch
江东剑仙=Giang Đông Kiếm Tiên
江神大人=Giang Thần đại nhân
江神殿=Giang Thần Điện
沙金亮=Sa Kim Lượng
河谷县=Hà Cốc Huyện
河谷张家=Hà Cốc Trương Gia
海口居=Hải Khẩu Cư
淮江江神=Hoài Giang Giang Thần
清定=Thanh Định
清定大真人=Thanh Định Đại chân nhân
清定真人=Thanh Định Chân Nhân
清微宗使臣=Thanh Vi Tông sứ thần
清河分舵=Thanh Hà Phân Đà
清河县=Thanh Hà Huyện
清河县衙=Thanh Hà Huyện Nha
清河围场=Thanh Hà Vi trường
清河地界=Địa giới Thanh Hà
清河城=Thanh Hà Thành
清河大街=Đại lộ Thanh Hà
清河安南镇=Thanh Hà An Nam Trấn
清河巷=Thanh Hà Hạng
清河新城=Thanh Hà Tân Thành
清河朱家=Thanh Hà Chu gia
清河武馆=Thanh Hà Võ Quán
清河河神=Thanh Hà Hà Thần
清河知县=Thanh Hà Tri Huyện
清风山庄=Thanh Phong Sơn Trang
渔帮=Ngư Bang
游龙六斩=Du Long Lục Trảm
潘翔=Phan Tường
火眉白猿=Hỏa Mi Bạch Viên
灵凤草=Linh Phượng Thảo
灵华阵=Linh Hoa trận
灵寿子=Linh Thọ Tử
灵树圣僧=Linh Thụ Thánh Tăng
灵芝粉=Linh Chi Phấn
烈火焚天锤=Liệt Hỏa Phần Thiên Chùy
烈炎体=Liệt Viêm Thể
烛龙城=Chúc Long Thành
牯牛卫=Cổ Ngưu Vệ
犇石=Bôn Thạch
狍子岭=Bào Tử Lĩnh
玄党=Huyền Đảng
玄国=Huyền Quốc
玄微真人=Huyền Vi Chân Nhân
玄微老道=Huyền Vi lão đạo
玄微道人=Huyền Vi đạo nhân
玄朝=Huyền Triều
玄水丹=Huyền Thủy Đan
玄水体=Huyền Thủy Thể
玄水气=Huyền Thủy Khí
玄水诀=Huyền Thủy Quyết
玄清气=Huyền Thanh Khí
玄鱼=Huyền Ngư
玄鱼峰=Huyền Ngư Phong
玄鱼殿=Huyền Ngư Điện
玄鱼道人=Huyền Ngư Đạo Nhân
玄鱼道长=Huyền Ngư Đạo Trưởng
玉京金阙天帝天真=Ngọc Kinh Kim Khuyết Thiên Đế Thiên Chân
玉谷关=Ngọc Cốc Quan
玉霄城=Ngọc Tiêu thành
王照=Vương Chiếu
王理=Vương Lý
王礼官=Vương Lễ Quan
瓢把子=Phiêu Bá Tử
田总旗=Điền Tổng Kỳ
白思道=Bạch Tư Đạo
白清宗=Bạch Thanh Tông
白猿披刀=Bạch Viên Phi Đao
白靖=Bạch Tĩnh
白鹤神拳=Bạch Hạc Thần Quyền
百刀斩魔图=Bách Đao Trảm Ma Đồ
百花真君=Bách Hoa chân quân
百里南安府=Bách Lý Nam An phủ
皇城内阁=Hoàng Thành Nội Các
盛道人=Thịnh Đạo Nhân
眉湖=Mi Hồ
石子沟=Thạch Tử Câu
石河子沟=Thạch Hà Tử Câu
破军堡=Phá Quân Bảo
破蛟军=Phá Giao quân
碧蛇枪=Bích Xà Thương
祁云=Kỳ Vân
祁和=Kỳ Hòa
祁天年=Kỳ Thiên Niên
祁影=Kỳ Ảnh
祁氏老祖=Kỳ thị lão tổ
祁煜=Kỳ Dục
祁熠=Kỳ Dập
祁瑞=Kỳ Thụy
祁白=Kỳ Bạch
祁童=Kỳ Đồng
祖皇帝=Tổ Hoàng đế
神兵符=Thần Binh Phù
神到经=Thần Đáo Kinh
神华峰=Thần Hoa Phong
神机天工=Thần Cơ Thiên Công
神火焚天锤=Thần Hỏa Phần Thiên Chùy
神玄宗=Thần Huyền Tông
神玄宫=Thần Huyền Cung
神隐符=Thần Ẩn Phù
神风居士=Thần Phong Cư Sĩ
神龙大道=Thần Long đại đạo
福德天君=Phúc Đức Thiên Quân
秋莲=Thu Liên
符箓居=Phù Lục Cư
紫眼蜓=Tử Nhãn Đình
紫金宫=Tử Kim cung
紫阳兄=Tử Dương huynh
紫阳峰=Tử Dương Phong
紫阳老道=Tử Dương lão đạo
紫阳道老=Tử Dương Đạo Lão
紫阳道长=Tử Dương Đạo Trưởng
總兵府=Tổng Binh phủ
總旗=Tổng kỳ
纯虚=Thuần Hư
纯虚子=Thuần Hư Tử
纯虚子道长=Thuần Hư Tử Đạo Trưởng
绫罗城主=Lăng La Thành Chủ
绫罗夫人=Lăng La phu nhân
羽翅白鳞蛟=Vũ Sí Bạch Lân Giao
老李头=Lão Lý Đầu
老马家=Lão Mã Gia
聂思明=Nhiếp Tư Minh
聖諭=Thánh dụ
花夜楼=Hoa Dạ Lâu
荣字门=Vinh Tự Môn
荣门=Vinh Môn
莲心阵=Liên Tâm Trận
菩萨蛮=Bồ Tát Man
落龙谭=Lạc Long Đàm
葛字门=Cát Tự Môn
蒋成=Tưởng Thành
薛总兵=Tiết Tổng Binh
薛貴=Tiết Quý
虎口关=Hổ Khẩu Quan
虎贲武馆=Hổ Bí Võ Quán
虎骨丹=Hổ Cốt Đan
虞国国师=Ngu Quốc Quốc Sư
虞国圣皇=Ngu Quốc Thánh Hoàng
虞國=Ngu Quốc
虞國太祖=Ngu Quốc Thái Tổ
虞巫=Ngu Vu
虞巫两国=Ngu Vu Lưỡng Quốc
虞巫边境=Biên giới Vu Ngu
蛙哥=Oa ca
蛮狮子=Man Sư Tử
蛮骨城=Man Cốt Thành
蛮骨城的城主=Man Cốt Thành đích Thành Chủ
蜀中剑圣=Thục Trung Kiếm Thánh
蜀中剑皇=Thục Trung Kiếm Hoàng
蜂麻燕雀，横兰葛荣=Phong Ma Yến Tước, Hoành Lan Cát Vinh
血影老祖=Huyết Ảnh Lão Tổ
血灵妖=Huyết Linh Yêu
血虎帮=Huyết Hổ Bang
行客院=Hành Khách Viện
袁侯爷=Viên Hầu Gia
袁安羽=Viên An Vũ
袁定庭=Viên Định Đình
袁总督=Viên Tổng Đốc
袁文瑞=Viên Văn Thụy
袁高=Viên Cao
西北军=Tây Bắc Quân
西北刀王=Tây Bắc Đao Vương
西北边军=Tây Bắc Biên Quân
西漠佛国=Tây Mạc Phật Quốc
许华=Hứa Hoa
许川=Hứa Xuyên
许言=Hứa Ngôn
谭虎=Đàm Hổ
贺山=Hạ Sơn
贾齐=Giả Tề
赤江=Xích Giang
赤江江神=Xích Giang Giang Thần
赤炼女=Xích Luyện Nữ
赤焰火狐=Xích Diễm Hỏa Hồ
赤角鹿=Xích Giác Lộc
赤金神虎=Xích Kim Thần Hổ
赤风谷=Xích Phong Cốc
赤龙神铁=Xích Long Thần Thiết
赤龙马=Xích Long Mã
走气图=Tẩu Khí Đồ
赵管粮=Triệu Quản Lương
赵麻子=Triệu Ma Tử
轲起=Kha Khởi
连鹤千年=Liên Hạc Thiên Niên
道始宗=Đạo Thủy Tông
道玄宗=Đạo Huyền Tông
都察院都察使=Đô Sát Viện Đô Sát Sử
酒香楼=Tửu Hương Lâu
野鸭湖=Dã Áp Hồ
金光桥=Kim Quang Kiều
金刚丸=Kim Cương Hoàn
金燕儿=Kim Yến Nhi
金骨兀=Kim Cốt Ngột
钟雷=Chung Lôi
钱宅=Tiền Trạch
铁刀武馆=Thiết Đao Võ Quán
银龙铁=Ngân Long Thiết
锐金体=Duệ Kim Thể
镇北军=Trấn Bắc Quân
镇山使=Trấn Sơn Sứ
镇山将军=Trấn Sơn Tướng Quân
镇科=Trấn Khoa
长椿功=Trường Xuân Công
长空会=Trường Không Hội
长青峰=Trường Thanh Phong
长青气=Trường Thanh Khí
问仙楼=Vấn Tiên Lâu
陈日月=Trần Nhật Nguyệt
陶丰=Đào Phong
雪阳=Tuyết Dương
雲州=Vân Châu
雲州知州=Vân Châu Tri Châu
雷勇=Lôi Dũng
霞照山=Hà Chiếu Sơn
青冥大界=Thanh Minh đại giới
青帝大道=Thanh Đế đại đạo
青木体=Thanh Mộc Thể
青玄之道=Thanh Huyền chi đạo
青面使=Thanh Diện Sứ
韓真=Hàn Chân
韩姓=Hàn tính
韩少全=Hàn Thiếu Toàn
韩沁=Hàn Thấm
项剑仙=Hạng Kiếm Tiên
项听南=Hạng Thính Nam
顾监正=Cố Giám Chính
颍东王氏=Dĩnh Đông Vương thị
颜中行=Nhan Trung Hành
颜提举=Nhan Đề Cử
颜沁=Nhan Thấm
风沙三狼=Phong Sa Tam Lang
飛鷹騎=Phi Ưng Kỵ
飞鹰骑=Phi Ưng kỵ
马典史=Mã Điển Sử
马副香主=Phó Hương chủ Mã
马宣=Mã Tuyên
马朝=Mã Triều
马福=Mã Phúc
驼山牛=Đà Sơn Ngưu
高真=Cao Chân
鬼冥教=Quỷ Minh Giáo
鬼面刀=Quỷ Diện Đao
鬼面刀呼延灼=Quỷ Diện Đao Hô Diên Chước
魏总旗=Ngụy Tổng Kỳ
魏王朱乾=Ngụy Vương Chu Càn
魏王殿下=Ngụy Vương điện hạ
魏翔=Ngụy Tường
鲁尚书=Lỗ Thượng thư
鲁辛=Lỗ Tân
鲛王泪=Giao Vương Lệ
鹤千年=Hạc Thiên Niên
鹰六=Ưng Lục
黄庭气=Hoàng Đình Khí
黄庭玄功=Hoàng Đình Huyền Công
黄庭玄经=Hoàng Đình Huyền Kinh
黄锤=Huang Chui
黄龙子=Hoàng Long Tử
黑巫卫=Hắc Vu Vệ
黑幽鹿=Hắc U Lộc
黑晶宫殿=Hắc Tinh Cung Điện
黑玄铁=Hắc Huyền Thiết
黑象=Hắc Tượng
黑龙令=Hắc Long Lệnh
齐泽=Tề Trạch
龍庭=Long Đình
龙庭之主=Long Đình Chi Chủ
龙游九霄=Long Du Cửu Tiêu
龙游九霄图=Long Du Cửu Tiêu Đồ
龙象真元劲=Long Tượng Chân Nguyên Kính
龙门境=Long Môn Cảnh
龟背阵=Quy Bối Trận
李广远=Lý Quảng Viễn
赵杰飞=Triệu Kiệt Phi
王桃桃=Vương Đào Đào
太白拳法=Thái Bạch quyền pháp
驭鬼术=Ngự Quỷ Thuật
百炼内甲=Bách Luyện Nội Giáp
夜叉观想法=Dạ Xoa Quan Tưởng Pháp
小栀子子=Tiểu Chi Tử Tử
山河万里伏=Sơn Hà Vạn Lý Phục
山神龙君=Sơn Thần Long Quân
能法=Năng Pháp
云山寺=Vân Sơn Tự
纳月术=Nạp Nguyệt Thuật
护神香=Hộ Thần Hương
能无=Năng Vô
黑玄蛇=Hắc Huyền Xà
鹰喙枪=Ưng Chủy Thương
魁梧男人=Người đàn ông vạm vỡ
飞燕逐月=Phi Yến Trục Nguyệt
回风落雁=Hồi Phong Lạc Nhạn
定神香=Định Thần Hương
清心玉佩=Thanh Tâm Ngọc Bội
高村长=Cao thôn trưởng
小余abc=Tiểu Dư abc
起点写手开玩笑=Khởi Điểm Tác Giả Nói Đùa
黄李=Hoàng Lý
观气符=Quan Khí Phù
中李=Trung Lý
好坏不定菇=Hảo Hoại Bất Định Cô
洗魂之风=Tẩy Hồn Chi Phong
黑底白条鸡血石=Hắc Để Bạch Điều Kê Huyết Thạch
欢喜仙=Hoan Hỉ Tiên
虎血草=Hổ Huyết Thảo
阳元花=Dương Nguyên Hoa
赤血参=Xích Huyết Sâm
犀角木=Tê Giác Mộc
大力果=Đại Lực Quả
寻鬼盘=Tầm Quỷ Bàn
炼魂幡=Luyện Hồn Phiên
大雷寺=Đại Lôi Tự
元气归一法=Nguyên Khí Quy Nhất Pháp
熊胆大力丸=Hùng Đảm Đại Lực Hoàn
神誓符=Thần Thệ Phù
夜睡咒=Dạ Thụy Chú
入定石=Nhập Định Thạch
追风靴=Truy Phong Ngoa
金刚醍醐酥=Kim Cương Đề Hồ Tô
白天深=Bạch Thiên Thâm
夏莫=Hạ Mạc
虎力丹=Hổ Lực Đan
皮肉境=Bì Nhục Cảnh
遇宝嗡嗡石=Ngộ Bảo Ông Ông Thạch
香火符钱=Hương Hỏa Phù Tiền
人品灵酒=Nhân Phẩm Linh Tửu
斗战法酒=Đấu Chiến Pháp Tửu
下品魂植=Hạ Phẩm Hồn Thực
忘尘草=Vong Trần Thảo
炽金精=Sí Kim Tinh
兵器符=Binh Khí Phù
一级惩恶令=Nhất Cấp Trừng Ác Lệnh
阴气领域=Âm Khí Lĩnh Vực
天月诸县=Thiên Nguyệt Chư Huyện
黑云镇鬼神都管司=Hắc Vân Trấn Quỷ Thần Đô Quản Tư
黑云镇定武司=Hắc Vân Trấn Định Võ Tư
李折=Lý Chiết
白化县=huyện Bạch Hóa
高都管=Cao Đô quản
洪都管=Hồng Đô quản
李执=Lý Chấp
平天牛魔炼形=Bình Thiên Ngưu Ma luyện hình
覆海蛟魔真劲=Phúc Hải Giao Ma chân kình
万均锤=Vạn Quân chùy
狼力丹=Lang Lực Đan
惑心丹=Hoặc Tâm Đan
钱都管=Tiền Đô Quản
洪副都管=Hồng Phó Đô quản
高问=Cao Vấn
高副都管=Cao phó đô quản
邪魔天女=Tà ma thiên nữ
贾上使=Giả Thượng sứ
黑云桃林=Hắc Vân Đào Lâm
倒悬山=Đảo Huyền Sơn
书友20221203084919876=Thư hữu 20221203084919876
彭刘铭=Bành Lưu Minh
郡鬼神都管司=Quận Quỷ Thần Đô Quản Tư
太白袋=Thái Bạch Đại
天青金液=Thiên Thanh Kim Dịch
鬼神都管司=Quỷ Thần Đô Quản Tư
州道观=Châu Đạo Quán
陆都=Lục Đô
千里掠影=Thiên Lý Lược Ảnh
赵谢=Triệu Tạ
高路=Cao Lộ
甲壳蚁=Giáp Xác Kiến
葆星=Bảo Tinh
裴屠狗=Bùi Đồ Cẩu
江河载月=Giang Hà Tái Nguyệt
白特慢啊=Bạch Đặc Mạn A
白若=Bạch Nhược
云呆呆=Vân Ngốc Ngốc
紫雷玉=Tử Lôi Ngọc
龙脉草=Long Mạch Thảo
震骨丹=Chấn Cốt Đan
凯申兄=Khải Thân Huynh
红缘楼=Hồng Duyên Lâu
藏宝石=Tàng Bảo Thạch
耳听八方石=Nhĩ Thính Bát Phương Thạch
玉京凌家=Ngọc Kinh Lăng Gia
血煞珠=Huyết Sát Châu
磨骨花=Ma Cốt Hoa
真元果=Chân Nguyên Quả
倪震刚=Nghê Chấn Cương
真否=Chân Phủ
高火=Cao Hỏa
翼蛇争寿图=Dực Xà Tranh Thọ Đồ
朱丈亭=Chu Trượng Đình
血鬼子=Huyết Quỷ Tử
朱亭丈=Chu Đình Trượng
苍穹弓=Cung Thương Khung
魏三=Ngụy Tam
追风紫雷靴=Truy Phong Tử Lôi Ngoa
郡城定武司=Quận Thành Định Võ Tư
朱都管=Chu Đô Quản
小云朵=Tiểu Vân Đóa
周天君=Chu Thiên Quân
铁一=Thiết Nhất
风华县=Phong Hoa Huyện
九洞龙君=Cửu Động Long Quân
熔岩鲶鱼=Dung Nham Niêm Ngư
灵阳湖龙宫三太子=Linh Dương Hồ Long Cung Tam Thái Tử
泥鳅精=Cá Chạch Tinh
灵阳花=Linh Dương Hoa
大日煌煌，余者皆黯=Đại Nhật Huy Hoàng, Dư Giả Giai Ảm
水元妙境=Thủy Nguyên Diệu Cảnh
天海水元盛会=Thiên Hải Thủy Nguyên Thịnh Hội
幻龙果=Huyễn Long Quả
水元之试=Thủy Nguyên Chi Thí
灵阳阳腾=Linh Dương Dương Đằng
玄薇=Huyền Vi
九洞湖龙君大人=Cửu Động Hồ Long Quân đại nhân
九洞湖龙君=Cửu Động Hồ Long Quân
灵阳湖三太子=Linh Dương Hồ Tam Thái Tử
阴空河=Âm Không Hà
阴空水主=Âm Không Thủy Chủ
蛟大将=Giao Đại Tướng
妙境之源=Diệu Cảnh Chi Nguyên
江南东=Giang Nam Đông
大齐朝廷=Đại Tề triều đình
地尸门=Địa Thi Môn
煞尸珠=Sát Thi Châu
祭龙王=Tế Long Vương
三江推荐=Tam Giang đề cử
夜的旅途=Dạ đích lữ đồ
诸葛夜华=Gia Cát Dạ Hoa
阳光的白鸽=Dương Quang đích Bạch Cát
我见青山万里=Ngã kiến Thanh Sơn Vạn Lí
好名字全重复了=Hảo danh tự toàn trùng phục liễu
若世间有神明=Nhược thế gian hữu thần minh
帝壹=Đế Nhất
暗月天明=Ám Nguyệt Thiên Minh
沉迷书中世界=Trầm Mê Thư Trung Thế Giới
温驯的折耳猫=Ôn Thuần Đích Chiết Nhĩ Miêu
阿政128=A Chính 128
落花有道=Lạc Hoa Hữu Đạo
最后的小吉=Tối Hậu Đích Tiểu Cát
善E=Thiện E
allGOD梦=allGOD Mộng
最后的落落=Tối Hậu Đích Lạc Lạc
黎丘=Lê Khâu
阴阳石灯=Âm Dương Thạch Đăng
铁石村=Thiết Thạch Thôn
姜望远=Khương Vọng Viễn
齐周晋=Tề Chu Tấn
闭眼姐=Bế Nhãn Tỷ
天骄之试=Thiên Kiêu Chi Thí
仙种之试=Tiên Chủng Chi Thí
黑白哥=Hắc Bạch Ca
登仙池=Đăng Tiên Trì
元魂之核=Nguyên Hồn Chi Hạch
生灵圣水=Sinh Linh Thánh Thủy
生命之潭=Sinh Mệnh Chi Đàm
黄泉阴露=Hoàng Tuyền Âm Lộ
阴华=Âm Hoa
青山武馆=Thanh Sơn Võ Quán
无命之面=Vô Mệnh Chi Diện
甄明=Chân Minh
南宣=Nam Tuyên
云龙卫=Vân Long Vệ
混天鹏骨=Hỗn Thiên Bằng Cốt
罗会=La Hội
孙通=Tôn Thông
海心甲=Hải Tâm Giáp
商主=Thương chủ
北边草原=Bắc Biên thảo nguyên
蛮族大祭司=Man tộc Đại tế tư
天月酒楼=Thiên Nguyệt Tửu Lâu
袁梅=Viên Mai
袁黄二家=Viên Hoàng nhị gia
郡道观=Quận Đạo Quan
武道大宗=Võ Đạo Đại Tông
天地奇珍=Thiên Địa Kỳ Trân
禺狨石=Ngu Nhung Thạch
五脏六腑神丹=Ngũ Tạng Lục Phủ Thần Đan
中皇城=Trung Hoàng Thành
天北域=Thiên Bắc Vực
瑶莀=Dao Trân
谢狂=Tạ Cuồng
林路飞=Lâm Lộ Phi
苏何=Tô Hà
三光福灵镜=Tam Quang Phúc Linh Kính
鬼长老=Quỷ trưởng lão
夜游境=Dạ Du cảnh
日游境=Nhật Du cảnh
安仙王=An Tiên Vương
元气屏障=Nguyên Khí Bình Chướng
幻梦术=Huyễn Mộng Thuật
脱衣咒=Thoát Y Chú
江文武=Giang Văn Võ
陇天俯=Lũng Thiên Phủ
黑云武卫=Hắc Vân Võ Vệ
张远涛=Trương Viễn Đào
萧卿绾=Tiêu Khanh Oản
洛妙妙=Lạc Diệu Diệu
天武侯府=Thiên Vũ Hầu Phủ
梦依允=Mộng Y Doãn
铁矿场=Mỏ Sắt
戴流=Đới Lưu
云家姐妹=Vân Gia tỷ muội
覆海蛟龙=Phúc Hải Giao Long
天海法会=Thiên Hải Pháp Hội
九洞=Cửu Động
灵阳=Linh Dương
仙器哥=Tiên Khí Ca
天海水族=Thuỷ tộc Thiên Hải
天海长公主=Thiên Hải Trưởng Công Chúa
天药鱼=Thiên Dược Ngư
鳄鱼精=Ngạc Ngư Tinh
金缕衣=Kim Lũ Y
天海龙君=Thiên Hải Long Quân
奂英=Hoán Anh
氿古=Cửu Cổ
冰灵寒魂焰=Băng Linh Hàn Hồn Diễm
无名阴火=Vô Danh Âm Hỏa
阴地火印=Âm Địa Hỏa Ấn
阴华县=Âm Hoa Huyện
阳地火印=Dương Địa Hỏa Ấn
黑云校场=Hắc Vân Giáo Trường
狂刀馆=Cuồng Đao Quán
灵犀棋局=Linh Tê Kỳ Cục
齐武经=Tề Võ Kinh
齐道经=Tề Đạo Kinh
灵心篇=Linh Tâm Thiên
段金=Đoạn Kim
临阳县=Lâm Dương huyện
加库玛=Gia Khố Mã
承山石=Thừa Sơn Thạch
轩师兄=Hiên sư huynh
日月石林=Nhật Nguyệt Thạch Lâm
紫气蕴焰蛇=Tử Khí Uẩn Diệm Xà
天行道=Thiên Hành Đạo
大夏太祖=Đại Hạ Thái Tổ
天行道节度使=Tiết độ sứ Thiên Hành Đạo
三生三世轮回经=Tam Sinh Tam Thế Luân Hồi Kinh
不坏天功=Bất Hoại Thiên Công
南山行者=Nam Sơn Hành Giả
从搜山降魔开始=Từ Sưu Sơn Hàng Ma Bắt Đầu
老山海域=Lão Sơn Hải Vực
青阳真人=Thanh Dương chân nhân
三阴村=Tam Âm Thôn
三阴湖=Tam Âm Hồ
三阴山=Tam Âm Sơn
阴灵入圣丹=Âm Linh Nhập Thánh Đan
圣心丹=Thánh Tâm Đan
太阳太阴真神丹=Thái Dương Thái Âm Chân Thần Đan
三阴幡=Tam Âm Phiên
紫灵玉=Tử Linh Ngọc
紫焰宗=Tử Diễm Tông
玄龙果=Huyền Long Quả
玄蛇果=Huyền Xà Quả
莲心丹=Liên Tâm Đan
十一天神丹=Thập Nhất Thiên Thần Đan
载意郡=Tái Ý Quận
晋司马=Tấn Tư Mã
慕婉=Mộ Uyển
慕冬山=Mộ Đông Sơn
八部天龙经=Bát Bộ Thiên Long Kinh
天龙不朽身=Thiên Long Bất Hủ Thân
云江龙女=Vân Giang Long Nữ
A级推荐=Đề xuất cấp A
天龙内门=Thiên Long nội môn
发惹=Phát Nhạ
顾左=Cố Tả
缺月大师=Khuyết Nguyệt đại sư
青天神君=Thanh Thiên Thần Quân
轮转法王=Luân Chuyển Pháp Vương
十方天光=Thập Phương Thiên Quang
刘臣=Lưu Thần
天阴定命草=Thiên Âm Định Mệnh Thảo
天灵金果=Thiên Linh Kim Quả
玄武灵丹=Huyền Vũ Linh Đan
卫州卫家=Vệ Châu Vệ Gia
聚火壶=Tụ Hỏa Hồ
纯质阳炎=Thuần Chất Dương Viêm
凤凰之火=Phượng Hoàng Chi Hỏa
黄明年=Hoàng Minh Niên
灵玄武馆=Linh Huyền Võ Quán
曹曲=Tào Khúc
灵玄观=Linh Huyền Quán
望月山=Vọng Nguyệt Sơn
大雷雨寺=Đại Lôi Vũ Tự
万道殿=Vạn Đạo Điện
天命仙种=Thiên Mệnh Tiên Chủng
州城董家=Châu Thành Đổng Gia
鼎鳞尊者=Đỉnh Lân Tôn Giả
冤刀武尊=Oan Đao Võ Tôn
博灵真人=Bác Linh Chân Nhân
天启之石=Thiên Khải Chi Thạch
天命之月计划=Thiên Mệnh Chi Nguyệt Kế Hoạch
天武学天龙变=Thiên Vũ Học Thiên Long Biến
天圆地方枪法=Thiên Viên Địa Phương Thương Pháp
丁六灵=Đinh Lục Linh
黄明日=Hoàng Minh Nhật
太白馆=Thái Bạch Quán
肖执=Tiêu Chấp
黄风话=Hoàng Phong Thoại
袁丽=Viên Lệ
于刃=Vu Nhận
天辰之金=Thiên Thần Chi Kim
金龙武馆=Kim Long Võ Quán
凤凰岁帝=Phượng Hoàng Tuế Đế
地兽遗命=Địa thú di mệnh
洛神扇=Lạc Thần Phiến
静若室=Tĩnh Nhược Thất
舍生开道法=Xả Sinh Khai Đạo Pháp
养命器=Dưỡng Mệnh Khí
丁六=Đinh Lục
九凤汤=Cửu Phượng Thang
青玉灵皇笋=Thanh Ngọc Linh Hoàng Măng
十二彩鸡=Thập Nhị Thải Kê
赤焰酒=Xích Diễm Tửu
六腑神丹=Lục Phủ Thần Đan
五脏神丹=Ngũ Tạng Thần Đan
卫州=Vệ Châu
望峰县=Vọng Phong Huyện
方振远=Phương Chấn Viễn
丁六地兽场=Đinh Lục Địa Thú Tràng
太白门=Thái Bạch Môn
翻海霸刀=Phiên Hải Bá Đao
真极宗=Chân Cực Tông
小圣寺=Tiểu Thánh Tự
楚师=Sở Sư
孟家废物少爷=Mạnh gia phế vật thiếu gia
方振兴=Phương Chấn Hưng
海侦=Hải Trinh
池瑶天女=Trì Dao Thiên Nữ
江南东家=Giang Nam Đông Gia
东圣天=Đông Thánh Thiên
东王镜=Đông Vương Kính
东王御仙道阵=Đông Vương Ngự Tiên Đạo Trận
天母教教主=Giáo chủ Thiên Mẫu Giáo
赵都管=Triệu Đô Quản
九邪鬼婴=Cửu Tà Quỷ Anh
无常阎罗域=Vô Thường Diêm La Vực
大河村=Đại Hà thôn
小草河=Tiểu Thảo hà
太白密室=Thái Bạch Mật Thất
承命符=Thừa Mệnh Phù
追月狼=Truy Nguyệt Lang
狼后=Lang Hậu
角光狐=Giác Quang Hồ
天地双虎=Thiên Địa Song Hổ
胡英俊=Hồ Anh Tuấn
合灵法=Hợp Linh Pháp
追月狼谷=Truy Nguyệt Lang Cốc
狼行=Lang Hành
黑山妖族=Hắc Sơn Yêu tộc
月神果=Nguyệt Thần Quả
接月圣泉=Tiếp Nguyệt Thánh Tuyền
狐谷=Hồ Cốc
月神树=Nguyệt Thần Thụ
阿列=A Liệt
承天镇世经=Thừa Thiên Trấn Thế Kinh
天子神拳=Thiên Tử Thần Quyền
狼虹=Lang Hồng
黑云卫=Hắc Vân Vệ
云家主=Vân Gia Chủ
无名宝花=Vô Danh Bảo Hoa
怪蜂蜂蜜=Quái Phong Mật Ong
熔岩墟金=Dung Nham Khư Kim
玄藤=Huyền Đằng
玄藤木珠=Huyền Đằng Mộc Châu
御石=Ngự Thạch
光明草=Quang Minh Thảo
天蛇藤花=Thiên Xà Đằng Hoa
玄藤甲=Huyền Đằng Giáp
天仙壶=Thiên Tiên Hồ
紫气幡=Tử Khí Phan
清元观=Thanh Nguyên Quan
太素玄真上仙=Thái Tố Huyền Chân Thượng Tiên
天子学宫=Thiên Tử Học Cung
大齐皇室=Đại Tề Hoàng thất
千师=Thiên Sư
南晋司马氏=Nam Tấn Tư Mã Thị
胡列列=Hồ Liệt Liệt
蒋英宇=Tưởng Anh Vũ
娑仙=Sa Tiên
寒州蒋家=Hàn Châu Tưởng Gia
栖凤花=Tê Phượng Hoa
真血大魔=Chân Huyết Đại Ma
原始海域=Nguyên Thủy Hải Vực
月神印记=Nguyệt Thần Ấn Ký
崔献=Thôi Hiến
主编力荐=Chủ biên lực tiến
夸克2021=Quark2021
狼谷=Lang Cốc
白馆主=Bạch Quán Chủ
林歌=Lâm Ca
仙器太素元真图=Tiên khí Thái Tố Nguyên Chân Đồ
玄木心=Huyền Mộc Tâm
落云石=Lạc Vân Thạch
绝真老祖=Tuyệt Chân Lão Tổ
陈晓=Trần Hiểu
黑云高家=Hắc Vân Cao Gia
混天鹏魔密式=Hỗn Thiên Bằng Ma Mật Thức
一宝妙树=Nhất Bảo Diệu Thụ
神华宗=Thần Hoa Tông
地级武馆=Địa Cấp Võ Quán
人级武馆=Nhân Cấp Võ Quán
娑仙道子=Sa Tiên Đạo Tử
食寿鬼=Thực Thọ Quỷ
大千仙树观想图=Đại Thiên Tiên Thụ Quan Tưởng Đồ
三阴丹道传承=Tam Âm Đan Đạo Truyền Thừa
基础法符传承=Cơ Sở Pháp Phù Truyền Thừa
三阴鼎=Tam Âm Đỉnh
逆命丹=Nghịch Mệnh Đan
太阳炼神法=Thái Dương Luyện Thần Pháp
观想图=Quán Tưởng Đồ
太阳炼神=Thái Dương Luyện Thần
太阴炼神=Thái Âm Luyện Thần
胡图图=Hồ Đồ Đồ
小晕=Tiểu Vựng
追月狼族=Truy Nguyệt Lang Tộc
追月狼王=Truy Nguyệt Lang Vương
月神之光=Nguyệt Thần Chi Quang
夜叉观想图=Dạ Xoa Quán Tưởng Đồ
追月狼爪=Truy Nguyệt Lang Trảo
天海升龙法会=Thiên Hải Thăng Long Pháp Hội
光狐族=Quang Hồ Tộc
太白馆主=Thái Bạch Quán Chủ
休命武道=Hưu Mệnh Võ Đạo
幽冥杀剑=U Minh Sát Kiếm
造化灵液=Tạo Hóa Linh Dịch
本源神池=Bản Nguyên Thần Trì
太上仙经=Thái Thượng Tiên Kinh
圣心咒=Thánh Tâm Chú
启灵养神法=Khải Linh Dưỡng Thần Pháp
缺月阁主=Khuyết Nguyệt Các chủ
天青郡=Thiên Thanh Quận
心眼秘术=Tâm Nhãn Bí Thuật
归真宝船=Quy Chân Bảo Thuyền
元涛=Nguyên Đào
平康坊=Bình Khang Phường
安定坊=An Định Phường
圣灵液=Thánh Linh Dịch
驱神禺狨=Khu Thần Ngu Nhung
混天鹏魔=Hỗn Thiên Bằng Ma
州鬼神司=Châu Quỷ Thần Tư
黄泉之门=Hoàng Tuyền Chi Môn
斩光刀=Trảm Quang Đao
神心果=Thần Tâm Quả
地肺果=Địa Phế Quả
六腑灵水=Lục Phủ Linh Thủy
搬山神躯=Bàn Sơn Thần Khu
吕华=Lữ Hoa
花果山水帘洞者行孙=Hoa Quả Sơn Thủy Liêm Động Giả Hành Tôn
山水武馆=Sơn Thủy Võ Quán
天山郡=Thiên Sơn Quận
中天商会=Trung Thiên Thương Hội
崔曜=Thôi Diệu
大齐钱庄=Đại Tề Tiền Trang
甲辰包厢=Giáp Thìn Bao Sương
掩天机=Yểm Thiên Cơ
都管=Đô Quản
四海龙皇=Tứ Hải Long Hoàng
董伟宇=Đổng Vĩ Vũ
极光武馆=Cực Quang võ quán
素恩武馆=Tố Ân Võ Quán
天归城=Thiên Quy Thành
素真山=Tố Chân Sơn
星罗武馆=Tinh La Võ Quán
神鹰武馆=Thần Ưng Võ Quán
天蟒武馆=Thiên Mãng Võ Quán
天斗武馆=Thiên Đấu Võ Quán
天西郡=Thiên Tây Quận
天北武馆=Thiên Bắc Võ Quán
九阳武馆=Cửu Dương Võ Quán
巩留=Củng Lưu
太白剑法=Thái Bạch Kiếm Pháp
震雷锤=Chấn Lôi Chùy
飞檐溅雪=Phi Diêm Tiễn Tuyết
武王霸剑=Võ Vương Bá Kiếm
武王武馆=Võ Vương Võ Quán
天灵武馆=Thiên Linh Võ Quán
吴英雄=Ngô Anh Hùng
白启=Bạch Khải
裂星=Liệt Tinh
绝命刀=Tuyệt Mệnh Đao
上阳真力=Thượng Dương Chân Lực
尸堂=Thi Đường
斗堂=Đấu Đường
技堂=Kỹ Đường
王大山=Vương Đại Sơn
天延郡=Thiên Duyên Quận
无序之境=Vô Tự Chi Cảnh
养尸袋=Dưỡng Thi Đại
周古进=Chu Cổ Tiến
斗堂堂主=Đấu Đường Đường Chủ
插翅紫僵=Sáp Sí Tử Cương
尸堂堂主=Thi Đường Đường Chủ
天妄郡城=Thiên Vọng Quận Thành
灵尸子=Linh Thi Tử
地尸道人=Địa Thi Đạo Nhân
技堂堂主=Kỹ Đường Đường Chủ
天妄山脉=Thiên Vọng Sơn Mạch
地尸山脉=Địa Thi Sơn Mạch
神器山海珠=Thần khí Sơn Hải Châu
万山之精=Vạn Sơn chi Tinh
小王庄=Tiểu Vương Trang
王根正=Vương Căn Chính
小草姐妹=Tiểu Thảo tỷ muội
王定蛮=Vương Định Man
腾空武馆=Đằng Không Võ Quán
天妄郡=Thiên Vọng quận
三星剑=Tam Tinh Kiếm
裂星弓=Liệt Tinh Cung
中天郡=Trung Thiên Quận
谢雷=Tạ Lôi
驱神禺狨图录=Khu Thần Ngu Nhung Đồ Lục
天蛇藤=Thiên Xà Đằng
黑云镇鬼神司=Hắc Vân Trấn Quỷ Thần Tư
万寿道果=Vạn Thọ Đạo Quả
三阴传承=Tam Âm Truyền Thừa
天妄古墓=Thiên Vọng Cổ Mộ
紫金宝箱=Rương báu Tử Kim
幽冥劫=U Minh Kiếp
林影=Lâm Ảnh
宁菀可=Ninh Uyển Khả
魂墨=Hồn Mặc
中天联合交易会=Trung Thiên Liên Hợp Giao Dịch Hội
黑火蚁族=Hắc Hỏa Kiến Tộc
天女神=Thiên Nữ Thần
蛮族大草原=Đại thảo nguyên Man tộc
百骨丹=Bách Cốt Đan
吞神功=Thôn Thần Công
余宾=Dư Tân
袁一寒=Viên Nhất Hàn
疤脸老汉=Ông Lão Mặt Sẹo
袁副都管=Viên Phó Đô Quản
晨光鬼神司=Thần Tư Ánh Sáng Buổi Sáng
晨光县=Thần Quang huyện
脏毒鬼手=Tạng Độc Quỷ Thủ
万田县=Vạn Điền huyện
风晓县=Phong Hiểu huyện
长河县=Trường Hà huyện
黑云镇外=ngoài Hắc Vân trấn
云云江龙宫=Vân Vân Giang Long Cung
天州鬼神司=Thiên Châu Quỷ Thần Tư
三阴遗藏=Tam Âm Di Tàng
死孽冥尸=Tử Nghiệt Minh Thi
武神花=Võ Thần Hoa
灵植益骨草=Linh Thực Ích Cốt Thảo
真元宝液=Chân Nguyên Bảo Dịch
千兵坊=Thiên Binh Phường
混湖=Hỗn Hồ
袁大师=Viên đại sư
日游长老=Nhật Du trưởng lão
窝迭=Oa Điệt
太白周清=Thái Bạch Chu Thanh
黄亥=Hoàng Hợi
黄石仁=Hoàng Thạch Nhân
绛云船=Giáng Vân Thuyền
苍天殿=Thương Thiên Điện
方振宇=Phương Chấn Vũ
三龙辇=Tam Long Liễn
古龙峰=Cổ Long Phong
圣龙峰峰主=Phong chủ Thánh Long Phong
西海龙君=Tây Hải Long Quân
黑山洞天福地=Hắc Sơn Động Thiên Phúc Địa
星之传承=Tinh Chi Truyền Thừa
宁麟=Ninh Lân
龙宫龙后=Long Cung Long Hậu
青霄殿主=Thanh Tiêu Điện Chủ
玄光王=Huyền Quang Vương
慕星主=Mộ Tinh Chủ
慕云萝=Mộ Vân La
天归郡城=Thiên Quy Quận Thành
山河苍生榜=Sơn Hà Thương Sinh Bảng
圣龙峰=Thánh Long Phong
黑山大阵=Hắc Sơn Đại Trận
三阴山谷=Tam Âm Sơn Cốc
八卦真炉=Bát Quái Chân Lô
天龙域=Thiên Long Vực
古龙峰主=Cổ Long Phong Chủ
天龙门主=Thiên Long Môn Chủ
绛云仙姑=Giáng Vân Tiên Cô
云绝真=Vân Tuyệt Chân
天龙老儿=Thiên Long Lão Nhi
圣龙峰主=Thánh Long Phong Chủ
若月=Nhược Nguyệt
远南=Viễn Nam
苏长安=Tô Trường An
黑云周清=Hắc Vân Chu Thanh
清月甲=Thanh Nguyệt Giáp
叶都管=Diệp Đô Quản
郡鬼神司=Quận Quỷ Thần Tư
魂魔上人=Hồn Ma Thượng Nhân
三念真王=Tam Niệm Chân Vương
黄泉雏丹=Hoàng Tuyền Sồ Đan
天月各县=Thiên Nguyệt Các Huyện
州定武司=Châu Định Võ Tư
天月五灵玄光阵=Thiên Nguyệt Ngũ Linh Huyền Quang Trận
陆都管=Lục Đô Quản
黑山福地=Hắc Sơn Phúc Địa
青华县=Thanh Hoa Huyện
血魂上人=Huyết Hồn Thượng Nhân
缺月丹阁=Khuyết Nguyệt Đan Các
慕大师=Mộ đại sư
阴天小尊=Âm Thiên Tiểu Tôn
阴神尊者=Âm Thần Tôn Giả
天月五灵玄光大阵=Thiên Nguyệt Ngũ Linh Huyền Quang Đại Trận
灵玄道观=Linh Huyền Đạo Quán
圆月武馆=Viên Nguyệt Võ Quán
周巡游=Chu Tuần Du
陈郡守=Trần Quận Thủ
黄腾=Hoàng Đằng
天州道观=Thiên Châu Đạo Quán
齐皇后=Tề Hoàng Hậu
落雨武馆=Lạc Vũ Võ Quán
风鸣道观=Phong Minh Đạo Quán
浩然大手印=Hạo Nhiên Đại Thủ Ấn
鬼神巡游=Quỷ Thần Tuần Du
张元涛=Trương Nguyên Đào
何风=Hà Phong
高顶天=Cao Đỉnh Thiên
陇天牙=Lũng Thiên Nha
陇天冲=Lũng Thiên Xung
两司=Lưỡng Tư
白姓皇室=Bạch Tính Hoàng Thất
白氏尊者=Bạch Thị Tôn Giả
左天正=Tả Thiên Chính
江都管=Giang Đô Quản
天河尊者=Thiên Hà Tôn Giả
高真雄=Cao Chân Hùng
云龙阁=Vân Long Các
元武宝树=Nguyên Võ Bảo Thụ
圣血树=Thánh Huyết Thụ
灵魂树=Linh Hồn Thụ
小真武神金=Tiểu Chân Võ Thần Kim
真武仙金=Chân Võ Tiên Kim
化神莲=Hóa Thần Liên
水元门=Thủy Nguyên Môn
天地钱庄=Thiên Địa Tiền Trang
神秘宝像=Thần Bí Bảo Tượng
阳武县=Dương Võ huyện
阳地县=Dương Địa huyện
云远南=Vân Viễn Nam
安愉=An Du
宋秋=Tống Thu
明空公主=Minh Không công chúa
青阳区域=Khu vực Thanh Dương
紫阳石=Tử Dương Thạch
紫阳墟=Tử Dương Khư
白阳区=Bạch Dương Khu
青阳区=Thanh Dương Khu
炽火道人=Sí Hỏa Đạo Nhân
青阳神火=Thanh Dương Thần Hỏa
纯白之森=Thuần Bạch Chi Sâm
白炽火=Bạch Sí Hỏa
九阳潮=Cửu Dương Triều
暗阳湖=Ám Dương Hồ
天城鬼王=Thiên Thành Quỷ Vương
墟蛮兽=Khư Man Thú
墟灵=Khư Linh
阳鬼=Dương Quỷ
阴天尊者=Âm Thiên Tôn Giả
地冥兽尊=Địa Minh Thú Tôn
九洞湖=Cửu Động Hồ
阳绪=Dương Tự
阳唯=Dương Duy
金火兽尊=Kim Hỏa Thú Tôn
厌冰=Yếm Băng
焚风尊者=焚 Phong Tôn Giả
玄光大阵=Huyền Quang Đại Trận
黄泉液=Hoàng Tuyền Dịch
九阳百科=Cửu Dương Bách Khoa
白阳墟=Bạch Dương Khư
赤阳区=Xích Dương Khu
赤阳墟=Xích Dương Khư
青阳墟=Thanh Dương Khư
郡定武司=Quận Định Võ Tư
史都管=Sử Đô Quản
万浪神金=Vạn Lãng Thần Kim
复神丹=Phục Thần Đan
灵阳圣果=Linh Dương Thánh Quả
深海银母=Thâm Hải Ngân Mẫu
神血丹=Thần Huyết Đan
灵阳湖龙君=Linh Dương Hồ Long Quân
傲阳甲=Ngạo Dương Giáp
地兽场=Địa Thú Tràng
乙十三号=Ất Thập Tam Hào
香字=Hương Tự
闻字令牌=Văn Tự Lệnh Bài
真血兽尊=Chân Huyết Thú Tôn
焚天宗=Phần Thiên Tông
暗阳墟=Ám Dương Khư
地熔妖=Địa Dung Yêu
地鳞=Địa Lân
十道殿=Thập Đạo Điện
鲲分身=Khôn Phân Thân
腾龙武馆=Đằng Long Võ Quán
覆海蛟=Phúc Hải Giao
灵鬼道人=Linh Quỷ Đạo Nhân
百阳鬼花=Bách Dương Quỷ Hoa
元丰县=Nguyên Phong Huyện
梁海=Lương Hải
天阳城=Thiên Dương Thành
沧元县=Thương Nguyên Huyện
天海郡=Thiên Hải Quận
天北郡=Thiên Bắc Quận
素真府=Tố Chân Phủ
素真城=Tố Chân Thành
林执事=Lâm chấp sự
天归郡=Thiên Quy Quận
姚欢欢=Diêu Hoan Hoan
崔曜之=Thôi Diệu Chi
飞仙道=Phi Tiên Đạo
幽灵尸火=U Linh Thi Hỏa
天火封印=Thiên Hỏa Phong Ấn
真阳天火=Chân Dương Thiên Hỏa
陨星石焰=Vẫn Tinh Thạch Diệm
暗天坑=Ám Thiên Hố
芙蓉尊者=Phù Dung Tôn Giả
阴地火=Âm Địa Hỏa
天墟郡=Thiên Khư Quận
紫薇下凡=Tử Vi Hạ Phàm
崔曜河=Thôi Diệu Hà
大岩山=Đại Nham Sơn
雪满人间=Tuyết Mãn Nhân Gian
张启灵=Trương Khải Linh
泰和郡=Thái Hòa Quận
泰保郡城=Thái Bảo Quận Thành
雪凤凰=Tuyết Phượng Hoàng
崔洞=Thôi Động
李元杰=Lý Nguyên Kiệt
沧澜之域=Thương Lan Chi Vực
沧澜千刃=Thương Lan Thiên Nhận
沧澜万剑=Thương Lan Vạn Kiếm
青州州城=Thanh Châu Châu Thành
元灵族=Nguyên Linh Tộc
古民=Cổ Dân
暖石=Noãn Thạch
玄都七十二外峰=Huyền Đô Thất Thập Nhị Ngoại Phong
怀远峰=Hoài Viễn Phong
冷面丹君=Lãnh Diện Đan Quân
琉璃峰=Lưu Li Phong
于雪=Vu Tuyết
归元峰=Quy Nguyên Phong
传道峰=Truyền Đạo Phong
玄法小市=Huyền Pháp Tiểu Thị
天律殿=Thiên Luật Điện
海藏峰=Hải Tàng Phong
黑白楼=Hắc Bạch Lâu
绝真神君=Tuyệt Chân Thần Quân
第二十一峰=Đệ Nhị Thập Nhất Phong
第三十六峰=Đệ Tam Thập Lục Phong
唐峰主=Đường Phong Chủ
二宝妙树=Nhị Bảo Diệu Thụ
诸葛副观主=Gia Cát Phó Quán Chủ
天母教主=Thiên Mẫu Giáo Chủ
通古海=Thông Cổ Hải
临雪郡=Lâm Tuyết Quận
离山海域=Ly Sơn Hải Vực
韩兴荣=Hàn Hưng Vinh
韩兴商=Hàn Hưng Thương
替心石=Thế Tâm Thạch
封印粉尘=Phong Ấn Phấn Trần
狂暴之晶=Cuồng Bạo Chi Tinh
禁空之羽=Cấm Không Chi Vũ
微挪移符=Vi Nọa Di Phù
蛊惑之瞳=Cổ Hoặc Chi Đồng
器物融合之光=Khí Vật Dung Hợp Chi Quang
小回天丹=Tiểu Hồi Thiên Đan
寒原郡城=Hàn Nguyên Quận Thành
韩德言=Hàn Đức Ngôn
韩德为=Hàn Đức Vi
折山枪=Chiết Sơn Thương
万川掌=Vạn Xuyên Chưởng
动地步=Động Địa Bộ
万川势=Vạn Xuyên Thế
空山枪=Không Sơn Thương
极光飞舟=Cực Quang Phi Chu
黑原郡=Hắc Nguyên Quận
天客楼=Thiên Khách Lâu
韩州=Hàn Châu
定武司=Định Võ Tư
杜都管=Đỗ Đô Quản
苏都管=Tô Đô Quản
横川县=Hoành Xuyên Huyện
万川真经=Vạn Xuyên Chân Kinh
寒原城=Hàn Nguyên Thành
水月周清=Thủy Nguyệt Chu Thanh
丹花=Đan Hoa
神农玉册=Thần Nông Ngọc Sách
功德殿殿主=Điện chủ Công Đức Điện
纪副观主=Kỷ phó quan chủ
张信理=Trương Tín Lý
三线峡=Tam Tuyến Hạp
江景若=Giang Cảnh Nhược
玄念道人=Huyền Niệm Đạo Nhân
忘尘殿主=Điện chủ Vong Trần Điện
玄都金册=Huyền Đô Kim Sách
玄都大阵=Huyền Đô Đại Trận
十大真传=Thập Đại Chân Truyền
大齐国=Đại Tề Quốc
尔木=Nhĩ Mộc
真传令=Chân Truyền Lệnh
武丹=Võ Đan
真宫=Chân Cung
鬼神传承=Quỷ Thần Truyền Thừa
天佑之光=Thiên Hữu Chi Quang
玄都仙阵=Huyền Đô Tiên Trận
漂流愿瓶=Phiêu Lưu Nguyện Bình
半妖岁=Bán Yêu Tuế
蜕凡之种=Thoái Phàm Chi Chủng
鸿天剑录=Hồng Thiên Kiếm Lục
归真剑典=Quy Chân Kiếm Điển
惊世古功=Kinh Thế Cổ Công
朝暮剑法=Triêu Mộ Kiếm Pháp
承道楼=Thừa Đạo Lâu
雷瀑神剑=Lôi Bộc Thần Kiếm
阴阳道剑=Âm Dương Đạo Kiếm
仙鹤峰=Tiên Hạc Phong
金足道=Kim Túc Đạo
紫电宫=Tử Điện Cung
冥云=Minh Vân
神农老人=Thần Nông Lão Nhân
玄都真丹=Huyền Đô Chân Đan
玄都传承=Huyền Đô Truyền Thừa
玄都真传=Huyền Đô Chân Truyền
立道池=Lập Đạo Trì
玄都根法=Huyền Đô Căn Pháp
密武=Mật Võ
真传峰=Chân Truyền Phong
混元火=Hỗn Nguyên Hỏa
仙鹤峰主=Tiên Hạc Phong Chủ
玄法河山=Huyền Pháp Hà Sơn
灵兽牌=Linh Thú Bài
通玄峰=Thông Huyền Phong
九阳联盟=Cửu Dương Liên Minh
玄法南域=Huyền Pháp Nam Vực
洛丹君=Lạc Đan Quân
齐氏兄弟=Tề Thị huynh đệ
古尽=Cổ Tẫn
倪轮光=Nghê Luân Quang
季行秋=Quý Hành Thu
宝光境=Bảo Quang Cảnh
真圣魔教=Chân Thánh Ma Giáo
玄都小市=Huyền Đô Tiểu Thị
百鬼噬心花=Bách Quỷ Phệ Tâm Hoa
忘尘殿=Vong Trần Điện
玄都净土=Huyền Đô Tịnh Thổ
幽鬼祖=U Quỷ Tổ
玄鬼祖=Huyền Quỷ Tổ
决明鬼祖=Quyết Minh Quỷ Tổ
天冬鬼祖=Thiên Đông Quỷ Tổ
魂域神树=Hồn Vực Thần Thụ
剑魂草=Kiếm Hồn Thảo
万浪血珊瑚=Vạn Lãng Huyết San Hô
无神丹=Vô Thần Đan
鬼神之息=Quỷ Thần Chi Tức
元灵液=Nguyên Linh Dịch
白玉盘=Bạch Ngọc Bàn
三千幻叶藤=Tam Thiên Huyễn Diệp Đằng
青白双生蛇=Thanh Bạch Song Sinh Xà
圆觉峰=Viên Giác Phong
杜金宁=Đỗ Kim Ninh
米芽鬼尊=Mễ Nha Quỷ Tôn
灵鬼祖=Linh Quỷ Tổ
青黛=Thanh Đại
玄都鬼神陵=Huyền Đô Quỷ Thần Lăng
三阴山神=Tam Âm Sơn Thần
逆乱阴阳宝香=Nghịch Loạn Âm Dương Bảo Hương
青囊阴阳经=Thanh Nang Âm Dương Kinh
逆阴乱阳道光=Nghịch Âm Loạn Dương Đạo Quang
血鬼祖=Huyết Quỷ Tổ
至阳血果=Chí Dương Huyết Quả
北寒郡=Bắc Hàn Quận
落神沼泽=Lạc Thần Chiểu Trạch
神魂门=Thần Hồn Môn
韩复=Hàn Phục
黑白鸡=Hắc Bạch Kê
福龟=Phúc Quy
南道郡=Nam Đạo quận
朔望郡=Sóc Vọng quận
万魂小店=Vạn Hồn Tiểu Điếm
付店主=Phó Điếm Chủ
朱姓武者=Võ giả họ Chu
五大鬼神=Ngũ Đại Quỷ Thần
步津=Bộ Tân
万魂镇=Vạn Hồn Trấn
青白蛇妖=Thanh Bạch Xà Yêu
天罡神拳=Thiên Cương Thần Quyền
十八天剑=Thập Bát Thiên Kiếm
天剑星=Thiên Kiếm Tinh
黑云鬼神司=Hắc Vân Quỷ Thần Tư
阴阳两极神丹=Âm Dương Lưỡng Cực Thần Đan
三凝三散=Tam Ngưng Tam Tán
冰雪巨人符=Băng Tuyết Cự Nhân Phù
阴阳合和丹=Âm Dương Hợp Hòa Đan
灵台丹=Linh Đài Đan
衍丹书=Diễn Đan Thư
冰雪薇甜=Băng Tuyết Vi Điềm
天寒神木=Thiên Hàn Thần Mộc
冰极神晶=Băng Cực Thần Tinh
碧幽蛇=Bích U Xà
寒冰巨鳄=Hàn Băng Cự Ngạc
谢年=Tạ Niên
天级武馆=Thiên Cấp Võ Quán
冰原郡的霸主=Bá chủ của Băng Nguyên Quận
极冰神典=Cực Băng Thần Điển
冰天冻地寒霜道气=Băng Thiên Đống Địa Hàn Sương Đạo Khí
蓝霜果=Lam Sương Quả
昆仑山主=Côn Lôn Sơn Chủ
北方大草原=Bắc Phương Đại Thảo Nguyên
东周诸圣书院=Đông Chu Chư Thánh Thư Viện
天璇圣山=Thiên Toàn Thánh Sơn
天图王=Thiên Đồ Vương
天图祭祀=Thiên Đồ Tế Tự
胡腓=Hồ Phỉ
万相魔经=Vạn Tướng Ma Kinh
万相圣经=Vạn Tướng Thánh Kinh
付师弟=Phó sư đệ
獛师弟=Điền sư đệ
仇姓=Cừu Tính
付姓=Phó Tính
獛姓=Điền Tính
灭蝶=Diệt Điệp
哑蝶=Ách Điệp
天阳郡=Thiên Dương Quận
渡世道=Độ Thế Đạo
姜烟瑶=Khương Yên Dao
上古魔君=Thượng Cổ Ma Quân
隐空虚蚕=Ẩn Không Hư Tằm
人族三国=Nhân Tộc Tam Quốc
古与今=Cổ Dữ Kim
无边天墟=Vô Biên Thiên Khư
隐空虚蚕丝=Ẩn Không Hư Tằm Tơ
显灵水=Hiển Linh Thủy
显圣洗髓=Hiển Thánh Tẩy Tủy
无相魔经=Vô Tướng Ma Kinh
蒋灵=Tưởng Linh
麟羽=Lân Vũ
天璇神山=Thiên Toàn Thần Sơn
天图部落=Thiên Đồ Bộ Lạc
黑山大战=Hắc Sơn Đại Chiến
云江龙后=Vân Giang Long Hậu
拉嘎=Lạp Già
第一功德殿=Đệ Nhất Công Đức Điện
第二功德殿=Đệ Nhị Công Đức Điện
华玉丹=Hoa Ngọc Đan
灭生丹=Diệt Sinh Đan
普照灯=Phổ Chiếu Đăng
化影液=Hóa Ảnh Dịch
重影珠=Trùng Ảnh Châu
冥河水=Minh Hà Thủy
雨打芭蕉=Vũ Đả Ba Tiêu
仇凛=Cừu Lẫm
付横=Phó Hoành
獛甲=Bồ Giáp
玄都除魔榜=Huyền Đô Trừ Ma Bảng
端长老=Đoan trưởng lão
清风拂尘=Thanh Phong Phất Trần
驭妖环=Ngự Yêu Hoàn
仙梦丹=Tiên Mộng Đan
金刚发=Kim Cương Phát
六耳风=Lục Nhĩ Phong
金睛光=Kim Tình Quang
忘尘殿主尔木=Vong Trần Điện Chủ Nhĩ Mộc
第六内峰=Đệ Lục Nội Phong
春秋峰=Xuân Thu Phong
方远=Phương Viễn
韩束=Hàn Thúc
五光峰=Ngũ Quang Phong
云江君=Vân Giang Quân
碧霞峰=Bích Hà Phong
清辉山=Thanh Huy Sơn
万窟峰=Vạn Quật Phong
九阳拍卖会=Cửu Dương Phách Mại Hội
和娣=Hòa Đệ
武神果=Võ Thần Quả
龙凤和鸣玉璧=Long Phượng Hòa Minh Ngọc Bích
凤魂=Phượng Hồn
神圣龙凰=Thần Thánh Long Hoàng
真龙血魂石=Chân Long Huyết Hồn Thạch
飞星丹=Phi Tinh Đan
紫薇星力=Tử Vi Tinh Lực
太阴星力=Thái Âm Tinh Lực
阵道之灵=Trận Đạo Chi Linh
仙树秘境=Tiên Thụ Bí Cảnh
大地神脉=Đại Địa Thần Mạch
大地武神树=Đại Địa Võ Thần Thụ
阴阳之源=Âm Dương Chi Nguyên
玄法洞天福地=Huyền Pháp Động Thiên Phúc Địa
阴阳法光=Âm Dương Pháp Quang
秦都管=Tần Đô Quản
通幽花=Thông U Hoa
吴都管=Ngô Đô Quản
五灵玄光大阵=Ngũ Linh Huyền Quang Đại Trận
阴阳不灭真经=Âm Dương Bất Diệt Chân Kinh
阴阳万劫真经=Âm Dương Vạn Kiếp Chân Kinh
补天藤=Bổ Thiên Đằng
羽化峰=Vũ Hóa Phong
渊峰=Uyên Phong
圣光镜=Thánh Quang Kính
白虎煞魂=Bạch Hổ Sát Hồn
天雷印=Thiên Lôi Ấn
白虎踏月=Bạch Hổ Đạp Nguyệt
太阴星神=Thái Âm Tinh Thần
紫薇星神=Tử Vi Tinh Thần
金古桥=Kim Cổ Kiều
龙虎榜=Long Hổ Bảng
苏家族峰=Tô Gia Tộc Phong
齐氏三兄弟=Tề Thị Tam Huynh Đệ
丹君=Đan Quân
通天花=Thông Thiên Hoa
天圣还魂液=Thiên Thánh Hoàn Hồn Dịch
战神血脉=Chiến Thần Huyết Mạch
元气晶=Nguyên Khí Tinh
玄法命符=Huyền Pháp Mệnh Phù
塑命丹=Tố Mệnh Đan
阴阳两极返命神丹=Âm Dương Lưỡng Cực Phản Mệnh Thần Đan
冰原郡=Băng Nguyên Quận
玄法洗礼=Huyền Pháp Tẩy Lễ
四灵天=Tứ Linh Thiên
生灭气=Sinh Diệt Khí
无神无我=Vô Thần Vô Ngã
渡宇步=Độ Vũ Bộ
天转地翻=Thiên Chuyển Địa Phiên
原始古地=Nguyên Thủy Cổ Địa
古州=Cổ Châu
不动金刚=Bất Động Kim Cang
天源道人=Thiên Nguyên Đạo Nhân
天源阵经=Thiên Nguyên Trận Kinh
天霞雪泉=Thiên Hà Tuyết Tuyền
寒原郡=Hàn Nguyên Quận
真血尊者=Chân Huyết Tôn Giả
敖寒=Ngao Hàn
冰原郡蒋家=Băng Nguyên Quận Tưởng Gia
极冰门=Cực Băng Môn
素天女=Tố Thiên Nữ
道魔子=Đạo Ma Tử
傀神之力=Khôi Thần Chi Lực
净焰峰=Tịnh Diệm Phong
守陵老人=Thủ Lăng Lão Nhân
玄都宝山=Huyền Đô Bảo Sơn
阴阳地火=Âm Dương Địa Hỏa
龙命草=Long Mệnh Thảo
净浊莲=Tịnh Trược Liên
圣火石=Thánh Hỏa Thạch
地神丹=Địa Thần Đan
金刚果=Kim Cương Quả
伏笝花=Phục Nạp Hoa
阵元石=Trận Nguyên Thạch
天律殿主=Điện chủ Thiên Luật Điện
韩具=Hàn Cụ
仙客峰=Tiên Khách Phong
沈鱼=Thẩm Ngư
冷辉仙子=Lãnh Huy Tiên Tử
云龙市=Vân Long Thị
龙君宴=Long Quân Yến
白卒路=Bạch Tốt Lộ
承望郡=Thừa Vọng Quận
九阳墟=Cửu Dương Khư
雪人族=Tuyết Nhân Tộc
虚空之鲲=Hư Không Chi Côn
真龙门=Chân Long Môn
九五前殿=Cửu Ngũ Tiền Điện
地尸宗=Địa Thi Tông
六极神光=Lục Cực Thần Quang
云虹果=Vân Hồng Quả
北圣派=Bắc Thánh Phái
纳风尊者=Nạp Phong Tôn Giả
白卒小市=Bạch Tốt Tiểu Thị
冥古神殿=Đền Minh Cổ
五圣诛邪大阵=Ngũ Thánh Tru Tà Đại Trận
冰泉尊者=Băng Tuyền Tôn Giả
玉池圣山=Ngọc Trì Thánh Sơn
冰泉兽尊=Băng Tuyền Thú Tôn
俗佛=Tục Phật
弥渡=Di Độ
恶山=Ác Sơn
古傀路=Cổ Khôi Lộ
北江郡=Bắc Giang Quận
大力金刚寺=Đại Lực Kim Cương Tự
金圣道树=Kim Thánh Đạo Thụ
冥古郡=Minh Cổ Quận
双头犬兽尊=Song Đầu Khuyển Thú Tôn
金阳神傀=Kim Dương Thần Khôi
尹幸=Doãn Hạnh
天图王部=Thiên Đồ Vương Bộ
周皇室=Chu Hoàng Thất
黄泉之龙=Hoàng Tuyền Chi Long
黄泉宝丹=Hoàng Tuyền Bảo Đan
乙玄神船=Ất Huyền Thần Thuyền
丙玄神船=Bính Huyền Thần Thuyền
宁菀=Ninh Uyển
曹伏=Tào Phục
雪山城=Tuyết Sơn Thành
万星交易会=Vạn Tinh Giao Dịch Hội
易宝阁=Dịch Bảo Các
葬古大沙漠=Táng Cổ Đại Sa Mạc
晋司马氏=Tấn Tư Mã Thị
晋世家宗门=Tấn Thế Gia Tông Môn
石曦=Thạch Hi
甲辰号=Giáp Thìn hiệu
甲卯号=Giáp Mão hiệu
山灵液=Sơn Linh Dịch
通元尊者=Thông Nguyên Tôn Giả
甲卯包厢=Bao sương Giáp Mão
万星城=Vạn Tinh Thành
浩然长明灯=Hạo Nhiên Trường Minh Đăng
雪桂=Tuyết Quế
阴阳洞=Âm Dương Động
天赐秘力=Thiên Tứ Bí Lực
天赐谷=Thiên Tứ Cốc
风雪谷=Phong Tuyết Cốc
三尺飘雪辰宁=Tam Xích Phiêu Tuyết Thần Ninh
天圣派=Thiên Thánh Phái
烈焰星神周清=Liệt Diễm Tinh Thần Chu Thanh
辰宁=Thần Ninh
福星高照=Phúc Tinh Cao Chiếu
阴现云=Âm Hiện Vân
风无己=Phong Vô Kỷ
叶功=Diệp Công
墨姨=Mặc Di
沈副观主=Thẩm phó quan chủ
万煞炼魂术=Vạn Sát Luyện Hồn thuật
青黛珠=Thanh Đại Châu
功德峰=Công Đức phong
第八真传=Đệ Bát Chân Truyền
甲玄神船=Giáp Huyền Thần Thuyền
大齐国教=Đại Tề Quốc Giáo
戴劲=Đái Kính
灰骨山脉=Hôi Cốt Sơn Mạch
大齐天鹰军=Đại Tề Thiên Ưng Quân
大千仙树=Đại Thiên Tiên Thụ
寒雪盛会=Hàn Tuyết Thịnh Hội
定光鹰=Định Quang Ưng
定灵之光=Định Linh Chi Quang
蛮鹫=Man Thứu
玄藤神甲=Huyền Đằng Thần Giáp
焚寂弓=Phần Tịch Cung
蛮鹫军=Man Thứu Quân
大千仙树观想法=Đại Thiên Tiên Thụ Quan Tưởng Pháp
天地冰湖=Thiên Địa Băng Hồ
古挞=Cổ Thát
小青湖=Tiểu Thanh Hồ
呼克=Hô Khắc
凛寒=Lẫm Hàn
月敕=Nguyệt Sắc
张信空=Trương Tín Không
韩铁林=Hàn Thiết Lâm
周智深=Chu Trí Thâm
漠古将部=Mạc Cổ Tướng Bộ
天子山河剑=Thiên Tử Sơn Hà Kiếm
西齐=Tây Tề
曦姐姐=Hy tỷ tỷ
须卜阿提拉=Tu Bặc A Đề Lạp
漠古部落=Mạc Cổ Bộ Lạc
曼吥=Mạn Phả
漠古祭祀=Mạc Cổ Tế Tự
横宇船=Hoành Vũ Thuyền
无上星神三叩首=Vô Thượng Tinh Thần Tam Khấu Thủ
万河养魂液=Vạn Hà Dưỡng Hồn Dịch
小天武丹=Tiểu Thiên Vũ Đan
阴灵土=Âm Linh Thổ
血煞神晶=Huyết Sát Thần Tinh
天杀仙石=Thiên Sát Tiên Thạch
落霞冰原=Lạc Hà Băng Nguyên
天星液=Thiên Tinh Dịch
天星碎片=Thiên Tinh Toái Phiến
重苍=Trọng Thương
脱胎丹=Thoát Thai Đan
六极战船=Lục Cực Chiến Thuyền
东周亚圣=Đông Chu Á Thánh
万星商主=Vạn Tinh Thương Chủ
紫霄天君=Tử Tiêu Thiên Quân
苍胤王=Thương Dận Vương
漠古=Mạc Cổ
赵利=Triệu Lợi
韩珊珊=Hàn San San
黄泉境=Hoàng Tuyền Cảnh
造化壶=Hồ Tạo Hóa
安息古棺=Quan tài cổ An Tức
异兽分身=Dị Thú Phân Thân
紫霄城=Tử Tiêu Thành
傀宗=Khôi Tông
玄都丹君=Huyền Đô Đan Quân
涅槃骨=Niết Bàn Cốt
神农谷=Thần Nông Cốc
山海域=Sơn Hải Vực
乱妖界=Loạn Yêu Giới
岁帝=Tuế Đế
天神道体=Thiên Thần Đạo Thể
天武学原始战体=Thiên Võ Học Nguyên Thủy Chiến Thể
通风猕猴髓法=Thông Phong Mị Hầu Tủy Pháp
山水寺=Sơn Thủy Tự
天母教=Thiên Mẫu Giáo
灵育大师=Linh Dục đại sư
灵惠首座=Linh Huệ thủ tọa
圆法师伯=Viên Pháp sư bá
那剋觉明佛=Na Khắc Giác Minh Phật
寒风老道=Hàn Phong Lão Đạo
龙境神域=Long Cảnh Thần Vực
玉应=Ngọc Ứng
玄法郡=Huyền Pháp Quận
冥古神山=Minh Cổ Thần Sơn
法真=Pháp Chân
寒风道人=Hàn Phong Đạo Nhân
龙境山神=Long Cảnh Sơn Thần
龙境山=Long Cảnh Sơn
元气魔=Nguyên Khí Ma
远山郡=Viễn Sơn Quận
灵育方丈=Linh Dục Phương Trượng
龙境县=Long Cảnh Huyện
圆法=Viên Pháp
水源道观=Thủy Nguyên Đạo Quán
那剋寺=Na Khắc Tự
甘霖符=Cam Lâm Phù
诸圣书院=Chư Thánh Thư Viện
太上三化=Thái Thượng Tam Hóa
承道峰=Thừa Đạo Phong
放置栏=Phóng Trí Lan
云江龙君=Vân Giang Long Quân
阳腾=Dương Đằng
灵阳湖=Linh Dương Hồ
万血灵花=Vạn Huyết Linh Hoa
境海三龙=Cảnh Hải Tam Long
小青小白=Tiểu Thanh Tiểu Bạch
雪龙族=Tuyết Long Tộc
水元盛会=Thủy Nguyên Thịnh Hội
龟勉=Quy Miễn
缙媃=Tấn Nhu
缙雎=Tấn Tư
境海龙宫=Cảnh Hải Long Cung
李灵秀=Lý Linh Tú
蛟孤=Giao Cô
蛟河=Giao Hà
镜我=Kính Ngã
云江龙宫=Vân Giang Long Cung
寒云别府=Hàn Vân Biệt Phủ
云江=Vân Giang
回元商会=Hồi Nguyên Thương Hội
双星镜=Song Tinh Kính
齐白氏=Tề Bạch Thị
蒋密=Tưởng Mật
天断台=Thiên Đoạn Đài
星河峰=Tinh Hà Phong
曹茵茵=Tào Nhân Nhân
齐云渊=Tề Vân Uyên
先天剑体=Tiên Thiên Kiếm Thể
仙衍天杀石=Tiên Diễn Thiên Sát Thạch
素真宫=Tố Chân Cung
太素玄真图=Thái Tố Huyền Chân Đồ
素真圣女=Tố Chân Thánh Nữ
六合仙莲印=Lục Hợp Tiên Liên Ấn
六极仙莲印=Lục Cực Tiên Liên Ấn
诸葛祖师=Gia Cát Tổ Sư
玄玄子祖师=Huyền Huyền Tử Tổ Sư
小祈=Tiểu Kỳ
境海流光域=Cảnh Hải Lưu Quang Vực
化神峰=Hóa Thần Phong
炼血窟=Luyện Huyết Quật
寒州龙虎榜=Hàn Châu Long Hổ Bảng
天杀剑=Thiên Sát Kiếm
元磁精石=Nguyên Từ Tinh Thạch
五灵铁=Ngũ Linh Thiết
原血期=Nguyên Huyết Kỳ
平天牛魔=Bình Thiên Ngưu Ma
覆海蛟魔=Phúc Hải Giao Ma
承道殿=Thừa Đạo Điện
六道轮回功=Lục Đạo Luân Hồi Công
龙凤大化=Long Phượng Đại Hóa
尘光剑=Trần Quang Kiếm
玄玉甲=Huyền Ngọc Giáp
定天弓=Định Thiên Cung
天灵法剑=Thiên Linh Pháp Kiếm
不动神钟=Bất Động Thần Chung
天命宗=Thiên Mệnh Tông
登仙殿=Đăng Tiên Điện
白若月=Bạch Nhược Nguyệt
太白武馆=Thái Bạch Võ Quán
黑山圣地=Hắc Sơn Thánh Địa
玄都祖师=Huyền Đô Tổ sư
黑山山神=Hắc Sơn Sơn Thần
天武学=Thiên Vũ Học
先天法体=Tiên Thiên Pháp Thể
真血武者=Chân Huyết Võ Giả
彻地境=Triệt Địa Cảnh
玄法净土=Huyền Pháp Tịnh Thổ
黄金叶=Hoàng Kim Diệp
黄金古叶=Hoàng Kim Cổ Diệp
原始战体=Nguyên Thủy Chiến Thể
黄泉彻地=Hoàng Tuyền Triệt Địa
碧落通天=Bích Lạc Thông Thiên
天门关=Thiên Môn Quan
静虚祖师=Tĩnh Hư Tổ Sư
葬古沙漠=Táng Cổ Sa Mạc
水月峰主=Thủy Nguyệt Phong chủ
圣命莲=Thánh Mệnh Liên
玄法群山=Huyền Pháp Quần Sơn
阴神真血境=Âm Thần Chân Huyết Cảnh
碧落通天境=Bích Lạc Thông Thiên Cảnh
同尘石=Đồng Trần Thạch
十地心乳=Thập Địa Tâm Nhũ
十地宝液=Thập Địa Bảo Dịch
福地之血=Phúc Địa Chi Huyết
恒心道人=Hằng Tâm Đạo Nhân
静虚山=Tĩnh Hư Sơn
静虚山主=Tĩnh Hư Sơn Chủ
琉璃心力=Lưu Ly Tâm Lực
真传宫=Chân Truyền Cung
玄都观主=Huyền Đô Quan Chủ
千老=Thiên lão
阴神境=Âm Thần Cảnh
鬼神司=Quỷ Thần Tư
蛮族王庭=Man Tộc Vương Đình
万法峰=Vạn Pháp Phong
鬼居=Quỷ Cư
水月峰=Thủy Nguyệt Phong
宋东辰=Tống Đông Thần
玄法山=Huyền Pháp Sơn
诸葛通达=Gia Cát Thông Đạt
沈愿宁=Thẩm Nguyện Ninh
长留道人=Trường Lưu Đạo Nhân
碧落境=Bích Lạc Cảnh
扶风真君=Phù Phong Chân Quân
诸葛英月=Gia Cát Anh Nguyệt
青黛鬼祖=Thanh Đại Quỷ Tổ
石易=Thạch Dịch
吕圆圆=Lữ Viên Viên
寒苦城=Hàn Khổ Thành
万星商会=Vạn Tinh Thương Hội
寒苦集=Hàn Khổ Tập
三主市=Tam Chủ Thị
洛琉璃=Lạc Lưu Li
剑一派=Kiếm Nhất Phái
天杀剑器图=Thiên Sát Kiếm Khí Đồ
天月郡=Thiên Nguyệt Quận
驭剑道人=Ngự Kiếm Đạo Nhân
地火印=Địa Hỏa Ấn
鬼神陵=Quỷ Thần Lăng
九幽神火=Cửu U Thần Hỏa
敖玄薇=Ngao Huyền Vi
陆清墨=Lục Thanh Mặc
黑云镇=Hắc Vân Trấn
境海=Cảnh Hải
齐境=Tề Cảnh
太白剑=Thái Bạch Kiếm
六灵傀=Lục Linh Khôi
八龙佛火=Bát Long Phật Hỏa
睡佛山=Thụy Phật Sơn
阴阳而火=Âm Dương Nhi Hỏa
戮仙剑域=Lục Tiên Kiếm Vực
五行法界=Ngũ Hành Pháp Giới
紫红玉符=Tử Hồng Ngọc Phù
天雷地火印=Thiên Lôi Địa Hỏa Ấn
觉闻=Giác Văn
古境宗=Cổ Cảnh Tông
阎浮圣界=Diêm Phù Thánh Giới
三灵之阵=Tam Linh Chi Trận
天地浩然剑=Thiên Địa Hạo Nhiên Kiếm
阙境郡=Khuyết Cảnh Quận
天极凰翼=Thiên Cực Hoàng Dực
天相寺=Thiên Tướng Tự
天龙相=Thiên Long Tướng
五鬼毒阴煞火=Ngũ Quỷ Độc Âm Sát Hỏa
阙境郡城=Khuyết Cảnh Quận Thành
天月郡城=Thiên Nguyệt Quận Thành
安琅=An Lang
天行神舟=Thiên Hành Thần Châu
重苍鼎=Trọng Thương Đỉnh
黄泉彻地境=Hoàng Tuyền Triệt Địa Cảnh
八部天龙护法道=Bát Bộ Thiên Long Hộ Pháp Đạo
