三十六骑=ba mươi sáu kỵ
三十年内力=ba mươi năm nội lực
不死不伤=bất tử bất thương
两个通缉犯=hai tên tội phạm bị truy nã
中意之人=vừa ý người
云州之大侠=Vân Châu đại hiệp
五年内力=năm năm nội lực
充当免费=sung làm miễn phí
剑宗的弟子=kiếm tông đệ tử
剑鞘=vỏ kiếm
去那些= đi những kia
向前扑倒=ngã nhào ra trước
在云端=trên đám mây
在原著=tại nguyên tác
如风中柳絮=như tơ lụa trong gió
定风波=định phong ba
宣亲王=Tuyên Thân Vương
宣王府=Tuyên Vương Phủ
就是靠=chính là dựa vào
层层覆盖=tầng tầng bao trùm
平安落地=hạ cánh an toàn
所中意=vừa ý
手中的剑鞘=vỏ kiếm trong tay
把控=khống chế
无人生还=không ai sống sót
有数了=nắm chắc
栽了大跟斗=thua lớn
此人的一生=người này khi còn sống
武尊毕玄=Võ Tôn Tất Huyền
死不死活不活=chết không chết, sống không sống
死不死活不活的=chết không chết, sống không sống
算尽天机=tính tận thiên cơ
结了怨=kết oán
这会儿=lúc này
金玉淬火=Kim Ngọc Thối Hỏa
顾大宗师=Cố đại tông sư