Lisa姐=Lisa tỷ
M4尾翼稳定贫铀穿甲弹=Đạn xuyên giáp ổn định cánh đuôi M4 bằng uranium nghèo
M87光线=Tia M87
M87至尊佛光=M87 Chí Tôn Phật Quang
TPC远东总部=Tổng bộ Viễn Đông TPC
X战警：第一战=X-Men: Thế Hệ Đầu Tiên
babobo一族=Tộc Babobo
baboo一族=bộ tộc Baboo
baboo族=Tộc Baboo
baboo星球=Tinh cầu Baboo
一阳神功=Nhất Dương Thần Công
丁香花粉=Bột đinh hương
七侠虹猫=Thất Hiệp Hồng Miêu
七剑合璧=Thất Kiếm Hợp Bích
万寿王=Vạn Thọ Vương
万相仙人=Vạn Tướng Tiên Nhân
万载泪泉=Vạn Tải Lệ Tuyền
三分教场=Tam Phân Giáo Trường
三十三天神力=Tam Thập Tam Thiên Thần Lực
三摩地=Tam Ma Địa
三连城=Tam Liên Thành
三首万相=Tam Thủ Vạn Tướng
上主=Thượng Chủ
上主梵天=Thượng Chủ Phạm Thiên
上主那罗延=Thượng Chủ Narayana
上单狗头=Đường trên Đầu Chó
不喜欢看书的我又来了=Tôi không thích đọc sách lại đến rồi
不幸女神【耶瑟陀】=Nữ thần bất hạnh [Yeshetha]
不死苏摩=Bất Tử Tô Ma
专职消防员=Lính cứu hỏa chuyên trách
世尊大梵天=Thế Tôn Đại Phạm Thiên
世尊梵天=Thế Tôn Phạm Thiên
业果神=Nghiệp Quả Thần
业果神娑尼=Nghiệp Quả Thần Sa Ni
东光国=Đông Quang Quốc
东弗婆提=Đông Phất Bà Đề
东弗婆提洲=Đông Phất Bà Đề Châu
东方神乞=Đông Phương Thần Khất
东杜毗=Đông Đỗ Tì
东瀛四岛=Bốn đảo Đông Doanh
东瀛宣化号=Đông Doanh Tuyên Hóa Hiệu
东瀛紫气宗=Đông Doanh Tử Khí Tông
两个就可=hai cái liền có thể
两人目=hai người mắt
两师兄弟=hai sư huynh đệ
中苏=Trung Tô
丹巴=Đan Ba
久良良岛屿=Cửu Lương Lương Đảo
之至阴=chí âm
乌格罗坦瓦=Ugrotanva
乌格罗迦=Ugroka
乌玛=Uma
乌辫若旋釜，恒河溅玉飞！=Ô biện nhược toàn phủ, Hằng hà tiên ngọc phi!
乌鲁鲁巨岩=Uluru Cự Nham
乌龟大师=Sư phụ Rùa
乔斯图跋=Jostubha
乔斯图跋宝石=Jewel Kaustubha
乔答摩=Gautama
乔答摩仙人=Kiều Đáp Ma tiên nhân
九空为一念，九空无界是意念的世界，在这里可以能外界之不能=Cửu Không Vi Nhất Niệm, Cửu Không Vô Giới Thị Ý Niệm Đích Thế Giới, Tại Giá Lý Khả Dĩ Năng Ngoại Giới Chi Bất Năng
九阳大霹雳=Cửu Dương Đại Phích Lịch
乾坤任我行=Càn Khôn Nhậm Ngã Hành
乾皇=Càn Hoàng
乾达摩陀那山=Càn Đạt Ma Đà Na Sơn
了他的心脏=hắn tâm tạng
二分时代=Nhị Phân Thời Đại
云无常=Vân Vô Thường
云神——娑罗尼尤=Vân Thần - Sāraṇyū
云神娑罗尼尤=Vân Thần Toa La Ni Vưu
云蝠=Vân Bức
云蝠军团=Vân Bức Quân Đoàn
云蝠盾=Vân Bức Thuẫn
云蝠神=Vân Bức Thần
云蝠阵=Vân Bức trận
云霆=Vân Đình
五子阿修罗=Ngũ Tử A Tu La
五行先天功=Ngũ Hành Tiên Thiên Công
五行忍者=Ngũ Hành Nhẫn Giả
五行晶石=Ngũ Hành Tinh Thạch
五行领域=Ngũ Hành Lĩnh Vực
五通庙=Ngũ Thông miếu
五通邪神=Ngũ Thông Tà Thần
五通镇=Ngũ Thông trấn
五雷化极手=Ngũ Lôi Hóa Cực Thủ
亚克迪斯号=Tàu Yacdes
亚拉伦拉府=Government House
亚穆纳河=Yamuna
亡月劫=Vong Nguyệt Kiếp
亲娘舅=cậu ruột
人狮=Nhân Sư
人狮那罗辛哈=Nhân Sư Na La Tân Ha
他生渡=Tha Sinh Độ
仙剑的世界=Thế giới Tiên Kiếm
仙风云体术=Tiên Phong Vân Thể Thuật
伊卡将军=Tướng quân Yka
伊罗=Ila
伏斯亚=Phục Tư Á
伏斯亚人=Người Exif
伐兰妮=Phạt Lan Ni
伐摩那=Phạt Ma Na
伐楼那=Phạt Lâu Na
伐楼那之力=Phạt Lâu Na Chi Lực
伐楼那天=Phạt Lâu Na Thiên
伐樓那=Varuna
伐由=Phạt Do
伐由之力=Phạt Do Chi Lực
伐由天=Phạt Do Thiên
众友=Chúng Hữu
众友仙人=Chúng Hữu Tiên Nhân
众生由我灭=Chúng Sinh Do Ngã Diệt
众车苑=Chúng Xa Uyển
优多摩=Ưu Đa Ma
优多摩仙人=Ưu Đa Ma Tiên Nhân
伽亭=Già Đình
伽内什=Già Nội Thập
伽奢南=Già Xa Nam
伽奢南达=Già Xa Nam Đà
伽旃延妮=Già Chiên Diên Ni
伽旃延那=Già Chiên Diên Na
伽罗尼米=Già La Ni Mễ
伽陀神杵=Gada Thần Xử
伽陀神锤=Chùy Gada
佐斯星系=Hệ sao Zoss
俏小龙=Tiếu Tiểu Long
俱卢之野=Câu Lư Chi Dã
俱卢族=Kaurava
倩女世界=Thế giới Thiện Nữ
倩女幽魂世界=Thế giới Thiện Nữ U Hồn
傲剑山庄=Ngạo Kiếm Sơn Trang
僧皇=Tăng Hoàng
元极摩柯无量=Nguyên Cực Ma Kha Vô Lượng
元正长老=Nguyên Chính trưởng lão
元空灭=Nguyên Không Diệt
元空间=Nguyên Không Gian
先天之法=Tiên Thiên chi pháp
光之国=Quốc gia Ánh sáng
光头强哥=Quang Đầu Cường Ca
克劳恰=Khắc Lao Xa
克里莫斯群岛=Quần đảo Kremos
全胜祭=Toàn Thắng Tế
八大不死神明=Bát Đại Bất Tử Thần Minh
八大恶魔=Bát Đại Ác Ma
八大恶魔篇=Bát Đại Ác Ma Thiên
八大魔气=Bát Đại Ma Khí
八大魔气篇=Bát Đại Ma Khí Thiên
八尾博士=Tiến sĩ Yawei
六勾玉轮回眼=Lục Câu Ngọc Luân Hồi Nhãn
六阳魁首=Lục Dương Khôi Thủ
兰巴=Lamba
兰巴阿修罗=Lan Ba A Tu La
兰帕尔特光弹=Đạn Ánh Sáng Rampart
兽主=Thú Chủ
兽主法宝=Thú Chủ Pháp Bảo
冲绳色=Màu Okinawa
冷胭=Lãnh Yên
净化天使=Tịnh Hóa Thiên Sứ
净流=Tịnh Lưu
凌云十八骑=Lăng Vân Thập Bát Kỵ
凌霄神殿=Lăng Tiêu Thần Điện
凤兮凤兮归故乡=Phượng hề phượng hề quy cố hương
凤凰大典=Phượng Hoàng Đại Điển
凤舞天际=Phượng Vũ Thiên Tế
刀龙=Đao Long
创界山=Sáng Giới Sơn
利吉迦=Lợi Cát Ca
利吉迦仙人=Lợi Cát Già Tiên Nhân
刺刃团=Thứ Nhận Đoàn
刺猬大师=Sư phụ Nhím
剑岳=Kiếm Nhạc
剑扫乾坤=Kiếm Tảo Càn Khôn
剑蝎=Kiếm Hạt
剑蝎纵横行=Kiếm Hạt Túng Hoành Hành
力量之主=Lực Lượng Chi Chủ
功夫熊猫世界=Thế giới Kungfu Panda
加州金色=Màu vàng California
加库玛贝塔=Gia Khố Mã Bối Tháp
加库玛阿尔法=Gia Khố Mã An Nhĩ Pháp
劫末之火=Kiếp Mạt Chi Hỏa
劫王=Kiếp Vương
勇莲=Dũng Liên
北俱卢=Bắc Câu Lô
北方冰原=Bắc Phương Băng Nguyên
北海幼儿园=Bắc Hải Nhà trẻ
北饮狂刀聂人王=Bắc Ẩm Cuồng Đao Nhiếp Nhân Vương
匠神=Tượng Thần
匠神毗首羯磨=Vishwakarma
十二星座战士=Thập Nhị Tinh Tọa chiến sĩ
十二星座装甲=Thập Nhị Cung Tinh Tọa Trang Giáp
十二生肖动物=Thập Nhị Sinh Tiếu Động Vật
十二生肖动物篇=Thập Nhị Sinh Tiếu Động Vật Thiên
十二符咒=Thập Nhị Phù Chú
十大气忍=Thập Đại Khí Nhẫn
十字戏=Thập Tự Hí
十车=Thập Xa
十车王=Dasharatha
十里画廊=Thập Lí Họa Lang
十首=Thập Thủ
十首罗刹=Thập Thủ La Sát
十首罗波那=Thập Thủ La Bà Na
千年僵尸王=Thiên Niên Cương Thi Vương
千年老树妖=Thiên Niên Lão Thụ Yêu
千眼的大神=Vị thần ngàn mắt
千首蛇王舍沙=Thiên Thủ Xà Vương Xá Sa
华丽贵族=Hoa Lệ Quý Tộc
南儋部州=Jambudvipa
南无初代奥特曼至尊佛=Nam mô Sơ Đại Ultraman Chí Tôn Phật
南无奥特佛之父=Nam mô Ultraman Chi Phụ
南无希瓦=Namo Shivaya
南无沙福林佛=Nam mô Sa Phước Lâm Phật
南无迪迦古佛=Nam mô Địch Gia Cổ Phật
南笛=Nam Địch
南阎浮提=Nam Diêm-phù-đề
南阎浮提州=Nam Diêm Phù Đề Châu
南阎浮提洲=Nam Diêm Phù Đề Châu
南麟剑首断帅=Nam Lân Kiếm Thủ Đoạn Soái
卡尼拉=Tạp Ni Lạp
卡拉法尔大帝=Karafar Đại Đế
卡玛苏尔=Tạp Mã Tô Nhĩ
卢茜尼=Lư Tây Ni
卢西檀=Lư Tây Đàn
友邻=Hữu Lân
友邻王=Hữu Lân Vương
双子飞碟=Song Tử Phi Điệp
双马童=Song Mã Đồng
双马童天=Song Mã Đồng Thiên
双鱼判官=Song Ngư Phán Quan
变种人黑皇=Dị nhân Black King
古兰斯菲亚=Goulud Sphire
古姜国=Cổ Khương Quốc
古昔仙人=Gu Xi Xianren
古藤林=Cổ Đằng Lâm
古鲁达=Guruda
右国师府=Hữu Quốc Sư phủ
合成兽达兰比尔=Quái thú tổng hợp Daranbir
吉什金陀=Kishkindha
吉古罗=Cát Cổ La
吉吉迦=Kikasa
吉提迦=Cát Đề Ca
吉祥之音=Âm thanh cát tường
吉祥女神=Cát Tường Nữ Thần
吉纲参谋=Tham mưu trưởng Yoshitsugu
吉纲参谋长=Tham mưu trưởng Kitsuna
吉罗娑=Cát La Sa
吐浑=Tuhan
吠琉璃=Phệ Lưu Li
吠陀女神=Nữ thần Veda
吠陀守护者=Người bảo vệ Veda
吠陀守护者因陀罗=Thần Indra Người bảo vệ Veda
吠陀智人=Phệ Đà Trí Nhân
周瑟=Chu Sắt
和平谷=Thung lũng Hòa Bình
咒蓝=Chú Lam
哈奴曼耆特=Hanuman
哈姆萨=Hamsa
哈斯底=Hastin
哈维拉塞尔=Harvey Russell
哈马行星=Hành tinh Hama
哑女=cô gái câm
哥布纽=Gobu Nu
唯敬=Duy Kính
唯清=Duy Thanh
商吉婆尼=Sanjivani
商吉婆尼之咒=Thương Cát Bà Ni Chi Chú
商吉婆尼咒=Chú Thương Cát Bà Ni
商波尊=Shambhu
商波罗=Shambala
啊尔何求=A Nhĩ Hà Cầu
善心之甲=Thiện Tâm Chi Giáp
善恶平衡器=Thiện Ác Bình Hành Khí
善见城=Thiện Kiến Thành
喜天仙人=Hỷ Thiên Tiên Nhân
喜林苑=Hỷ Lâm Uyển
喵绅士=Miêu thân sĩ
嗡拿马西瓦=Om Namah Shivaya
四大瑞兽=Tứ Đại Thụy Thú
四天玄男=Tứ Thiên Huyền Nữ
四方魔渡行=Tứ Phương Ma Độ Hành
四部吠陀=Tứ Bộ Vệ Đà
回元血手=Hồi Nguyên Huyết Thủ
因陀罗之弓=Cung Indra
因陀罗之矢=Mũi tên Indra
因陀罗之轮=Luân xa của Indra
因陀罗尼=Nhân Đà La Ni
因陀罗尼耶=Indraniye
因陀罗耆特=Nhân Đà La Kỳ Đặc
土忍者=Thổ Ninja
土魔兽=Thổ Ma Thú
圣主符咒=Thánh Chủ Phù Chú
圣城迦尸=Thánh Thành Ca Thi
圣心功=Thánh Tâm Công
圣心真气=Thánh Tâm Chân Khí
圣灵披风=Thánh Linh Phi Phong
圣辉星云=Tinh vân Thánh Huy
地心之谷=Địa Tâm Chi Cốc
地极摩诃无量=Địa Cực Ma Kha Vô Lượng
地母昔弥=Địa Mẫu Tích Di
地球和平联合组织=Tổ chức Liên hợp Hòa bình Trái Đất
地魁=Địa Khôi
坦达瓦=Tandava
埃尔斯巨岩=Tảng đá khổng lồ Els
城堡破坏者=Kẻ Phá Hoại Thành Trì
基加哥布纽=Giga Gebonew
基里艾洛德之神=Thần Kirieloid
基里艾洛德预言家=Nhà tiên tri Kiri-elod
塞巴斯蒂安—肖=Sebastian Shaw
塞巴斯蒂安肖=Sebastian Shaw
塞迪克科技公司=Công ty Khoa học Kỹ thuật Sedic
壳生女神=Xác Sinh Nữ Thần
夕瑶玄女=Tịch Dao Huyền Nữ
多刹迦=Đa Sát Ca
夜凌云=Dạ Lăng Vân
夜枭子=Dạ Kiêu Tử
夜柔吠陀=Yajurveda
大力猫=Đại Lực Miêu
大力神发射井=Giếng phóng Đại Lực Thần
大力罗摩=Đại Lực La Ma
大哥斯拉=Đại Godzilla
大地女神昔弥=Đại Địa Nữ Thần Tích Di
大天=Đại Thiên
大天之子=Đại Thiên Chi Tử
大天湿婆=Đại Thiên Shiva
大天生子=Đại Thiên Sinh Tử
大自然灵心=Đại Tự Nhiên Linh Tâm
大迦那主=Đại Ca Na Chủ
大黑暗天=Đại Hắc Ám Thiên
大黑暗天法象=Đại Hắc Ám Thiên Pháp Tượng
大黑虎佛=Đại Hắc Hổ Phật
天使光环=Thiên Sứ Quang Hoàn
天兵队长=Đội trưởng Thiên Binh
天命圣教=Thiên Mệnh Thánh Giáo
天帝伏羲=Thiên Đế Phục Hy
天帝因陀罗=Thiên Đế Indra
天帝神殿=Thiên Đế Thần Điện
天帝阿耆尼=Thiên Đế Agni
天悬白练=Thiên Huyền Bạch Luyện
天授海螺=Thiên Thụ Hải Loa
天池十二杀手=Thiên Trì Thập Nhị Sát Thủ
天狼堂=Thiên Lang Đường
天狼法杖=Thiên Lang Pháp Trượng
天狼神功=Thiên Lang Thần Công
天狼门=Thiên Lang Môn
天玄神刃=Thiên Huyền Thần Nhận
天界判官=Thiên Giới Phán Quan
天界法庭=Thiên Giới Pháp Đình
天界警备队=Thiên Giới Cảnh Bị Đội
天神星乐园化计划=Kế hoạch Lạc Viên hóa Thiên Thần Tinh
天神星防护罩=Thiên Thần Tinh Phòng Hộ Tráo
天秤判官=Thiên Xứng Phán Quan
天空魔=Thiên Không Ma
天蛇杖=Thiên Xà Trượng
天门观想法=Thiên Môn Quan Tưởng Pháp
天音老人=Thiên Âm lão nhân
天音谷=Thiên Âm Cốc
天音门=Thiên Âm Môn
天香公主=Thiên Hương Công Chúa
天魔三噬=Thiên Ma Tam Phệ
天魔之刃=Thiên Ma Chi Nhận
天魔九噬=Thiên Ma Cửu Phệ
天魔乱舞大法=Thiên Ma Loạn Vũ Đại Pháp
天魔六欲五行破灭大混洞妙法=Thiên Ma Lục Dục Ngũ Hành Phá Diệt Đại Hỗn Động Diệu Pháp
天魔国=Thiên Ma Quốc
天魔大化=Thiên Ma Đại Hóa
天魔大霹雳=Thiên Ma Đại Phích Lịch
天魔女葵羽=Thiên Ma Nữ Quỳ Vũ
太古魔兽=Thái Cổ Ma Thú
太白仙人=Thái Bạch tiên nhân
太白老爹=Thái Bạch Lão Đệ
太阳神甲=Thái Dương Thần Giáp
太阳神苏利耶=Thần Mặt Trời Surya
太阳神马=Thái Dương Thần Mã
太阴上人=Thái Âm Thượng Nhân
太阴宗=Thái Âm Tông
太阴玄冰阵=Thái Âm Huyền Băng Trận
头提头颅者=Đầu Đề Đầu Lư Giả
奇车王=Kỳ Xa Vương
奔雷剑主=Bôn Lôi Kiếm Chủ
奢耶=Jaya
奥古玛=Áo Cổ Mã
奥特之父=Ultra Father
奥特大力龙象飞踢=Ultraman Đại Lực Long Tượng Phi Thích
奥特曼世界=Thế Giới Ultraman
奥特签名=Chữ ký Ultraman
奥特赛文=Ultra Seven
女娲大神=Nữ Oa Đại Thần
女娲血玉=Nữ Oa Huyết Ngọc
如意神树=Như Ý Thần Thụ
如意神牛=Như Ý Thần Ngưu
妖星格拉斯=Yêu tinh Grass
妙光=Diệu Quang
妙相仙人=Diệu Tướng Tiên Nhân
妙竹=Diệu Trúc
妙见=Diệu Kiến
妙见神轮=Diệu Kiến Thần Luân
妙项=Diệu Hạng
娑尼=Sa Ni
娑底耶=Ta Để Gia
娑摩吠陀=Samaveda
娑罗室伐底女神=Nữ thần Sarasvati
娑罗室伐底女神之力=Ta Bà Thất Phạt Để Nữ Thần Chi Lực
娑罗室伐底河=Sông Toa La Thất Phạt Để
娑罗尼尤=Salarinju
娑羅室伐底=Sa La Thất Phạt Để
娜迦之王=Na Già Chi Vương
娜迦蛇王=Naga Xà Vương
婆力古=Bhrigu
婆毗文=Bà Tỳ Văn
婆罗多=Bharata
婆罗娑罗摩=Parashurama
孙尼塔=Sunita
孙跋=Tôn Bạt
孙跋阿修罗=Tôn Bạt A-tu-la
孝义黑三郎=Hiếu Nghĩa Hắc Tam Lang
宁三叉戟=Ninh Tam Xoa Kích
宇宙球体斯菲亚=Quả Cầu Vũ Trụ Sphia
宇宙钢铁龙=Long thép vũ trụ
宇宙钢铁龙古瓦木=Long thép vũ trụ Guwamu
安伽=An Già
安伽城=An Già Thành
安奢那=Anjana
安溪海底城=An Khê Hải Để Thành
安陀迦=Andhaka
安陀迦那=An Đà Ca Na
宗方副队长=Đội trưởng phó Munakata
宝青坊=Bảo Thanh Phường
宝青坊主=Bảo Thanh Phường Chủ
室利因陀罗=Thất Lợi Nhân Đà La
室利那罗延=Sri Narayana
室建陀=Skanda
宿那山=Núi Sukuna
宿那鬼=Ác quỷ Sukuna
寒冰面具=Hàn Băng Diện Cụ
小短腿=chân ngắn nhỏ
小象神伽内什=Thần Voi Ganesha
小鱼水中游=Tiểu Ngư Thủy Trung Du
尘云=Trần Vân
尼嘉将军=Tướng quân Ni Gia
尼奢陀=Nishaadha
尼婆多迦婆遮=Ni Bà Đa Già Bà Che
尼孙跋=Ni Tôn Bạt
尼迦斯=Ni Ca Tư
山之恶魔波刚=Ác ma núi Bagan
山君庙=Sơn Quân miếu
崛井=Quật Tỉnh
崩德罗迦=Paundraka
巨人骑士=Cự Nhân Kỵ Sĩ
巨大吼声=cự đại tiếng rống
巨山相扑超魔兽=Quái thú Sumo Siêu Ma Núi Lớn
巨魔兵=Cự Ma Binh
巨魔团=Cự Ma Đoàn
巴乎迦=Ba Hô Già
巴湿伽罗=Ba Thấp Già La
布湿波迦=Bùshī bōjiā
布莱克警长=Cảnh trưởng Blake
布陀=Budha
希特拉=Hi Tạp Lạp
帕媚陀拉妮=Patumtara
帕尔瓦蒂女神=Nữ thần Parvati
帕罗格=Paroga
帝国恶魔攻略计划=Kế hoạch chinh phục ác ma đế quốc
常在仙人=Chang Zai Xianren
干燥之雷=Khô Táo Chi Lôi
幽冥界八云易=U Minh Giới Bát Vân Dịch
幽怜=U Liên
广袤神=Quảng Mậu Thần
广袤神阿迦奢=Quảng Mậu Thần A-ca-xá
广袤阿迦奢天=Quảng Mậu A Già Xa Thiên
床界山=Sàng Giới Sơn
库摩兰妮=Kumolanani
底提=Dethius
底提之子=Đế Đề Chi Tử
底提耶=Ditiye
庚伮金刚杵=Geng Nu Kim Cang Chử
度母=Độ Mẫu
异次元魔神艾塔尔加=Dị Thứ Nguyên Ma Thần艾塔尔加
异界伐楼那=Dị Giới Phạt Lâu Na
异界伐由=Dị Giới Phạt Do
异界因陀罗=Dị Giới Nhân Đà La
异界梵天=Phạm Thiên Dị Giới
异界毗湿奴=Tỳ Thấp Nô Dị Giới
异界毗首羯磨=Dị Giới Tỳ Thủ Yết Ma
异界苏利耶=Dị Giới Tô Lợi Gia
异界阿耆尼=Dị Giới A Kỳ Ni
引妖香=Dẫn Yêu Hương
弗栗多=Vritra
弥娜迦=Menaka
弥提罗国=Mithila
弥那迦山=Di Na Ca Sơn
彩虹魔境=Cầu Vồng Ma Cảnh
德伐波罗=Dvapara
德克萨斯炮=Đức Khắc Tát Tư Pháo
德拉姆车=Xe Dram
德髻=Đức Kế
心水=Tâm Thủy
快乐星猫=Happy Star Cat
快活林酒坊=Khoái Hoạt Lâm Tửu Phường
快螳螂=Khoái Đường Lang
怒剑=Nộ Kiếm
怒剑狂刀=Nộ Kiếm Cuồng Đao
怛特罗=Đát Đặc La
怛罗=Tara
怛罗女神=Tara
怛（da）罗女神=Đát La Nữ Thần
怪兽行星=Hành tinh quái vật
恐怖大王=Khủng Bố Đại Vương
恒河女神=Hằng Hà Nữ Thần
恰雅=Qià yǎ
恶鬼迦娜=Ác Quỷ Ca Na
恶魔小龙=Ác Ma Tiểu Long
悉多梵=Sita Phạm
悠悠然地道=khoan thai nói
悲痛莫名=Bi Đau Mạc Danh
情欲阿修罗=Tình Dục A-tu-la
惊瑞之期=Kinh Thụy Chi Kỳ
成龙历险记】=Những cuộc phiêu lưu của Thành Long
我等大师你=ta đợi Đại Sư ngươi
战狼军团=Chiến Lang Quân Đoàn
战神迦希吉夜=Chiến Thần Già Hi Cát Dạ
戳眼者=Người Chọc Mắt
戴西斯星人=Người Dessis
戴西斯星系=Hệ Daiysis
手持雷杵=Vajra-Holder
扶我起来我还能继续战斗=Đỡ ta dậy ta vẫn còn có thể tiếp tục chiến đấu
投山仙人=Đầu Sơn Tiên Nhân
护世神=Hộ Thế Thần
护世神毗湿奴=Hộ Thế Thần Tỳ Thấp Nô
拄着手杖=dựa vào thủ trượng
拉伊哈罗巴舞=Lai Haroba
拉克什米=Lakshmi
拉克什米女神=Lakshmi
拘湿伽=Câu Thấp Già
拘湿迦=Câu Thấp Ca
拘魂套索=Câu Hồn Sáo Tác
拿山君庙=Ná Sơn Quân Miếu
持金刚杵者=Trì Kim Cương Chử Giả
接龙=chơi đô-mi-nô/chơi domino
提婆希那=Đề Bà Hi Na
提毗波=Dvipa
提迭=Die
提迭希那=Đề Điệt Hi Na
搭帕=Đát Mạt
摄天剑=Nhiếp Thiên Kiếm
摩伽婆=Ma Già Bà
摩伽罗=Makara
摩伽罗之剑=Ma Già La Chi Kiếm
摩利坎杜=Marikandu
摩厘耶梵山=Ma Lị Gia Phạn Sơn
摩喜施末底=Mahishmati
摩多梨=Matali
摩奴=Manu
摩根德耶=Ma Căn Đức Gia
摩梨伽尸罗=Ma Lê Già Thi La
摩磋=Matsya
摩羯判官=Ma Kết Phán Quan
摩羯罗=Makara
摩耶之光=Ma Da Chi Quang
摩耶之力=Ma Da Chi Lực
摩耶城=Ma Da Thành
摩耶幻力=Maya Ảo Lực
摩耶幻术=Ma Da Huyễn Thuật
摩耶智慧=Trí tuệ Maya
摩耶苍穹=Ma Gia Thương Khung
摩耶迷宫=Ma Da Mê Cung
摩耶阿修=Ma Da A Tu La
摩耶阿修罗=Ma Gia A Tu La
摩西妮=Mohini
摩西沙=Moshisha
摩西沙阿修罗=Ma Tây Sa A Tu La
摩西湿=Ma Tây Thấp
摩诃因陀罗=Ma Ha Nhân Đà La
摩诃班达=Ma Ha Ban Đà
摩诃迦梨=Ma Ha Ca Lỵ
摩诃钵利=Ma Ha Bát Lợi
摩诃阿底提耶=Ma Ha A Để Đề Gia
摩鲁特=Marut
敝衣=Bế Y
敝衣仙=Tệ Y Tiên
敝衣仙人=Tệ Y Tiên Nhân
文底耶山=Vindhya
斗争时代=Đấu Tranh Thời Đại
斩侠大会=Trảm Hiệp Đại Hội
斩那牟质=Namuchi-Slayer
斯菲亚球体=Hình cầu Sphia
斯菲亚生命体=Thực thể sống Sphia
新麦克斯炮=Tân Mạch Khắc Tư Pháo
方位者=Phương vị Giả
方大法师=Phương Đại Pháp Sư
旋风剑主=Toàn Phong Kiếm Chủ
无形道=Vô Hình Đạo
无忧妙=Vô Ưu Diệu
无极拈花指=Vô Cực Niêm Hoa Chỉ
无限麦克斯动力系统=Hệ thống động lực Max Vô Hạn
无限麦克斯系统=Hệ thống Max vô hạn
日出山=Nhật Xuất Sơn
日落山=Nhật Lạc Sơn
旱魔弗栗多=Hạn Ma Phất Lật Đa
时夜=Thời Dạ
时夜女神=Thời Dạ Nữ Thần
时空城=Thời Không Thành
时空界=Giới Thời Không
明台桥=Minh Đài Kiều
明度贝=Mindobe
昔弥=Tích Di
昔弥天=Tích Di Thiên
昔弥女神=Tích Di Nữ Thần
星云体=Tinh Vân Thể
星座战士=Tinh Tọa Chiến Sĩ
星座装甲=Tinh Tọa Trang Giáp
星猫=Tinh Miêu
星盘阵=Tinh Bàn Trận
星目阿修罗=Tinh Mục A Tu La
星辰母=Mẹ của Các Vì Sao
春滋泉=Xuân Tư Tuyền
春滋神泉=Xuân Tư Thần Tuyền
昴星女神=Mão Tinh Nữ Thần
昴星神=Pleiades
普罗曼=Phổ La Mạn
普里提=Phổ Lí Đề
普鲁沙=Phổ Lỗ Sa
景菁=Cảnh Tinh
智人=Trí Nhân
智人迦玛帕拉=Trí Nhân Già Ma Ba Lạp
暗黑三叉戟=Ám Hắc Tam Xoa Kích
暗黑魔铠装=Ám Hắc Ma Khải Trang
暴躁因陀罗=Bạo Táo Nhân Đà La
暴躁苏利耶=Bạo Táo Tô Lợi Gia
曜星=Diệu Tinh
曲女城=Khúc Nữ Thành
曼妲=Manda
曼度陀里=Mạn Độ Đà Lí
曼罗迦=Manasa
曼荼罗山=Mạn Đồ La Sơn
曼迦勒=Mạn Già Lặc
曼陀罗山=Mạn Đà La Sơn
曼陀罗山脉=Dãy núi Mandara
月之恶魔=Ác ma mặt trăng
月桂叶=Lá nguyệt quế
月神之子【布陀】=Con trai của Thần Mặt Trăng [Budha]
月神苏摩=Nguyệt Thần Soma
月铃母=Nguyệt Linh Mẫu
月魇=Nguyệt Yểm
月魇之刀=Nguyệt Yểm Chi Đao
有喜仙人=You Xi Xianren
木橘叶=Mộc Quất Diệp
机械哥斯拉=Mecha Godzilla
杀弗栗多=Vritra-Slayer
杂林苑=Tạp Lâm Uyển
李雾龙=Lý Vụ Long
杜兰塔克=Đỗ Lan Tháp Khắc
杜尔迦玛=Đỗ Nhĩ Già Ma
杜尔迦马=Durgama
杜摩陀耆尼=Đỗ Ma Đà Kỳ Ni
杜浑陀=Đỗ Hỗn Đà
杜鲁刚=Đỗ Lỗ Cương
杵瘤=Xử Lựu
极裕仙人=Vasishtha
林业平=Lâm Nghiệp Bình
林氏王朝=Lâm Thị vương triều
林迦=Linga
林迦柱=Lâm Già Trụ
枫叶大阵=Phong Diệp Đại Trận
枫叶武士=Phong Diệp võ sĩ
格兰雷恩=Gran Reign
格拉斯中校=Trung tá Glass
桑娜提=Tang Na Đề
桑布提=Sambūti
桔梨箩柚=Quất Lê La Dữu
梓诉=Tử Tố
梨俱吠陀=Rigveda
梨多=Rita
梵力=Phạm Lực
梵卵=Brahmanda
梵天之颅=Sọ Phạm Thiên
梵天界=Phạm Thiên Giới
梵湖=Phạm Hồ
梵颅=Phạn Lô
棕发女=Tóc Nâu Nữ
森美队=Sâm Mỹ Đội
楞伽城=Lăng Già Thành
橄榄之国弗朗机=Nước Olive Phlang Cơ
檀奴=Danu
檀奴之子=Đàn Nô Chi Tử
檀奴克=Đàn Nô Khắc
檀奴迦=Đàn Nô Già
檀那婆=Đàn Na Bà
檀那婆族=Đàn Na Bà Tộc
檀那婆普罗曼=Đàn Na Bà Phổ La Mạn
檀那婆王=Đàn Na Bà Vương
檀那婆王普罗曼=Vua Danava Proman
欧应万=Âu Ứng Vạn
欧若拉之眼=Đôi mắt của Aurora
正法之神=Chính Pháp Chi Thần
正法之网=Lưới Chánh Pháp
正法战士=Chiến binh chính pháp
正法神=Chính Pháp Thần
正理经=Chánh Lý Kinh
步氏神族=Bộ Thị Thần Tộc
武大强=Võ Đại Cường
歩渊亭=Bộ Uyên Đình
死神套索=Dây thòng lọng Thần Chết
死神阎摩=Tử Thần Diêm Ma
比那迦=Pinaka
比那迦神弓=Pinaka
毕鲁萨鲁多=Tất Lỗ Tát Lỗ Đa
毕鲁萨鲁多人=Tất Lỗ Tát Lỗ Đa Nhân
毕鲁萨鲁多族长=Tộc trưởng Bilusaldo
毗奢密多罗=Vishwamitra
毗奢耶=Vijaya
毗娜达=Tỳ Na Đạt
毗娜迦=Pinaka
毗娜迦之弓=Cung Pinaka
毗娜迦神弓=Cung thần Pinaka
毗婆罗吉提=Tỳ Bà La Cát Đề
毗尸罗婆=Tỳ Thi La Bà
毗德尔跋=Vidarbha
毗恭吒=Tỳ Cung Tra
毗毗陀迦树=cây Vibhitaka
毗波制底=Tỳ Ba Chế Để
毗湿奴之力=Tỳ Thấp Nô Chi Lực
毗湿摩=Bhishma
毗罗=Tỳ La
毗羚陀=Tỳ Lăng Đà
毗老师=Thầy Tỳ
毗诃波提=Tỳ Ha Ba Đề
毗贡吒=Vaikuntha
毗达斯=Vitas
毗那夜迦=Vinayaka
毗里妮=Virini
毗首羯磨=Tỳ Thủ Yết Ma
毗首羯磨之妻=Tỳ Thủ Yết Ma Chi Thê
水之恶魔=Ác ma nước
水持=Svadhisthana
水星神=Thủy Tinh Thần
水火土风雷=Thủy Hỏa Thổ Phong Lôi
水瓶判官=Thủy Bình Phán Quan
水神伐楼那=Thủy Thần Phạt Lâu Na
水神岛=Thủy Thần Đảo
水神王=Thủy Thần Vương
永安当=Vĩnh An Đương
永童仙人=Yong Tong Xianren
汉塔克=Hantake
沙利耶迦=Sa Lợi Da Ca
沙漠死神内瑟斯=Sa Mạc Tử Thần Nasus
沙福林=Sa Phúc Lâm
沙罗宝多迦=Sa La Bảo Đa Ca
波刚=Ba Cương
波士顿芬威球场=Sân vận động Fenway Park Boston
波罗跋娑=Ba La Bạt Sa
波陀罗=Patala
波陀罗之界=Patala Giới
波陀罗界=Ba Đà La Giới
泥犁=Nê lê
泥犁若=Nê lê nhược
泰雷=Thái Lôi
泽井=Trạch Tỉnh
泽井总监=Tổng giám đốc Sawai
洛佩=Lạc Bội
洛摩巴陀=Lạc Ma Ba Đà
洪呼王=Hồng Hô Vương
浑天四绝=Hỗn Thiên Tứ Tuyệt
浑陀=Hỗn Đà
浣熊大师=Sư phụ Gấu Mèo
深蓝圆舞曲=Thâm Lam Viên Vũ Khúc
渡津者=Độ Tân Giả
温驽=Ôn Nô
湿婆神力=Thấp Bà Thần Lực
湿润之雷=Ướt Át Chi Lôi
溺爱阿修罗=Nịch Ái A Tu La
潘库=Phan Khố
潘库宝盒=Hộp Bàn Khố
潘普洛纳古城=Cổ thành Pamplona
澳国总统=Tổng thống Úc
火无定=Hỏa Vô Định
火星曼迦勒=Hỏa Tinh Mạn Già Lặc
火焰哥尔赞=Hỏa Diễm Gorzam
火神阿耆尼=Hỏa Thần A Kỳ Ni
火舞旋风=Hỏa Vũ Toàn Phong
火鬼王=Hỏa Quỷ Vương
火魔兽=Hỏa Ma Thú
火麟飞=Hỏa Lân Phi
灭世班达=Diệt Thế Ban Đà
灰狼拉夫尔=Sói xám Laffer
灵山引=Linh Sơn Dẫn
灵山掌=Linh Sơn Chưởng
灵山渡=Linh Sơn Độ
灵山门=Linh Sơn Môn
灵山门主=Linh Sơn môn chủ
灵泉宝玉=Linh Tuyền Bảo Ngọc
灵鱼摩蹉=Linh Ngư Ma Tha
灵龟库尔玛=Linh Quy Khố Nhĩ Mã
炎拳=Viêm Quyền
炎波泉=Viêm Ba Tuyền
炎波血刃=Viêm Ba Huyết Nhận
炎魔战士=Chiến binh Yan Ma
炎魔战士基里艾洛德人=Chiến binh Quỷ Lửa Kirieloid
炎魔战士基里艾洛德人二代=Chiến binh Quỷ Lửa Kirieloid II
烈火狮王=Liệt Hỏa Sư Vương
烟目=Yên Mục
烟目阿修罗=Yên Mục A Tu La
照胆泉=Chiếu Đảm Tuyền
熊猫阿宝=Gấu trúc A Bảo
爱婆罗多=Airavata
爱神迦摩=Thần Tình Yêu Kama
爱罗婆多=Ái La Bà Đa
爱罗婆多主神庙=Ái La Bà Đa Chủ Thần Miếu
爱罗婆多神庙=Đền Airavata
爱罗婆罗=Ái La Bà La
牛战士=Ngưu Chiến Sĩ
牛节=Ngưu Tiết
牛节望=Uchchaihshravas
牛节王=Ngưu Tiết Vương
牟质=Mưu Chất
特里库=Đặc Lí Khố
特雷达=Treta
特鲁妈妈=Mẹ Tulu
狂刀怒剑=Cuồng Đao Nộ Kiếm
狂雷天牢=Cuồng Lôi Thiên Lao
狗将军=Cẩu Tướng Quân
狮子树海=Sư Tử Thụ Hải
狮面=Sư Diện
狮面阿修罗=Sư Diện A Tu La
猩猩乔治=Tinh tinh George
猪笼城寨=Lồng Heo Thành Trại
猴国=Hầu Quốc
玄冥之棺=Huyền Minh Chi Quan
玄冥黑洞=Huyền Minh Hắc Động
玄冰护体=Huyền Băng Hộ Thể
玄易子=Huyền Dịch Tử
玄武号=Huyền Vũ Hào
玄武号飞船=Phi thuyền Huyền Vũ
玄道观=Huyền Đạo Quán
玄阴剑晨=Huyền Âm Kiếm Thần
玉兔仙子=Ngọc Thố Tiên Tử
玉蟾宫=Ngọc Thiềm Cung
玉龙阴狐和合功=Ngọc Long Âm Hồ Hòa Hợp Công
王中因陀罗=Vương Trung Nhân Đà La
班苏里笛=Ban Tô Lý Địch
班达阿修罗=Ban Đạt A Tu La
瑞兽凤血=Thụy Thú Phượng Huyết
瑞兽精元=Thụy Thú Tinh Nguyên
瓦龙=Ngõa Long
甘蔗族=Cam Giá Tộc
甘陀利=Cam Đà Lợi
甚至已经=thậm chí đã
生主达刹=Sinh Chủ Đạt Sát
电环=Điện Hoàn
畏怖尊=Bhairava
白羊判官=Bạch Dương Phán Quan
白羊武士=Bạch Dương Võ Sĩ
白羊虚影=Bạch Dương Hư Ảnh
白苗族=Bạch Miêu Tộc
白蛇缘起=Bạch Xà Duyên Khởi
白象之王=Bạch Tượng Chi Vương
白象爱罗婆多=Bạch Tượng Ai La Bà Đa
白鼠谷=Bạch Thử Cốc
白龙族=Bạch Long Tộc
百祭=Bách Tế
百草谷=Bách Thảo Cốc
盎伽=Áng Già
盖世五侠=Ngũ Hiệp Cái Thế
盖图跋=Cái Đồ Bạt
盖达跋=Cái Đạt Bạt
盗取鲜花者=Kẻ trộm hoa
盘螭神云枪=Bàn Si Thần Vân Thương
真田良介=Chân Điền Lương Giới
睡熊猛醒=Thụy Hùng Mãnh Tỉnh
瞻巴拉=Chiêm Ba Lạp
瞿陀尼=Cù Đà Ni
知树=Tri Thụ
知秋一叶=Tri Thu Nhất Diệp
石化怪兽加库玛=Thạch Hóa Quái Thú Gia Khố Mã
破空术=Phá Không Thuật
碎天绝手=Toái Thiên Tuyệt Thủ
碳叶=Thán Diệp
磁力小丑=Từ Lực Tiểu Sửu
礼貌天帝=Thiên Đế Lễ Phép
礼赞三相神=Lễ tán Tam tướng thần
礼赞上主=Lễ tán Thượng chủ
礼赞仁慈的天帝=Ca ngợi Thiên Đế nhân từ
礼赞大天=Lễ tán Đại Thiên
礼赞天神=Lễ Tán Thiên Thần
礼赞持金刚杵者=Ca ngợi người giữ Kim Cang Chử
礼赞耶瑟陀=Lễ tán Da Sắt Đà
礼赞迦叶波仙人=Lễ Tán Ca Diệp Ba Tiên Nhân
礼赞那罗~那罗延=Lễ tán Nara~Narayana
神仙迷心丸=Thần Tiên Mê Tâm Hoàn
神光棒=Thần Quang Bổng
神光神波罗跋娑=Thần Quang Thần Ba La Bạt Ta
神劈=Thần Phách
神将飞蓬=Thần Tướng Phi Bồng
神明战甲=Thần minh chiến giáp
神武纪=Thần Võ Kỷ
神牛南笛=Nandi
神犬萨罗摩=Thần Khuyển Tát La Ma
神界天池=Thiên Trì Thần Giới
神盾巨蟹=Thần Thuẫn Cự Giải
神矛阿摩迦=Thần Mâu A Ma Già
神象之王=Thần Tượng Chi Vương
神马高耳=Thần Mã Cao Nhĩ
神龙卷轴=Thần Long Quyển Trục
神龙秘籍=Thần Long Bí Kíp
祭主=Tế Chủ
祭主仙=Tế Chủ Tiên
祭主仙人=Tế Chủ Tiên Nhân
科目三=Khoa mục 3
穆俱昆陀=Mukunda
穆湿伽=Mushika
空谷罪犯感化院=Trại cải huấn tội phạm Thung lũng Không
第一平行宇宙=Vũ trụ song song thứ nhất
第七平行宇宙=Vũ trụ song song thứ bảy
第三平行宇宙=Vũ trụ song song thứ ba
第二平行宇宙=Vũ trụ song song thứ hai
第五平行宇宙=Vũ trụ song song thứ năm
第六平行宇宙=Vũ trụ song song thứ sáu
第四平行宇宙=Vũ trụ song song thứ tư
筏罗诃=Varaha
米国总统=Tổng thống Mỹ
粗恶苑=Thô Ác Uyển
索兰达=Solanda
紫云剑主=Tử Vân Kiếm Chủ
紫云剑主莎丽=Tử Vân Kiếm Chủ Sally
紫云剑法=Tử Vân Kiếm Pháp
紫云真气=Tử Vân Chân Khí
紫兔=Tử Thỏ
紫玉佩=Tử Ngọc Bội
紫翼魔尊=Tử Dực Ma Tôn
红冠=Hồng Quán
红烧牛肉面=Mì bò kho tàu
红花粉=Bột hồng hoa
红葵=Hồng Quỳ
约尼=Ước Ni
纵意登仙步=Túng Ý Đăng Tiên Bộ
维摩纳斯=Vimanas
维摩那斯=Duy Ma Na Tư
维毗沙那=Vibhishana
维纳琴=Đàn Vina
绿魔飞行器=Phi Thuyền Lục Ma
缚罪者=Phược Tội Giả
罗刹之王=La Sát Chi Vương
罗刹之王罗波那=La Sát Vương Ravana
罗刹十首=La Sát Thập Thủ
罗延=La Duyên
罗怙=La Hộ
罗毗=La Tỳ
罗睺星=Sao La Hầu
罗睺计都=Rahu Ketu
罗蒂=Rati
罗辛哈=Narasimha
羊面=Dương Diện
美森队=Đội Mĩ Sâm
群山之翼=Cánh núi non
翡翠之刃=Phỉ Thúy Chi Nhận
翡翠僵尸=Cương thi Ngọc Bích
老七剑=Lão Thất Kiếm
老了=già rồi/già
老天皇=Lão Thiên Hoàng
老山羊=Lão Sơn Dương
耶瑟陀=Gia Sắt Đà
耶瑟陀女神=Gia Sắt Đà Nữ Thần
聚元宝鼎=Tụ Nguyên Bảo Đỉnh
肥仔聪=Phì Tử Thông
胜166=Thắng 166
胜利队=Đội Chiến Thắng
胜利飞燕号=Victory Flier
自杀仙人=Tiên Nhân Tự Tử
至净法=Chí Tịnh Pháp
舍沙=Shesha
舍波罗=Shebala
舍脂=Xá Chi
舍脂之主=Xá Chi Chi Chủ
般度族=Pandava
艾勃隆=Ngải Bột Long
花尾=Hoa Vĩ
苇轭=Veeyoga
苍月奥特曼=Ultraman Trăng Xanh
苏利耶之子=Tô Lợi Da Chi Tử
苏利耶之子娑尼=Tô Lợi Gia Chi Tử Sa Ni
苏利耶天=Tô Lợi Da Thiên
苏摩天=Tô Ma Thiên
苏摩耶=Tô Ma Gia
苏摩酒=rượu Soma
苏维妮=Suvini
苏羯罗=Sukra
苏羯罗仙人=Tiên nhân Sukra
苏羯罗导师=Đạo sư Tô Yết La
苏羯里婆=Sugriva
苏陀罗=Sutala
苏陀罗之王=Tô Đà La Chi Vương
苏陀罗之界=Tô Đà La Chi Giới
苏陀罗界=Tô Đà La Giới
苗条俊=Miêu Điều Tuấn
苦力强=Khổ Lực Cường
英武天神=Valiant Deva
茂茂=Mậu Mậu
莫仇=Mạc Cừu
莫将=Mạc Tương
莱奴迦=Lai Nô Già
莲目=Liên Mục
菊石兽=Cúc Thạch Thú
萨克蒂=Sakti
萨克蒂之力=Tát Khắc Đế Chi Lực
萨克蒂女神=Nữ Thần Shakti
萨奇帕提=Tát Kỳ Mạt Đề
萨罗摩=Tát La Ma
葛兰花=Hoa Kanak Champa
葫芦娃大战变形金刚=Hồ Lô Oa đại chiến Biến Hình Kim Cương
葵羽=Quỳ Vũ
葵羽玄女=Quỳ Vũ Huyền Nữ
蒙平原=Mông Bình Nguyên
蒙达苏尔=Mông Đạt Tô Nhĩ
蓝兔=Lam Thỏ
蓝色行星的爱=Tình Yêu Hành Tinh Xanh
蓝葵=Lam Quỳ
藤甲军团=Đằng Giáp Quân Đoàn
虎头佛母森多玛=Hổ Đầu Phật Mẫu Sâm Đa Mã
虎魄刀=Đao Hổ Phách
虎魄空间=Không gian Hổ Phách
虬藤翻潦浪，灿然额前辉！=Cù đằng phiên lạo lãng, Sán nhiên ngạch tiền huy!
虹猫=Hồng Miêu
虹猫仗剑走天涯=Hồng Miêu Trượng Kiếm Tẩu Thiên Nhai
虹猫蓝兔=Hong Mao Lan Tu
虹猫蓝兔七侠传世界=Hồng Miêu Lam Thố Thất Hiệp Truyện thế giới
虹猫蓝兔世界=Thế giới Hồng Miêu Lam Thỏ
虹蓝=Hồng Lam
虹蓝七侠传=Hồng Lam Thất Hiệp Truyện
蚁蛭=Nghĩ Điệt
蚁蛭仙人=Nghĩ Điệt Tiên Nhân
蛇女曼罗迦=Xà Nữ Mạn La Già
蛇床=Xà Sàng
蛇床者=Xà sàng giả
蛇母=Xà Mẫu
蛇母迦德卢=Xà Mẫu Ca Đức Lâu
蛇王婆苏吉=Xà Vương Vasuki
蛇王舍沙=Xà Vương Xá Sa
蜀山灵脉=Thục Sơn linh mạch
蝎子女=Thiết Nữ
蝎子王龙莹=Hạt Tử Vương Long Oánh
蝙蝠战团=Biên Bức Chiến Đoàn
蝰蛇武装直升机=Trực thăng vũ trang Viper
血种阿修罗=Asura Huyết Chủng
行星斯菲亚=Hành tinh Sphia
补卢山=Bổ Lư Sơn
补卢罗婆娑=Bổ Lư La Bà Sa
补米伽=Bhumika
补罗私底耶=Bổ La Tư Để Da
被缚者=Người bị trói
西方水域=Thủy Vực Phương Tây
西木=Tây Mộc
西瞿陀尼=West Godhaniya
解脱者=Giải Thoát Giả
詹巴拉=Chiêm Ba Lạp
詹琉璃=Chiêm Lưu Li
讫利多=Krita
设阇卢祇那=Shatrughna
诃利=Hari
诃利阿修罗=Hà Lợi A Tu La
诃德莉=Ha Đức Lị
诃拉=Ha Lạp
诃拉诃拉=Halahala
诃拉诃拉之毒=Độc Hala Hala
诃拉诃拉之箭=Mũi tên Hala Hala
诃耶羯里婆=Ha Da Yết Lí Bà
诸世纪=Các thế kỷ
诸天之门=Chư Thiên Chi Môn
诸天：从破坏之王开始=Chư Thiên: Bắt đầu từ Vua Phá Hoại
象面=Tượng Diện
象魔=Tượng Ma
象魔阿修罗=Tượng Ma A Tu La
豹尾脚=Báo Vĩ Cước
贝琉多拉=Belial Dora
财富女神拉克什米=Nữ thần Tài Lộc Lạp Khắc Thập Mễ
财神俱毗罗=Thần Tài Kubera
贪欲阿修罗=Tham Dục A-tu-la
贪狼剑=Tham Lang Kiếm
赤炎火龙阵=Xích Diễm Hỏa Long Trận
超兽战士=Siêu Thú Chiến Sĩ
超兽战队=Siêu Thú Chiến Đội
超兽武装=Siêu Thú Vũ Trang
超兽神=Siêu Thú Thần
跋伽=Bạt Già
跋兰妮=Bạt Lan Ni
跋录吉=Bạt Lục Cát
跋陀罗=Bhadra
路长官=Lộ trưởng quan
身披金闪衣=Golden-Clad
车底国=Nước Chedi
辛希嘉=Tân Hi Gia
辛杜拉=Tân Đỗ La
辛辣天塞=Shinra Tensei
辩才天女=Biện Tài Thiên Nữ
达刹=Daksha
达尔蒂=Đạt Nhĩ Đế
达尔蒂·玛塔=Đạt Nhĩ Đế · Mã Tháp
达录那=Daruna
达拉姆=Đạt Lạp Mỗ
达摩洞=Đạt Ma Động
达摩衍蒂=Damayanti
达湿罗=Đạt Thấp La
达玛鲁=Damaru
达玛鲁鼓=Đạt Ma Lỗ Cổ
达达=Đạt Đạt
达陀利耶=Đạt Đà Lợi Da
远东总部=Tổng bộ Viễn Đông
迦利=Già Lợi
迦叶波=Ca Diếp Ba
迦叶波仙人=Ca Diếp Ba Tiên Nhân
迦娄陀=Ca Lâu Đà
迦尔吉=Kalki
迦尸=Già Thi
迦尸之城=Ca Thi Chi Thành
迦尸城=Ca Thi Thành
迦希吉夜=Kashyapa
迦德卢=Kadru
迦拘吒迦=Ca Câu Tra Ca
迦旃延妮=Ca Chiên Diên Ni
迦旃延那=Katyayana
迦梨女神=Nữ thần Kali
迦梨时代=Ca Lỵ Thời Đại
迦楼罗=Già Lâu La/Garuḍa/Garuda
迦楼罗族=Gia Lâu La Tộc
迦玛帕拉=Già Ma Mạt Lạp
迦罗尼弥=Ca La Ni Di
迦陵频迦鸟=Ca Lăng Tần Già Điểu
迦频奢罗鸟=Ca Tần Xa La Điểu
迪利波=Địch Lợi Ba
迪迦世界=Thế giới Tiga
迪迦奥特曼世界=Thế giới Ultraman Tiga
迷魂台=Mê Hồn Đài
遨游四海求其凰=Ngao du tứ hải cầu kỳ hoàng
遮那迦=Janaka
那兰奇=Na Lan Kỳ
那吒俱伐罗=Na Tra Câu Phạt La
那牟质=Na Mâu Chất
那罗=Nara
那罗延=Narayana
那罗辛哈=Narasimha
那罗迦=Na La Ca
那罗陀=Narada
那罗陀仙人=Narada Tiên nhân
邪蛟=Tà Giao
邪血劫=Tà Huyết Kiếp
邪迪=Tà Diga
郭北镇=Quách Bắc Trấn
酱爆=Tương Bạo
里婆蒂=Lý Bà Đế
里蜀山=Lý Thục Sơn
重力球=Trọng Lực Cầu
重名者钵利=Trùng Danh Giả Bát Lợi
野猪化身=Dã Trư Hóa Thân
野猪筏罗诃=Dã Trư Phiệt La Ha
野瑞=Dã Thụy
金刚菩提子=Kim Cương Bồ Đề Tử
金刚身阿修罗=Kim Cang Thân Asura
金叉罗=Kim Xoa La
金发男=Tóc Vàng Nam
金床=Kim Sàng
金床阿修罗=Kim Sàng A Tu La
金忍者=Kim Ninja
金星之神=Kim Tinh Chi Thần
金星仙人=Tiên nhân Kim Tinh
金灶沐=Kim Táo Mộc
金牛战车=Kim Ngưu Chiến Xa
金狼百兽王=Kim Lang Bách Thú Vương
金目和金床=Kim Mục và Kim Sàng
金目阿修罗=Kim Mục A Tu La
金目阿修罗王=Kim Mục A Tu La Vương
金翅鸟迦楼罗=Kim Sí Điểu Già Lâu La
金蜈火毒=Kim Ngô Hỏa Độc
金象族=Kim Tượng tộc
金鞭溪=Kim Tiên Khê
金鞭溪客栈=Kim Tiên Khê Khách Sạn
金龙戈尔德拉斯=Kim Long Goldras
钢甲铁面人=Người Mặt Sắt Bọc Thép
钱江大坝=Tiền Giang Đại Bá
钵利=Bát Lợi
钵利王=Bát Lợi Vương
钵利阿修罗王=Bát Lợi A Tu La Vương
钵底=Bát Để
钵罗诃罗陀=Bát La Ha La Đà
钵那=Bát-Na
钵那阿修罗=Bát Na A Tu La
铁心岛=Thiết Tâm Đảo
铁血星=Tinh cầu Thiết Huyết
铁血星人=Người Sắt Máu
铁血星球=Thiết Huyết Tinh Cầu
铁首=Thiết Thủ
铁鬃灰熊=Thiết Tông Hôi Hùng
铠甲勇士刑天=Khải Giáp Dũng Sĩ Hình Thiên
银龙希尔巴贡=Ngân Long希尔巴贡
铸剑池=Chú Kiếm Trì
锐金剑气=Nhuệ Kim Kiếm Khí
长暗仙人=Trường Ám Tiên Nhân
长生不死之神=Trường Sinh Bất Tử Chi Thần
闪闪爱=Lấp lánh yêu
闰土=Nhuận Thổ
阎摩使=Sứ giả Diêm Ma
阎摩判官=Diêm Ma Phán Quan
阎摩城=Diêm Ma Thành
阎摩天=Diêm Ma Thiên
阎浮提树=Cây Jambu
阎浮树=Cây Diêm Phù
阎浮树叶=Diêm Phù Thụ Diệp
阎蜜=Diêm Mật
阿修罗女舍脂=A Tu La Nữ Xá Chi
阿修罗导师=Đạo sư A Tu La
阿修罗王金目=A Tu La Vương Kim Mục
阿修罗王钵利=Asura Vương Bali
阿修罗神殿=A Tu La Thần Điện
阿修罗蒙达苏尔=A Tu La Mông Đạt Tô Nhĩ
阿修罗金床=Giường Vàng Asura
阿修罗阿鲁纳=A Tu La Aruna
阿修罗陀罗迦=Asura Taraka
阿利耶迦=A Lợi Da Ca
阿努波=A Nậu Ba
阿奋=A Phấn
阿奴苏耶=A Nô Tô Gia
阿娑妮=A Sa Ni
阿婆罗=A Bà La
阿尼罗=Anila
阿布婆=A Bố Bà
阿底=Adi
阿底利=A Để Lợi
阿底利仙人=Atri tiên nhân
阿底提=Adieti
阿底提耶=A Để Đề Gia
阿拉克什米=A Lạp Khắc Thập Mễ
阿摩迦=A Ma Già
阿摩迦之矛=A Ma Già Chi Mâu
阿斯多山=A Tư Đa Sơn
阿格尼亚=Agniya
阿沃索希=A-wo-suo-xi
阿特曼林迦=Atman Linga
阿瑞斯号=Ares Hào
阿瑞斯号战舰=Chiến hạm Ares
阿耆=A Kỳ
阿耆尼=A Kỳ Ni
阿耆尼之影=A Kỳ Ni Chi Ảnh
阿耆尼天=A Kỳ Ni Thiên
阿诃利耶=A Kha Lợi Gia
阿诃姆=Aham
阿达婆吠陀=Atharvaveda
阿迦=A Già
阿迦奢=A Già Xa
阿迦奢之力=A Già Xá Chi Lực
阿迦提耶=A Ca Đề Da
阿迦沙耶=Akasha
阿迪湿婆=A Địch Thấp婆
阿迪瑜吉=A Địch Du Già
阿逾陀=Ayodhya
阿逾陀国=A Du Đà Quốc
阿逾陀城池=Thành A Du Đà
阿那罗=Anala
阿闼婆吠陀=Atharvaveda
阿鲁纳=A Lỗ Nạp
阿鲁诺=Aruna
陀兰那=Đà Lan Na
陀娑羯里婆=Đà Sa Yết Lí Bà
陀提遮=Đà Đề Già
陀提遮仙人=Đà Đề Già Tiên Nhân
陀罗迦=Draka
陀罗迦阿修罗=Tu La Đà La Ca
陆惊天=Lục Kinh Thiên
降龙神丐=Hàng Long Thần Cái
除障者伽内什=Trừ Chướng Giả Già Nội Thập
难胜=Nan Thắng
雄贤=Hùng Hiền
雅典娜一号=Athena 1
雨花剑=Vũ Hoa Kiếm
雨花剑主=Vũ Hoa Kiếm Chủ
雪山女神=Tuyết Sơn Nữ Thần
雪山族=Tuyết Sơn Tộc
雪山王=Tuyết Sơn Vương
雪山神女=Tuyết Sơn Thần Nữ
雪山神女帕尔瓦蒂=Nữ thần Tuyết Sơn Parvati
雪岛上人=Tuyết Đảo Thượng Nhân
雪晶夫人=Tuyết Tinh phu nhân
雪舍利=Tuyết Xá Lợi
雷土灵珠=Lôi Thổ Linh Châu
雷无向=Lôi Vô Hướng
雷杵阵=Lôi Xử Trận
雷电交加=Lôi Điện Giao Gia
雷电恶魔=Ác ma sấm sét
雷电恶魔中苏=Lôi Điện Ác Ma Trung Tô
雷遁星云=Lôi Độn Tinh Vân
雷魔兽=Lôi Ma Thú
霍丽嘉=Holiqa
露兜花=Hoa Lộ Đâu
露露耶=Lộ Lộ Gia
霸王装甲=Bá Vương Trang Giáp
青光剑=Thanh Quang Kiếm
青光剑主=Thanh Quang Kiếm Chủ
青颈=Thanh Kình
青颈之主=青颈之主 - Chúa tể cổ xanh
青龙族=Thanh Long Tộc
青龙降魔=Thanh Long Hàng Ma
静修林=Tĩnh Tu Lâm
靳韵翠=Cận Vận Thúy
韩偓=Hàn Ác
顶礼那罗延=Đỉnh Lễ Na La Diên
须摩利=Sumali
顾留芳=Cố Lưu Phương
颜盈=Nhan Doanh
风之恶魔=Ác ma gió
风云天诀=Phong Vân Thiên Quyết
风神伐由=Phong Thần Phạt Do
风群之主=Phong Quần Chi Chủ
风耀=Phong Diệu
风雷妖鸟=Phong Lôi Yêu Điểu
风魔兽=Phong Ma Thú
飞燕一号=Phi Yến 1
飞燕二号=Phi Yến Nhị Hào
飞龙再生=Phi Long Tái Sinh
食为先=Thực Vi Tiên
食火仙人=Thực Hỏa Tiên Nhân
香醉山=Hương Túy Sơn
马三娘=Mã Tam Nương
马克48重型线导鱼雷=Ngư lôi dẫn đường hạng nặng Mark 48
马克50=Mark 50
马克50战甲=Áo Giáp Mark 50
马克50钢铁战甲=Áo giáp sắt Mark 50
马提迦婆多=Matika婆多
马特斯亚=Mattysia
马首阿修罗=Mã Thủ A Tu La
骄生=Kiêu Sinh
骄生阿修罗=Kiêu Sinh A Tu La
骄罗毗耶=Kiêu La Tỳ Da
骷髅女=Khô Lâu Nữ
高耳=Cao Nhĩ
鬈发城=Quyền Phát Thành
鬼叉罗=Quỷ Xoa La
鬼影兵团=Quỷ Ảnh Binh Đoàn
鬼影军团=Quỷ Ảnh Quân Đoàn
鬼影军团篇=Quỷ Ảnh Quân Đoàn Thiên
鬼影巨魔=Quỷ Ảnh Cự Ma
鬼影忍者=Quỷ Ảnh Ninja
鬼影王国=Quỷ Ảnh Vương Quốc
鬼王九尾狐=Quỷ Vương Cửu Vĩ Hồ
魔化大天神=Ma Hóa Đại Thiên Thần
魔化天使=Ma Hóa Thiên Sứ
魔怪诃拉诃拉=Ma quái Hô-la-hô-la
魔王金垫子=Quỷ vương Đệm Vàng
魔王金眼睛=Quỷ vương Mắt Vàng
鲸鲨族=Kình Sa Tộc
鲸鲨王=Kình Sa Vương
鳄魔=Ngạc Ma
鳄魔兵团=Ngạc Ma Binh Đoàn
鳄鱼利兹=Cá sấu Liz
鳄鱼帮=Băng Cá Sấu
鸯耆罗=Angiras
鸯耆罗仙人=Angiras
麒麟套装=Kỳ Lân Sáo Trang
麒麟甲=Kỳ Lân Giáp
麻鹬山=Ma Úc Sơn
黄金太阳神甲=Hoàng Kim Thái Dương Thần Giáp
黄金山羊=Hoàng Kim Sơn Dương
黄金行星=Hoàng Kim Hành Tinh
黑三郎=Hắc Tam Lang
黑云巨人=Hắc Vân Cự Nhân
黑小虎=Hắc Tiểu Hổ
黑山神拳=Hắc Sơn Thần Quyền
黑影王国=Vương quốc Bóng tối
黑手帮=Hắc Thủ Bang
黑无情=Hắc Vô Tình
黑暗的支配者加坦杰厄=Kẻ thống trị bóng tối Gatanothor
黑暗行星古兰斯菲亚=Hành tinh Hắc ám Guransufia
黑暗迪迦=Diga Bóng Tối
黑海深渊=Hắc Hải Thâm Uyên
黑虎大佛=Hắc Hổ Đại Phật
黑虎崖=Hắc Hổ Nhai
黑虎洞=Hắc Hổ Động
黑魔王=Hắc Ma Vương
黑鹰传书=Hắc Ưng Truyền Thư
黑龙剑=Hắc Long Kiếm
鼠后=Thử Hậu
鼠族大祭司=Thử tộc Đại Tế Tư
龙小组=Long Tiểu Tổ
龙莹=Long Oánh
黑目=Hắc Mục
红色全能形态=Hình thái Toàn năng Đỏ
白色初生形态=Hình thái Sơ Sinh Trắng
蜘蛛古朗基=Gourongi Nhện
绿色形态=Hình thái Lục sắc
白色保命形态=Hình thái Bảo mệnh Trắng
B1=B1
玫瑰女=Nữ Hoa Hồng
古朗基之王达古巴=Vua Gurongi Daguva
初生究极空我=Rising Ultimate Kuuga
愤怒之塔=Tháp Phẫn Nộ
钢之蕾=Nụ Thép
基博隆=Kiboron
未确认生命体联合搜查总部=Tổng bộ điều tra liên hợp vật thể sống chưa xác định
泽渡小姐=Cô Zawa-do
青龙形态=Thanh Long Hình thái
量产型特殊摩托车TryChaser2000A=Mô tô đặc chủng sản xuất hàng loạt TryChaser 2000A
葛饰2号=Katsushika Số 2
水元公园=Công viên Mizumoto
未确认生命体联合搜查本部=Trụ sở Điều tra Liên hợp Sinh vật Chưa xác định
长野县警视厅=Sở cảnh sát tỉnh Nagano
长野県=Tỉnh Nagano
三田総合病院=Bệnh viện Tổng hợp Mita
亀山=Kameyama
九郎岳遺跡=Di tích Kurogatake
青木原森林=Rừng Aokigahara
ダグバ=Daguba
长野县警察部=Sở cảnh sát tỉnh Nagano
天马形态=Hình thái Thiên Mã
警视庁=Sở Cảnh sát
滋集团=Nhóm Zuu
PolePoleコーヒー馆=Quán cà phê PolePole
夏目実加=Natsume Mika
達古巴=Daguba
未確認生命体=Unidentified Life Form
夏目教授=Giáo sư Natsume
台场=Odaiba
小冴=Sae
乌贼古朗基=Unizaurus Gurongi
食人鱼古朗基「魅·比婪·基」=Gurongi cá hổ Piranha "Me·Biran·Gi"
基德鲁腰带=Đai lưng Gegeru
恩·达古巴·杰巴=N-Daguva-Zeba
螳螂古朗基=Gurongi Bọ ngựa
基德鲁=Gegiru
东京若叶保育员=Nhân viên trông trẻ Wakaba, Tokyo
凄厉战士=Chiến binh kinh hoàng
未确认生命体22号=Sinh vật sống chưa xác định số 22
螳螂古朗基伽利玛=Mantis Gurongi Garima
魅集团古朗基=Me Group Gurongi
基德隆灵石=Linh thạch Kidoron
御殿场线=Gotenba Line
谷峨站=Gaga Station
山北町立花小学=Yamakita Tachibana Elementary School
Zio=Zio
犀牛古朗基=Rhino Gurongi
老虎古朗基=Tiger Gurongi
N集团=Tập đoàn N
风早小学=Trường Tiểu học Kazahaya
坂田区=Khu Sakata
夏目实加=Natsume Mika
新日本桥站=Ga Shin-Nihombashi
涉谷站=Ga Shibuya
新宿站=Ga Shinjuku
秋叶原站=Ga Akihabara
中央区马喰町站=Ga Bakurocho, quận Chuo
东京站=Ga Tokyo
千叶站=Ga Chiba
马喰町站=Ga Bakurochō
伽利玛=Galima
总武本线=Tổng Vũ Bản Tuyến
Me集团=Tập đoàn Me
白暗阶段=Giai đoạn trắng đen
全能骑士踢=Đá Hiệp sĩ Toàn năng
荒川区=Quận Arakawa
板桥区=Quận Itabashi
葛饰区=Quận Katsushika
葛·卜洛·古=Ge-Buroru-Gu
涉谷区=Shibuya-ku
卜洛=Bốc Lạc
蝙蝠古朗基=Dơi Gurongi
葛·查查璐·巴=Ge Chachiru Ba
卑弥乌=Bimyuu
太平二丁目富永公司总部大厦=Trụ sở chính Tòa nhà Công ty TNHH Tominaga, Taito 2-chome
猫头鹰古朗基=Cú Guronji
跃动追迹者=Rising Chaser
福泽大厦=Tòa nhà Fukuzawa
新宿警局=Sở cảnh sát Shinjuku
泰坦形态=Titan Form
伽美戈=Gamego
西工厂=Nhà máy phía Tây
假面骑士一号=Kamen Rider 1
哥莱姆灵石=Golem Stone
亚刻=Ark
雷克萨斯游泳学校=Trường bơi Lexus
水泽水上乐园=Công viên nước Mizusawa
幻景酒店=Khách sạn Mirage
神崎昭二=Kanzaki Shoji
栃木县=Tỉnh Tochigi
海豚泳馆=Hồ bơi Dolphin
革命进行曲=Bản hành khúc Cách mạng
袖浦海岸=Bãi biển Sodegaura
宗武海岸=Bãi biển Munetake
青龙棍=Gậy Rồng Xanh
蝶野润一=Chouno Junichi
食人鱼古朗基=Gurongi cá hổ piranha
魅集团=Nhóm Me
TryChaser2000A=TryChaser2000A
外浦海岸=Urakaigan
雾岛拓=Kirishima Taku
小稔=Minoru
海蛇古朗基=Hải Xà Gurongi
行政部长=Bộ trưởng hành chính
暴太郎战队=Avataro Sentai Donbrothers
究极初生=Ultimate Born
追迹者=TryChaser
葛·巴达·巴=Ge Badada Ba
基德隆腰带=Gedoron Belt
试验追迹者2000=Thí Nghiệm Người Truy Đuổi 2000
Drive驾驭表头=Drive Gia Ngự Biểu Đầu
门矢=Kadoya
Zu集团=Zu Group
未来逢魔时王=Oma Zi-O tương lai
品红色=Màu đỏ tía
假面骑士Geiz=Kamen Rider Geiz
假面骑士ZiO=Kamen Rider Zi-O
逢魔=Oma
时劫者=Time Jackers
Build=Build
异类甲斗=Another Kabuto
异类铠武=Another Gaim
异类Build=Another Build
异类大橙丸=Another Daidai Maru
明光院盖茨=Myōkōin Geiz
复活者驾驭表头=Revive RideWatch
时间极限剑=Saikyo Girade
庄吾=Trang Ngô
ZiO二阶=Zi-O Nhị Giai
异类ZiO二阶=Another Zi-O Nhị Giai
异类ZiO=Another Zi-O
加古川飞流=Kakogawa Hiryu
崇皇时王=Grand Zi-O
异类电王=Another Den-O
驾驭表头=Rider Watch
科技大厦=Tòa nhà Khoa học Công nghệ
三井会社=Công ty Mitsui
田崎秀二=Tasaki Shuji
葛集团最强三人=The Strongest Three of the Ge Group
究极初生空我=Ultimate Beginning Kuuga
全能型空我=All-Round Kuuga
亚极陀(AgitΩ)=Agito
饰玉老爹=Ông già Shodama
星之碎片=Mảnh vỡ Ngôi sao
基基鲁=Gegiru
白暗游戏=Trò chơi Hakuan
未确认生命体42号=Unidentified Lifeform No. 42
豪猪古朗基=Porcupine Gurongi
G1=G1
巴贝鲁=Baberu
伽雅泽=Gayaza
葛·伽雅泽·基=Ge-Gayaza-Gi
鲨鱼古朗基=Guarongi Cá Mập
蝗虫古朗基=Guarongi Châu Chấu
龟种古朗基=Gurongi Rùa
天马空我=Pegasus Form Kuuga
Ra集团=Tập đoàn Ra
升华之力=Sức mạnh Thăng Hoa
升华天马弩=Nỏ Thiên Mã Thăng Hoa
拉集团=Nhóm Ra
秃鹫古朗基=Gryphon Grongi
榎田教授=Giáo sư Enokida
法医鉴定科=Khoa Giám định Pháp y
水牛古朗基=Gurongi Trâu Nước
UltChaser(究极追迹者)=UltChaser
45号(水牛古朗基)=Số 45
GX机枪=Súng Máy GX
大BOSS=Trùm Cuối
TryChaser2000(试验追迹者2000)=TryChaser 2000
古贺政男=Koga Masao
Kamen Rider=Kamen Rider
葛·伽多鲁·巴=Ge Garudoruba
联合搜查部=Bộ phận Điều tra Liên hợp
奈奈酱=Nana-chan
凯罗帕=Kairoppa
Go集团=Tập đoàn Go
未确认生命体4号=Sinh vật chưa xác định số 4
港区东京塔=Tháp Tokyo khu Minato
葛集团=Tập đoàn Ge
基德隆=Kidlon
杉田=Sugita
惊异全能空我=Amazing Mighty Kuuga
九郎岳遗迹=Di tích Kurogatake
SIC=SIC
临多部落=bộ lạc Linto
長野県=Nagano
東都=Tokyo
警視庁=Sở Cảnh sát
一条薫=Ichijo Kaoru
杉田警官=Thanh tra Sugita
関東医大病院=Bệnh viện Y khoa Kanto
江東区=Koto
异类Decade=Another Decade
Decade驾驭表头=Decade Ridewatch
时空驱动器=Ziku-Driver
常磐庄吾=Tokiwa Sougo
亚玛达姆灵石=Amadam Stone
巴格达(baguda)=Baghdad
Agit欧米茄=Agit Omega
Agito=Agito
椿先生=Ông Tsubaki
神崎老师=Thầy Kanzaki
伽多鲁=Gadoru
假面骑士Decade(帝骑)=Kamen Rider Decade
ZiO世界=Thế giới ZiO
假面骑士甲斗=Kamen Rider Kabuto
Decade时空=Không gian Decade
Fangire=Fangire
zio=Zio
黑色空我=Kuga Đen
鱼人族=Người cá
科学怪人族=Quái vật Frankenstein
Ⅲ世=Thế hệ thứ 3
空我世界=Thế giới Kuuga
暗夜牙血鬼=Fangire Bóng Đêm
甲虫牙血鬼=Fangire bọ cánh cứng
亚古鲁前辈=Tiền bối Aguru
燕尾蝶牙血鬼=Fangire Bướm đuôi én
Kivat三世=Kivat III
Kivat=Kivat
假面骑士Abyss=Kamen Rider Abyss
辰巳真嗣=Tatsumi Shinji
幽灵螳螂=Bọ ngựa ma
龙骑世界=Thế giới Ryuki
时间降临卡牌=Thẻ Thời Gian Giáng Lâm
红心K幽灵螳螂=Bọ ngựa ma cơ K
初生空我=Growing Form Kuuga
水母Undead=Undead Sứa
狼蛛Undead=Undead Nhện sói
大兜虫=Kabutomushi/Bọ hung lớn
苍穹下的孤狼=Cang Qiong Xia De Gu Lang/Con sói cô độc dưới bầu trời
夏海=Natsumi
长野县九郎岳=Núi Kurou thuộc tỉnh Nagano
G3小组=Tổ G3
灯熔山=Núi Touyou
女王蚂蚁尊者=Nữ Vương Kiến Tôn Giả
异类亚极陀=Another Agito
品红骑士=Hiệp sĩ Crimson
狼族古朗基=Gurongi tộc Sói
全能形态=Dạng toàn năng
蚂蚁尊者=Ant Lord
八代蓝=Yashiro Ai
古朗基之王=Vua Gurongi
一条警官=Thanh tra Ichijo
奈奈=Nana
小稔稔=Komu Minoru
堤口惠美子=Tsutsumiguchi Emiko
灯熔山遗迹=Di tích núi Torō
傲慢之弓=Cung Ngạo Mạn
铅白豹尊者=Tôn giả Báo trắng chì
堤口夫人=Phu nhân Tsutsumiguchi
松仓部长=部長松倉
TryChaser2000=TryChaser2000
松仓贞雄=Sadao Matsukura
北条警官=Cảnh sát Hojo
试验追迹者=Thí Nghiệm Truy Tích Giả
丰岛区=Toshima
长崎公园=Công Viên Nagasaki
金铜龟尊者=Kim Đồng Quy Tôn Giả
银铜龟尊者=Ngân Đồng Quy Tôn Giả
白神普罗米斯=Hakushin Prometheus
美杉义彦=Misugi Yoshihiko
古政贺男=Komassa Heo Nam
追迹者2000=Tracer 2000
斗真(Theos)=Tōma
饰玉三郎=Osamu Saburo
审判之杖=Trượng Phán Quyết
哥莱姆=Golem
假面骑士亚极陀=Kamen Rider Agito
三云咲子=Mikumo Sakiko
欧帕兹研究所=Viện Nghiên cứu Ooparts
片平真由美=Katahira Mayumi
片平久雄=Katahira Hisao
G系统=Hệ thống G
G3-X系统=Hệ thống G3-X
警察部=Bộ phận Cảnh sát
龟山警部=Thanh tra Kameyama
G3系统=Hệ thống G3
乌鸦种属=Crow Genus
黑神斗真=Kurokami Touma
斗真=Touma
品川区=Quận Shinagawa
东京都警察厅=Sở Cảnh sát Thủ đô Tokyo
乌鸦尊者=Lord Crow
黑暗金属=Dark Metal
城北大学=Đại học Johoku
骸之镰=Hài Chi Liêm
水牛尊者=Minotaur Lord
独眼乌鸦尊者=Quạ Một Mắt Chúa Tể
亚极陀捕获计划=Kế hoạch bắt giữ Agito
九郎岳陨坑事件=Sự kiện Hố thiên thạch Cửu Lang Nhạc
未确认生命体档案=Hồ sơ Sinh vật chưa xác nhận
G系列=Dòng G
神经断裂弹=Đạn cắt thần kinh
豹尊者=Báo Tôn Giả
未确认生命体37号=Sinh vật chưa xác nhận số 37
未确认生命体47号=Sinh vật chưa xác nhận số 47
亚古鲁灵石=Aguile Stone
白色2号=White No. 2
白发乌鸦尊者=White-haired Raven Lord
秃顶乌鸦尊者=Bald Raven Lord
GX-05=GX-05
GS-03=GS-03
尸之刀=Corpse Blade
女王乌鸦尊者=Nữ Vương Quạ Tôn Giả
火天使=Thiên Sứ Lửa
G1装甲=Áo giáp G1
G挂车=Xe kéo G
未确认生命体46号=Sinh vật sống chưa xác định số 46
长野县=Tỉnh Nagano
B1号=Số B1
V带扣=Khóa V
忿怒之塔=Tháp Phẫn Nộ
津上家=Gia tộc Tsugami
笹山=Sasayama
泽木先生=Ông Sawaki
红心A=Át cơ
红心K=Già cơ
假面骑士Chalice=Kamen Rider Chalice
假面骑士Chalice(卡利斯)=Kamen Rider Chalice
狂野Chalice(卡利斯)=Wild Chalice
狂野斩击者=Wild Slasher
白色初生空我=White Proto Kuuga
Blay=Blay
假面骑士Garren(格连)=Kamen Rider Garren
假面骑士Blade=Kamen Rider Blade
Chalice=Chalice
黑桃A=Bích A
方块A=Rô A
黑桃K=Bích K
锯锹Undead=Undead Bọ Que Cưa
长颈鹿锯锹=Bọ Que Cưa Hươu Cao Cổ
BOARD=BOARD
方块10=Rô 10
方块K=Rô K
Garren=Garren
上城睦月=Kamijō Mutsuki
KingForm=KingForm
梅花Q=Chuồn Q
梅花K=Chuồn K
奈雀儿=Natsue
Leangle=Leangle
白井虎太郎=Shirai Kotaro
剑崎一真=Kenzaki Kazuma
岛升=Shima Noboru
蓝花楹咖啡店=Tiệm cà phê Jacaranda
栗原遥香=Kurihara Haruka
栗原天音=Kurihara Amane
Blue Spader(绀蓝黑桃)=Blue Spader
梅花A=Chuồn A
橘朔也=Tachibana Sakuya
BOARD研究所=Viện nghiên cứu BOARD
Garren觉醒器(醒枪)=Garren Awakener
广濑先生=Ông Hirose
TrialB=TrialB
广濑栞=Hirose Shiori
广濑义人=Hirose Yoshito
天王路=Tennouji
天王路博史=Tennouji Hiroshi
乌丸启=Karasuma Hajime
剑崎=Kenzaki
白井农场=Nông trại Shirai
相川始=Aikawa Hajime
蝎子尊者=Bọ Cạp Tôn Giả
冥府之斧=Minh Phủ Chi Phủ
松仓=Matsukura
关东医大病院=Bệnh viện Đại học Y Kanto
风谷老师=Thầy Kazatani
G4计划=Kế hoạch G4
真鱼=Mana
美杉家=Misugi Gia
翔一=Shoichi
美杉太一=Misugi Taiichi
川原一路=Kawahara Ichiro
东京警视厅=Sở Cảnh sát Thủ đô Tokyo
河野=Kouno
未确认生命体联合搜查部=Bộ phận Điều tra Chung về Sinh vật Sống Chưa được Xác nhận
G3挂车移动指挥室=Phòng chỉ huy di động xe moóc G3
深海里沙=Risa Fukami
秦王绕柱=Tần vương nhiễu trụ
超能力研究所=Viện nghiên cứu siêu năng lực
虎鲸天使=Thiên thần Orca
黄泉之镋=Hoàng Tuyền Chi Đảng
火焰军刀=Kiếm lửa
警卫追迹者=Người theo đuổi bảo vệ
蚂蚁女王尊者=Nữ hoàng kiến Tôn giả
可奈=Kana
Geiz=Geiz
G3装甲=Áo giáp G3
港口公寓=Căn hộ Cảng
时间降临=Thời Gian Giáng Lâm
樱井警官=Cảnh sát Sakurai
筱原佐惠子=Shinohara Saeko
未确认生命体事件=Vụ án sinh vật chưa xác định
木野薫=Kino Kaoru
葦原涼=Ashihara Ryo
真島浩二=Mashima Koji
松倉=Matsukura
澤木哲也=Sawaki Tetsuya
風谷真魚=Kazaya Mana
美杉=Misugi
紗綾香=Sayaka
绫香=Ayaka
泽木=Sawaki
河野警官=Cảnh sát Kawano
笹山望见=Sasayama Nozomi
G3训练室=Phòng Huấn luyện G3
尾室隆弘=Omiro Takahiro
小泽澄子=Ozawa Sumiko
津上府邸=Dinh thự Tsugami
胡狼尊者=Jackal Lord
橘纯=Tachibana Jun
关谷真澄=Quan Cốc Chân Trừng
黑色究极空我=Hắc Sắc Cứu Cực Không Ngã
怨嗟之堕=Oán Ta Chi Đọa
多摩江=Sông Tama
八王子区=Khu Hachioji
川原正=Kawahara Tadashi
外祖母悖论=Nghịch lý bà ngoại
珍珠贝牙血鬼=Pearl Fangire
小太牙=Tiểu Taiga
牙血鬼之王=Chúa tể Fangire
魔皇之铠=Áo giáp Ma Hoàng
暗黑Kiva=Dark Kiva
假面骑士Ixa=Kamen Rider Ixa
真夜=Maya
Dark Kiva=Dark Kiva
德伽=Dogga
巴夏=Basshaa
铃木深央=Suzuki Mio
德兰龙城堡=Lâu đài Doran
牙血鬼=Fangire
King=Vua
太牙=Taiga
神崎士郎=Shirō Kanzaki
津上=Tsugami
风谷小姐=Cô Phong Cốc
水之天使=Thiên sứ Nước
未确认生命体=Unidentified Life Form
猫头鹰尊者=Owl Lord
蜥蜴尊者=Lizard Lord
光之力=Power of Light
木野薰=Kino Kaoru
猎隼尊者=Falcon Lord
劫掠者机车=Raider Motorcycle
北条透=Hojo Toru
天亮号事件=Sự kiện tàu Tenrei
地之天使=Thiên sứ Đất
松仓先生=Ông Matsukura
临多=Rinto
饰玉=Kazutama
美杉教授=Misugi Giáo sư
虎鲸尊者=Hổ Kình Tôn Giả
螳螂尊者=Đường Lang Tôn Giả
G3-X装甲=Giáp G3-X
隅田公园=Công viên Sumida
多摩市警察部=Sở Cảnh sát thành phố Tama
劫掠者摩托车=Mô tô Cướp Bóc
黑暗蝗虫=Dark Hopper
风之上神=Phong chi Thượng Thần
怜悯之弓=Cung Thương Xót
地之上神=Địa chi Thượng Thần
亚古鲁符印=Agul Rune
七大上神尊者=Thất Đại Thượng Thần Tôn Giả
火之上神普罗米斯=Hỏa chi Thượng Thần Prometheus
水之上神=Thủy chi Thượng Thần
冰川城=Hikawa Makoto
火之天使=Hỏa Chi Thiên Sứ
上翔一=Tsukasa Shouichi
普罗米斯=Prometheus
冈村小姐=Cô Okamura
椿秀一=Tsubaki Shuichi
青龙空我=Dragon Form Kuuga
若叶幼儿园=Nhà trẻ Wakaba
城南大学=Đại học Jounan
津上先生=Tsugami
椿医生=Bác sĩ Tsubaki
机械龙卷者=Machine Tornado
榊亚纪=Sakaki Aki
泽渡樱子=Sawatari Sakurako
九郎岳=Kurougatake
可奈酱=Kana-chan
黑色2号=Black No. 2
G4装甲=Áo giáp G4
创世王=Sáng Thế Vương
究极升华空我=Ultimate Rising Kuuga
音效卡=Thẻ Âm Thanh
无效卡=Thẻ Vô Hiệu
牙蝙蝠族=Tộc Răng Dơi
假面骑士Kiva-la=Kamen Rider Kiva-la
杰克将军=Tướng Quân Jack
KamenRide=KamenRide
创世王影月=Vua Sáng Thế Kageyama
究极力量=Sức mạnh Tối thượng
地狱大使=Đại sứ Địa ngục
响尾蛇怪人=Quái nhân Rắn đuôi chuông
白色小蝙蝠=Dơi trắng nhỏ
世纪王影月=Thế Kỷ Vương Kageyama
地之石=Đá Đất
大修卡城堡=Lâu đài Đại Tu Tạp
假面骑士2号=Kamen Rider 2
假面骑士龙骑=Kamen Rider Ryuki
红色空我=Kuuga đỏ
究极形态=Hình thái Cực
升华究极空我=Siêu việt Ultimate Kuuga
撒旦军刀=Satan Saber
帝王石=Kingstone
假面骑士J=Kamen Rider J
假面骑士Kuuga=Kamen Rider Kuuga
假面骑士1号=Kamen Rider 1
假面骑士电王=Kamen Rider Den-O
假面骑士RX=Kamen Rider RX
大修卡组织=Tổ chức Dai-Shocker
月影信彦=Tsukikage Nobuhiko
小渡=Wataru
真嗣=Shinji
剑立一真=Tachibana Kazuma
尾上巧=Onoue Takumi
假面骑士Kiva=Kamen Rider Kiva
红音也=Otoya Kurenai
门矢小夜=Sayo Kadoya
死神博士=Doctor Shinigami
双重驱动器=Double Driver
Trigger=Trigger
夏蜜柑=Natsumikan
Queen=Queen
Decade驱动器=Decade Driver
时空之壁=Bức tường Không-Thời gian
暗之力=Sức mạnh Bóng tối
睦月安纱美=Mutsuki Asami
红渡=Wataru Kurenai
光氏秘技笑穴指=Tuyệt kỹ Tiếu Huyệt Chỉ của dòng họ Hikari
Skull=Skull
假面骑士Skull=Kamen Rider Skull
起始之夜=Đêm Khởi Đầu
川原一步=Kawahara Ayumu
极光帷幕=Màn cực quang
DCD事务=Công việc DCD
风都久保川=Kubokawa Futo
Faiz=Faiz
Masquerade=Masquerade
拟似记忆体=Giả Lập Memory
武器掺杂体=Arms Dopant
獠牙x王牌=FangJoker
Joker(王牌)=Joker
Fang(獠牙)=Fang
谢拉德=Sherard
獠牙王牌=Fang Joker
红色全能空我=Red Mighty Kuuga
漆黑JOKER=Black Joker
Taboo（禁忌）=Taboo
园咲雾彦=Sonozaki Kirihiko
久保川大厦=Tòa nhà Kubokawa
Nasca（纳斯卡）=Nasca
仓田剑二=Kurata Kenji
麻生冬美=Aso Fuyumi
双子怪盗=Song Tử Quái Đạo
回旋冲刺者号=Cyclone Dasher
禁忌记忆体=Taboo Memory
恐惧记忆体=Terror Memory
Taboo=Taboo
Smilodon=Smilodon
升华天马空我=Rising Pegasus Kuuga
全能空我=Ultimate Kuuga
Terror（恐惧）=Terror
狼族古朗基之王=Vua Gurongi tộc sói
W世界=Thế giới W
搀杂体=Dopant
风都电台=Đài Phát Thanh Fuuto
ClayDoll=ClayDoll
ClayDoll（泥娃娃）=ClayDoll
AttackRide=AttackRide
Gigant=Gigant
Metal=Metal
Clock Up=Clock Up
Final AttackRide=Final AttackRide
De-De-De-Decade=De-De-De-Decade
恐惧掺杂体=Terror Dopant
恐惧沼泽=Đầm lầy Khủng bố
Terror=Terror
园咲=Sonozaki
若菜公主=Công chúa Wakana
Fang=Fang
封印之石=Phong Ấn Thạch
Undead=Undead
园咲府邸=Dinh thự Sonozaki
W的世界=Thế giới W
川原先生=Ông Kawahara
园咲冴子=Sonozaki Saeko
须藤雾彦=Sudo Kirihiko
纳斯卡记忆体=Nazca Memory
DCD事务所=Văn phòng DCD
照井龙=Terui Ryu
Blade=Blade
基基鲁游戏=Gegiru Game
八王子驻地研究所=Viện nghiên cứu thường trú Hachioji
泽木雪菜=Sawaki Yukina
岗村老师=Thầy Okamura
苇原先生=Ngài Ashihara
木野先生=Ngài Kino
三浦智子=Miura Tomoko
科学警察研究所=Viện Nghiên Cứu Khoa Học Cảnh Sát
榎田=Enokida
PolePole咖啡馆=Quán cà phê PolePole
五代稔=Godai Minoru
朝比奈奈奈=Asahina Nana
饰玉店长=Quản lý tiệm trang sức ngọc
天亮号=Thiên Lượng Hào
未知生命体=Unknown Lifeform
未知生命体对策组=Nhóm Biện pháp Đối phó Sinh vật Chưa biết
科警研=Viện Nghiên cứu Khoa học Cảnh sát
G3小队=Đội G3
Gills劫掠者=Gills Raider
黑暗蝗虫号=Dark Hopper
Gills=Gills
超越形态=Beyond Form
PolePole=PolePole
Unknown=Unknown
岡村可奈=Okamura Kana
苇原=Ashihara
榎田女士=Enokida-san
榎田光=Enokida Hikari
真鱼酱=Mana-chan
风谷教授=Giáo sư Kazaya
真鱼小姐=Tiểu thư Mana
木野熏=Kino Kaoru
真岛浩二=Majima Koji
G3=G3
相良克彦=Sagara Katsuhiko
超越Gills=Exceed Gills
木野熏AgtiΩ=Kaoru Kino Agito
苇原凉=Ryo Ashihara
闪耀亚极陀=Shining Agito
暴风战戟=Storm Halberd
闪耀王剑=Shining Calibur
冰川诚=Hikawa Makoto
G3-X=G3-X
一条薰=Ichijo Kaoru
水城史朗=Mizushiro Shiro
G4=G4
多摩市=Thành phố Tama
纱绫香=Sayaka
风谷真鱼=Kazaya Mana
AgtiΩ=AgtiΩ
冈村可奈=Okamura Kana
江东区=Quận Koto
芭璐芭=Baluba
泽木哲也=Sawaki Tetsuya
星徒开关=Công tắc Stardust
黑暗星云=Tinh vân Hắc ám
川原愿=Kawahara Negai
大杉忠太=Osugi Chuta
贤吾=Kengo
悠木=Yuki
五代雄介=Godai Yusuke
津上翔一=Tsugami Shoichi
星座使徒开关=Zodiac Astro Switch
Three=Three
Two=Two
One=One
ZiO=Zi-O
X财团=Tập đoàn X
金毛恶鬼=Ác quỷ tóc vàng
弦太朗桑=Gentaro-san
汉堡套餐=Hamburger Set
假面骑士部=Câu lạc bộ Kamen Rider
切换者=Switcher
仙贝汤=Bánh gạo Senbei súp
园咲来人=Sonozaki Raimon
园咲琉兵卫=Sonozaki Ryubee
Nasca=Nasca
Weather=Weather
迷失驱动器=Lost Driver
Elek=Elek
JACK=JACK
神宫海藏=Jingu Kaizo
我望光明=Garou Izumi
天之川高校=Trường trung học Amanogawa
剑川虹=Kengawa Koji
天之川学园都市=Thiên Chi Xuyên Học Viện Đô Thị
Yummy=Yummy
博物馆组织=Tổ Chức Bảo Tàng
员工掺杂体=Nhân Viên Tham Tạp Thể
螳螂噬欲怪=Bọ Ngựa Phệ Dục Quái
独角仙噬欲怪=Bọ Cánh Cứng Phệ Dục Quái
泰坦空我=Titan Kuuga
岩浆掺杂体=Nham Tương Tham Tạp Thể
暴力掺杂体=Bạo Lực Tham Tạp Thể
核心开关=Hạch Tâm Khai Quan
究极之暗=Cực Hạn Hắc Ám
究极黑暗空我=Cực Ám Không Ngã
园咲若菜=Viên Tiếu Nhược Thái
地球巫女=Vu nữ Địa Cầu
禁忌掺杂体=Cấm kỵ tạp chất
纳斯卡掺杂体=Nazca tạp chất
UltChaser=UltChaser
JOKER=JOKER
Core Switch=Core Switch
细胞硬币=Cell Medal
天蝎座使徒=Scorpio Zodiarts
昴星高校=Subaru High School
Arcle盖亚记忆体=Arcle Gaia Memory
雷姆·康纳基=Rem Kannagi
核心硬币=Core Medal
驾驭贩卖号=Ride Vendor
鹰虎蝗联组=Taka Tora Batta Combo
猎户座星座使徒=Orion Zodiarts
蝘蜓座星座使徒=Chamaeleon Zodiarts
独角兽座星座使徒=Unicorn Zodiarts
猎犬座星座使徒=Canis Minor Zodiarts
锹螳蝗联组=Kuwagata Kamakiri Batta Combo
鹰雀鹫联组=Taka Kujaku Condor Combo
OOO驱动器=Driver OOO
未来核心硬币=Huy chương Cốt lõi Tương lai
狼鱼=Cá sói
假面骑士Nadeshiko=Kamen Rider Nadeshiko
斯沃鲁兹=Swartz
时空之力=Sức mạnh Thời Không
疾风王牌黄金极限形态=Phong Tật Vương Bài Hoàng Kim Cực Hạn Hình Thái
美咲抚子=Misaki Nadeshiko
Power=Power
鸣海庄吉=Narumi Soukichi
雄介=Yusuke
假面骑士kiva-la=Kamen Rider Kivala
kivatⅢ世=Kivat Đệ Tam
疾风王牌=Cyclone Joker
W驱动器=W Driver
极限疾风王牌=Cyclone Joker Xtreme
风都塔=Futo Tower
棱镜耀光（剑与盾）=Prism Bicker
耀光圣盾=Bicker Shield
Heat=Heat
Luna=Luna
海贼战队豪快红=Kaizoku Sentai Gokaiger
黄金极限=Gold Xtreme
崴尔兹·吉尔=Warz Gill
阿库德斯吉尔=Akudos Gill
戈冥=Gormin
康纳基=Connarky
星座开关=Astro Switches
大文字隼=Daimonji Shun
真剑者=Shinkenger
魔法连者=Magiranger
MAGI MAGI MAGIC=MAGI MAGI MAGIC
烈火凤凰=Inferno Phoenix
破里剑者=Hurricaneger
乾燥枪=Dryer Gun
残虐干部=Zangyack Cadre
豪快三叉戟=Gokai Trident
豪快戟=Gokai Spear
豪快粉=Gokai Pink
隐连者=Kakuranger
豪快手枪=Gokai Gun
残虐军队=Zangyack Army
五连者=Gorenger
戈冥战斗员=Chiến binh qua minh
豪快银=Gokai Silver
豪快黄=Gokai Yellow
露卡·米露菲=Luka Millfy
伊狩凯=Ikari Gai
修卡=Shocker
芦河翔一=Ashikawa Shoichi
天装战队=Tensou Sentai
Kiva-la=Kivala
天之川学园=Học viện Amanogawa
玉兔舱=Khoang Thỏ Ngọc
歌星贤吾=Utahoshi Kengo
Fourze驱动器=Fourze Driver
天文开关=Công tắc thiên văn
W硬汉号=Hardboilder
布雷多兰=Buredoran
Taka=Taka
Tora=Tora
Batta=Batta
未晴=Misora
机械冲天号=Machine Meteorstar
Cyclone=Cyclone
Joker=Joker
特命战队=Tokumei Sentai
大残虐帝国=Great Zangyack Empire
究极空我=Ultimate Kuuga
天装战队护星者=Thiên Trang chiến đội Hộ Tinh Giả
假面骑士亚古鲁=Giả Diện Kỵ Sĩ A Cổ Lỗ
护星红=Hộ Tinh Đỏ
露卡=Luka
爱姆=Ahim
假面骑士响鬼=Kamen Rider Hibiki
甲斗=Kabuto
东·德盖亚=Đông · Đức Cái Á
假面骑士Diend=Kamen Rider Diend
地球之井=Giếng Trái Đất
崴尔兹=Wels
影子将军=Tướng Quân Bóng Tối
世界的破坏者Decade=Kẻ hủy diệt thế giới Decade
升华泰坦剑=Kiếm Titan Thăng Hoa
大残虐军团=Đại Tàn Bạo Quân Đoàn
乌贼恶魔=Ác Ma Mực
泰坦剑=Kiếm Titan
骑士卡盒剑=Kiếm hộp thẻ Rider
阿库德斯=Akudosu
豪快蓝=Gokai Blue
豪快绿=Gokai Green
原桑=Hara-san
乔·吉布肯=Joe Gibken
Diend=Diend
天马弩=Pegasus Bowgun
Dummy=Dummy
Rocket On=Rocket On
漆黑空我=Kuga đen
豪快手机=Gokai Cellular
连者钥匙=Ranger Key
海贼战队=Kaizoku Sentai
豪快变身=Gokai Change
豪快马刀=Gokai Saber
克莱西斯要塞=Pháo đài Crisis
巨马战舰=Tàu chiến Kyoma
豪快者=Gokaiger
玛贝拉斯=Marvelous
假面骑士W=Kamen Rider W
假面骑士OOO=Kamen Rider OOO
假面骑士Fourze=Kamen Rider Fourze
BIG MACHINE=Cỗ máy Lớn
残虐帝国=Đế quốc Zangyack
大帝王=Đại Đế Vương
星座使徒=Apostle Chòm sao
掺杂体=Dopant
贪欲者=Greeed
噬欲怪=Yummy
豪快飞船=Gokai Galleon
左翔太郎=Hidari Shotaro
如月弦太朗=Gentaro Kisaragi
翔太郎=Shotaro
园咲家=Gia tộc Sonozaki
火野映司=Eiji Hino
泉比奈=Hina Izumi
鸣海侦探事务所=Văn phòng thám tử Narumi
究极黑暗=Ultimate Darkness
大残虐=Dai-Zangyack
钢铁之针=Kim châm sắt
豪快红=Gokai Red
园咲集团=Tập đoàn Sonozaki
大修卡=Dai Shocker
超级战队=Super Sentai
财团X=Tổ chức X
超银河王=Siêu Ngân Hà Vương
地球图书馆=Thư viện Địa Cầu
盖亚记忆体=Gaia Memory
Arcle记忆体=Arcle Memory
鸣海事务所=Văn phòng Narumi
W基地=Căn cứ W
光照相馆=Hiệu ảnh Hikari
鸣海亚树子=Narumi Akiko
小野寺雄介=Onodera Yusuke
Fourze世界=Thế giới Fourze
光夏海=Hikari Natsumi
光荣次郎=Hikari Eijiro
牙兰=Galan
机械十年号=Machine Decader
UltApple=Ult Apple
ArcleApple=Arcle Apple
BlackApple=Black Apple
假面骑士巴隆=Kamen Rider Baron
Zi-O=Zi-O
Gaim铠武=Gaim/Kaimu
Baron巴隆=Baron/Ba-ron
Ryugen（龙玄）=Ryugen
Gridon=Gridon
BadApple=BadApple
天之川=Thiên Chi Xuyên
Armored Rider=Armored Rider
Wizard=Wizard
武神OOO=Vũ Thần OOO
Kiva=Kiva
柳橙定锁种子=Orange Lock Seed
Orange=Orange
Lock On=Lock On
Soiya=Soiya
Orange Arms=Orange Arms
花道On Stage=Hanamichi On Stage
蜜瓜=Melon
Zangetsu=Zangetsu
风都=Fuuto
世界树集团=Yggdrasil Corporation
究极追迹者=Ultimate Chaser
猪笼草异域者=Inves Cây Nắp Ấm
亚古鲁腰带=Agul Belt
假面骑士魔法师=Kamen Rider Wizard
骑士指环=Nhẫn Hiệp Sĩ
驱纹戒斗=Kumen Kaito
蜜瓜能量=Năng lượng Dưa lưới
假面骑士斩月=Kamen Rider Zangetsu
蜜瓜防御盾=Khiên phòng ngự Dưa lưới
武神骑士=Vũ Thần Rider
晴人=Haruto
草莓定锁种子=Hạt giống Lock Strawberry
武神Wizard=Vũ Thần Wizard
Ichigo——Lock On！=Ichigo - Lock On!
Ichigo Arms！=Ichigo Arms!
咻咻地——Spark！=Shushu di - Spark!
草莓装甲=Strawberry Armor
假面骑士空我=Kamen Rider Kuuga
假面骑士Decade=Kamen Rider Decade
阿玛达姆=Amadam
假面骑士Beast=Kamen Rider Beast
武神W=Vũ Thần W
武神Fourze=Vũ Thần Fourze
假面骑士Wizard=Kamen Rider Wizard
Rider Kick=Rider Kick
门矢士=Kadoya Tsukasa
仁藤攻介=Nitou Kousuke
Beast=Beast
武神铠武=Vũ Thần Gaim
Sid（西德）=Sid
光实=Mitsuzane
链隙=Crack
异域者游戏=Trò chơi Inves
亚极陀=Agito
OOO=OOO
Fourze=Fourze
假面骑士铠武=Kamen Rider Gaim
异域者=Inves
Lock On！=Lock On!
Henshin～=Henshin～
Dragon——Lock On！=Dragon——Lock On!
Soiya！=Soiya!
Dragon Arms！=Dragon Arms!
战极凌马=Chiến Cực Lăng Mã
世界树塔=Thế Giới Thụ Tháp
创世纪驱动器=Sáng Thế Kỷ Khu Động Khí
黄金果实争夺战=Hoàng Kim Quả Thực Tranh Đoạt Chiến
Bad Apple=Bad Apple
铠武街舞团=Đội nhảy đường phố Gaimu
大橙丸=Daidaimaru
无双军刀=Musou Saber
铠武=Gaimu
Decade=Decade
Pine=Pine
葛叶纮太=Kazuraba Kouta
高司舞=Takatsukasa Mai
川原=Kawahara
葛叶纮汰=Katsuraba Kouta
DJ相良=DJ Sagara
吴岛贵虎=Kureshima Takatora
吴岛光实=Kureshima Mitsuzane
战极驱动器=Sengoku Driver
定锁种子=Lock Seed
西瓜定锁种子=Watermelon Lock Seed
火龙果定锁种子=Dragon Fruit Lock Seed
赫尔海姆之森=Heim Helheim Forest
世界树财团=Yggdrasil Corporation
沢芽市=Zawame City
假面骑士龙玄=Kamen Rider Ryugen
起源之女=Maiden of Beginning
