AC尼尔森=AC Nielsen
CMFU=CMFU
Rebellion=Rebellion
T-BAG=T-BAG
ixa=ixa
jessaphy=jessaphy
kiva=kiva
一个系统=một hệ thống
一到五=một đến năm
一到五号=số một đến năm
一号外挂=số 1 hack
一号老者=Lão giả số một
一失神=vừa thất thần
一拜大年=Nhất Bái Đại Niên
一指帮=Nhất Chỉ Bang
一烟冰=Nhất yên băng
一百斤=năm mươi cân
一石居酒楼=Nhất Thạch Cư tửu lâu
一级浮屠=Nhất Cấp Phù Đồ
一线香=Nhất Tuyến Hương
一辉=Nhất Huy¦Ikki
丁坚=Đinh Kiên
丁字巷=Hẻm chữ Đinh
丁寒=Đinh Hàn
丁春茹=Đinh Xuân Như
丁蟹=Đinh Giải
丁香巷=Hẻm Đinh Hương
七宝玄丹=Thất Bảo Huyền Đan
七情宝树=Thất Tình Bảo Thụ
七旋真斩=Thất Toàn Chân Trảm
七星轩=Thất Tinh Hiên
七虎=Thất Hổ
七里坡=Thất Lí Pha
万卷堂=Vạn Quyển Đường
万松堂=Vạn Tùng Đường
万民血书=Vạn Dân Huyết Thư
万里悲秋常作客=Vạn lý bi thu thường tác khách
万雷阁=Vạn Lôi Các
丈八骨矛=Trượng Bát Cốt Mâu
三叶=Tam Diệp
三号=số 3
三大坊=Tam Đại Phường
三嫂子=Tam tẩu tử
三寺=Tam Tự
三山镇=Tam Sơn Trấn
三岔口驿站=Tam Xá Khẩu Dịch Trạm
三峡大坝=Đập Tam Hiệp
三皇子李承平=Tam hoàng tử Lý Thừa Bình
三石=Tam Thạch
三石大师=Tam Thạch đại sư
三级浮屠=Tam Cấp Phù Đồ
三角枫树=Tam Giác Phong Thụ
三首龙=Tam Thủ Long¦rồng ba đầu
三首龙王=Tam Thủ Long Vương
上京太学=Thượng Kinh Thái Học
上官祥云=Thượng Quan Tường Vân
上杉破=Thượng Sam Phá
上杉虎=Thượng Sam Hổ
上阳=Thượng Dương
上阳世家=Thượng Dương Thế Gia
上阳久=Thượng Dương Cửu
上阳乾坤功=Thượng Dương Càn Khôn Công
上阳冲=Thượng Dương Xung
上阳城=Thượng Dương Thành
上阳城主=Thượng Dương Thành chủ
上阳宇=Thượng Dương Vũ
上阳潮=Thượng Dương Triều
上阳烈=Thượng Dương Liệt
上阳焌=Thượng Dương Tuấn
上阳礼=Thượng Dương Lễ
上阳胤=Thượng Dương Dận
上阳芸=Thượng Dương Vân
上阳虎=Thượng Dương Hổ
上阳血脉=Thượng Dương Huyết Mạch
上阳詹=Thượng Dương Chiêm
上阳雪=Thượng Dương Tuyết
上阳鞅=Thượng Dương Ưởng
不死秘境=Bất Tử Bí Cảnh
不群师兄=Bất Quần sư huynh
且听龙吟=Lại Nghe Long Ngâm
世子弘成=Thế Tử Hoằng Thành
世子李弘成=Thế tử Lý Hoằng Thành
丙国=Bính Quốc
丙坊=Bính Phường
东夷剑=Đông Di Kiếm
东夷剑庐=Đông Di Kiếm Lư
东宫皇后=Đông Cung Hoàng Hậu
东山庙=Đông Sơn Miếu
东山路=Đông Sơn Lộ
东川路=Đông Xuyên Lộ
东方敬=Đông Phương Kính
东界王神=Đông Kaioshin
东顾城剑庐=Đông Cố Thành Kiếm Lư
东龙西凤北豹=Đông Long Tây Phượng Bắc Báo
东龙西凤南虎北豹=Đông Long Tây Phượng Nam Hổ Bắc Báo
两人之外=hai người bên ngoài
两位高人=hai vị cao nhân
严江=Nghiêm Giang
中书=Trung Thư
中书台=Trung Thư Đài
临庐=Lâm Lư
丹菊=Đan Cúc
之澜=Chi Lan
乐兴贤=Nhạc Hưng Hiền
乔仙仙=Kiều Tiên Tiên
乔玲玉=Kiều Linh Ngọc
乙四房=Ất Tứ phòng
乙国=Ất Quốc
乙坊=Ất Phường
九号青年=Cửu Hào thanh niên
九天甘露=Cửu Thiên Cam Lộ
九曲十弯八尽头=Cửu Khúc Thập Loan Bát Tẫn Đầu
九棵松=Cửu Khoa Tùng
九樱果=Quả Cửu Anh
九级浮屠=Cửu Cấp Phù Đồ
九花客栈=Cửu Hoa Khách Sạn
九阳无量=Cửu Dương Vô Lượng
九阴归元功=Cửu Âm Quy Nguyên Công
九龙帮=Cửu Long Bang
书文=thư văn
乱春园=Loạn Xuân Viên
乾州=Càn Châu
了欲=Liễu Dục
了空中=không trung
二五仔=tên khốn kiếp¦gián điệp¦kẻ phản bội¦phản đồ¦nội gian
二十八里坡=28 dặm sườn nuối
二号=số 2
二帮=hai bang
二甲进士=Nhị Giáp Tiến sĩ
二皇子府=Nhị Hoàng Tử Phủ
二祭祀=Nhị Tế Tự
二级浮屠=Nhị Cấp Phù Đồ
二虎滩=Nhị Hổ Than
二道村=Nhị Đạo Thôn
于二娘=Vu Nhị Nương
于寿先=Vu Thọ Tiên
于正云=Vu Chính Vân
于秀英=Vu Tú Anh
于老二=Vu lão nhị
于老哥=Vu lão ca
于老大=Vu lão đại
于老英雄=Vu lão anh hùng
云台之上=Vân Đài bên trên
云大家=Vân Đại Gia
云大才子=Vân Đại Tài Tử
云姑=Vân Cô
云姥=Vân Mụ
云梦鱼=Vân Mộng Ngư
云水宫=Vân Thủy Cung
云睿=Vân Duệ
云雀镇=Vân Tước Trấn
五号外挂=số 5 hack
五品官员=ngũ phẩm quan viên
五峰采花=Ngũ Phong Thái Hoa
五更冷=Ngũ Canh Lãnh
五竹叔=Ngũ Trúc thúc
五级浮屠=Ngũ Cấp Phù Đồ
五绝斧法=Ngũ Tuyệt Phủ Pháp
五色骨=Ngũ Sắc Cốt
五蕴宗=Ngũ Uẩn Tông
五路神=Ngũ Lộ Thần
五里峡=Ngũ Lí Hạp
些人的心=trái tim của một số người
亦德=Diệc Đức
京中范府=Kinh Trung Phạm Phủ
京华江南=Kinh Hoa Giang Nam
京外=Ngoại kinh
京志=Kinh Chí
京船=Kinh Thuyền
京西苍山=Kinh Tây Thương Sơn
京都司南伯爵府=Kinh Đô Tư Nam Bá Tước phủ
京都回春堂=Kinh Đô Hồi Xuân Đường
京都守备军方=Kinh Đô Thủ Bị Quân Phương
京都守备师=Kinh Đô Thủ Bị Sư
京都守备条例=Điều lệ phòng thủ kinh đô
京都庆庙=Kinh Đô Khánh Miếu
京都府丞=Kinh Đô Phủ Thừa
京都府尹=Kinh Đô phủ doãn
京都府尹孙家=Kinh Đô Phủ Doãn Tôn Gia
京都府尹梅执礼=Kinh Đô Phủ Doãn Mai Chấp Lễ
京都府尹田靖牧=Kinh Đô phủ doãn Điền Tĩnh Mục
京都府衙=Kinh Đô Phủ Nha
京都新风馆=Kinh Đô Tân Phong Quán
京都监察院=Kinh Đô Giám Sát Viện
人在旅途=Nhân Tại Lữ Đồ
人的尸体=người thi thể
什么东西绊了下=cái gì đó vấp ngã
什图海草甸=Thập Đồ Hải Thảo Điện
从武当=từ Võ Đang
令狐醉鬼=Lệnh Hồ Túy Quỷ
任伟=Nhậm Vĩ
任伯安=Nhậm Bá An
任少安=Nhậm Thiếu An
任正卿=Nhậm Chính Khanh
伊周=Y Chu
伍佰=Ngũ Bách
伍麦=Ngũ Mạch
伏波娃=Phục Ba Oa
伏犀骨=Phục Tê Cốt
伏虎帮=Phục Hổ Bang
伯公庙=Miếu Bá Công
伯爵别府=Bá tước biệt phủ
何七干=Hà Thất Càn
何三喜=Hà Tam Hỉ
何中群=Hà Trung Quần
何咏志=Hà Vịnh Chí
余佻=Dư Thiêu
余佻州=Dư Thiêu Châu
余月红=Dư Nguyệt Hồng
侯三儿=Hầu Tam Nhi
侯咏志=Hầu Vịnh Chí
侯季常=Hầu Quý Thường
俊美无俦=tuấn mỹ vô cùng
俞副总兵=Du phó tổng binh
俞门穴=Du Môn huyệt
俞龙=du long
信阳离宫=Tín Dương Ly Cung
信阳长公主=Tín Dương Trưởng công chúa
修巳=Tu Tị
倪冬月=Nghê Đông Nguyệt
傅季风=Phó Quý Phong
傅家坡=Phó Gia Pha
傅彩娥=Phó Thải Nga
傅长春=Phó Trường Xuân
元以中=Nguyên Dĩ Trung
元台=Nguyên Đài
元善镇=Nguyên Thiện Trấn
元敬=Nguyên Kính
元春=Nguyên Xuân
元老会领事大臣=Nguyên lão hội Lãnh sự Đại thần
元鼎山=Nguyên Đỉnh Sơn
先天武者=Tiên Thiên võ giả
先帝爷=Tiên Đế Gia
党骁波=Đảng Tiêu Ba
全蝎肉=Toàn Hạt nhục
八品协律郎=Bát Phẩm Hiệp Luật Lang
八家将=Bát Gia Tướng
八尺宣花板斧=Bát Xích Tuyên Hoa Bản Phủ
六号外挂=số 6 hack
六处剑手=Lục Xứ Kiếm Thủ
六级浮屠=Lục Cấp Phù Đồ
六路总督=Lục Lộ Tổng Đốc
六部三司=Lục Bộ Tam Tư
兰石=Lan Thạch
兰花姐=Lan Hoa tỷ
关妩媚=Quan Vũ Mị
关宗才=Quan Tông Tài
关杰=Quan Kiệt
关河山=Quan Hà Sơn
兵圣真域=Binh Thánh Chân Vực
典师弟=Điển sư đệ
典韋=Điển Vi
内库三大坊=Nội khố tam đại phường
内库衙门=Nha Môn Nội Khố
内库转运副使=Nội Khố Chuyển Vận Phó Sứ
内库转运司=Nội Khố Chuyển Vận Tư
内库运使司正使=Nội Khố Vận Sử Tư Chính Sử
冥药师=Minh Dược Sư
冬暖轩=Đông Noãn hiên
冰火城=Băng Hỏa Thành
冰煞魔功=Băng Sát Ma Công
冰珺=Băng Quận
冲儿小心=Xung nhi cẩn thận
冷霜掌=Lãnh Sương Chưởng
冷面判官=Lãnh Diện Phán Quan
净乐堂=Tịnh Lạc Đường
净心白莲露=Tịnh Tâm Bạch Liên Lộ
凌提督=Lăng Đề đốc
凝翠崖=Ngưng Thúy Nhai
凝霜宝录=Ngưng Sương Bảo Lục
凝霜寒劲=Ngưng Sương Hàn Kính
几叶=Kỷ Diệp
凡人世界=phàm nhân thế giới
凤床=Phượng Sàng
凤珠=Phượng Châu
凤珠姑娘=Phượng Châu Cô Nương
凤辣子=Phượng Lạt Tử
凶人谷=Hung Nhân Cốc
刀剑镇=Đao Kiếm Trấn
刁蛇功=Điêu Xà Công
分身乏术=không cách nào phân thân
刑部十三衙门=Hình bộ Thập Tam Nha Môn
刑部尚书颜行书=Hình Bộ Thượng Thư Nhan Hành Thư
刘元冲=Lưu Nguyên Xung
刘大厨=Lưu Đại Trù
刘天寒=Lưu Thiên Hàn
刘忠俊=Lưu Trung Tuấn
刘朝海=Lưu Triều Hải
刘章=Lưu Chương
刘阮=Lưu Nguyễn
别的师兄弟=những sư huynh đệ khác
刽子王=Quái Tử Vương
剑庐首徒=Kiếm Lư Thủ Đồ
剑气冲霄=Kiếm Khí Trùng Tiêu
副使马楷=Phó Sứ Mã Khải
副招抚使=Phó Chiêu Phủ Sứ
力沉象步=lực trầm tượng bộ
加库玛=Gakuma¦Gia Khố Mã
劳德=lao đức¦Lord
劳德洛=Lao Đức Lạc
勾弋夫人=Câu Dặc phu nhân
包自守=Bao Tự Thủ
化木神功=Hóa Mộc Thần Công
化木老祖=Hóa Mộc Lão Tổ
化木门=Hóa Mộc Môn
化生之术=Hóa Sinh Chi Thuật
化龙的=hóa long
北三司=Bắc Tam Tư
北冲平原=Bắc Xung Bình Nguyên
北围=Bắc Vi
北大营=Bắc Đại Doanh
北方大都督=Bắc Phương Đại Đô Đốc
北海雾=Bắc Hải Vụ
北牢关=Bắc Lao Quan
北营=Bắc Doanh
北豹=Bắc Báo
北镇抚司=Bắc Trấn Phủ Ti
北门天关=Bắc Môn Thiên Quan
北魏国=Bắc Ngụy Quốc
北齐上京=Bắc Tề Thượng Kinh
北齐上京城=Bắc Tề Thượng Kinh thành
北齐公主=Công chúa Bắc Tề
北齐国=Bắc Tề Quốc
北齐圣女=Bắc Tề Thánh Nữ
北齐大公主=Bắc Tề Đại Công Chúa
北齐大公长=Bắc Tề Đại Công Chúa
北齐太后=Bắc Tề Thái Hậu
北齐小皇帝=Bắc Tề Tiểu Hoàng Đế
北齐朝廷=Triều Đình Bắc Tề
北齐锦衣卫=Cẩm Y Vệ Bắc Tề
匡广荣=Khuông Quảng Vinh
十三城门司=Thập Tam Thành Môn Tư
十三衙门=Thập Tam Nha Môn
十大凶人=Thập Đại Hung Nhân
十方拳=Thập Phương Quyền
千手老鬼=Senju Lão quỷ
千浪异血=Thiên Lãng Dị Huyết
千浪诀=Thiên Lãng Quyết
千羽山=Thiên Vũ Sơn
千羽风魔劲=Thiên Vũ Phong Ma Kính
千金阁=Thiên Kim Các
千钧重斧=Thiên Quân Trọng Phủ
半闲斋=Bán Nhàn Trai
半闲斋书话=Bán Nhàn Trai thư thoại
半闲斋诗话=Bán Nhàn Trai thi thoại
半闲斋诗集=Bán Nhàn Trai thi tập
华山那边=Hoa Sơn bên kia
华扁鹊=Hoa Biển Thước
华玲玲=Hoa Linh Linh
华英宫=Hoa Anh Cung
华阳门=Hoa Dương Môn
协律郎=Hiệp Luật Lang
卓大长老=Trác Đại trưởng lão
卓春华=Trác Xuân Hoa
单于速必达=Đơn Vu Tốc Tất Đạt
单臂擎天=Đan Tí Kình Thiên
单达=Đan Đạt
南原=Nam Nguyên
南庆使节=Nam Khánh Sứ Tiết
南虎=Nam Hổ
南衙十二卫=Nam Nha Thập Nhị Vệ
南陵郡=Nam Lăng Quận
卜沉=Bốc Trầm
卫太后=Vệ Thái Hậu
卫少卿=Vệ Thiếu Khanh
卫英宁=Vệ Anh Ninh
卫青阳=Vệ Thanh Dương
卷云府=Quyển Vân Phủ
卷气书斋=Quyển Khí Thư Trai
厉英武=Lệ Anh Vũ
双峰镇=Song Phong trấn
双营=Song Doanh
双锏无情=Song Giản Vô Tình
口中了= trong miệng
古尔多=Cổ Nhĩ Đa
古明真=Cổ Minh Chân
古玉宝=Cổ Ngọc Bảo
台阶上=bậc thang bên trên
史阐立=Sử Xiển Lập
史震象=Sử Chấn Tượng
史飞=Sử Phi
史黑虎=Sử Hắc Hổ
叶参将=Diệp Tham Tướng
叶守备=Diệp Thủ Bị
叶家小姐=Diệp Gia Tiểu Thư
叶秦两家=Diệp Tần Lưỡng Gia
叶秦二家=Diệp Tần nhị gia
叶重大人=Diệp Trọng đại nhân
叶韬=Diệp Thao
司凌妇人=Tư Lăng phu nhân
司南伯家=Tư Nam Bá gia
司南伯府=Tư Nam Bá Phủ
司南伯爵别府=Tư Nam Bá Tước Biệt Phủ
司南伯范建=Tư Nam Bá Phạm Kiến
司库=Tư Khố
司祺=Tư Kỳ
吃了一半=ăn một nữa
吃瘪=ăn quả đắng
各位朋友=các vị bằng hữu
合阑亭=Hợp Lan Đình
吉云祥=Cát Vân Tường
吉州=Cát Châu
同文阁=Đồng Văn Các
名明=tên Minh
向士高=Hướng Sĩ Cao
吕思思=Lữ Tư Tư
吕炎玉=Lữ Viêm Ngọc
吕长生=Lữ Trường Sinh
吕麒麟=Lữ Kỳ Lân
君临广场=Quân Lâm quảng trường
君山会=Quân Sơn Hội
吟风阁=Ngâm Phong Các
含光殿=Hàm Quang Điện
含巧=Hàm Xảo
吴三两=Ngô Tam Lưỡng
吴星野=Ngô Tinh Dã
吴格非=Ngô Cách Phi
吴雪宁=Ngô Tuyết Ninh
吸星大·法=Hấp Tinh Đại · Pháp
周士南=Chu Sĩ Nam
周家小姐=Tiểu thư Chu
周松=Chu Tùng
周流水劲=Chu Lưu Thủy Kình
周流真水=Chu Lưu Chân Thủy
和亲王妃=Hòa Thân Vương Phi
和亲王府=Hòa Thân Vương Phủ
和亲王爷=Hòa thân vương gia
和气宗=và Khí tông
哈尼死=Cáp Ni Tử
哑娘子=Ách Nương Tử
哥尔赞=Gorzan¦Ca Nhĩ Tán
商友平=Thương Hữu Bình
喀尔纳=Khách Nhĩ Nạp
嗜血老魔=Thị Huyết Lão Ma
四号外挂=số 4 hack
四合村=Tứ Hợp thôn
四品居中郎=Tứ phẩm Cư Trung Lang
四方客栈=Tứ Phương Khách Sạn
四祺=Tứ Kỳ
四褀=Tứ Kỳ
四象教=Tứ Tượng Giáo
四顾剑决=Tứ Cố Kiếm Quyết
四顾剑法=Tứ Cố Kiếm Pháp
回天功=Hồi Thiên Công
国公巷=Hạng Quốc Công
国师苦荷=Quốc sư Khổ Hà
土地神张文德=Thổ Địa Thần Trương Văn Đức
地级初期锻骨=Địa Cấp Sơ Kỳ Đoán Cốt
基多拉=Ghidorah
墨香斋=Mặc Hương Trai
墨香阁=Mặc Hương Các
声音速度=thanh âm tốc độ
夏容道=Hạ Dung Đạo
夏时=Hạ Thời
夏明氏=Hạ Minh Thị
夏明氏的商队=Hạ Minh Thị thương đội
夏明记=Hạ Minh Ký
夏栖飞=Hạ Tê Phi
夏荷院=Hạ Hà viện
多姑娘=Đa cô nương
夜天明=Dạ Thiên Minh
夜子羽=Dạ Tử Vũ
夜殿=Dạ Điện
夜魈=Dạ Tiêu
大东山=Đại Đông Sơn
大东边=Đại Đông Biên
大人的对手=đại nhân đối thủ
大古=Đại Cổ¦Daigo
大宁坊=Đại Ninh Phường
大宁府=Đại Ninh Phủ
大宣=Đại Tuyên
大庆国=Đại Khánh Quốc
大庆朝=Đại Khánh Triều
大有师兄=Đại Hữu sư huynh
大湖城=Đại Hồ Thành
大王妃=Đại Vương Phi
大理寺副卿=Đại Lý Tự Phó Khanh
大理寺少卿=Đại Lý Tự Thiếu Khanh
大皇妃=Đại Hoàng Phi
大皇子府=Đại Hoàng Tử Phủ
大祚=Đại Tộ
大蛟=đại giao
大通坊=Đại Thông Phường
大青树=Đại Thanh Thụ
大青玉=Đại Thanh Ngọc
大魏天子剑=Đại Ngụy Thiên Tử Kiếm
大魏朝=Đại Ngụy Triều
大魏添子剑=Đại Ngụy Thiêm Tử Kiếm
天一道=Thiên Nhất Đạo
天一道大庙=Thiên Nhất Đạo Đại Miếu
天一道心法=Thiên Nhất Đạo Tâm Pháp
天一道门=Thiên Nhất Đạo Môn
天元玄指=Thiên Nguyên Huyền Chỉ
天元门=Thiên Nguyên Môn
天南城门司=Thiên Nam Thành Môn Tư
天地交征阴阳大悲赋=Thiên Địa Giao Chinh Âm Dương Đại Bi Phú
天寒师兄=Thiên Hàn sư huynh
天心台=Thiên Tâm Đài
天承县=Thiên Thừa Huyện
天松师弟=Thiên Tùng sư đệ
天河大路=Thiên Hà đại lộ
天河大道=Thiên Hà Đại Đạo
天河道=Thiên Hà Đạo
天祥缎=Thiên Tường Đoạn
天秀弧光剑法=Thiên Tú Hồ Quang Kiếm Pháp
天脊山=Thiên Tích Sơn
天裳间=Thiên Thường Gian
太乙分光=Thái Ất Phân Quang
太刀门=Thái Đao Môn
太医正=Thái y chính
太史明月=Thái Sử Minh Nguyệt
太后娘娘=Thái hậu nương nương
太后老祖宗=Thái Hậu Lão Tổ Tông
太子东宫=Đông cung Thái tử
太子承乾=Thái Tử Thừa Càn
太子李承乾=Thái Tử Lý Thừa Càn
太学司业=Thái Học Tư Nghiệp
太学奉正=Thái học Phụng Chính
太学正=Thái Học Chính
太师祖根尘=Thái Sư Tổ Căn Trần
太常寺协律郎=Thái Thường Tự Hiệp Luật Lang
太常寺少卿=Thái Thường Tự Thiếu Khanh
太常寺正卿=Thái Thường Tự Chính Khanh
太平别庄=Thái Bình Biệt Trang
太平钱庄=Thái Bình Tiền Trang
太极大殿=Thái Cực điện
太郎帮=Thái Lang Bang
夷洞天=Di Động Thiên
夷种=Di Chủng
夹竹道=Giáp Trúc Đạo
夹落岛=Giáp Lạc Đảo
夺魂镖=Đoạt Hồn Tiêu
奈何烧我宝玉=Nại hà thiêu ngã Bảo Ngọc
奈良一族=tộc Nara
奉正=Phụng Chính
奚官局=Ty Khí Quan
女人嘴角=nữ nhân khoé miệng
女人大喜=nữ nhân vui mừng
奴骨=Nô Cốt
好霸道的功法=thật là bá đạo công pháp
如意书斋=Như Ý Thư Trai
妙华=Diệu Hoa
姚太监=Diêu thái giám
姚莉=Diêu Lị
姹女映月神功=Xá Nữ Ánh Nguyệt Thần Công
娄琪美=Lâu Kỳ Mỹ
嫁衣诀=Giá Y Quyết
子澄爵府=Tử Trừng Tước Phủ
孔曰成仁，孟曰取义=Khổng viết thành nhân, Mạnh viết thủ nghĩa
孙吉祥=Tôn Cát Tường
孙家小姐=Tôn gia tiểu thư
孙悟饭=Son Gohan
孙敬修=Tôn Kính Tu
孙熊诸氏=Tôn Hùng Chư Thị
孙颦儿=Tôn Tần Nhi
孟守先=Mạnh Thủ Tiên
孟棣=Mạnh Đệ
孤云山=Cô Vân Sơn
孤云山庄=Cô Vân Sơn Trang
学会了空翻=học xong lộn mèo
宁修巳=Ninh Tu Tị
宁大姑=Ninh Đại Cô
宁妃=Ninh Phi
宁玉环=Ninh Ngọc Hoàn
宁行之=Ninh Hành Chi
宁行云=Ninh Hành Vân
宁行空=Ninh Hành Không
宁贵嫔=Ninh Quý Tần
宁赤练=Ninh Xích Luyện
宇文定=Vũ Văn Định
宇文屁股=Vũ Văn mông
宇文阔=Vũ Văn Khoát
安仁坊=An Nhân phường
安翠=An Thúy
宋世仁=Tống Thế Nhân
宋国州城=Tống Quốc Châu Thành
宋嫂鱼羹=Tống Tẩu ngư canh
宋教头=Tống giáo đầu
宋锦成=Tống Cẩm Thành
宋长工=Tống Trường Công
宗追=Tông Truy
官雄=Quan Hùng
定州军=Định Châu Quân
定州叶家=Định Châu Diệp Gia
定州大都督=Định Châu Đại Đô Đốc
定青二州=Định Thanh Nhị Châu
宜贵嫔=Nghi Quý tần
宝血树=Bảo Huyết Thụ
宝鹃=Bảo Quyên
宣花板斧=Tuyên Hoa Bản Phủ
宫坊司=Cung Phường Tư
宰相公卿=Tể tướng công khanh
宰相大人=Tể tướng đại nhân
家小=vợ con¦vợ
寇梅=Khấu Mai
富嘴=Phú Chủy
富嘴儿=Phú Chủy Nhi
富岳大人=Fugaku đại nhân
富春县=Phú Xuân Huyện
寒冰刀=Hàn Băng Đao
寒冰手=Hàn Băng Thủ
寒派=Hàn Phái
寒香派=Hàn Hương Phái
寒香谷=Hàn Hương Cốc
寒鹰帮=Hàn Ưng Bang
封了侯=phong hầu
将军骨=Tướng Quân Cốt
小史=Tiểu Sử
小娄巷=Tiểu Lâu Hạng
小宦官=tiểu hoạn quan
小梁国=Tiểu Lương Quốc
小洪公公=Tiểu Hồng công công
小溪上游=dòng suối nhỏ thượng du
小白蛟龙=tiểu bạch giao long
小秦大人=Tiểu Tần đại nhân
小范大人=Tiểu Phạm đại nhân
小范夫人=Tiểu Phạm phu nhân
小范院长=Viện trưởng Tiểu Phạm
小言公子=Tiểu Ngôn công tử
小言大人=Tiểu Ngôn đại nhân
小通河=Tiểu Thông Hà
小闲闲=Tiểu Nhàn Nhàn
小陈国=Tiểu Trần Quốc
小雪谷=Tiểu Tuyết Cốc
小韦=Tiểu Vi
少卿任少安=Thiếu Khanh Nhậm Thiếu An
少安=Thiếu An
尚书巷=Thượng Thư Hạng
尚盈盈=Thượng Doanh Doanh
尹叔华=Doãn Thúc Hoa
尹家小姐=Doãn Gia Tiểu thư
尹玉娥=Doãn Ngọc Nga
屠呦呦=Đồ U U
山东路银钱司=Sơn Đông Lộ Ngân Tiền Tư
山中一族= tộc Yamanaka
山甲肉=Sơn Giáp Nhục
山阳冲=Sơn Dương Trùng
岑月娇=Sầm Nguyệt Kiều
岭南熊家=Lĩnh Nam Hùng Gia
岳、宁夫妇=Nhạc , Ninh vợ chồng
崔天虎=Thôi Thiên Hổ
崔天豹=Thôi Thiên Báo
崔家行=Thôi Gia Hành
崔清泉=Thôi Thanh Tuyền
崔芷慧=Thôi Chỉ Tuệ
崤山冲=Hào Sơn Trùng
崩云乱=Băng Vân Loạn
巡抚江南路=Tuần Phủ Giang Nam Lộ
工部员外郎=Công Bộ Viên Ngoại Lang
左丘一之=Tả Khâu Nhất Chi
左五房=Phòng số năm bên trái
左六房=Phòng số sáu bên trái
左副都御使=Tả Phó Đô Ngự Sử
左右二贤王=Tả Hữu Nhị Hiền Vương
左右谷益王=Tả Hữu Cốc Ích Vương
巧姐=Xảo Tỷ
巨人的名字=cự nhân danh tự
巨鳌骨=Cự Ngao Cốt
巴比迪=Babidi
巴陵郡=Ba Lăng Quận
布尔凯索=Bul-Kathos¦Bố Nhĩ Khải Tác¦Bourkeso
布武天下=bố võ thiên hạ
师傅了=sư phụ
师傅的=sư phụ
师兄的错误=lỗi của sư huynh
带花花=mang Hoa Hoa
席风山=Tịch Phong Sơn
帮闲记=Bang Nhàn Ký
平了=bình¦bằng
平安镇=Bình An Trấn
并连山=Tịnh Liên Sơn
幽花=U Hoa
广信宫=Quảng Tín Cung
广惠库=Quảng Huệ Khố
庄墨韩=Trang Mặc Hàn
庄大家=Trang Đại Gia
庄氏评论集=Trang Thị Bình Luận Tập
庄贤公=Trang Hiền Công
庆人=Người Khánh
庆历七年=Khánh Lịch 7 năm
庆历九年=Khánh Lịch Cửu Niên
庆历二年=Khánh Lịch 2 năm
庆历五年=Khánh Lịch 5 năm
庆历八年=Khánh Lịch 8 năm
庆历六年=Khánh Lịch 6 năm
庆历十一年=Khánh Lịch 11 năm
庆历十年=Khánh Lịch 10 năm
庆国朝廷=Khánh Quốc Triều Đình
庆国皇后=Khánh Quốc Hoàng Hậu
庆国监察院=Giám Sát Viện Khánh Quốc
庆庙大祭祀=Khánh Miếu Đại Tế Tự
庆律=Khánh Luật
庘=giá
庞九平=Bàng Cửu Bình
庞全安=Bàng Toàn An
弘毅公=Hoằng Nghị Công
张九阳=Trương Cửu Dương
张乾坤=Trương Càn Khôn
张妙玉=Trương Diệu Ngọc
张子乾=Trương Tử Càn
张家店=Trương Gia Điếm
张忘尘=Trương Vong Trần
张文德=Trương Văn Đức
张演员=Diễn viên Trương
张灵玉=Trương Linh Ngọc
张萌萌=Trương Manh Manh
张言之=Trương Ngôn Chi
张贤亮=Trương Hiền Lượng
归阳功=Quy Dương Công
归阳劲=Quy Dương Kính
彭亭生=Bành Đình Sinh
彭园=Bành Viên
彭氏庄园=Bành thị trang viên
影竹苑=Ảnh Trúc Uyển
征北军=Chinh Bắc Quân
征北大营=Chinh Bắc Đại Dinh
征北大都督=Chinh Bắc Đại Đô Đốc
征北营=Chinh Bắc Doanh
征西军=Chinh Tây Quân
徐崖主=Từ Nhai Chủ
徐曹=Từ Tào
徐水英=Từ Thủy Anh
得将=phải đem¦đắc tướng
御前官司=Ngự Tiền Quan Ty
御史贺宗纬=Ngự Sử Hạ Tông Vĩ
御史郭铮=Ngự Sử Quách Tranh
御山道=Ngự Sơn Đạo
忠骨=Trung Cốt
怀远大将军=Hoài Viễn Đại Tướng Quân
思亲堂=Tư Thân Đường
恐魔教=sợ Ma giáo
恒山脚下=Hằng Sơn chân núi
悬空庙=Huyền Không Miếu
意难平=ý nan bình
戌北神策军=Tuất Bắc Thần Sách Quân
成佳林=Thành Giai Lâm
成朴竹=Thành Phác Trúc
成西林=Thành Tây Lâm
战明月=Chiến Minh Nguyệt
战清风大师=Chiến Thanh Phong đại sư
战豆豆=Chiến Đậu Đậu
戴思成=Đái Tư Thành
才仔=Tài Tử
执笔御史=Chấp Bút Ngự Sử
承运库=Thừa Vận Khố
把仙刀=thanh Tiên Đao
抖动了=run run¦đẩu động¦run rẩy
抖动了下=lắc xuống
抱日楼=Bão Nhật Lâu
抱月楼=Bão Nguyệt Lâu
招商钱庄=Chiêu Thương Tiền Trang
拜大年=Bái Đại Niên
掌一处=Chưởng Nhất Xứ
提司大人=Đề Tư Đại Nhân
提费先生=Đề Phí tiên sinh
提运司=Đề Vận Ty
搬山功=Bàn Sơn Công
搬山劲=Bàn Sơn Kính
搬山勁=Bàn Sơn Kình
搬山异血=Bàn Sơn Dị Huyết
搬山派=Ban Sơn Phái
搬山门=Bàn Sơn Môn
搬山骨劲=Bàn Sơn Cốt Kính
搬山魔猿=Bàn Sơn Ma Viên
摇摇头说道=lắc lắc đầu nói
教育院=Giáo Dục Viện
敬畏的=kính sợ¦kính uý
文书阁=Văn Thư Các
文云=Văn Vân
文英总校处=Văn Anh Tổng Hiệu Xứ
文茂=Văn Mậu
斗战神=Đấu Chiến Thần
斧兄=Phủ huynh
斩蛟龙=trảm Giao Long
斩钉刀法=Trảm Đinh Đao Pháp
新槐巷=Tân Hòe Hạng
新街口=Tân Nhai Khẩu
新风馆=Tân Phong Quán
方励=Phương Lệ
方廷石=Phương Đình Thạch
方氏兄弟=Phương thị huynh đệ
方觉=Phương Giác
方达人=Phương Đạt Nhân
方连昌=Phương Liên Xương
方龙野=Phương Long Dã
施提督=Thi Đốc
施辟宝=Thi Bích Bảo
无上大力杵法=Vô Thượng Đại Lực Xử Pháp
无恙=không việc gì¦khoẻ mạnh¦không thiệt hại
无招剑书=Vô Chiêu Kiếm Thư
无明火劲=Vô Minh Hỏa Kính
无明烈焰掌=Vô Minh Liệt Diễm Chưởng
无明神功=Vô Minh Thần Công
无相劲=Vô Tướng Kính
无相异血=Vô Tướng Dị Huyết
日角骨=Nhật Giác Cốt
日轮石=Đá Nhật Luân
昌运城=Xương Vận Thành
明七公子=Minh thất công tử
明七少=Minh Thất Thiếu
明七少爷=Minh Thất Thiếu Gia
明七爷=Minh Thất Gia
明三爷=Minh Tam Gia
明业=Minh Nghiệp
明二爷=Minh Nhị gia
明六爷=Minh Lục Gia
明兰石=Minh Lan Thạch
明孙熊=Minh Tôn Hùng
明少东=Minh Thiếu Đông
明少爷=Minh Thiếu Gia
明氏商行=Minh Thị Thương Hành
明老七=Minh lão thất
明老三=Minh lão tam
明老六=Minh Lão Lục
明老太君=Minh Lão Thái Quân
明老太爷=Minh lão thái gia
明老爷=Minh Lão gia
明老爷子=Minh lão gia tử
明银=Minh Ngân
明青城=Minh Thanh Thành
明青达=Minh Thanh Đạt
易筋境=Dịch Cân Cảnh
星光三黎础宁=Tinh Quang Tam Lê Sở Ninh
星野=Tinh Dã¦Hoshino
映秀=Ánh Tú
映秀烧鸡=Ánh Tú Thiêu Kê
映蓉=Ánh Dung
春日野一辉=Kasugano Ikki
春林=Xuân Lâm
春闱案=Xuân Vi án
晚亭=Vãn Đình
晨妹妹=Thần muội muội
晨姐姐=Thần tỷ tỷ
晨郡主=Thần Quận Chúa
景星庆云=Cảnh Tinh Khánh Vân
景阳门=Cảnh Dương Môn
暗影堂=Ám Ảnh Đường
暗香虫=Ám Hương Trùng
曲向东=Khúc Hướng Đông
更俗=Canh Tục
曹之达=Tào Chi Đạt
曹在邦=Tào Tại Bang
曹山川=Tào Sơn Xuyên
曹胡=Tào Hồ
曾少安=Tằng Thiếu An
曾文祥=Tằng Văn Tường
曾缘=Tằng Duyên
月牙海=Nguyệt Nha Hải
月角骨=Nguyệt Giác Cốt
有多特殊=có bao nhiêu đặc thù
有求必应屋=Hữu Cầu Tất Ứng Phòng
朔冬=Sóc Đông
望了望天色=nhìn sắc trời một chút
望春门=Vọng Xuân Môn
木槿茶=Mộc Cẩn Trà
木蓬=Mộc Bồng
朱占彪=Chu Chiêm Bưu
朱又玄=Chu Hựu Huyền
朱开雄=Chu Khai Hùng
朱彦秀=Chu Ngạn Tú
朱春宝=Chu Xuân Bảo
朱本宗=Chu Bản Tông
朱本渊=Chu Bản Uyên
朱格=Chu Cách
朱荃=Chu Thuyên
朱贵生=Chu Quý Sinh
朱逵=Chu Quỳ
李云睿=Lý Vân Duệ
李伯华=Lý Bá Hoa
李弘子=Lý Hoằng Tử
李杜苏三=Lý Đỗ Tô Tam
李棋师=Lý Kỳ Sư
李氏皇族=Lý thị hoàng tộc
李洪松=Lý Hồng Tùng
李浩源=Lý Hạo Nguyên
李玉成=Lý Ngọc Thành
李离思=Lý Ly Tư
李红素=Lý Hồng Tố
李老杜=Lý Lão Đỗ
李长志=Lý Trường Chí
李阔=Lý Khoát
杏云=Hạnh Vân
杜刚=Đỗ Cương
杜十三=Đỗ Thập Tam
来华山=đến Hoa Sơn
来天骄=đến thiên kiêu
杨攻城=Dương Công Thành
杨百刀=Dương Bách Đao
杨继美=Dương Kế Mỹ
杭州会=Hàng Châu Hội
杭州知州=Hàng Châu Tri Châu
松居酒楼=Tùng Cư Tửu Lâu
松干赞普=Tùng Càn Tán Phổ
松林包=Tùng Lâm Bao
松林镇=Tùng Lâm Trấn
松永贞德=Tùng Vĩnh Trinh Đức
松芝仙令=Tùng Chi Tiên Lệnh
松芝王女=Tùng Chi Vương Nữ
松鹤居=Tùng Hạc Cư
极上山庄=Cực Thượng Sơn Trang
极火老人=Cực Hỏa Lão Nhân
极火邪功=Cực Hỏa Tà Công
极火鸟=Cực Hỏa Điểu
林大宝=Lâm Đại Bảo
林宰相=Lâm Tể tướng
林家二公子=Lâm Gia Nhị Công Tử
林家姐姐=Lâm gia tỷ tỷ
林晨儿=Lâm Thần Nhi
林湛恩=Lâm Trạm Ân
林相爷=Lâm tướng gia
林竹镇=Lâm Trúc Trấn
枢密副使秦恒=Xu Mật Phó Sứ Tần Hằng
枢密院参谋部=Xu Mật Viện Tham Mưu Bộ
枢密院正使=Xu Mật Viện Chính Sử
柔嘉小郡主=Nhu Gia Tiểu Quận Chúa
柔嘉郡主=Nhu Gia Quận Chúa
柳国公=Liễu Quốc Công
柳国公府=Liễu Quốc Công Phủ
柳如玉=Liễu Như Ngọc
柳师傅=Liễu sư phó
柳恒=Liễu Hằng
柳氏府=Liễu Thị Phủ
柳氏忠毅国府=Liễu thị Trung Nghị Quốc phủ
柳池=Liễu Trì
柳河清=Liễu Hà Thanh
柳锦玉=Liễu Cẩm Ngọc
格格猪=Cách Cách Trư
桂离坊=Quế Ly Phường
桑威=Tang Uy
桔梗=Kikyou
梁点点=Lương Điểm Điểm
梅圃夹院=Mai Phố Giáp Viện
梦如花=Mộng Như Hoa
梦蝶师姐=Mộng Điệp sư tỷ
梧桐巷=Ngô Đồng Hạng
梵圣金功=Phạn Thánh Kim Công
梵圣金劲=Phạn Thánh Kim Kính
梵圣门=Phạn Thánh Môn
检蔬司=Kiểm Thư Ty
椒仔肉=Thịt tiêu tử
楠竹苑=Nam Trúc Uyển
楼上楼=Lâu Thượng Lâu
横亘天气=vắt ngang thiên khí
橙花=Hoa cam
檀郎=Đàn Lang
次里=Thứ Lí
欧藏华=Âu Tàng Hoa
欲罗汉=Dục La Hán
正卿=Chính Khanh
正气异血=Chính Khí Dị Huyết
正阳门=Chính Dương Môn
步千军=Bộ Thiên Quân
武骨=võ cốt
残影盗=Tàn Ảnh Đạo
段三=Đoạn Tam
段黑虎=Đoạn Hắc Hổ
殷正行=Ân Chính Hành
殿前欢尽须断肠=Điện Tiền Hoan Tận Tu Đoạn Trường
毅公府=Nghị Công phủ
毒蛇帮=Độc Xà Bang
毛阅良=Mao Duyệt Lương
气升龙舞=khí thăng long vũ
水天楼=Thủy Thiên Lâu
水运总督衙门=Thủy Vận Tổng Đốc Nha Môn
永夜之庙=Vĩnh Dạ Chi Miếu
永宁坊=Phường Vĩnh Ninh
永耀集=Vĩnh Diệu Tập
永陶长公主=Vĩnh Đào Trưởng công chúa
汉武道=Hán Vũ Đạo
汗郯城=Hãn Đàm Thành
汗阳城=Hãn Dương Thành
江一草=Giang Nhất Thảo
江北大营=Giang Bắc Đại Dinh
江北路=Giang Bắc Lộ
江南三大坊=Giang Nam Tam Đại Phường
江南内库=Giang Nam Nội Khố
江南居=Giang Nam Cư
江南总督=Giang Nam Tổng Đốc
江南总督府=Giang Nam Tổng đốc phủ
江南总督薛清=Tổng đốc Giang Nam Tiết Thanh
江南明家=Gia tộc họ Minh ở Giang Nam
江南水寨=Giang Nam Thủy Trại
江南水师=Giang Nam Thủy Sư
江南行=Giang Nam Hành
江南路=Giang Nam Lộ
江南路总督薛清=Tổng Đốc Tiết Thanh Giang Nam Lộ
江南路总督衙门=Giang Nam Lộ Tổng Đốc Nha Môn
江左清吏司=Giang Tả Thanh Lại Tư
江府一案=Vụ án Giang phủ
江景山=Giang Cảnh Sơn
江景行=Giang Cảnh Hành
江达聪=Giang Đạt Thông
池太问=Trì Thái Vấn
池音=Trì Âm
汪元亭=Uông Nguyên Đình
沈婉儿=Thẩm Uyển Nhi
沈守备=Thẩm Thủ Bị
沈家姑娘=Thẩm gia cô nương
沈指挥使=Thẩm Chỉ Huy Sứ
沐三琊=Mộc Tam Gia
沐全安=Mộc Toàn An
沐冰清=Mộc Băng Thanh
沐尚千=Mộc Thượng Thiên
沐尚白=Mộc Thượng Bạch
沐府=Mộc Phủ
沐恩重=Mộc Ân Trọng
沐昆山=Mộc Côn Sơn
沐氏寒派=Mộc Thị Hàn Phái
沐氏水派=Mộc Thị Thủy Phái
沐水生=Mộc Thủy Sinh
沐渺远=Mộc Diểu Viễn
沐重=Mộc Trọng
沐风儿=Mộc Phong Nhi
沙一策=Sa Nhất Sách
沙州别院=Sa Châu Biệt Viện
沙州城=Sa Châu Thành
沙州客栈=Sa Châu Khách Sạn
沙河街=Sa Hà Nhai
沙湖=Sa Hồ
沙湖水师=Sa Hồ Thủy Sư
沧州城=Thương Châu Thành
沧州路=Thương Châu Lộ
河工衙门=Hà Công Nha Môn
河洛帮=Hà Lạc Bang
河运总督衙门=Hà Vận Tổng Đốc Nha Môn
泉州孙家=Tuyền Châu Tôn Gia
泉州水师=Tuyền Châu thủy sư
泰塔尼克号=Titanic
泰杰=thái kiệt¦Tyje
泺州=Lạc Châu
洗岛=Tẩy Đảo
洗衣坊=Giặt Y Phường
洛东道=Lạc Đông Đạo
洛川帮=Lạc Xuyên bang
洞室=động thất
洪亦青=Hồng Diệc Thanh
洪四庠=Hồng Tứ Tường
洪四痒=Hồng Tứ Dạng
洪竹=Hồng Trúc
洪老公公=Hồng Lão công công
流云世叔=Lưu Vân Thế Thúc
流云散手=Lưu Vân Tán Thủ
流星锁链锤=Lưu tinh tỏa liên chùy
流晶河=Lưu Tinh Hà
流苏坊=Lưu Tô Phường
浑天真阳功=Hồn Thiên Chân Dương Công
浣衣坊=Hoán Y Phường
浣衣局=Hoán Y Cục
浮光七色鹿=Phù Quang Thất Sắc Lộc
浮木居士=Phù Mộc Cư Sĩ
海府=Hải phủ
海棠依旧在=Hải Đường Y Cựu Tại
海棠姑娘=Hải Đường cô nương
海棠朵朵=Hải Đường Đóa Đóa
海棠朵要=Hải Đường Đóa Yếu
海焕光=Hải Hoán Quang
淡州=Đạm Châu
淡泊公=Đạm Bạc Công
淮上=Hoài Thượng
深正道=Thâm Chính Đạo
清乐坊=Thanh Nhạc Phường
清心池=Thanh Tâm Trì
清远禅师=Thanh Viễn Thiền Sư
清香朵朵=Thanh Hương Đóa Đóa
温若玉=Ôn Nhược Ngọc
渴望到了=khao khát đã đến
游天行=Du Thiên Hành
游山问道=du sơn vấn đạo
溷元书院=Hỗn Nguyên Thư Viện
溷元功=Hỗn Nguyên Công
溷元四杰=Hỗn Nguyên Tứ Kiệt
漱芳宫=Sấu Phương Cung
潘天飞=Phan Thiên Phi
潘郎=Phan Lang
潘龄大学士=Phan Linh Đại Học Sĩ
潘龄老=Phan Linh Lão
潜龙湾=Tiềm Long Loan
澄海子爵府=Trừng Hải Tử Tước Phủ
澹州城=Đạm Châu Thành
澹州港=Đạm Châu Cảng
澹泊书局=Đạm Bạc Thư Cục
澹泊医馆=Đạm Bạc Y Quán
澹菊花茶=Đạm Cúc Hoa Trà
火炬奇树=Hỏa Cự Kỳ Thụ
火烛杖=Hỏa Chúc Trượng
火狐狸=Hỏa Hồ Ly
火神丹=Hỏa Thần Đan
火神幻影=Hỏa Thần Huyễn Ảnh
火腿丁=Hăm băm nhỏ
灯市口=Ngõ Chợ Đèn¦Đăng Thị Khẩu
灰太狼=lão sói xám¦Khôi Thái Lang¦Lão Sói Xám
灵玉师兄=Linh Ngọc sư huynh
灵鹤门=Linh Hạc Môn
烈日游龙掌=Liệt Nhật Du Long Chưởng
無明火勁=Vô Minh Hỏa Kình
焦子恒=Tiêu Tử Hằng
焦阳镇=Tiêu Dương Trấn
熊百龄=Hùng Bách Linh
燕京大营=Yến Kinh Đại Dinh
燕大都督=Yến đại đô đốc
燕小艺=Yến Tiểu Nghệ
燕山崖=Yên Sơn Nhai
燕慎独=Yến Thận Độc
燕红凤=Yến Hồng Phượng
燕都督=Yến Đô đốc
爆血丹=Bạo Huyết Đan
牛兴鸿=Ngưu Hưng Hồng
牛堡主=Ngưu bảo chủ
牛娟儿=Ngưu Quyên Nhi
牛家堡=Ngưu Gia Bảo
牛家岭=Ngưu Gia Lĩnh
牛敬武=Ngưu Kính Vũ
牢州=Lao Châu
特莱=Đặc Lai¦Telai
狄宏图=Địch Hoành Đồ
狼骨帮=Lang Cốt Bang
猎园=Liệp Viên
猛子哥=Mãnh Tử ca
猫腻宇宙=Vũ trụ Mèo Lười
玄冥毒=Huyền Minh Độc
玄冥花=Huyền Minh Hoa
玄冥龟=Huyền Minh Quy
玄春海神=Huyền Xuân Hải Thần
玄水龟=Huyền Thủy Quy
玄级锻骨=Huyền Cấp Đoán Cốt
玄羽门=Huyền Vũ Môn
玄蛇藤=Huyền Xà Đằng
玄蛇藤浆液=Huyền Xà Đằng Tương Dịch
玉山城=Ngọc Sơn Thành
玉泉河=Ngọc Tuyền Hà
王倦=Vương Quyện
王十三郎=Vương Thập Tam Lang
王啸林=Vương Khiếu Lâm
王啸林府邸=Vương Khiếu Lâm Phủ Để
王坠儿=Vương Trụy Nhi
王大都督=Vương Đại Đô Đốc
王妃叶灵儿=Vương Phi Diệp Linh Nhi
王巧巧=Vương Xảo Xảo
王教头=Vương giáo đầu
王曈=Vương Đồng
王曈儿=Vương Đồng Nhi
王海东=Vương Hải Đông
玛索索=Mã Tác Tác
玲婆婆=Linh bà bà
玲珑棋子=Cờ Linh Lung
珙儿=Củng Nhi
琅玡州=Lang Nha Châu
理贵妃=Lý Quý Phi
瑯琊郡=Lang Nha Quận
瑶华宫=Diêu Hoa Cung
瑶州=Dao Châu
瓦弄巷=Ngõ Ngõa Lộng
甄宝玉=Chân Bảo Ngọc
甘谢=Cam Tạ
生活在异界=Sinh Hoạt Tại Dị Giới
生龙活虎的模样=bộ dáng mạnh như rồng như hổ
田大泽=Điền Đại Trạch
田陵候=Điền Lăng Hầu
田靖牧=Điền Tĩnh Mục
甲一房=Giáp Nhất phòng
甲区=Giáp Khu
甲四号=Giáp Tứ Hào
甲国=Giáp Quốc
甲坊=Giáp Phường
申冲文=Thân Xung Văn
申时=giờ Thân
留宿谷=Lưu Túc Cốc
疏义郎=Sơ Nghĩa Lang
疤虎包三爷=Sẹo Hổ Bao Tam Gia
疯人剑=Phong Nhân Kiếm
疾风螳螂刀=Tật Phong Đường Lang Đao
瘦湖=Sấu Hồ
登闻院=Đăng Văn Viện
白参=Bạch Tham
白名媛=Bạch Danh Viện
白子夜=Bạch Tử Dạ
白当=làm chùa
白桦巷=Bạch Hoa Hạng
白玉君子树=Bạch Ngọc Quân Tử Thụ
白眉鹰侠=Bạch Mi Ưng Hiệp
白眼瞳力=Bạch Nhãn đồng lực
白英=Bạch Anh
白袖招=Bạch Tụ Chiêu
白阳宗=Bạch Dương Tông
白骨岛=Đảo Bạch Cốt
白鹤门=Bạch Hạc Môn
百叶镇=Bách Diệp Trấn
百岁松居=Bách Tuế Tùng Cư
百拳会=Bách Quyền Hội
百草养骨丹=Bách Thảo Dưỡng Cốt Đan
的真域=chân vực
皇商=Hoàng Thương
皇商内库=Hoàng Thương Nội Khố
皇室别院=Hoàng Thất Biệt Viện
皇家虎卫=Hoàng Gia Hổ Vệ
盐市口=Diêm Thị Khẩu
监察院八处=Giám Sát Viện Bát Xứ
监察院六处=Giám Sát Viện Lục Xứ
监察院提司=Giám sát viện đề ty
监察院院长=Giám sát viện Viện trưởng
盘州=Bàn Châu
盛怀仁=Thịnh Hoài Nhân
瞎大师=Hạt Đại Sư
瞎子叔=Hạt Tử Thúc
瞿伯庄=Cù Bá Trang
石头皇兄=Thạch Đầu Hoàng Huynh
石清儿=Thạch Thanh Nhi
石牌村=Thạch Bài Thôn
石碌=Thạch Lộc
碎骨帮=Toái Cốt Bang
碧涛门=Bích Đào Môn
礼部员外郎=Lễ Bộ Viên Ngoại Lang
礼部尚书郭攸之=Lễ Bộ Thượng Thư Quách Du Chi
祝万里=Chúc Vạn Lý
祝余安=Chúc Dư An
神兵魔刃=Thần Binh Ma Nhận
神针记=Thần Châm Ký
禁军大统领=Cấm Quân Đại Thống Lĩnh
福堂=Phúc Đường
秀水街=Tú Thủy Nhai
秉承天命=tuân theo thiên mệnh
秋园小楼=Thu Viên tiểu lâu
秋风阁=Thu Phong các
秦叶两家=Tần Diệp 2 nhà
秦小将军=Tần tiểu tướng quân
秦恒=Tần Hằng
秦淑莲=Tần Thục Liên
秦玉春=Tần Ngọc Xuân
程副卿=Trình Phó Khanh
程巨树=Trình Cự Thụ
竹园馆=Trúc Viên Quán
糜花鹿=My Hoa Lộc
紫兆国=Tử Triệu Quốc
紫珠草=Tử Châu Thảo
紫竹苑=Tử Trúc Uyển
紫莲肉=Tử Liên Nhục
紫轩仙帝=Tử Hiên Tiên Đế
紫铜宝镜=Tử Đồng Bảo Kính
紫阳之气=Tử Dương Chi Khí
紫霞功=Tử Hà Công
红山口=Hồng Sơn Khẩu
红月蜂=Hồng Nguyệt Phong
红袖招=Hồng Tụ Chiêu
红袖添香夜读书=Hồng Tụ Thiêm Hương Dạ Độc Thư
纪姬=Kỷ Cơ
纽约剑修=New York Kiếm Tu
练筋篇=Luyện Cân Thiên
绝命镇=Tuyệt Mệnh Trấn
绣衣局=Tú Y Cục
绿光珠=Lục Quang Châu
绿液池=Lục Dịch Trì
绿竹别院=Lục Trúc Biệt Viện
罗元俊=La Nguyên Tuấn
罗桑实=La Tang Thực
罗田岛=La Điền Đảo
罗真真=La Chân Chân
羊葱巷=Dương Thông Hạng
美人游=Mỹ Nhân Du
翁花狼肉=Ông Hoa lang nhục
老书斋=Lão thư trai
老人家好意=lão nhân gia hảo ý
老军部=Lão Quân Bộ
老叶家=Lão Diệp gia
老叶掌柜=Lão Diệp Chưởng Quỹ
老崔家=Lão Thôi Gia
老林府=Lão Lâm Phủ
老秦大人=Lão Tần đại nhân
老秦家=Lão Tần Gia
老秦将军=Lão Tần Tướng Quân
老翡翠=Lão Phỉ Thúy
老范家=Lão Phạm Gia
老范尚书=Lão Phạm Thượng Thư
老衡居=Lão Hành Cư
老诚王=Lão Thành Vương
老跛子=Lão quái dị
老都察院=Lão Đô Sát Viện
老黄头=Lão Hoàng Đầu
聚味阁=Tụ Vị Các
聚沙门=Tụ Sa Môn
肖今=Tiêu Kim
肥花猫=Phì Hoa Miêu
肾门雪山=Thận Môn Tuyết Sơn
胡二娘=Hồ Nhị Nương
胡学士=Hồ học sĩ
胡悦=Hồ Duyệt
胡舒=Hồ Thư
胡苏=Hồ Tô
胡虚之=Hồ Hư Chi
胡金林=Hồ Kim Lâm
胶东路=Giao Đông Lộ
胶州府=Giao Châu Phủ
胶州水师=Giao Châu thủy sư
胶州知州吴格非=Giao Châu Tri châu Ngô Cách Phi
舒学士=Thư học sĩ
舒老头儿=Thư Lão Đầu Nhi
舒胡=Thư Hồ
舒芜=Thư Vu
舒芜大学士=Thư Vu đại học sĩ
良哥儿=Lương Ca Nhi
艳骨=Diễm Cốt
花南星=Hoa Nam Tinh
花慕云=Hoa Mộ Vân
花慕容=Hoa Mộ Dung
花梦舞=Hoa Mộng Vũ
花梦蝶=Hoa Mộng Điệp
花燕荣=Hoa Yến Vinh
花玲珑=Hoa Linh Lung
花琼=Hoa Quỳnh
花盼容=Hoa Phán Dung
花素清=Hoa Tố Thanh
花芬=Hoa Phân
花茗薇=Hoa Mính Vi
花蕊芳=Hoa Nhụy Phương
花蝶梦=Hoa Điệp Mộng
花蝶舞=Hoa Điệp Vũ
花雨晴=Hoa Vũ Tình
花香楼=Hoa Hương Lâu
芸香草=Vân Hương Thảo
苍山别业=Thương Sơn biệt nghiệp
苍山别院=Thương Sơn Biệt Viện
苍山雪=Thương Sơn Tuyết
苍桐镇=Thương Đồng trấn¦Thương Đồng Trấn
苏凤=Tô Phượng
苏凤二女=Tô Phượng nhị nữ
苏妩媚=Tô Vũ Mị
苏姚=Tô Diêu
苏婉晴=Tô Uyển Tình
苏家宅院=Tô Gia Trạch Viện
苏家小姐=Tô Gia Tiểu Thư
苏少久=Tô Thiếu Cửu
苏州千总=Tô Châu Thiên Tổng
苏州城内库转运司=Tô Châu Thành Nội Khố Chuyển Vận Tư
苏州府衙=Tô Châu Phủ Nha
苏州港=Cảng Tô Châu
苏州知州=Tri Châu Tô Châu
苏敬贤=Tô Kính Hiền
苏文茂=Tô Văn Mậu
苏瑜=Tô Du
苏远江=Tô Viễn Giang
苗万涛=Miêu Vạn Đào
苗东岩=Miêu Đông Nham
苗人蛮=Miêu Nhân Man
若甫=Nhược Phủ
若若姐=Nhược Nhược tỷ
苦玄肉=Khổ Huyền nhục
苦竹苑=Khổ Trúc Uyển
苦老光头=Khổ Lão Đầu Trọc
苦荷国师=Khổ Hà Quốc Sư
苦荷大师=Khổ Hà đại sư
苦行记=Khổ Hành Ký
英明神武的皇帝陛下=Hoàng đế Anh Minh Thần Võ
范一掌=Phạm Nhất Chưởng
范侍郎=Phạm Thị lang
范党=Phạm Đảng
范宅=Phạm Trạch
范安之=Phạm An Chi
范家二少爷=Phạm gia nhị thiếu gia
范家老二=Phạm Gia Lão Nhị
范家蔡家=Phạm gia Thái gia
范小花=Phạm Tiểu Hoa
范小花儿=Phạm Tiểu Hoa Nhi
范尚书=Phạm Thượng Thư
范府庄园=Phạm phủ trang viên
范提司=Phạm Đề Tư
范族=Phạm Tộc
范族庄园=Phạm Tộc Trang Viên
范族田庄=Phạm Tộc Điền Trang
范族祠堂=Phạm Tộc Từ Đường
范柳=Phạm Liễu
范柳林=Phạm Liễu Lâm
范正=Phạm Chính
范正使=Phạm Chính Sứ
范氏大宅=Phạm Thị Đại Trạch
范氏子=Phạm Thị Tử
范淑宁=Phạm Thục Ninh
范诗仙=Phạm Thi Tiên
范钦差=Phạm Khâm Sai
范门四子=Phạm Môn Tứ Tử
茅家寨=Mao Gia Trại
茗薇=Mính Vi
茶女=Trà Nữ
荆怡红=Kinh Di Hồng
荆戈=Kinh Qua
荆采菽=Kinh Thái Thục
荣九昌=Vinh Cửu Xương
荣然=Vinh Nhiên
荥江城=Huỳnh Giang Thành
荷池坊=Hà Trì Phường
荷竹苑=Hà Trúc Uyển
莲衣=Liên Y
莼菜汤=Thuần thái thang
莽苍剑派=Mãng Thương kiếm phái
菊儿胡同=Cúc Nhi Hồ Đồng
菊次郎的夏天=Mùa hè của Kikujiro
菊花古剑与酒之二=Cúc Hoa Cổ Kiếm và Rượu chi Nhị
萍萍=Bình Bình
萧主事=Tiêu chủ sự
萧元炳=Tiêu Nguyên Bỉnh
董陆王=Đổng Lục Vương
蓝东玉=Lam Đông Ngọc
蓝玉石床=Lam Ngọc Thạch Sàng
蓝苗寨=Lam Miêu Trại
蕴脏境=Uẩn Tạng Cảnh
薛总督=Tiết Tổng đốc
藤大=Đằng Đại
藤大媳妇=Đằng Đại Tức Phụ
藤大家=Đằng Đại Gia
藤田淑子=Đằng Điền Thục Tử
蘇婉晴=Tô Uyển Tình
虎卫高达=Hổ Vệ Cao Đạt
虎煞功=Hổ Sát Công
虎煞帮=Hổ Sát Bang
虎象=Hổ Tượng
虎面鱼肉=Thịt cá mặt hổ
虞竹青=Ngu Trúc Thanh
虞雪婷=Ngu Tuyết Đình
虹英=Hồng Anh
虽然穿越=tuy nhiên xuyên qua
蚩木功=Xi Mộc Công
蚩木劲=Xi Vưu Mộc Kính
蚩木勁=Si Mộc Kình
蚩木神功=Xi Vưu Thần Công
蚩木骨劲=Xi Vưu Cốt Kình
蛇眉铜鱼=Xà Mi Đồng Ngư
蛇骨剑=Xà Cốt Kiếm
蛔虫妖=Giun yêu
蛮妃=Man Phi
蛰龙=chập long¦rồng ngủ đông
蛰龙诀=Chập Long Quyết
蝉鸟=Thiền Điểu
血劲=Huyết Kình
行万里见闻录=Hành Vạn Lý Kiến Văn Lục
行北路=Hành Bắc Lộ
行南路=Hành Nam Lộ
衼邪珠=Trừ Tà Châu
袁伯安=Viên Bá An
袁北坡=Viên Bắc Pha
袁大家=Viên Đại Gia
袁惊梦=Viên Kinh Mộng
被外挂=bị hack
裴文碧=Bùi Văn Bích
西亭=Tây Đình
西凉路=Tây Lương Lộ
西凉路总督府=Tây Lương Lộ Tổng Đốc Phủ
西北路=Tây Bắc Lộ
西城别院=Biệt viện Tây Thành
西大营=Tây Đại Doanh
西山书坊=Tây Sơn Thư Phường
西山纸坊=Tây Sơn chỉ phường
西方法术=Tây phương pháp thuật
西池河子=Tây Trì Hà Tử
西涂六指怪=Tây Đồ Lục Chỉ Quái
西涂山=Tây Đồ Sơn
西胡单于速必达=Tây Hồ Thiền Vu Tốc Tất Đạt
西胡左贤王=Tây Hồ Tả Hiền Vương
西胡王庭=Vương Đình Tây Hồ
西胡草原=Tây Hồ Thảo Nguyên
西胡部落=Bộ lạc Tây Hồ
西赫森林=Tây Hách Sâm Lâm
西路军=Tây lộ quân
角房=Giác Phòng
言冰云=Ngôn Băng Vân
言府=Ngôn Phủ
詹事府=Chiêm Sự Phủ
讲武=giảng võ
许寿山=Hứa Thọ Sơn
许明净=Hứa Minh Tịnh
许晶晶=Hứa Tinh Tinh
许茂才=Hứa Mậu Tài
诚王妃=Thành Vương Phi
谢容儿=Tạ Dung Nhi
谢苏=Tạ Tô
质问他=chất vấn hắn
质问他的=chất vấn hắn
费介先生=Phí Giới tiên sinh
费Ｔ老师=Phí T lão sư
贺大学=Hạ Đại Học
贺派=Hạ phái
赖名成=Lại Danh Thành
赤月崖=Xích Nguyệt Nhai
赤金真功=Xích Kim Chân Công
赫连世家=Hách Liên Thế Gia
赫连无恨=Hách Liên Vô Hận
赵人杰=Triệu Nhân Kiệt
赵人熊=Triệu Nhân Hùng
赵宗胜=Triệu Tông Thắng
赵长乐=Triệu Trường Nhạc
赶蝉追风步=Cản Thiền Truy Phong Bộ
转司所=Chuyển Ty Sở
转运司副使=Chuyển Vận Tư Phó Sứ
轻车熟路了=xe nhẹ đường quen
辛二=Tân Nhị
辛其物=Tân Kỳ Vật
辛少卿=Tân Thiếu Khanh
辛老苏=Tân Lão Tô
辜先生=Cồ tiên sinh
辰廊=Thần Lang
达州城=Đạt Châu Thành
达州知州=Đạt Châu Tri Châu
还是个人才=vẫn là nhân tài
这般做=làm như vậy
连平=liên bình
连环穿心脚=Liên Hoàn Xuyên Tâm Cước
迟志强=Trì Chí Cường
迭衣巷=Điệt Y Hạng
送菜老哈=Tống Thái Lão Cáp
速必达=Tốc Tất Đạt
速生柳树=Tốc Sinh Liễu Thụ
逢春=Phùng Xuân
道人脸上=đạo nhân trên mặt
遮合岛=Già Hợp Đảo
邓八公=Đặng Bát Công
邓子越=Đặng Tử Việt
邓莉=Đặng Lị
邓迪文=Đặng Địch Văn
邗江水匪=Hàn Giang Thủy Phỉ
那多叶=Na Đa Diệp
那把刀=thanh đao kia
邱广诚=Khâu Quảng Thành
邱草长=Khâu Thảo Trường
邵三洞=Thiệu Tam Động
邵以仁=Thiệu Dĩ Nhân
邵以辰=Thiệu Dĩ Thần
邵仲文=Thiệu Trọng Văn
邹磊=Trâu Lỗi
郁巧=Úc Xảo
郁觀石=Úc Quan Thạch
郁观石=Úc Quan Thạch
郑教头=Trịnh Giáo Đầu
郑茂=Trịnh Mậu
郡主娘娘=Quận chúa nương nương
郡主驸马=Quận Chúa Phò Mã
郡王府=Quận Vương Phủ
郭尚书=Quách Thượng Thư
都水清吏司=Đô Thủy Thanh Lại Tư
酒中仙=Tửu Trung Tiên
酸斋=Toan Trai
醒儿=Tỉnh Nhi
金光霸功=Kim Quang Bá Công
金海功=Kim Hải Công
金瓜葛=Kim Qua Cát
金盆赌坊=Kim Bồn đổ phường
金虎客栈=Kim Hổ Khách Sạn
金角银角=Kim Giác Ngân Giác¦Kinkaku Ginkaku
金鹰国=Kim Ưng Quốc
钟玉晶=Chung Ngọc Tinh
钟素=Chung Tố
钦天监正=Khâm Thiên Giám Chính
钦天监监正=Khâm Thiên Giám Giám Chính
铁兴城=Thiết Hưng Thành
铁手会=Thiết Thủ Hội
铁手帮=Thiết Thủ Bang
铁狂笑声=Thiết Cuồng tiếng cười
铁相=Thiết Tương
铜川街=Đồng Xuyên Nhai
铜石街=Đồng Thạch Nhai
银兰=Ngân Lan
银山赌坊=Ngân Sơn đổ phường
银牛=Ngân Ngưu
银面荆戈=Ngân Diện Kinh Qua
锤法·千重浪=Chuy pháp · Thiên Trọng Lãng
锤法·奔雷袭=Chuy pháp · Bôn Lôi Tập
锤法·扫烈风=Chuy pháp · Tảo Liệt Phong
锦毛狮=Cẩm Mao Sư
锦鲤化龙=cá chép hóa rồng
镇北大都督=Trấn Bắc Đại Đô Đốc
镜泊弯=Kính Bạc Loan
镜湖女妖=Kính Hồ nữ yêu
长乐哥哥=Trường Nhạc ca ca
长乐大哥=Trường Nhạc đại ca
长乐少侠=Trường Nhạc thiếu hiệp
长乐师侄=Trường Nhạc sư điệt
长乐师兄=Trường Nhạc sư huynh
长亭古道=Trường Đình Cổ Đạo
长公主李云睿=Trưởng công chúa Lý Vân Duệ
长兴坊=Trường Hưng phường
长刀虎卫=Trường Đao Hổ Vệ
长剑出鞘=trường kiếm xuất vỏ
长宁侯府=Trường Ninh Hầu Phủ
长宁侯爷=Trường Ninh Hầu Gia
长安侯=Trường An Hầu
长寿坊=Trường Thọ Phường
长荣街=Trường Vinh Nhai
长青帮=Trường Thanh Bang
门下中书=Môn Hạ Trung Thư
门下中书省=Môn Hạ Trung Thư Tỉnh
门下中书行走大学士=Môn Hạ Trung Thư Hành Tẩu Đại Học Sĩ
门下中书都察院=Môn Hạ Trung Thư Đô Sát Viện
门下议事=Môn Hạ Nghị Sự
门师=Môn Sư
门掌法=môn chưởng pháp
门生出了=môn sinh ra khỏi
闽初=Mân Sơ
闽北三大坊=Mân Bắc Tam Đại Phường
阎龟山=Diêm Quy Sơn
阑珊的=rã rời
阳州=Dương Châu
阴乱庆国=Âm Loạn Khánh Quốc
阴虎妖王=Âm Hổ Yêu Vương
陆大有师兄=Lục Đại Hữu sư huynh
陆行风=Lục Hành Phong
陈五常=Trần Ngũ Thường
陈伯常=Trần Bá Thường
陈叔平=Trần Thúc Bình
陈园有客=Trần Viên hữu khách
陈平安=Trần Bình An
陈老跛子=Trần Lão Bả Tử
陈老院长=Viện trưởng Trần
陈跛子=Trần Bễ Tử
陈长=Trần Trường
陶弘景=Đào Hoằng Cảnh
隋炀帝杨广=Tùy Dạng Đế Dương Quảng
隐州=Ẩn Châu
雅易安=Nhã Dịch An
集贤馆大学士=Tập Hiền Quán đại học sĩ
雨水天=Vũ Thủy Thiên
雪山气海=Tuyết Sơn Khí Hải
雪蛮=Tuyết Man
雷雨夜=Đêm Mưa Bão
雾渡河=Vụ Độ Hà
雾渡河镇=Trấn Vụ Độ Hà
霸道的功法=bá đạo công pháp
霸道真气=Bá Đạo Chân Khí
青光剑派=Thanh Quang Kiếm Phái
青园=Thanh Viên
青夜穹顶=Thanh Dạ Khung Đỉnh
青娃=Thanh Oa
青娃儿=Thanh Oa Nhi
青山一脉=Thanh Sơn Nhất Mạch
青山天一道=Thanh Sơn Thiên Nhất Đạo
青山木蓬=Thanh Sơn Mộc Bồng
青州石=Thạch Thanh Châu
青芒剑诀=Thanh Mang Kiếm Quyết
靖王世子李弘成=Tĩnh Vương Thế Tử Lý Hoằng Thành
靖王妃=Tĩnh Vương phi
靖王府诗会=Thi Hội Tĩnh Vương Phủ
靖王爷府=Tĩnh Vương Gia Phủ
靖郡王世子=Tĩnh Quận Vương Thế tử
靖郡王府=Tĩnh Quận Vương Phủ
静坐经=Tĩnh Tọa Kinh
静思庭=Tĩnh Tư Đình
静澄伯府=Tĩnh Trừng Bá Phủ
静澄子府=Tĩnh Trừng Tử phủ
面子果实=mặt mũi trái cây
韩尚书=Hàn Thượng thư
韩志维=Hàn Chí Duy
韩敖启=Hàn Ngao Khải
韩艺瑟=Han Ye Seul
顺德镇=Thuận Đức trấn
须龙肉=Tu Long nhục
顾天金=Cố Thiên Kim
顾广雄=Cố Quảng Hùng
顾萍=Cố Bình
顾长春=Cố Trường Xuân
领事大臣=Lãnh sự đại thần
颜冰云=Nhan Băng Vân
颜尚书=Nhan Thượng Thư
颜行书=Nhan Hành Thư
风太师叔=Phong thái sư thúc
风无流=Phong Vô Lưu
风来客栈=Phong Lai Khách Sạn
风雨剑法=Phong Vũ Kiếm Pháp
风雨斋=Phong Vũ Trai
风骨圆满=Phong Cốt Viên Mãn
风魔剑法=Phong Ma Kiếm Pháp
飞雪山庄=Phi Tuyết Sơn Trang
飞雷神印记=Phi Lôi Thần Ấn Ký
食色无双=Thực Sắc Vô Song
饮鸠止渴=uống rượu độc giải khát
饶是如此=dù là như thế
马主簿=Mã Chủ Bạ
马五奎=Mã Ngũ Khuê
马楷=Mã Khải
马花花=Mã Hoa Hoa
驿马骨=Dịch Mã Cốt
高克新=Cao Khắc Tân
高冰清=Cao Băng Thanh
高娃=Cao Oa
高山塔=Cao Sơn Tháp
高氏姐妹=Cao Thị tỷ muội
高玉洁=Cao Ngọc Khiết
高远静=Cao Viễn Tĩnh
魏东行=Ngụy Đông Hành
魏尚书=Ngụy Thượng thư
魏无成=Ngụy Vô Thành
魏灵王=Ngụy Linh Vương
魏皇=Ngụy Hoàng
魏秀芝=Ngụy Tú Chi
鲁庆余=Lỗ Khánh Dư
鲁教头=Lỗ Giáo Đầu
鲁耀兴=Lỗ Diệu Hưng
鲍大同=Bào Đại Đồng
鳄鱼统领=Cá Sấu thống lĩnh
鸿胪寺少卿=Hồng Lư Tự Thiếu Khanh
鹤大宗师=Hạc Đại Tông Sư
鹰爪神功=Ưng Trảo Thần Công
鹿茸肉=Lộc Nhung Nhục
麦哥儿=Mạch Ca Nhi
麦新儿=Mạch Tân Nhi
麦苗儿=Mạch Miêu Nhi
麻烦大家=phiền toái mọi người
麻黄丸=Ma Hoàng Hoàn
黄一昌=Hoàng Nhất Xương
黄完树=Hoàng Hoàn Thụ
黄富贵=Hoàng Phú Quý
黄立峰=Hoàng Lập Phong
黄级锻骨=Hoàng Cấp Đoán Cốt
黄谷村=Hoàng Cốc thôn
黄谷镇=Hoàng Cốc Trấn
黄金骰子=Hoàng Kim Xúc Xắc
黄锤=Hoàng Chùy
黄黑色的瞳孔=đồng tử màu vàng đen
黎宝鼎=Lê Bảo Đỉnh
黎锦光=Lê Cẩm Quang
黑原镇=Hắc Nguyên Trấn
黑夜刀法=Hắc Dạ Đao Pháp
黑夜堂=Hắc Dạ Đường
黑山栀=Hắc Sơn Chi
黑斑肉=Hắc Ban nhục
黑沙河=Hắc Sa Hà
黑沙河神=Hắc Sa Hà Thần
黑煞宗=Hắc Sát Tông
黑莲寺=Hắc Liên Tự
黑铁剑=Hắc Thiết Kiếm
黑铁掌=Hắc Thiết Chưởng
黑骑军=Hắc Kỵ Quân
黑骑营=Hắc Kỵ Doanh
鼎香坊=Đỉnh Hương Phường
鼠大郎=Thử Đại Lang
齐云杰=Tề Vân Kiệt
齐任平=Tề Nhậm Bình
齐勇=Tề Dũng
齐家老祖=Tề Gia Lão Tổ
齐庙=Tề Miếu
齐念生=Tề Niệm Sinh
齐教头=Tề giáo đầu
齐星河=Tề Tinh Hà
齐木清=Tề Mộc Thanh
龙宫骨=Long Cung Cốt
龙泉驿=Long Tuyền Dịch
龙神功=Long Thần Công
龙神青年=Long Thần Thanh Niên
龙角骨=Long Giác Cốt
龙象之力=Long Tượng chi lực
龙象真元劲=Long Tượng Chân Nguyên Kình
龙骑尉=Long Kỵ Úy
龚亲王=Cung Thân Vương
ＳＭ=SM