一端览祭=Nhất Đoan Lãm Tế¦Nhất Đoan Lãm Tế (Ichihanaransai)
一苇渡江=Nhất Vĩ Độ Giang¦Nhất Vi Độ Giang
丁俊晖=Đinh Tuấn Huy¦Đinh Tuấn Thui
七天七刀=Thất Thiên Thất Đao¦Shichiten Shichitou
七窍玲珑心=Thất Khiếu Linh Lung Tâm¦Xuất xứ từ truyện Phong Thần¦Tỷ Can thông minh bởi có tim 7 lỗ
七龙珠=7 Viên Ngọc Rồng¦thất long châu¦bảy viên ngọc rồng¦Bảy viên ngọc rồng, bộ truyện tranh và phim hoạt hình Nhật Bản
万事屋=Vạn Sự Ốc¦Yorozuya
万古霉素=Vancomycin¦van-cô-mi-xin
万宝路=Marlboro¦Vạn Bảo Lộ
万寿山=Vạn Thọ Sơn¦Núi vạn thọ
万应素=Vạn Ứng Tố¦mana
万恶之源=Vạn Ác Chi Nguyên¦cội rễ của mọi điều ác
万条巧手=Vạn Điều Xảo Thủ¦Banjō Shite
万灵血玺=Vạn Linh Huyết Tỉ¦Vạn Linh Huyết Tỷ
万物使者=Vạn Vật Sử Giả¦Vạn Vật Sứ Giả
万箭王=Vạn Tiễn Vương¦Vạn Tiến Vương
万里长城=Vạn Lý Trường Thành¦Trường Thành
万金商会=Vạn Kim Thương Hội¦Vạn Kim thương hội
万魔洞=Vạn Ma Động¦Vạn Ma động
三中全会=Tam Trung Toàn Hội¦Đại hội đại biểu toàn quốc lần thứ ba của Đảng Cộng sản Trung Quốc
三乡雫=Sango Shizuku¦tam hương tích
三光神水=Tam Quang Thần Thuỷ¦Tam Quang Thần Thủy
三妙仙子=Tam Diệu Tiên Tử¦Tam Diệu tiên tử
三字经=Tam Tự Kinh¦tam tự kinh¦kinh tam tự¦lời thề
三尖两刃刀=Tam Tiêm Lưỡng Nhận Đao¦Tam Tiên Lưỡng Nhận Đao
三山五岳=Tam Sơn Ngũ Nhạc¦tam sơn ngũ nhạc¦Ba núi năm nhạc¦Tam sơn ngũ nhạc
三日月宗近=Munechika Mikazuki¦Tam Nhật Nguyệt Tông Cận¦Mikazuki Munechika
三昧真火=Tam Muội Chân Hoả¦tam muội chân hoả¦tam muội chân hỏa¦Tam Muội Chân Hỏa
三角龙=Tam Giác Long¦triceratops
三论宗=Tam Luận Tông¦Trường phái Tam luận
三足乌=Tam Túc Ô¦Tiếng Hàn: samjog'o
三途川=Sanzu-no-Kawa¦Tam Đồ Xuyên¦Sanzu-no-kawa¦Mitogawa
三途河=Tam Đồ Hà¦Mitogawa
三霄娘娘=Tam Tiêu Nương Nương¦Tam Tiêu nương nương
上善若水=Thượng Thiện Nhược Thủy¦thượng thiện nhược thuỷ
上清圣人=Thượng Thanh thánh nhân¦Thượng Thanh Thánh Nhân
上苍之手=Thượng Thương Chi Thủ¦Thượng Thương thủ
下品圣器=Hạ Phẩm Thánh Khí¦Hạ phẩm Thánh khí
不列颠=Britain¦Nước Anh
不周山=Bất Chu Sơn¦Núi Buzhou, ngọn núi trong truyền thuyết Trung Quốc¦Bất Chu sơn
不朽神王=Bất Hủ Thần Vương¦Bất Hủ thần vương
不灰木=Amiăng¦a-mi-ăng¦asbestos
世界之心=Thế Giới Chi Tâm¦Thế Giới Tâm
世贸大厦=Cao ốc Thương mại Thế giới¦Thế Mậu Đại Hạ¦World Trade Center
丘成桐=Khâu Thành Đồng¦Shing-Tung Yau
东不拉=Dombra¦đàn đon-bô-ra
东伯雪鹰=Dong Bo Xue Ying¦Đông Bá Tuyết Ưng
东方钱柜=Đông Phương Tiền Quỹ¦Đông Phương Tiễn Quỹ
东海帝王=Tōkai Teiō¦Đông Hải Đế Vương
东王公=Đông Vương Công¦Đông vương công¦Mu Kung hay Tung Wang Kung, Thần của những người bất tử
两面宿傩=Ryōmen Sukuna¦Lưỡng Diện Túc Na
丧门星=Tang Môn Tinh¦tang môn tinh¦sao tai họa¦người mang đến sự xui xẻo¦sứ giả của cái chết
丧门神=Tang Môn Thần¦sứ giả của cái chết
中南海=Trung Nam Hải¦Trung Nam Hải, cung điện tiếp giáp với Tử Cấm Thành, nay là trụ sở trung ương của Đảng Cộng sản và Quốc vụ viện
中央邦=Trung Ương Bang¦Madhya Pradesh bang
中纪委=Trung Kỷ Ủy¦Ủy ban Kiểm tra Kỷ luật Trung ương
丰收女神=Nữ Thần Mùa Màng¦Phong Thu Nữ Thần
丹妮尔=Danièle¦Danielle
丽娜莎=Linasha¦Lệ Na Toa
丽欧妮=Lệ Âu Ny¦Laine
义和团=Nghĩa Hoà Đoàn¦Nghĩa hoà đoàn
义大利=Italy¦Ý
义阳武卒=Nghĩa Dương Vũ Tốt¦Nghĩa Dương vũ tốt
乌兰巴托=Ulan Bator¦Ô Lan Ba Thác¦U-lan-ba-to
乌兹别克=Uzbekistan¦Ô Tư Biệt Khắc¦U-dơ-bê-ki-xtan
乌尔格=Urban Grid¦tên cổ của Ulan Bator
乌干达=Uganda¦U-gan-đa
乌拉圭=Uruguay¦Urugoay¦ô lạp khuê¦U-ru-goay
乌拉尔=Ural¦Ô Lạp Nhĩ¦dãy núi Ural ở Nga, phân chia châu Âu với châu Á
乌斯藏=Ô Tư Tàng¦Uszang
乌瑞亚=Ô Thụy Á¦Ourea
乌鲁克=Uruk¦Ô Lỗ Khắc
乌鲁木齐=Ürümqi¦Urumqi¦Ô Lỗ Mộc Tề
乌鸦岭=Ô Nha Lĩnh¦Raven Hill
乐园之塔=Nhạc Viên Chi Tháp¦Tower of Heaven
乔伊娜=Kiều Y Na¦Joyna
乔克斯=Jocks¦Kiều Khắc Tư
乔安妮=Joanie¦Joanne¦Kiều An Ny
乔布斯=Jobs¦Steve Jobs¦Việc làm
乔比亚=Geobia¦Kiều Bỉ Á
乔治亚=Georgia¦Gioóc-gi-a¦Gioóc-gi-ơ
乔治夫=Kiều Trì Phu¦George
乔治敦=Georgetown¦Gioóc-giơ-tao-nơ
乔纳森=Jonathan¦Kiều Nạp Sâm
九五至尊=Cửu Ngũ Chí Tôn¦cửu ngũ chí tôn¦chín năm chí tôn
九天玄女=Cửu Thiên Huyền Nữ¦Xuan Nü, một nàng tiên trong thần thoại Trung Quốc
九头狮子=Cửu Đầu Sư Tử¦cửu đầu sư tử
九头蛇=Hydra¦cửu đầu xà¦rắn chín đầu
九头鸟=Cửu Đầu Điểu¦người tinh ranh hoặc ranh mãnh
九寨沟=Cửu Trại Câu¦Thung lũng Cửu Trại Câu, Tứ Xuyên
九转金丹=Cửu Chuyển Kim Đan¦cửu chuyển kim đan
九阴真经=Cửu Âm Chân Kinh¦cửu âm chân kinh
九齿钉耙=Cửu Xỉ Đinh Ba¦đinh ba chín răng
九龙坡=Cửu Long Pha¦Quận Jiulongpo của đô thị trung tâm Trùng Khánh, trước đây thuộc Tứ Xuyên
九龙城寨=Cửu Long Thành Trại¦Kowloon Walled City
书剑恩仇录=Thư Kiếm Ân Cừu Lục¦Ân thù kiếm lục
买买提=Mãi Mãi Đề¦Mehmet
乱石山=loạn thạch sơn¦Loạn Thạch Sơn
乾坤决=Càn Khôn Quyết¦Kiền Khôn Quyết
乾坤剑匣=Kiền Khôn Kiếm Hạp¦Càn Khôn Kiếm Hạp
乾达婆王=Kiền Đạt Bà Vương¦Càn Đạt Bà Vương
乾道九五=Kiền Đạo Cửu Ngũ¦Càn Đạo Cửu Ngũ
乾闼婆=Kiền Thát Bà¦Càn Thát Bà
二人台=Nhị Nhân Đài¦hát kiểu Nhị Nhân Đài
二零八室=Phòng 208¦phòng 208
于正林=Vu Chánh Lâm¦Vu Chính Lâm
于霸天=Yu Batian¦Vu Bá Thiên
云中君=Vân Trung Quân¦vân trung quân
云逸舟=Vân Dật Châu¦Vân Dật Chu
云雾山脉=Mây Mù Sơn Mạch¦Vân Vụ Sơn Mạch¦Vân Vụ Sơn Mạch( The Clouds Peaks)
五斗米道=Ngũ Đấu Mễ Đạo¦Con đường của Thiên chủ
五爪金龙=Ngũ Trảo Kim Long¦ngũ trảo kim long
五粮液=Ngũ Lương Dịch¦rượu ngũ lương¦ngũ lương dịch¦ngũ cốc dịch
五角大楼=Lầu Năm Góc¦ngũ giác đài¦lầu năm góc
五谷丰登=Ngũ Cốc Phong Đăng¦ngũ cốc phong đăng
五龙玺=Ngũ Long Tỷ¦Ngũ Long Tỉ
亚利桑那=Arizona¦Á Lợi Tang Na¦A-ri-dô-na E-ri-dâu-nơ
亚力克=Á Lực Khắc¦Alick¦Alec¦Aggreko
亚尔夫海姆=Álfheim¦Álfheimr¦Alfheim
亚帝斯=Á Đế Tư¦Adis¦Adil
亚拉撒=Lazard Asia¦Á Lạp Tát
亚松森=Asunción¦A-xun-xi-ôn
亚的斯亚贝巴=Addis Ababa¦A-đít A-bê-ba
亚米拉=Yamila¦Á Mễ Lạp¦Yamila
亚美克=Á Mỹ Khắc¦Imex
亚美利加=America¦Châu Mỹ
亚莉克希亚=Alexia¦ Á Lỵ Khắc Hi Á
亚非拉=Á Phi Mỹ Latin¦Châu Á, Châu Phi và Châu Mỹ Latinh¦Á Phi Lạp¦Africa
亚麦尼亚=Jamnia¦Á Mạch Ni Á
亡天箭=Vong Thiên Tiễn¦Vong Thiên Tiến
亢龙有悔=Cang Long Hữu Hối¦Kháng Long Hữu Hối
京杭大运河=Kinh Hàng Đại Vận Hà¦Grand Canal, 1800 km từ Bắc Kinh đến Hàng Châu, được xây dựng bắt đầu từ năm 486 trước Công nguyên
人头马=Rémy Martin¦Rémy martin
人猿泰山=Nhân Viên Thái Sơn¦Tarzan
人间界=Nhân Gian Giới¦Nhân Gian giới
人面虫=Nhân Diện Trùng¦Người Mặt Trùng
什刹海=Thập Sát Hải¦Shichahai, khu danh lam thắng cảnh phía tây bắc Bắc Kinh với ba hồ
今川义元=Kim Xuyên Nghĩa Nguyên¦Imagawa Yoshimoto
仙女岛=Tiên Nữ Đảo¦Fair Isle
仙女星系=Tiên Nữ Tinh Hệ¦thiên hà Tiên Nữ
以西结书=Ezekiel¦Sách Ê-xê-chi-ên
以诺亚=Lấy Noah¦từ Noah
伊万科夫=Ivankov¦Y Vạn Khoa Phu
伊亚卡诺=Oia Carnot¦Y Á Tạp Nặc
伊克西=Y Khắc Tây¦Yikexi
伊内丝=Inês¦Ines
伊凡娜=Y Phàm Na¦Ivana
伊利诺=Illino¦Illinois¦Illinois, tiểu bang Hoa Kỳ
伊利诺伊=Illinois¦Illinois, tiểu bang Hoa Kỳ
伊势丹=Isetan¦Isetan, cửa hàng bách hóa Nhật Bản
伊士卡=Y Sĩ Tạp¦Eska
伊拉克=Iraq¦Irag¦I-rắc
伊拉姆=Iram¦Y Lạp Mỗ (Iram)
伊斯兰=Islam¦đạo Hồi
伊斯兰堡=Islamabad¦Islamabat¦I-xla-ma-bát
伊斯坦布尔=Istanbul¦Istanbul, Thổ Nhĩ Kỳ
伊斯法罕=Isfahan¦Isfahan hoặc Eşfahān, tỉnh và thành phố ở miền trung Iran
伊格内修斯=Ignatius¦Y Cách Nội Tu Tư
伊玛目=Y Mã Mục¦Imam
伊琳娜=Irene¦Irena¦Y Lâm Na¦Elena
伊瑟拉=Ysera¦Y Sắt Lạp
伊瑟琳=Y Sắt Lâm¦Yssring
伊莱恩=Elaine¦Y Lai Ân
伊藤清子=Itou Kiyoko¦Y Đằng Thanh Tử
伊西丝=Isis¦Y Tây Ti (Isis)
伊西斯=Isis¦Y Tây Tư¦Iset
伊迪卡伦=Edie Callan¦Y Địch Tạp Luân
伊里奇=Ilyich¦Illich¦Ilyich hoặc Illich
伍六七=Ngũ Lục Thất¦Wu Liuqi
伍子胥=Ngũ Tử Tư¦Wu Zixu
伏地魔=Voldermort¦Voldemort¦Chúa tể Voldemort
伏牛山=Phục Ngưu Sơn¦phục ngưu sơn
伏特加=Vodka¦vodka¦rượu Vodka
伏羲氏=Fuxi¦Fuxi hay Fu Hsi, hoàng đế huyền thoại của Trung Quốc 2852-2738 trước Công nguyên, người sáng tạo thần thoại về đánh cá, bẫy và viết
伏魔链=Phục Ma Liên¦Phục Ma Liệm
优书网=Yousuu¦Ưu Thư Võng
优衣库=Uniqlo¦Uniqlo, thương hiệu quần áo Nhật Bản
伟大航路=Đại Hải Trình¦con đường tuyệt vời
伟大航道=Đại Hải Trình¦Grand Line
传奇九变=Truyền Kỳ Cửu Biến¦Truyện Kỳ Cửu Biến
伦勃朗=Rembrandt¦Luân Bột Lãng
伯利兹=Belize¦Bá Lợi Tư¦Bê-li-xê
伯尔尼=Bern¦Béc-nơ
伯恩斯=Burns¦Bá Ân Tư¦Bones
伯邑考=Bá Ấp Khảo¦Hakuyūkō
伽利略=Galileo¦Galile¦Ga-li-Lê
佐佐木=Sasaki¦Tá Tá Mộc
佐尔坦=Zoltán¦Zoltan
佐治亚=Georgia¦Georgia, tiểu bang Hoa Kỳ
何大壮=Hà Đại Tráng。¦Hà Đại Tráng
何太冲=Hà Thái Xung¦Hà Thái Trùng
佛之战国=Sengoku Đức Phật¦Phật chi Sengoku
佛光寺=Phật Quang Tự¦Phật quang tự
佛地兰=Phật Địa Lan¦Fodirland
佛得角=Cape Verde¦Phật Đắc Giác¦Cáp-ve
佛洛里斯=Phật Lạc Lý Tư¦Floris
佛罗伦斯=Florence¦Florence, thành phố ở Ý
佛罗伦萨=Firenze¦Florence, thành phố ở Ý¦Florence¦Florentia
佛罗里达=Florida¦Flo-ri-đa Flo-ri-đơ
佛蒙特=Vermont¦Véc-mông Vơ-mon
佟丽娅=Đồng Lệ Á¦Đông Lệ Á
佩特拉=Petra¦Thành cổ Petra¦Petora
佩索托=Bội Tác Thác¦Pessoto
佩雷斯=Pérez¦Perez
侯塞尼=Hosseini¦Hầu Tắc Ni
侯赛因=Hussein¦Husain hoặc Hussein
俄亥俄=Ohio¦Ô-hai-ô¦Âu-hai-âu
俄克拉何马=Oklahoma¦Ô-cla-hô-ma¦Âu-clơ-hâu-mơ¦Aklahoma
俄底浦斯=Oedipus¦Oedipus, vị vua huyền thoại của Thebes, người đã giết cha mình và kết hôn với mẹ mình
俄狄浦斯=Oedipus¦Oedipus, anh hùng của bi kịch của nhà biên kịch người Athen Sophocles
保加利亚=Bulgaria¦Bun-ga-ri Bảo Gia Lợi
偃月刀=Yển Nguyệt Đao¦Cây đao lưỡi cong hình trăng khuyết.
儒林外史=Nho Lâm Ngoại Sử¦môn sinh¦học giả¦ngoại sử Nho Lâm
元合岛=Nguyên Hợp Đảo¦Nguyên Hợp đảo
元武境=Nguyên Vũ Cảnh¦Nguyên võ cảnh
光禄寺=Quang Lộc Tự¦Quan thự trông coi việc ăn uống cho vua.
光翼魔女=Quang Dực Ma Nữ¦Gloriara
克兰斯顿=Cranston¦Khắc Lan Tư Đốn
克利夫兰=Cleveland¦Khắc Lợi Phu Lan
克劳伦斯=Clarence¦Khắc Lao Luân Tư¦Clawrence
克劳克=Khắc Lao Khắc¦Croaker
克劳尔=Clair¦Claus¦Kraul¦Crowl¦Khắc Lao Nhĩ¦Crouch
克劳斯=Klaus¦Claus hoặc Klaus
克劳迪娅=Claudia¦Khắc Lao Địch Á
克劳迪娜=Claudina¦Khắc Lao Địch Na
克拉克=Clark¦Clark hoặc Clarke
克拉科夫=Kraków¦Krakow
克朗顿=Khắc Lãng Đốn¦Cromton¦Kronton
克洛索=Khắc Lạc Tác¦Clotho
克罗埃=Chloe¦Chloé
克苏鲁=Cthulhu¦Cthulhu, thực thể vũ trụ hư cấu được tạo ra bởi nhà văn H. P. Lovecraft
克莉斯汀=Cristine¦Khắc Lỵ Tư Đinh¦Christine¦Kristine
克莉斯蒂=Cristi¦Christie¦Kristie¦Khắc Lỵ Tư Đế
克莱多=Khắc Lai Đa¦Credo
克莱夫=Clive¦Khắc Lai Phu
克莱奥=Khắc Lai Áo¦Clio
克莱斯=Kreis¦Khắc Lai Tư
克莱门蒂娜=Clementine¦ Khắc Lai Môn Đế Na
克里丝=Chris¦Khắc Lý Ti
克里克=Krieg¦Crick¦Francis Crick nhà sinh vật học người Anh đoạt giải Nobel y học năm 1962 cùng với Waston trong đề tài DNA.
克里兹=Khắc Lý Tư¦Criz
克里姆=Klim¦Khắc Lý Mỗ¦Klimt
克里斯丁=Kristen¦Christin¦Khắc Lý Tư Đinh
克里斯奥=Christopher¦Khắc Lý Tư Áo
克里斯汀娜=Christine¦Khắc Lý Tư Đinh Na¦Christina
克里斯蒂娜=Christina¦ Khắc Lý Tư Đế Na¦Cristina
克里斯蒂安=Christian¦Christiane¦Kristian hoặc Christian¦ Khắc Lý Tư Đế An
克里斯蒂那=Christina¦Khắc Lý Tư Đế Na
克里普斯=Cripps¦Khắc Lí Phổ Tư
克里曼=Keli Man¦Khắc Lí Mạn¦Kinnunen¦Linnunen
克里顿=Kriton¦Khắc Lý Đốn
克雷芒=Clément¦Clement
克雷西=Crécy¦Khắc Lôi Tây¦ Crécy¦Cressie
克雷顿=Creighton¦Khắc Lôi Đốn
兔斯基=Tuzki¦Tuzki, một nhân vật minh họa thỏ nổi tiếng của Trung Quốc
全聚德=Toàn Tụ Đức¦Quanjude
八卦掌=Bát Quái Chưởng¦baguazhang
八咫镜=Bát Chỉ Kính¦Yata no Kagami
八咫鸦=Bát Chỉ Nha¦Yatagarasu
八荒六合=Bát Hoang Lục Hợp¦bát hoang lục hợp
八贤王=Bát Hiền Vương¦Bát Hiền vương
八路军=Bát Lộ Quân¦Bát Lộ quân
八部天龙=Bát Bộ Thiên Long¦Thiên Long Bát Bộ
公侯伯子男=Công Hầu Bá Tử Nam¦công hầu bá tử nam
公孙差=Công Tôn Soa¦Công Tôn Sai
六合彩=Lục Hợp Thải¦Mark Six
六合游身尺=Lục Hợp Du Thân Thước¦Lục Hợp Du Thân Xích
六式·剃=Lục Thức · Cạo¦Lục Thức Cạo
六扇门=Lục Phiến Môn¦lục phiến môn¦sáu cánh cửa¦lực lượng cảnh sát đặc biệt
六盘水=Lục Bàn Thuỷ¦Lục Bàn Thủy
兰伯恩=Lambourne¦Lan Bá Ân
兰伯特=Lan Bá Đặc¦Lambert
兰帝斯=Landis¦Lan Đế Tư
兰斯洛=Lan Tư Lạc¦Lancelot
共产党=Đảng Cộng Sản¦đảng cộng sản¦Đảng Cộng sản
共济会=Hội Tam Điểm¦Tam điểm¦Cộng Tế Hội
关东煮=Oden¦oden¦lẩu oden
兽神将=Thú Thần Tướng¦¦Thú Thần Tương (Animal GOD)
内华达=Nevada¦Nội Hoa Đạt¦Nê-va-đa¦Nơ-va-đơ
内布拉斯加=Nebraska¦Ni-brét-xcơ
内蒙古=Nội Mông Cổ¦Nội Mông
冈比亚=Gambia¦Găm-bi-a
冒纳罗亚=Mauna Loa¦Moanalua, núi lửa Hawaii
冥月使=Minh Nguyệt Sứ¦Minh Nguyệt Sử
冥王星=Sao Diêm Vương¦sao Diêm Vương¦sao Diêm vương¦Meiōsei¦Pluto Batō
冬不拉=Dombra¦đàn đon-bô-ra
冬令营=Đông Lệnh Doanh¦trại mùa đông¦Trại mùa đông
冰刃风暴=Băng Nhận Phong Bạo¦Băng nhận phong bạo
冰封千里=Băng Phong Thiên Lý¦băng phong thiên lý
冰河世纪=Kỷ Băng Hà¦Ice Age
冰裂纹=Băng Liệt Văn¦băng liệt văn
冻涟的雪姬=Đống Liên Tuyết Cơ¦Đống Liên Tuyết Cơ (Michelia)
准噶尔=Chuẩn Cát Nhĩ¦Lưu vực Dzungar, Junggar hoặc Dsungharian ở Tân Cương¦Junggar
凉白开=Lương Bạch Khai¦nước sôi để nguội¦mát mẻ và mở ra
凌波微步=Lăng Ba Vi Bộ¦lăng ba vi bộ¦Lăng Ba vi bộ
凌韵儿=Lăng Vận Nhi¦Lăng Vận Nhân
凝液期=Ngưng Dịch Kì¦Ngưng Dịch Kỳ
几内亚=Guinea¦Ghine¦Ghi-nê¦Cộng hoà Ghi-nê¦Republic of Guinea
几内亚比绍=Guinea Bissau¦Ghi-nê Bít-xao
凡人=phàm nhân¦người phàm¦người bình thường¦người tầm thường
凡尔赛=Versailles¦versailles¦Vẹc-xây
凤凰宫=Phượng Hoàng Cung¦Phượng Hoàng cung
凤凰山=núi Phượng Hoàng¦Phượng Hoàng Sơn
凤凰男=Phượng Hoàng Nam¦anh chàng lớn lên ở nông thôn và có được chỗ đứng ở thành phố nhờ làm việc chăm chỉ
凸凹曼=Ultraman¦Siêu Nhân Điện Quang
凹凸曼=Siêu Nhân Điện Quang¦ao đột mạn¦Gập ghềnh
刀疤刘=Lưu Mặt Thẹo¦Lưu mặt sẹo
列奥尼达斯=Leonidas¦Liệt Áo Ni Đạt Tư
列支敦士登=Liechtenstein¦Lích-ten-xten
刘伯温=Lưu Bá Ôn¦Liu Bowen
刘宝瑞=Lưu Bảo Thụy¦Lưu Bảo Thuỵ
刘政启=Lưu Chính Khải¦Lưu Chánh Khải
刘正中=Lưu Chính Trung¦Lưu Chánh Trung
创世录=Sáng Thế Lục¦Sang Thế Lục
创世纪=Sáng Thế Kỷ¦Sáng Thế Ký¦Sáng thế ký¦Genesis¦Sáng Thế Kỷ [Genisys]
初号机=Evangelion¦máy khai sơ¦EVA-01
初音未来=Hatsune Miku¦phải là 未来初音
利伯维尔=Libreville¦Li-brơ-vin
利古里亚=Liguria¦Liguria, tây bắc Ý
利奥波德=Leopold¦Léopold
利比里亚=Liberia¦Lợi Bỉ Lý Á¦Li-bê-ri-a
利隆圭=Lilongwe¦Li-lông-uê
利雅得=Riyadh¦Lợi Nhã Đắc¦Ri-át
刺穿荆棘之枪=Thứ Xuyên Kinh Cức Chi Thương¦Gáe Bolg
前方之风=Vento Phía Trước¦Vento of the Front
剑心通明=Kiếm Tâm Thông Minh¦kiếm tâm sáng trưng
剑齿犀=Tê Giác Răng Kiếm¦Kiếm Xỉ Tê
剑齿龙=Kiếm Xỉ Long¦Belodon
加利利=Galilee¦Ga-li-lê
加利福尼亚=California¦Ca-li-phoóc-ni-a Ke-li-pho-ni-ơ: California
加利西亚=Galicia¦Galicia, tỉnh và vương quốc cũ của Tây Ban Nha¦José María
加勒比=Caribe¦Caribbean¦Ca-ri-bê
加尔各答=Calcutta¦Gia Nhĩ Cáp
加德林=Gardelin¦Gardeling¦Gia Đức Lâm
加德满都=Katmandu¦Gia Đức Mãn¦Cát-măng-đu
加德纳=Gardner¦Người làm vườn
加拉加斯=Caracas¦Ca-ra-cát
加拿大=Canada¦Gia Nã Đại¦Ca-na-đa
加查林=Gatralan¦Gia Tra Lâm
加百列=Gabriel¦Tổng lãnh thiên thần Gabriel của Truyền tin
加速术=Gia Tốc Thuật¦Gia tốc thuật
加里帕兰=Garypalan¦Gia Lý Mạt Lan
加里曼丹=Kalimantan¦Gia Lý Mạn Đan
加里略=Garrillo ¦Gia Lý Lược¦Garrillo¦Galileo
加雷斯=Gareth¦Gares¦Gia Lôi Tư
努库阿洛法=Nukualofa¦Nu-qua-lô-pha
努瓦克肖特=Nouakchott¦Nu-ác-sốt
努美阿=Nouméa¦Nỗ Mĩ A¦Nu-mê-a
勃朗宁=Browning¦Browning, thương hiệu súng của Hoa Kỳ
勒克斯=Lux¦lu-xơ
匈牙利=Hungary¦hung nha lợi¦Hung-ga-ri¦Hung Gia Lợi
化神丹=Hóa Thần Đan¦Hóa Thần đan
北上广深=Bắc Thượng Quảng Thâm¦Bắc Kinh, Thượng Hải, Quảng Châu và Thâm Quyến
北伐军=Bắc Phạt Quân¦quân đội viễn chinh phương Bắc
北冥剑=Bắc Minh Kiếm¦Bắc Minh kiếm
北冰洋=Bắc Băng Dương¦Arctic Ocean
北卡罗来纳=North Carolina¦No Ke-rơ-lai-nơ
北大清华=Thanh Hoa Bắc Đại¦Bắc Đại Thanh Hoa
北斗七星=Bắc Đẩu Thất Tinh¦bắc đẩu thất tinh¦Cái môi lớn
北海道=Hokkaido¦Hốc-Cai-Đô¦Bắc Hải Đạo
北灵境=Bắc Tiên Cảnh¦Bắc Linh Cảnh
北达科他=North Dakota¦No Đơ-câu-tơ
北风之神=Bắc Phong Chi Thần¦Gió Bắc Chi Thần
匹兹堡=Pittsburgh¦thành phố Pittsburgh, tiểu bang Pennsylvania)
匹拉米洞=Pyramidon¦py-ra-pi-đông
十万大山=Thập Vạn Đại Sơn¦thập vạn đại sơn
十三太保=Thập Tam Thái Bảo¦thập tam thái bảo¦Mười Ba Thái Bảo
十三郎=Odzu¦Thập Tam Lang
十二环=Thập Nhị Hoàn¦thập nhị hoàn
十常侍=Thập Thường Thị¦Mười chức năng vĩnh viễn ở cuối Hán, một từ ngữ cho sự tham nhũng
十拳剑=Thập Quyền Kiếm¦Totsuka-no-Tsurugi¦Totsuka kiếm
十皇子=Thập Hoàng Tử¦Thập hoàng tử
千仞雪=Thiên Nhận Tuyết¦Qian Renxue
千光寺=Senkōji¦Thiên Quang Tự
千户所=Thiên Hộ Sở¦thiên hộ sở
千本樱=Senbonzakura¦Thiên Bản Anh
千里眼=Thiên Lý Nhãn¦thiên lý nhãn¦ống nhòm¦kính viễn vọng¦kính thiên văn¦thiên lí nhãn¦Qianliyan
千针石林=Thiên Châm Thạch Lâm¦Thousand Needles
华严经=Hoa Nghiêm Kinh¦Kinh Avatamsaka của trường phái Hoa Nghiêm
华尔兹=Waltz¦hoa nhĩ tư¦điệu waltz¦điệu vanse¦điệu van-sơ
华盛顿=Washington¦Oa-sinh-tơn Hoa Thịnh Đốn
华纳兄弟=Warner Bros¦Anh em nhà Warner
南十字=Nam Thập Tự¦Minami Jūji
南卡罗来纳=South Carolina¦Xao Ke-rơ-lai-nơ
南奥塞梯=Nam Ossetia¦Nam Ossetia, khu tự trị của Georgia trên dãy núi Caucasus
南安普敦=Southampton¦Southampton, thị trấn ở miền nam nước Anh
南宫三八=Nangong Sanba¦Nam Cung Tam Bát
南宫五月=Nangong Wuyue¦Nam Cung Ngũ Nguyệt
南拳妈妈=Nam Quyền Mama¦Nan Quan Mama, một nhóm nhạc Đài Loan
南斯拉夫=Nam Tư¦Yugoslavia¦Nam Tư Lạp Phu
南泥湾=Nam Nê Loan¦Nanniwan
南直隶=Nam Trực Lệ¦nam Trực Lệ
南赡部洲=Nam Thiệm Bộ Châu¦Jambudvipa
南达科他=South Dakota¦Nam Dakota, tiểu bang Hoa Kỳ
南达科塔=South Dakota¦Xao Đơ-câu-tơ
博斯腾湖=Bác Tư Đằng Hồ¦Hồ Bosten ở Tân Cương
博福斯=Bofors¦Bofors, công ty vũ khí Thụy Điển dính líu đến vụ tham nhũng lớn trong những năm 1980
博茨瓦纳=Botswana¦Bốt-xoa-na
卡伦斯=Karen¦Tạp Luân Tư¦Callens
卡列尼娜=Karenina¦Tạp Liệt Ni Na
卡拉布里亚=Calabria¦Calabria, tỉnh cực nam nước Ý
卡斯蒂利亚=Castilla¦Castilla, vương quốc Tây Ban Nha cũ
卡特尔=Cartel¦cartel¦Katell¦các-ten¦cạc-ten
卡萨布兰卡=Casablanca¦Tát Bố Lan Tạp
卡西姆=Qasím¦Kasim¦Qassim
卡雷拉斯=José Carreras¦Carreras
卢卡申科=Lukashenko¦Aleksandr Grigoryevich Lukachenko, tổng thống Belarus từ năm 1994
卢塞恩=Luzern¦Lucerne, Thụy Sĩ
卢旺达=Rwanda¦Ru-an-đa
卢森堡=Luxembourg¦Lúc-xăm-bua¦Lục Xâm Bảo¦Đại công quốc Lúc-xăm-bua
卢森堡城=Luxembourg¦Lúc-xăm-bua
卢瑟福=Rutherford¦Lư Sắt Phúc- Rutherford
卢西奥=Lúcio¦Lucio
卢象升=Lư Tượng Thăng¦Lô Tượng Thăng
卧龙凤雏=Ngoạ Long Phượng Sồ¦Ngọa Long Phượng Sồ
卫拉特=Oirat¦Vê-lát
卫斯理=Wisely¦Wesley¦Vệ Tư Lý¦Weasley
印古什=Ingushetia¦Vùng Ingushetia của Nga Phía bắc Kavkaz
印地安=Indian¦Ấn Độ
印地安纳=Indiana¦Anh-đi-a-na¦In-đi-e-nơ
印度尼西亚=Indonesia¦In-đô-nê-xi-a¦Nam Dương
印度支那=Indochina¦Đông Dương
印度洋=Ấn Độ Dương¦Indian Ocean
印第安纳=Indiana¦Indiana, tiểu bang Hoa Kỳ
厄尔尼诺=El Niño¦El Niño, biến đổi khí hậu xích đạo ở Thái Bình Dương
厄尔布鲁士=Elbrus¦núi Elbrus, đỉnh cao nhất của dãy núi Caucasus
厄底斯=Ách Để Tư¦Odes
厄毗米修斯=Ách Bì Mễ Tu Tư¦Epimetheus
厄瓜多尔=Ecuador¦Ê-cu-a-đo
厄立特里亚=Eritrea¦Lập Đặc Lý Á¦Ê-ri-trê
原始秘境=Nguyên Thủy Bí Cảnh¦Nguyên Thủy bí cảnh
参天造化露=Tham Thiên Tạo Hóa Lô¦Tham Thiên Tạo Hóa Lộ
双城记=Chuyện hai thành phố¦Song Thành Ký
双头蛇=Song Đầu Xà¦song đầu xà
变形金刚=Transformers¦Người vận chuyển
古天乐=Cổ Thiên Lạc¦Cổ Thiên Nhạc
古德拉=Cổ Đức Lạp¦Dracula
古拉多=Cổ Lạp Đa¦Groudon
可爱橘子=Khả Ái Quất Tử¦Quả Quýt Dễ Thương
史提夫=Sử Đề Phu¦Steve
右方之火=Fiamma bên phải¦Fiamma Bên Phải¦Fiamma of the Right
叶卡捷琳娜=Ekaterina¦Catherine Đại đế hay Catherine Đệ nhị¦Catherine
叶广行=Diệp Quảng Hành¦Diệp Nghiễm Hành
叶永烈=Diệp Vĩnh Liệt¦Ye Yonglie
司徒雷登=Tư Đồ Lôi Đăng¦John Leighton Stuart
司礼监=Ty Lễ Giám¦Ty lễ giám
司马炎=Tư Mã Viêm¦Sima Yan
司马错=Ti Mã Thác¦Ty Mã Thác
司马阴=Ti Mã Âm¦Tư Mã Âm
吉娃娃=Chihuahua¦Chihuahua (chó nhỏ mexico)
吉祥天=Cát Tường Thiên¦Kisshō-ten
同仁堂=Đồng Nhân Đường¦Tongrentang, công ty dược phẩm Trung Quốc
名古屋=Nagoya¦Nagoya, thành phố ở Nhật Bản
吐谷浑=Thổ Dục Hồn¦dân tộc Thổ Dục Hồn
吐鲁番=Thổ Lỗ Phiên¦thành phố Turpan ở Tân Cương
吕不韦=Lã Bất Vi¦Lữ Bất Vi
吕洞宾=Lã Động Tân¦Lü Dongbin
吕贝克=Lübeck¦Lübeck, Đức
君士坦丁堡=Constantinopolis¦Constantinople¦Constantinople, thủ đô của Byzantium
君天仇=Quân Thiên Thù¦Quân Thiên Cừu
君威山主=Quân Uy Sơn Chủ¦Quân Uy sơn chủ
吞天灭地=Thôn Thiên Diệt Địa¦thôn thiên diệt địa
启示录=Sách Khải Huyền¦Sự khải truyền
启示者=Apocalypse¦người mặc khải
吴三桂=Ngô Tam Quế¦Wu Sangui
吴镇宇=Ngô Trấn Vũ¦Francis Ng Chun-Yu
周公瑾=Chu Công Cẩn¦Zhō Gongjin
周华健=Chu Hoa Kiện¦Wakin Chau
周子瑜=Chu Tử Du¦Tzuyu
周小胖=Chu Tiểu Béo¦Chu Tiểu Bàn
周慧敏=Chu Tuệ Mẫn¦Châu Huệ Mẫn
周文王=Chu Văn Vương¦Vua Ôn của nhà Chu
周星星=Châu Tinh Tinh¦Chu Tinh Tinh
周杰伦=Châu Kiệt Luân¦Chu Kiệt Luân
周武王=Chu Võ Vương¦Chu Vũ Vương
周海媚=Chu Hải Mị¦Châu Hải My
周润发=Châu Nhuận Phát¦Chow Yun-Fat
周穆王=Chu Mục Vương¦Vua Mu, vị vua thứ năm của Chu, được cho là sống đến 105 và trị vì 976-922 trước Công nguyên hoặc 1001-947 trước Công nguyên, giàu thần thoại liên quan
周香凛=Chu Hương Lẫm¦Zhou Xianglin
呼伦贝尔=Hulunbuir¦thành phố cấp tỉnh Hulunbuir ở Nội Mông
和菜头=He Caitō¦Hòa Thái Đầu
哆啦A梦=Doraemon¦Doremon¦Đôrêmon
哈加纳=Cáp Gia Nạp¦Hagana
哈拉雷=Harare¦Cáp Lạp Lôi
哈杰霍纳=Cáp Kiệt Hoắc Nạp¦Hadrhune
哈格曼=Cáp Cách Mạn¦Hagman
哈米吉多顿=Armageddon¦Ha-ma-ghê-đôn
哈萨克=Kazakh¦Nhóm dân tộc Kazakh ở CHND Trung Hoa¦Cáp Tát Khắc¦Kazakhstan
哈萨克斯坦=Kazakhstan¦Ca-dắc-xtan
哈迪克=Cáp Địch Khắc¦Hardik
哈里森=Harrison¦Cáp Lý Sâm¦Harison
哥伦比亚=Columbia¦Colombia¦Cô-lôm-bi-a
哥打巴鲁=Kota Bahru¦Kota Bharu, thành phố ở Malaysia giáp với Thái Lan, thủ phủ của vương quốc Kelantan
哥斯达黎加=Costa Rica¦Costarica¦Cô-xta-ri-ca
哥玛兽=Cát Mã Thú¦Gomamon
哥老会=Kha Lão Hội¦Kha lão hội
哥萨克=Cossack¦Cô-dắc
哮天犬=Hao Thiên Khuyển¦Hạo Thiên Khuyển
哲罗姆=Jérôme¦Jerome
唐三藏=Đường Tam Tạng¦Tang Sanzang¦Tam Tạng
唐吉坷德=Don Quixote¦Đôn Kihôtê
唐宣宗=Đường Tuyên Tông¦Hoàng đế Huyền Tông đời Đường
唐明皇=Đường Minh Hoàng¦Hoàng đế nhà Minh
唐泰斯=Dantès¦Dantes
唐玄宗=Đường Huyền Tông¦Hoàng đế Đường Huyền Tông
唐赛儿=Đường Tái Nhi¦Đường Trại Nhi
商纣王=Thương Trụ Vương¦Vua Chu của nhà Thương
喀喇汗=Khách Lạt Hãn¦Khách Lạt hãn¦Ca Lạt Hãn
喀土穆=Khartoum¦Khách Thổ Mục¦Khác-tum
喀布尔=Kabul¦Khách Bố Nhĩ¦Ca-bun
喀秋莎=Katyusha¦pháo Ca-chiu-sa¦khẩu Ca-chiu-sa
喀麦隆=Cameroon¦Camerun¦Ca-mơ-run
喜相逢=Hỉ Tương Phùng¦hỉ tương phùng
喜马拉雅山=Himalaya¦Himalayas¦núi Himalaya
四大天王=Tứ Đại Thiên Vương¦tứ đại Thiên vương¦tứ đại thiên vương¦bốn người bảo vệ hoặc chiến binh hầu cận của Đức Phật
四季豆=Tứ Quý Đậu¦cây đậu cô-ve¦đậu cove¦đậu que¦đậu bốn mùa
四库全书=Tứ Khố Toàn Thư¦Siku Quanshu
四绝公子=Tứ Tuyệt Công Tử¦"Tứ Tuyệt Công Tử"
四魂之玉=Ngọc Tứ Hồn¦Shikon no Tama
回春堂=Hồi Xuân Đường¦Hồi Xuân đường
回神丹=Hoàn Hồn Đan¦Hồi Thần Đan
因塞莱斯=Yacerila¦Nhân Tắc Lai Tư
因斯布鲁克=Innsbruck¦Innsbruck, thành phố ở Áo
固有结界=Cố Hữu Kết Giới¦Koyū Kekkai - Cố Hữu Kết Giới
国子监=Quốc Tử Giám¦quốc tử giám
国标舞=Quốc Tiêu Vũ¦Quốc tiêu vũ
国民党=Quốc Dân Đảng¦quốc dân đảng¦Quốc dân đảng
图内斯=Tounès¦Tunes
图坦卡蒙=Tutankhamun¦Tutankhamen, vua của Ai Cập cổ đại 1333-1323 trước Công nguyên
图波列夫=Tupolev¦Tupolev, hãng sản xuất máy bay Nga
图鲁斯=Toulouse¦Đồ Lỗ Tư¦Figure Andrews
圆明园=vườn Viên Minh¦Viên Minh Viên
土库曼=Turkmenistan¦Cộng hòa Turkmenistan, nước cộng hòa thuộc Liên Xô cũ tiếp giáp với Iran¦Thổ Khố Mạn (Turkmenistan)
土库曼斯坦=Turkmenistan¦Tuốc-mê-ni-xtan
土耳其=Thổ Nhĩ Kỳ¦Turkey
土行孙=Thổ Hành Tôn¦Thổ Hành tôn
圣乔治=thánh George¦Svätý Jur¦Saint George
圣但尼=Saint-Denis¦St Denis hoặc St Dennis
圣何塞=San Jose¦Xan Hô-xê
圣保罗=São Paulo¦São Paulo¦Paul¦Sao Paulo¦St. Paul
圣地亚哥=San Diego¦Santiago¦Xan-ti-a-gô
圣多明各=Santo Domingo¦Santo Domingo, thủ đô của Cộng hòa Dominica
圣多明哥=Santo Domingo¦Xan-tô Đô-min-gô
圣彼得=Thánh Peter¦St. Peter¦Saint Peter
圣母玛利亚=Đức Mẹ Maria¦Mary
圣皮埃尔=Saint-Pierre¦Xanh Pi-e-rơ¦Saint Pierre
圣萨尔瓦多=San Salvador¦Thánh Tát Nhĩ Ngoã¦Xan Xan-va-đo
圣赫勒拿岛=Saint Helena¦Xan Hê-li-na
圣雷米=thánh Rémy¦Saint-Rémy
圣马力诺=San Marino¦Xan Ma-ri-nô¦Saint Marino
圭亚那=Guyana¦Khuê Á Na¦Guy-a-na¦Cộng hoà hợp tác Guy-a-na
地爆天星=Địa Bộc Thiên Tinh¦Chibaku Tensei
地狱熔炉=Địa Ngục Dung Lô¦Địa Ngục Dong Lô
地藏王菩萨=Địa Tạng Vương Bồ Tát¦Địa Tạng Vương Bồ tát Đại Thế Chí Bồ tát
地藏菩萨=Địa Tạng Bồ Tát¦Địa Tạng Vương Bồ tát Đại Thế Chí Bồ tát
地裂斩=Địa Liệt Trảm¦Địa liệt trảm
地裂谷=Địa Liệt Cốc¦Đích Liệt Cốc
地风水火=Địa Phong Thủy Hỏa¦địa phong thuỷ hoả
地龙兽=Địa Long Thú¦Groundramon
坎特拉=Khảm Đặc Lạp¦Cantera
坚韧之手=Kiên Nhận Chi Thủ¦Buff
埃博拉=Ebola¦Vi rút Ebola)
埃及艳后=Cleopatra¦Ai Cập Diễm Hậu Cleopatra
埃塞俄比亚=Ethiopia¦Ê-ti-ô-pi-a¦Ê-ti-ô-pi
埃尔南德斯=Hernandez¦Hernández
埃德尔=Hélder¦Edel
埃德米=Edmé¦Edme
埃涅阿斯=Aeneas¦Aeneas, anh hùng của Virgil's Aeneid
埃瑞克=Erik¦Ai Thụy Khắc¦Eric
埋葬机关=Mai Táng Cơ Quan¦Cơ Quan Mai Táng¦Burial Agency
域外天魔=Vực Ngoại Thiên Ma¦Extraterrestrial Demon
基什尼奥夫=Kishinev¦Ki-si-nhép
基德曼=Kidman¦Cơ Đức Mạn
基拉韦厄=Kīlauea¦Kilauea, Hawaii, ngọn núi lửa hoạt động mạnh nhất thế giới
堪培拉=Canberra¦Kham Bối Lạp¦Can-be-ra
堪萨斯=Kansas¦Kham Tát Tư¦Căng-xát¦Ken-zớt
塔什干=Tashkent¦Tháp Thập Cán¦Ta-xken
塔伊斯=Thaís¦Thaïs¦Tayis
塔兰特=Tháp Lan Đặc¦Tarrant
塔利班=Taliban¦Tháp Lợi Ban
塔力克=Tháp Lực Khắc¦Korlic
塔吉克=Tajik¦Dân tộc Tajik¦Tacik
塔吉克斯坦=Tajikistan¦Tát-gi-ki-xtan
塔吉特=Target¦Tháp Cát Đặc¦Targett
塔塔尼亚=Tataniya¦Tháp Tháp Ni Á
塔妮娅=Tânia¦Taania¦Tania
塔希提=Tahiti¦Tahiti, hòn đảo thuộc nhóm Quần đảo Society ở Polynesia thuộc Pháp
塔米克=Tamik¦Tháp Mễ Khắc
塔里木=Tarim¦lưu vực Tarim ở nam Tân Cương
塞伦斯=Zaerens¦Tắc Luân Tư
塞内加尔=Senegal¦Tắc Nội Gia Nhĩ¦Xê-nê-gan
塞勒姆=Salem¦Salem, thủ đô của Oregon
塞图巴尔=Setubal¦Setúbal
塞巴斯蒂安=Sebastian¦Sébastien¦Sebastien
塞德里克=Cédric¦Cedric
塞拉利昂=Sierra Leona¦Tắc Lạp Lợi Ngang¦Sierra Leone¦Xi-ê-ra Lê-ôn
塞浦路斯=Cyprus¦Tắc Phổ Lộ Tư¦Síp
塞维利亚=Sevilla¦Seville, Tây Ban Nha¦Festival
塞舌尔=Seychelles¦Tắc Thật Nhĩ¦Xây-sen
塞莉娅=Celia¦Célia
塞萨尔=Cèsar¦César
塞西尔=Cecil¦Cécile
塞雷娜=Séréna¦Serena
墓陵之舟=Mộ Lăng Chi Chu¦Mộ Lăng Chi Thuyền
墨尔本=Melbourne¦Melbourne, Úc
墨西哥=Mexico¦Mê-hi-cô
备前长船长光=Bị Tiền Trường Thuyền Trường Quang¦Bizen Osafune Nagamitsu
夏侯惇=Hạ Hầu Đôn¦Kakōton¦Xiahō Dun
夏倾月=Xia Qingyue¦Hạ Khuynh Nguyệt
夏威夷=Hawaii¦Hawai¦Ha-oai¦Hạ Uy Di
夏虫语冰=Hạ Trùng Ngữ Băng¦[Hạ Trùng Ngữ Băng]
外界宿=Outlaw¦Outlaw (ngoại giới túc)
多伦多=Toronto¦Toronto, thủ phủ của Ontario, Canada
多拉戈=Đa Lạp Qua¦Do Lago¦Dolago
多普勒=Doppler¦Christian Johann Doppler, nhà vật lý người Áo, người phát hiện ra hiệu ứng Doppler
多米尼克=Dominica¦Dominic¦Thịnh vượng chung Dominica¦Dominique
多米尼加=Dominica¦Đa Mễ Ni¦Đô-mi-ních¦Đô-mi-ni-ca
夜叉王=Dạ Xoa Vương¦Dạ Xoa vương
夜神月=Yagami Raito¦Yagami Light¦Dạ thần nguyệt
大不列颠=Great Britain¦Nước Anh
大不里士=Tabriz¦thành phố Tabriz ở tây bắc Iran, thủ đô của Đông Azerbaijan Iran
大中华=Đại Trung Hoa¦Trung Quốc vĩ đại¦Chūka
大仲马=Dumas¦Alexandre Dumas, père
大内密探=Đại Nội Mật Thám¦mật thám bên trong lớn
大召唤术=Đại Triệu Hoán Thuật¦đại triệu hoán thuật
大司马=Đại Tư Mã¦đại tư mã
大地之城=Earth City¦Đại Địa Chi Thành
大地咆哮=Đại Địa Gào Thét¦Đại Địa Bào Hao
大小乔=Đại Tiểu Kiều¦kích thước Joe
大幂幂=Đại Mịch Mịch¦Mậu Mập
大悲咒=Đại Bi Chú¦Chú Đại Bi
大摔碑手=Đại Suất Bi Thủ¦Đại Ngã Bi Thủ
大数据=Big Data¦Big Data là các tập dữ liệu có khối lượng lớn và phức tạp
大日如来=Đại Nhật Như Lai¦Dainichi Nyorai¦mặt trời mọc như đến¦Vairocana, Đức Phật của sự giác ngộ tối cao¦Vairochana
大日真火=Đại Nhật Chân Hoả¦Đại Nhật Chân Hỏa
大梵般若=Đại Phạn Bàn Nhược¦Đại Phạm Bàn Nhược
大梵音雷寺=Đại Phạn Lôi Âm Tự¦Đại Phạm Lôi Âm Tự
大江山=Đại Giang Sơn¦núi Ōeyama
大灭神王=Đại Diệt Thần Vương¦Đại Diệt thần vương
大灵书回廊=Đại Linh Thư Hồi Lang¦Daireishokairō
大筒木=Ōtsutsuki¦gỗ ống lớn¦Ootutuki
大筒木羽村=Ōtsutsuki Hamura¦làng Mộc Vũ ống lớn
大筒木辉夜=Ōtsutsuki Kaguya¦ống lớn Mộc Huy Dạ¦Ootutuki Kaguya¦Ootsutsuki Kaguya
大胃王=Đại Vị Vương¦vua tham ăn
大荒郡=Đại Hoang Quận¦Đất Hoang Quận
大萨满=Đại Tát Mãn¦đại shaman
大蛇丸=Orochimaru¦Orochimaru, anh hùng truyện dân gian Nhật Bản
大蜜蜜=Đại Mịch Mịch¦mật ong lớn
大轮回=Đại Luân Hồi¦đại luân hồi
大运河=Đại Vận Hà¦sông đào lớn¦kênh lớn
大通母钱=Đại Thông Mẫu Tiền¦Đại Thông Mẫu Tiễn
大隈重信=Ōkuma Shigenobu¦đại tùy thư trọng thư
大雁塔=Đại Nhạn Tháp¦Chùa ngỗng hoang khổng lồ ở Tây An
大雪山=Đại Tuyết Sơn¦núi tuyết lớn
大青山=Đại Thanh Sơn¦núi ở tỉnh Hắc Long Giang
大预言术=Đại Dự Ngôn Thuật¦Đại dự ngôn thuật
大食教=Đại Thực Giáo¦Đại Thực giáo
大马士革=Damascus¦Đa-mát
大魔王=Đại Ma Vương¦đại ma vương
大魔门=Đại Ma Môn¦đại ma môn
大鹏王=Đại Bằng Vương¦Đại Bàng Vương
大黄蜂=Bumblebee¦Đại Hoàng Phong¦Hornet
天之矛=Thiên Chi Mâu¦Ama no Hoko
天使具装=Thiên Sứ Cụ Trang¦Thiên Sử Cụ Trang
天元宗=Thiên Nguyên Tông¦Thiên Nguyên Tông
天元突破=Gurren Lagann¦Thiên Nguyên Đột Phá
天启坦克=Apocalypse Tank¦Apocalypse Tanks (Xe tăng bọc thép)
天地乖离=Thiên Địa Quai Ly¦Enuma
天堂岛=Thiên Đường Đảo¦Paradise Island
天壤劫火=Thiên Nhưỡng Kiếp Hỏa¦Tenjō no Gōka¦Cosmicjhor
天巧门={Thiên Xảo Môn}¦Thiên Xảo Môn
天平秤=Thiên Bình Xứng¦cân Thiên Bình
天戈符=Thiên Qua Phù¦Thiên Thương Phù
天机宫=Thiên Cơ Cung¦Thiên Cơ cung
天武国=Thiên Vũ Quốc¦Thiên Vũ quốc
天涯海阁=Thiên Nhai Hải Các¦{Thiên Nhai Hải Các}
天狐一族=Thiên Hồ Nhất Tộc¦Thiên Hồ nhất tộc
天王山=núi Thiên Vương¦Thiên Vương Sơn
天理教=Tenrikyo¦Thiên lý giáo¦giáo phái Thiên lý
天生牙=Thiên Sinh Nha¦Tenseiga
天破壤碎=Thiên Phá Nhưỡng Toái¦Tenpa Jōsai
天穹之弓=Thiên Khung Chi Cung¦Thiên Khung Chi Cung (Tauropolos)¦Tauropolos
天空之龙=Thiên Không Chi Long¦Thiên Không Long
天翔龙闪=Thiên Tường Long Thiểm¦Tenshōryūsen
天蚕土豆=Tian Can Tu Dō¦Thiên Tằm Thổ Đậu¦Thiên Tàm Thổ Đậu
天衣着装=Rampage Dress¦Rampage Dress (Thiên Y Trứ Trang)
天道宫=Thiên Đạo Cung¦Tendōkyū
天青山=Thiên Thanh Sơn¦Tensei Mount
天顶星=Zentradi¦robotech¦Ngôi sao trên mái nhà
天魔功=Thiên Ma Công¦Thiên Ma công
太上老君=Thái Thượng Lão Quân¦Thái Thượng lão quân¦Taijō Rōkun
太乙真人=Thái Ất Chân Nhân¦Thái Ất chân nhân¦Taiitsu Shinjin
太仆寺=Thái Bộc Tự¦Tòa án hoàng gia, văn phòng ban đầu phụ trách chăn nuôi ngựa
太公望=Thái Công Vọng¦Taikōbō
太史慈=Taishiji¦Thái Sử Từ
太和殿=Thái Hoà Điện¦Sảnh Hòa hợp Tối cao
太子太保=Thái Tử Thái Bảo¦Thái tử thái bảo¦gia sư cho thái tử
太师叔祖=Thái Sư Thúc Tổ¦thái sư thúc tổ
太平天国=Thái Bình Thiên Quốc¦Thái bình Thiên Quốc
太平洋=Thái Bình Dương¦Taihei Hiroshi¦Pacific Ocean
太极图=Thái Cực Đồ¦thái cực đồ
太玄殿=Thái Huyền Điện¦Thái Huyền điện
太白金星=Thái Bạch Kim Tinh¦sao Thái Bạch¦sao Bạch Kim quá
太空步=Moonwalk¦bước không gian¦moonwalk
太行山=Thái Hành Sơn¦Dãy núi Taihang ở biên giới giữa Hà Bắc và Sơn Tây
夸父逐日=Khoa Phụ Trục Nhật¦Khoa Phụ đuổi mặt trời¦quyết tâm lớn
夺天丹=Đoạt Thiên Đan¦Đoạt Thiên đan
奇奥大陆=Kỳ Ảo Đại Lục¦Kỳ Áo Đại Lục
奈洛比=Nairobi¦Nai-rô-bi
奎斯特=Queste¦Khuê Tư Đặc
契科夫=Chekhov¦Bychkov¦Khế Khoa Phu¦Chekov
奥克萨=Oksa¦Áo Khắc Tát
奥兰纳=Áo Lan Nạp¦Orana
奥利哈钢=Orichalcos¦Orichalcum¦Orichalcum kim loại
奥利奥=Oreo¦Bánh quy Oreo¦Oglio¦oreo
奥古都斯=Augustus¦Áo Cổ Đô Tư
奥地利=Áo¦nước Áo¦Austria
奥姆真理教=Aum Shinrikyō¦Aum Shinrikyo¦Japanese Aum Doomsday Cult¦Aum Chân Lý Giáo
奥尔巴尼=Albany¦Áo Ba Ni
奥尔法=Áo Nhĩ Pháp¦Orfa
奥尔良=Orleans¦Orléans
奥德赛=Odyssey¦sử thi Odyssey¦Homer's Odyssey
奥斯丁=Austin¦Austin hoặc Austen
奥斯卡=Oscar¦Òscar
奥斯忒=Oersted¦Ơ-xtét
奥斯曼=Ottoman¦Đế chế Ottoman)¦Othman¦Osman¦Haussmann
奥斯瑞克=Áo Tư Thụy Khắc¦Ostrenko
奥斯陆=Oslo¦Áo Tư Lục¦Ô-xlô
奥本海默=Oppenheimer¦Áo Bản Hải Mặc
奥林匹亚=Olympia¦Olimpia¦Ô-lim-pi-a Ơ-lim-pi-ơ
奥格斯=Áo Cách Tư¦Augus
奥西里斯=Osiris¦Áo Tây Lý Tư
奥里西斯=Áo Lý Tây Tư¦Osiris
奥黛丽雅=Odelia¦Áo Đại Lệ Nhã
女儿红=Nữ Nhi Hồng¦nữ nhi hồng¦con gái đỏ
女武神=Nữ Võ Thần¦Valkyrie¦nữ võ thần
女诸葛=Nữ Gia Cát¦Nữ Chư Cát
奴佛卡因=Novocaine¦Nô-vô-ca-in
如来佛=Phật Như Lai¦phật như lai¦Như Lai Phật
如来佛祖=Như Lai Phật Tổ¦phật tổ Như Lai¦Như Lai phật tổ
妖魔王=Yomao¦Yêu Ma Vương
妮蒂娅=Nídia¦Nidia
妮西雅=Ny Tây Nhã¦Nyasi¦Nisea
姆巴巴纳=Mbabane¦Mơ-ba-ban
始皇帝=Thuỷ Hoàng Đế¦First Emperor¦Shikōtei
姚天君=Yō Tenkun¦Diêu Thiên Quân
姜子牙=Khương Tử Nha¦Jiang Ziya
姬长生=Cơ Trường Sanh¦Cơ Trường Sinh
威尔士=Wales¦Wales, quốc gia cấu thành Vương quốc Anh
威尔斯=Welles¦Wells¦Wales¦cái giếng
威廉斯塔德=Willemstad¦Vin-lem-xtát
威斯康星=Wisconsin¦Uy Tư Khang¦Uy-xcon-xin
威灵顿=Wellington¦Arthur Wellesley, Công tước Wellington
娘子军=Nương Tử Quân¦nương tử quân¦đội quân tóc dài
婆罗洲=Borneo¦Đảo Borneo
子母河=sông Tử Mẫu¦Tử Mẫu Hà
孔夫子=Khổng Phu Tử¦Khổng Tử
孔尚任=Khổng Thượng Nhiệm¦Kong Shangren
孔雀王=Khổng Tước Vương¦Kujakuō
孙大圣=Tôn Đại Thánh¦Mặt trời vĩ đại
孙思邈=Tôn Tư Mạc¦Sun Simiao
孙悟天=Son Goten¦Sôn Gô Tên
孙悟空=Tôn Ngộ Không¦Wukong Sun¦Son Goku
孙燕姿=Tôn Yến Tư¦Stefanie Sun
孛儿只斤=Bột Nhi Chỉ Cân¦Borjigit
孟什唯克=Menshevik¦Men-sê-vích
孟尝君=Mạnh Thường Quân¦Lãnh chúa Menchang của Qi, tể tướng của Qi và của Wei trong thời Chiến quốc
季羡林=Quý Tiễn Lâm¦Ji Xianlin
孤独九剑=Độc Cô Cửu Kiếm¦cô đơn chín thanh kiếm¦Cô Độc Cửu Kiếm
宁风致=Trữ Phong Trí¦Ning Fengzhi
宇多田光=Utada Hikaru¦Vũ Đa Điền Quang
安东尼奥=Antonio¦António
安吉尔=Angel¦thiên thần
安塔那那利佛=Antananarivo¦An-ta-na-na-ri-vô
安大略省=Ontario¦Tỉnh Ontario, Canada
安宁道=An Ninh Đạo¦Path of Peace¦An'neidō
安德丽娅=Andréa¦Andrea
安德烈=Andre¦Andrei¦Andrew¦An Đức Liệt¦Andrea
安德蕾=Andrée¦Andere
安德逊=An Đức Tốn¦Anderson
安德鲁斯=Andrews¦Andrew¦An Đức Lỗ Tư
安瑞尔=An Thụy Nhĩ¦Airial¦Ariel
安第斯=Andes¦dãy núi Andes
安纳塞隆=An Nạp Tắc Long¦Anetheron
安纳托利亚=Tiểu Á¦Anatolia, trẻ vị thành niên châu Á
安纳波利斯=Annapolis¦Anápolis
安蒂妮=Etienne¦An Đế Ny
安赫尔=Ángel¦Angel
安迪斯=Andis¦An Địch Tư¦Andes
安道尔=Andorra¦An Đạo Nhĩ¦An-đo-ra
安都瑞尔=Andúril¦Anduril
安鲁拉=An Lỗ Lạp¦Anlula
安黛儿=An Đại Nhi¦Andel
宋徽宗=Tống Huy Tông¦Hoàng đế Huizong
宋祖儿=Tống Tổ Nhi¦Tống Tổ nhi
宋祖英=Tống Tổ Anh¦Song Zuying
宋美龄=Tống Mỹ Linh¦Soong Mei-ling
定海神针=Định Hải Thần Châm¦ổn định lực lượng
宝诗龙=Bảo Thi Long¦Boucheron
家乐福=Carrefour¦Carrefour, chuỗi siêu thị Pháp¦Carrefour (*France)¦Gia Nhạc Phúc
宾夕法尼亚=Pennsylvania¦Pen-xin-va-ni-a Pen-xiu-vây-ni-ơ
密克罗尼西亚=Micronesia¦Mi-crô-nê-xi-a
密尔沃基=Milwaukee¦Miwaukee¦Mật Nhĩ Ốc Cơ
密拉丝=Mật Lạp Ti¦Milace
密斯拉=Mật Tư Lạp¦Misra¦Mystra¦Mithras
密歇根=Michigan¦Mật Hiết Căn¦Mi-si-gân
密苏里=Missouri¦Mật Tô Lý¦Mi-xu-ri Mi-du-ri
富士康=Foxconn¦Phú Sĩ Khang¦Tập đoàn công nghệ Foxconn
寒冰山=Hàn Băng Sơn¦Hàn Băng sơn
察合台=Sát Hợp Đài¦Chagatai
察哈尔=Sát Cáp Nhĩ¦Chahar¦Tỉnh Chahar¦Chakhar
寸劲拳=Thốn Kình Quyền¦Thốn Kính Quyền
寻宝鼠=Tầm Bảo Thử¦chuột tầm bảo
封神传=Phong Thần Truyện¦phong thần truyện¦truyện phong thần
射杀百头=Xạ Sát Bách Đầu¦Nine Lives
射雕英雄传=Xạ Điêu Anh Hùng Truyện¦xạ điêu anh hùng truyện¦Legend of the Condor Heroes, tiểu thuyết wuxia
尉迟元=Úy Trì Nguyên¦Uất Trì Nguyên
尉迟恭=Uất Trì Cung¦Tướng quân Yuchi Gong
尉迟雪=Úy Trì Tuyết¦Uất Trì Tuyết
尊药鼎=Dược Đỉnh¦Tôn Dược Đỉnh
小三儿=Tiểu Tam Nhi¦tiểu tam nhi
小乾坤界=Tiểu Càn Khôn Giới¦Tiểu Kiền Khôn Giới
小亚细亚=Tiểu Á¦Asia Minor
小刀会=Tiểu Đao Hội¦Dagger Society, hội kín chống nhà Thanh, người đã tổ chức một cuộc nổi dậy bất thành vào năm 1855
小医仙=Tiểu Y Tiên¦tiểu y tiên
小叮当=Doraemon¦Tiểu Đinh Đương
小李飞刀=Tiểu Lý Phi Đao¦tiểu lý phi đao¦Tiểu Lý phi đao
小武神=Tiểu Võ Thần¦Tiểu Vũ Thần
小甜甜=Tiểu Điềm Điềm¦Britney
小田樱子=Oda Yingzi¦Tiểu Điền Anh Tử
小白龙=tiểu bạch long¦Tiểu Bạch Long
小静静=Tiểu Tĩnh Tĩnh¦Shizuka-chan
少林寺=Thiếu Lâm Tự¦Thiếu Lâm tự¦chùa Thiếu Lâm¦Chùa Thiếu Lâm, tu viện Phật giáo nổi tiếng với các nhà sư kung fu
少林拳=Thiếu Lâm Quyền¦quyền thuật thiếu lâm¦võ thiếu lâm
少林长拳=Thiếu Lâm Trường Quyền¦thiếu lâm trường quyền
尖沙咀=Tiêm Sa Trớ¦Tiêm Sa Chuỷ¦Tsim Sha Tsui, khu đô thị hóa ở Hồng Kông¦Tiêm Sa Chủy
尚书令=Thượng Thư Lệnh¦thượng thư lệnh
尚方宝剑=Thượng Phương Bảo Kiếm¦thượng phương bảo kiếm¦Thượng phương bảo kiếm
尤丽娅=Julia¦Vưu Lệ Á
尤里斯=Joris¦Vưu Lý Tư¦Juris¦Uris
尸骨脉=Shikotsumyaku¦Thi Cốt Mạch
尹红袖=Doãn Hồng Tụ¦Duẫn Hồng Tụ
尼亚美=Niamey¦Ni-a-mây
尼可拉斯=Nicolas¦Ni Khả Nạp Tư¦Nicholas
尼奥特=Neot¦Ni Áo Đặc
尼尔森=Nelson¦Ni Nhĩ Sâm¦Nielsen hoặc Nelson
尼德兰=Netherlands¦hà lan¦Nederland¦Nederan
尼日利亚=Nigeria¦Nigiêria¦Ni-giê-ri-a
尼日尔=Niger¦Ni Nhật Nhĩ¦Ni-giê
尼普尔=Nippur¦Ni Phổ Nhĩ¦Nipple
尼泊尔=Nepal¦Ni Bạc Nhĩ¦Nê-pan
尼科西亚=Nicosia¦Ni-cô-xi-a
尼索德=Nethod¦Ni Tác Đức
居合斩=Cư Hợp Trảm¦Cut
屏息术=Bình Tức Thuật¦Nín Thở Thuật
屠龙匕=Lưỡi Dao Đồ Long¦dao Đồ Long
山口百惠=Sơn Khẩu Bách Huệ¦Yamaguchi Momoe
山椒鱼半藏=Hanzō Kì Nhông¦Salamanders Hanzo¦Salamander Hanzo
岩王帝君=Nham Vương Đế Quân¦Nham vương Đế quân
崇侯虎=Su Koko¦Sùng Hầu Hổ
崇文门=Sùng Văn Môn¦Cổng Chongwenmen ở Bắc Kinh
崔判官=Thôi phán quan¦Thôi Phán Quan
川端康成=Kawabata Yasunari¦Kawabata Yasunari, người đoạt giải Nobel văn học Nhật Bản
左宗棠=Tả Tông Đường¦Zuo Zongtang
左都御史=Tả Đô Ngự Sử¦tả đô ngự sử
巨斧创始者=Người Sáng Lập Cự Phủ¦Cự Phủ người sáng lập
巨鲸帮=Cự Kình Bang¦Cự Kình bang
巫妖王=Vu Yêu Vương¦vu yêu vương
巴伦西亚=Valencia¦Valencia, Tây Ban Nha
巴克斯=Bacchus¦Bacchus, thần rượu vang của Hy Lạp¦Buck¦Bax
巴克科斯=Bacchus¦Bacchus, thần rượu vang của Hy Lạp
巴克莱=Barclays¦Barclay hoặc Berkeley
巴列奥略=Palaiológos¦Palaeologus
巴勒斯坦=Palestine¦Ba Lặc Tư Thản
巴勒莫=Palermo¦Palermo, Ý
巴哈马=Bahamas¦Thịnh vượng chung Bahamas
巴基斯坦=Pakistan¦Ba Cơ Tư Thản¦Pa-ki-xtan
巴塞尔=Basel¦Basel, Thụy Sĩ
巴尔干=Balkan¦Ba Nhĩ Kiền¦Balkans
巴尔扎克=Balzac¦Honoré de Balzac
巴尔托=Polus¦Ba Nhĩ Thác
巴尔默=Balmer¦Ba Nhĩ Mặc¦Barmer¦Ballmer
巴巴里=Barbary¦Ba Ba Lý
巴布亚新几内亚=Papua New Guinea¦Pa-pua Niu Ghi-nê
巴托里=Báthory¦Bathory
巴拉圭=Paraguay¦Ba Lạp Khuê¦Pa-ra-goay
巴拉尔=Ba Lạp Nhĩ¦Balar
巴拉马利波=Paramaribo¦Paramaribo, thủ đô của Suriname
巴斯克=Basque¦Xứ Basque¦Baasker
巴斯塔=Ba Tư Tháp¦Basta
巴斯特尔=Basseterre¦Ba-xte-rơ
巴格达=Baghdad¦Bát Đa¦Bát-đa
巴特拉=Ba Đặc Lạp¦Battra¦Battera
巴萨卡=Basac¦Ba Tát Tạp¦Berserker¦berserk
巴西利亚=Brasilia¦Ba Tây Lợi Á¦Bra-xi-li-a¦Brasília
巴贝尔=Babel¦Ba Bối Nhĩ
巴达克=Bardack¦Ba Đạt Khắc¦Kakalat
巴达思=Badas¦Ba Đạt Tư
巴达斯=Badas¦Ba Đạt Tư
巴达维=Batavi¦Ba Đạt Duy¦Batavodurum¦Badawi
巴迪特=Ba Địch Đặc¦Baditt
巴风特=Baphomet¦Ba Phong Đặc
巴马科=Bamako¦Ba-ma-cô
巴鲁特=Baruth¦Ba Lỗ Đặc¦Brloote
布伦德=Bố Luân Đức¦Blender¦Brund
布兰卡=Blanca¦Bố Lan Tạp
布兰奇=Blanche¦Bố Lan Kỳ¦Branch
布兰森=Bronson¦Branson hoặc Brandsen
布列塔尼=Bretagne¦Brittany hoặc Bretagne, khu vực phía tây nước Pháp¦Brittany¦Breton
布列斯特=Brest¦Brest, thị trấn ở Belarus
布加勒斯特=Bucharest¦Bố Gia Lặc Tư¦Bu-ca-rét
布加迪=Bugatti¦Bố Gia Địch
布卡斯=Bố Tạp Tư¦Bucas
布哈拉=Bukhara¦Bokhara hoặc thành phố Bukhara ở Uzbekistan
布基纳法索国=Burkina Faso¦Buốc-ki-na Pha-xô
布宜诺斯艾利斯=Buenos Aires¦Bu-ê-nốt Ai-rét
布尔什维克=Bolshevik¦bôn-sê-vích¦cộng sản¦đa nguyên đa đảng
布拉吉=Blazy¦váy liền áo¦váy liền¦Bragi
布拉德福德=Bradford¦Bradford, thành phố ở Tây Yorkshire, Anh
布拉特=Blatter¦Bố Lạp Đặc
布林顿=Bố Lâm Đốn¦Blington
布格尔=Bố Cách Nhĩ¦Bugle
布泽尔=Boozer¦Bố Trạch Nhĩ
布洛芬=Ibuprofen¦Ibuprofen hoặc Nurofen
布瑞特=Bố Thụy Đặc¦Brett¦Brit
布纳洛迦=Bố Nạp Lạc Già，¦Bố Nạp Lạc Già
布莱克=Blake¦Bố Lai Khắc¦Black
布莱顿=Brighton¦Brighton, thị trấn ở Anh
布达佩斯=Budapest¦Bu-đa-pét
布里斯托尔=Bristol¦thành phố cảng Bristol ở tây nam nước Anh
布里斯班=Brisbane¦Brisbane, thủ phủ của Queensland, Úc
布隆伯格=Bloomberg¦Blumberg hoặc Bloomberg¦Blumberg
布隆迪=Burundi¦Bố Long Địch¦Bu-run-đi
布雷尔=Blair¦Bố Lôi Nhĩ¦Brel
布雷恩=Brian¦Bố Lôi Ân¦Brean¦Brain
布雷斯特=Brest¦Brest, thị trấn cực tây ở Pháp
布雷纳=Brénaz¦Brainer
布雷纳斯=Bố Lôi Nạp Tư¦Brenas
布雷肯=Bố Lôi Khẳng¦Bracken
布鲁克林=Brooklyn¦Brooklyn, quận của Thành phố New York
布鲁塞尔=Brussels¦Brúc-xen
布鲁托=Pluto¦Plutos¦Bố Lỗ Thác
布鲁斯=Bruce¦Điệu blue
希伯来=Hebrew¦Tiếng Do Thái
希拉克=Chirac¦Jacques René Chirac
希拉尔=Hi Lạp Nhĩ [Shiela]¦Hi Lạp Nhĩ
希拉特=Hi Lạp Đặc¦Herat
希拉里=Hillary¦Hi Lạp Lý
帕克斯顿=Parkston¦Mạt Khắc Tư Đốn¦Paxton
帕尔玛=Mạt Nhĩ Mã¦Palma¦Parma
帕拉马里博=Paramaribo¦Pa-ra-ma-ri-bô
帕果帕果=Pago Pago¦Pa-gô Pa-gô
帕格尼尼=Paganini¦Niccolò Paganini
帕特里夏=Patrícia¦Patricia
帕米尔=Pamir¦Cao nguyên Pamir ở biên giới giữa Tân Cương và Tajikistan¦Pamirs
帕维尔=Pavel¦Mạt Duy Nhĩ
帕里斯=Paris¦Mạt Lý Tư
帖木儿=Thiếp Mộc Nhi¦Timur hoặc Tamerlane
干将莫邪=Can Tương Mạc Tà¦Can Tương, Mạc Tà
平天大圣=Bình Thiên Đại Thánh¦Bình Thiên đại thánh
平英团=Bình Anh Đoàn¦Bình Anh đoàn
幻想乡=Gensōkyō¦Huyễn Tưởng Hương¦Gensokyo¦Gensokyou
幻空戒=Huyễn Không Giới Chỉ¦Huyễn Không Giới
广寒冰焰=Quảng Hàn Băng Diễm¦Nghiễm Hàn Băng Diễm
广武殿=Quảng Vũ Điện¦Nghiễm Vũ Điện
广目天=Quảng Mục Thiên¦Nghiễm Mục Thiên
底格里斯=Tigris¦Sông Tigris, Iraq
底格里斯河=Sông Tigris¦sông Cách Lý Tư¦Sông Ti-grơ¦Tigris
底比斯=Thebes¦Thebes, thành phố cổ đại của Hy Lạp
底特律=Detroit¦Đề Đặc Luật
庞加莱=Poincaré¦Henri Poincaré
康涅狄格=Connecticut¦Khanh Niết Địch Cách¦Cơ-nê-ti-cớt
开天斧=Khai Thiên Phủ¦Khai Thiên Phu
开尔文=Kelvin¦Kelvins¦Khai Nhĩ Văn- Kelvin
异端审判庭=Ordo Hereticus¦dị đoan thẩm phán đình
弗吉尔=Vergil¦Phất Cát Nhĩ
弗吉尼亚=Virginia¦Phất Cát Ni Á¦Viếc-gi-ni-a¦Vơ-gi-ni-ơ
弗拉维奥=Fravio¦Flávio¦Flavio
弗洛伊德=Freud¦Floyd¦Tiến sĩ Sigmund Freud
弗洛里安=Flórián¦Florian
弗瑞德=Fred¦Phất Thụy Đức
弗雷德里克=Frederick¦Frederic¦Frédéric
张三李四=Trương Tam Lý Tứ¦ông A bà B¦anh mít anh xoài
张作霖=Trương Tác Lâm¦Zhang Zuolin
张国荣=Trương Quốc Vinh¦Leslie Cheung
张学友=Trương Học Hữu¦Jacky Cheung hoặc Hok Yau Jacky
张居正=Trương Cư Chính¦Zhang Juzheng
张廷玉=Trương Đình Ngọc¦Zhang Tingyu
张怡宁=Trương Di Ninh¦Zhang Yining
张惠妹=Trương Huệ Muội¦A-Mei, hay còn gọi là Gulilai Amit
张柏芝=Trương Bá Chi¦Cecilia Cheung¦Trương Bách Chi
张爱玲=Trương Ái Linh¦Eileen Chang
张献忠=Trương Hiến Trung¦Zhang Xianzhong
张翠山=Trương Thuý Sơn¦Trương Thúy Sơn
张若虚=Trương Nhược Hư¦Zhang Ruoxu
张韶涵=Trương Thiều Hàm¦Angela Chang
弥勒佛=Phật Di Lặc¦Di lặc
弥勒佛祖=Di Lặc Phật Tổ¦Di Lặc Phật tổ
弥留斯=Di Lưu Tư¦Myos
弥赛亚=Messiah¦chúa cứu thế¦Đấng cứu thế
弹指神通=Đạn Chỉ Thần Công¦đạn chỉ thần công¦chỉ thần thông
弼马温=Bật Mã Ôn¦bật mã ôn
形意拳=Hình Ý Quyền¦Hình Ý quyền¦Xingyiquan
彭泽斯=Bành Trạch Tư¦Penzes
彼岸之桥=Cây Cầu Bỉ Ngạn¦Bỉ Ngạn Chi Kiều
彼岸性=Paramita¦Fa-ra-mi-ta¦tính bờ bên kia¦bỉ an tính
彼岸花=Bỉ Ngạn Hoa¦hoa bỉ ngạn
彼得潘=Peter Pan¦Peter Pan, nhân vật tiểu thuyết
彼得里克=Peter Lik¦Petrică
彼拉多=Pilatius¦Philatô
彼拉森=Bilason¦Bỉ Lạp Sâm
徐光启=Từ Quang Khải¦Xu Guangqi
徐天宏=Từ Thiên Hoằng¦Từ Thiên Hoành
徐志摩=Từ Chí Ma¦Xu Zhimo
徐悲鸿=Từ Bi Hồng¦Xu Beihong
得克萨斯=Texas¦Texas, tiểu bang Hoa Kỳ
御剑山庄=Ngự Kiếm Sơn Trang¦Ngự Kiếm sơn trang
御史台=Ngự Sử Đài¦Đô ngự sử là Chức quan đứng đầu cơ quan của nhà nước phong kiến
御灵宗=Ngự Linh Tông¦Ngự Linh tông
德克萨斯=Texas¦Tếch-xát¦Tếch-xớt
德加尔=Degar¦Đức Gia Nhĩ¦Degarre
德古拉=Dracula¦Dracula, tiểu thuyết của Bram Stoker
德意志=Đức¦nước Đức¦Tiếng Đức
德瑞尔=Driel¦Đức Thụy Nhĩ
德瑞拉=Đức Thụy Lạp¦Deira¦Derella
德科尔=Décor¦Đức Khoa Nhĩ
德萨尔=Đức Tát Nhĩ¦Desal
德西克=Derthick¦Đức Tây Khắc¦Decyk
德里克=Derek¦Đức Lý Khắc¦Derrick
德鲁夫=Drouffe¦Đức Lỗ Phu
德黑兰=Tehran¦Đức Hắc Lan¦Tê-hê-ran
心灵之眼=Tâm Linh Chi Nhãn¦Tâm linh chi nhãn
必要之恶=Tất Yếu Chi Ác¦Necessarius
忒瑞西阿斯=Théresias¦Tiresias
快乐大本营=Khoái Lạc Đại Bản Doanh¦Happy Camp
忽必烈=Hốt Tất Liệt¦Khubilai Khan
怀俄明=Wyoming¦Hoài Nga Minh¦Oai-âu-minh
恩格斯=Engels¦Ân Cách Tư¦Ăng-ghen¦Friedrich Engels
恩莱科=Unluck¦Ân Lai Khoa
恩贾梅纳=Ndjamena¦Da-mơ-na
恶魔召唤=Ác Ma Triệu Hoán¦ác ma triệu hoán
悉德尼=Sidney¦Sidney hoặc Sydney
悟吉塔=Gogeta¦Siêu Xay Da
悬空寺=Huyền Không Tự¦Đền Xuankong hoặc Đền treo gần Yanyuan ở Sơn Tây
惠灵顿=Wellington¦Huệ Linh Đốn¦Oen-linh-tơn
惩戒骑士=Trừng Phạt Kỵ Sĩ¦Trừng Giới kỵ sĩ¦Khiển trách kỵ sĩ¦Trừng Giới Kỵ Sĩ
意大利=Italy¦I-ta-li-a¦Ý¦Ý Đại Lợi¦Italia
感恩节=Lễ Tạ Ơn¦ngày lễ Tạ Ơn
慕容奇=Mộ Dung Kì¦Mộ Dung Kỳ
慕尼黑=Munich¦Mu-ních
慕杰特=Mojester¦Mộ Kiệt Đặc
戈壁=sa mạc¦vùng sa mạc
戈尔曼=Qua Nhĩ Mạn¦Gorman
戈德温=Godwin¦Qua Đức Ôn
戏志才=Hí Chí Tài¦Hi Chí Tài
我吃西红柿=Wo Chi Xihong Shi¦Ngã Cật Tây Hồng Thị
战国策=Chiến Quốc Sách¦Chiến quốc sách
战律魔女=Sigrdrifa¦Chiến Luật Ma Nữ (Sigrdrifa)
戚继光=Thích Kế Quang¦Qi Jiguang
戴丽丝=Đái Lệ Ti¦Dalice¦Dilys
戴安娜=Diana¦Đái An Na
戴小楼=Đái Tiểu Lâu¦Đới Tiểu Lâu
戴沐白=Đái Mộc Bạch¦Dai Mu Bai
戴维德=David¦Davide¦Đới Duy Đức
戴维斯=Davis¦Đái Duy Tư¦Dai Weisi¦Davis hoặc Davies
打狗棒法=Đả Cẩu Bổng Pháp¦đả cẩu bổng pháp¦đánh chó¦Đả cẩu bổng pháp
托塔天王=Thác Tháp Thiên Vương¦chùa mang chúa
托天魔功=Thác Thiên Ma Công¦"Thác Thiên Ma Công"
托尔斯=Towers¦Thác Nhĩ Tư¦Tors¦Torth
托拉斯=Tơ-rớt¦Trust
托木尔峰=Thác Mộc Nhĩ Phong¦núi Tomur
托瑞尔=Toril¦Thác Thụy Nhĩ
托莱多=Toledo¦Thác Lai Đa¦Tô-li-đô
托马森=Thomason¦Thác Mã Sâm (Thomason)¦Tomasson¦Thomassen
拉包尔=Rabaul¦Rabaul, thành phố cảng và thủ đô của New Britain, đảo phía đông bắc Papua New Guinea
拉尔夫=Ralph¦Lạp Nhĩ Phu
拉巴特=Rabat¦Lạp Ba Đặc¦Ra-bát
拉文纳=Ravenna¦Ravenna trên bờ biển Adriatic của Ý
拉格朗日点=Điểm Lagrangian¦Điểm Lagrange
拉法兰=Raffarin¦Raffarin, thủ tướng Pháp dưới thời Jacques Chirac
拉泽尔=Lazăr¦Lazawr
拉米亚=Lạp Mễ Á¦Lamia
拉脱维亚=Latvia¦Lạp Thoát Duy Á¦Lát-vi-a
拉苏克=Lạp Tô Khắc¦Larzuk
拉菲尔=Rafael¦Lạp Phỉ Nhĩ¦Raphael¦Raphiel
拍立得=Polaroid¦chụp đứng
拔刀术=Thuật Rút Đao¦Bạt Đao Thuật
拔舌地狱=Cắt Lưỡi Địa Ngục¦Địa Ngục Bạt Thiệt
招宝天尊=Chiêu Bảo Thiên Tôn¦Chiêu Bảo thiên tôn
拜兰斯=Bailance¦Bái Lan Tư
拜恩斯=Bái Ân Tư-Baines¦Baines¦Byanse¦Bynes
拜火教=Bái Hoả Giáo¦đạo thờ Thần lửa¦bái hỏa giáo
拿破仑=Napoléon¦Napoleon
捷克斯洛伐克=Tiệp Khắc¦Cộng hòa Tiệp Khắc
捷尔任斯克=Dzerzhinsk¦Dzerzhinsk, thành phố Nga
掌中佛国=Chưởng Trung Phật Quốc¦Trong Bàn Tay Phật Quốc
掌心雷=Chưởng Tâm Lôi¦chưởng tâm lôi¦bàn tay sấm sét
探耽求究=Tham Đam Cầu Cứu¦Seeking Researcher
接引道人=Tiếp Dẫn Đạo Nhân¦Tiếp Dẫn đạo nhân
控火术=Khống Hoả Thuật¦Khống Hỏa Thuật¦Khống hỏa thuật
控球后卫=Point Guard¦hậu vệ kiểm soát bóng¦Hậu vệ dẫn bóng, hậu vệ kiểm soát bóng
提米丝=Timmce¦Đề Mễ Ti
搜狐网=Sohu¦Sohu, cổng thông tin điện tử và công ty truyền thông trực tuyến của Trung Quốc
摄魂术=Nhiếp Hồn Thuật¦Nhiếp hồn thuật
摇头丸=Ecstacy¦diêu đầu hoàn¦Thuốc lắc
摩加迪沙=Mogadishu¦Ma Gia Địch Sa¦Mô-ga-đi-xi-ô
摩哈迪=Mohardy¦Ma Cáp Địch
摩奇铊=Ma Kỳ Tha¦Ma Kì Tha
摩尔多瓦=Moldova¦Ma Nhĩ Đa Ngoã¦Môn-đô-va
摩德纳=Modena¦Modena, Ý
摩洛哥=Morocco¦Ma Lạc Ca¦Ma Rốc
摩纳哥=Monaco¦Mô-na-cô
摩萨德=Mossad¦Ma Tát Đức
撒克逊=Saxon¦Tát Khắc Tốn
撒切尔=Thatcher¦Nam tước Thatcher hay Margaret Thatcher
撒拉弗=Tát Lạp Phất [Sarof]¦Seraphim¦Sarof
撒马尔罕=Samarkand¦Samarkand, thành phố ở Uzbekistan
擒拿手=Cầm Nã Thủ¦cầm nã thủ
救世军=Cứu Thế Quân¦Salvation Army
敦刻尔克=Dunkirk¦Dunkirk, cảng ở miền bắc nước Pháp
文天祥=Văn Thiên Tường¦Wen Tianxiang
文征明=Văn Chinh Minh¦Wen Zhengming
文殊菩萨=Văn Thù Bồ Tát¦Văn Thù, vị Bồ tát của tỉnh giác sâu sắc
斗战胜佛=Đấu Chiến Thắng Phật¦chiến thắng Phật
斗破苍穹=Đấu Phá Thương Khung¦đấu phá thương khung
断地风=Đoạn Địa Phong¦Tachikaze
断魂刃=Đoạn Hồn Nhận¦Đao Đoạn Hồn
斯伯德=Sbard¦Tư Bá Đức
斯佩斯=Tư Bội Tư¦Space¦Speiss
斯卡其=Tư Tạp Kỳ¦Scary¦Skechers
斯卡特=Tư Tạp Đặc¦Stark¦Scater¦Scarter¦Skate
斯图卡=Tư Đồ Tạp¦Junkers¦Stuka
斯坦普=Tư Thản Phổ¦Stamford
斯坦科=Stanko¦Tư Thản Khoa¦Stanco
斯堪的纳维亚=Scandinavia¦Bán Đảo Scandinavia
斯塔夫=Tư Tháp Phu¦Gustav
斯塔德=Sittard¦Tư Tháp Đức
斯塔诺=Tư Tháp Nặc¦Stano
斯奈克=[Snake]¦Tư Nại Khắc
斯宾塞=Spencer¦Spencer hoặc Spence
斯宾诺莎=Spinoza¦Baruch hoặc Benedict Spinoza
斯巴特=Butte¦Tư Ba Đặc
斯巴达=Sparta¦điên cuồng¦bất ngờ¦shock¦không thể tin được
斯德哥尔摩=Stockholm¦Tư Đức Nhĩ Ma¦Xtốc-khôm
斯托克=Stork¦Tư Thác Khắc¦Stark
斯拉克=Tư Lạp Khắc¦Dothraki
斯拉夫=Slavic¦Tiếng Slavic¦Slav
斯拉夫人=Slav¦người Slavic
斯捷潘=Stepan¦Stepan hoặc Stefan
斯柯达=Skoda¦Škoda, nhà sản xuất xe hơi của Cộng hòa Séc, một công ty con của Tập đoàn Volkswagen
斯洛伐克=Slovak¦Slovakia¦Tiệp Khắc
斯洛克=Snocker (bida lỗ)¦Tư Lạc Khắc¦Snooker
斯特劳=Stelo¦Tư Đặc Lao¦Strout
斯特尔=Tư Đặc Nhĩ¦Ster
斯特恩=Stern¦nghiêm khắc
斯特曼=Steman¦Tư Đặc Mạn
斯皮尔=Spear¦Tư Bì Nhĩ
斯蒂尔=Stihl¦Tư Đế Nhĩ¦Steele¦Styre
斯蒂芬=Stephen¦Stéphane¦Stephen hoặc Steven¦Steven¦Stephan
斯蒂芬兰=Stephen Lang¦Tư Đế Phân Lan
斯蒂芬希格=Tư Đế Phân Hi Cách¦Steven Seagal ¦Steven Seagal
斯里兰卡=Sri Lanka¦Tư Lí Lan Tạp¦Xri Lan-ca¦Tích Lan
斯里巴加湾港=Bandar Seri Begawan¦Xơ-ri Bơ-ga-van
新加坡=Singapore¦Xin-ga-po¦Tân Gia Ba
新喀里多尼亚=New Caledonia¦Tân Ca-lê-đô-ni
新四军=Tân Tứ Quân¦Tân Tứ quân
新墨西哥=New Mexico¦Niu Mếch-xi-câu
新德里=New Delhi¦Tân Đức Lý¦Niu Đê-li
新斯科舍=Nova Scotia¦Tỉnh Nova Scotia, Canada
新泽西=New Jersey¦Tân Trạch Tây¦Niu Giơ-di
新浪网=Sina¦Sina, cổng thông tin điện tử Trung Quốc và công ty truyền thông trực tuyến
新西兰=New Zealand¦Tân Tây Lan¦Niu Di-lơn
新霉素=Tân Môi Tố¦Xtơ-rep-tô-mi-xin
方天画戟=Phương Thiên Hoạ Kích¦phương thiên họa kích¦Phương Thiên Họa Thích
方文山=Phương Văn Sơn¦Vincent Fang
方正容=Phương Chính Dung¦Phương Chánh Dung
施塔德=Thi Tháp Đức¦Stade
施奈德=Thi Nại Đức¦Schneider
施密特=Smith¦Schmidt hoặc Schmitt
旋风术=Toàn Phong Thuật¦Gió Xoáy Thuật
无名秘典=Vô Danh Bí Điển¦Vô Danh bí điển
无毁的湖光=Arondight¦Arondight: Ánh hồ bất diệt¦Aroundight
无生道=Vô Sinh Đạo¦Vô Sinh đạo
无相劫指=Vô Tướng Kiếp Chỉ¦Vô Tương Kiếp Chỉ
无相诀=Vô Tương Quyết¦Vô Tướng Quyết
无量寿=Vô Lượng Thọ¦Vô Lượng Thọ, vị Phật của cuộc sống vô lượng, may mắn và trí tuệ
无间地狱=Vô Gian Địa Ngục¦Địa Ngục Vô Gián¦vô gian địa ngục
无限大炮=Vô Hạn Đại Pháo¦Infinity Cannon
日内瓦=Geneva¦Geneva, Thụy Sĩ¦Genève
日月重光=Nhật Nguyệt Trọng Quang¦mọi thứ trở lại bình thường sau một biến động
日耳曼=Germanic¦Người Đức
旧日支配者=Cựu Nhật Chi Phối Giả¦Great Old Ones¦Great Old One
旧金山=San Francisco¦Cựu Kim Sơn
早老性痴呆= Bệnh Alzheimer¦Alzheimer's disease
时代华纳=Time Warner¦WarnerMedia¦Time Warner Inc., công ty truyền thông Hoa Kỳ
时间塔=Thời Gian Tháp¦Thời Gian tháp
明尼苏达=Minnesota¦Minh Ni Tô Đạt¦Mi-nê-dô-ta¦Mi-ni-xâu-tơ
明斯克=Minsk¦Minsk, thủ đô của Belarus
明月山水图=Minh Nguyệt Sơn Thủy Đồ¦Minh Nguyệt Sơn Thủy đồ
明月策=Minh Nguyệt Sách¦Minh Nguyệt sách
明治维新=Minh Trị Duy Tân¦Minh Trị Duy tân của Nhật Bản năm 1868
明特尔=Minteer¦Minh Đặc Nhĩ
昏睡术=Hôn Thụy Thuật¦Hôn Mê Thuật¦Hôn mê thuật
星宿海=Tinh Túc Hải¦Xingxiuhai, cao nguyên ở Qinhai gần đầu nguồn sông Hoàng Hà¦Tinh Tú Hải
星巴克=Starbucks¦tinh ba khắc¦Starbucks, chuỗi cửa hàng cà phê ở Mỹ
星星草=Tinh Tinh Thảo¦Stargrass
星月城=Tinh Nguyệt Thành¦Tinh Nguyệt thành
星爆气流斩=Starburst Stream¦Tinh Bạo Khí Lưu Trảm
星球大战=Star Wars¦Chiến tranh giữa các vì sao
星脉世代=Genestella¦Genestella (Tinh Mạch Thế Đại)¦
星黎殿=Tinh Lê Điện¦Seireiden
晋文公=Tấn Văn Công¦Công tước Wen of Jin
晓组织=Akatsuki¦Akatsuki tổ chức¦tổ chức Akatsuki
普修斯=Phổ Tu Tư¦Psius¦Perseus
普兰西=Phổ Lan Tây¦Plancy
普利策奖=Pulitzer¦giải thưởng Pulitzer
普尔曼=Pullman¦Phổ Nhĩ Mạn
普惠斯=Phổ Huệ Tư¦Puhuisi
普拉亚=Praia¦Phổ Lạp Á¦Pra-i-a
普罗列塔利亚=Proletariat¦Pơ-rô-lê-ta-ri-a
普莱斯=Price¦Giá
普贤菩萨=Phổ Hiền Bồ Tát¦Samantabhadra, Đức Chân lý của Phật giáo
普雷斯顿=Preston¦Preston, thành phố ở Anh
普鲁卡音=Procaine¦Prô-ken
普鲁士=nước Phổ¦Prussia¦Phổ
景德镇=Cảnh Đức Trấn¦Jingdezhen
暗光之剑=Ám Quang Chi Kiếm¦Ám Quang Kiếm
暴风城=Bạo Phong Thành¦Stormwind City
暴龙兽=Bạo Long Thú¦Greymon
曼哈顿=Manhattan¦Quận Manhattan của Thành phố New York
曼尼斯=Mạn Ni Tư¦Mannes
曼彻斯特=Manchester¦Man-chétx-tơ
曼德勒=Mandalay¦Mandalay, tỉnh và thành phố thứ hai của Myanmar
曼德拉=Mandela¦Mạn Đức Lạp¦Mandrake¦Nelson Mandela¦Mandora
曼德琳=Mạn Đức Lâm¦đàn Măng-đô-lin
曼海姆=Mannheim¦Mannheim, thành phố của Đức ở ngã ba sông Rhine và Neckar
曼陀铃=Mandolin¦đàn Măng-đô-lin
曾书书=Tằng Thư Thư¦Tăng Thư Thư
曾国藩=Tằng Quốc Phiên¦Tăng Quốc Phiên¦Zeng Guofan
曾阿牛=Tăng A Ngưu¦Từng A Ngưu
最后之剑=Tối Hậu Chi Kiếm¦Halvanhelev
月牙天冲=Getsuga Tenshō¦Nguyệt Nha Thiên Xung¦Getsuga Tenshou
月落星沉=Nguyệt Lạc Tinh Trầm¦chỉ trăng sắp lặn¦sao cũng đang mờ đi¦trời sắp sáng
望天港=Vọng Thiên Cảng¦cảng Vọng Thiên
望月城=Vọng Nguyệt Thành¦Vọng Nguyệt thành
望月湖=Vọng Nguyệt Hồ¦Vọng Nguyệt hồ
朝阳门=Triêu Dương Môn¦Khu phố Triều Dương Môn của Bắc Kinh
朝鲜族=Triều Tiên¦dân tộc Triều Tiên
朦胧术=Mông Lông Thuật¦Mông Lung Thuật
未央宫=cung Vị Ương¦Vị Ương Cung
本因坊=Bản Nhân Phường¦Honinbo, trường phái cờ vây chính ở Nhật Bản
本因坊秀策=Bản Nhân Phường Shūsaku¦Honinbo Shusaku
本杰明=Benjamin¦Benjamim¦Bổn Kiệt Minh¦Bennie
朱丽叶=Juliet¦Juliet hoặc Juliette
朱丽安娜=Julianna¦Chu Lệ An Na
朱利安=Julian¦Julian hoặc Julien¦Chu Lợi An
朱常洵=Chu Thường Tuân¦Can't sample empty collection
朱竹清=Chu Trúc Thanh¦Zhu Zhuqing
朱自清=Chu Tự Thanh¦Zhu Ziqing
朱莉安娜=Juliana¦Chu Lỵ An Na¦Julianna
朴次茅斯=Portsmouth¦Portsmouth, cảng biển miền nam nước Anh
朽木白哉=Hủ Mộc Bạch Tai¦Kuchiki Byakuya
杀人蜂=Sát Nhân Phong¦Bumblebee
杀戮之王=Sát Lục Chi Vương¦Sát Lục chi vương
李乘风=Lí Thừa Phong¦Lý Thừa Phong
李亚鹏=Lý Á Bằng¦Li Yapeng
李元霸=Lý Nguyên Bá¦Lý Nguyên Phách
李冰冰=Lý Băng Băng¦Li Bingbing
李嘉欣=Lý Gia Hân¦Michele Monique Reis
李嘉诚=Lý Gia Thành¦Sir Li Ka-shing
李天正=Lý Thiên Chính¦Lý Thiên Chánh
李天烈=Lý Thiên Liệt¦Lí Thiên Liệt
李天王=Lý Thiên Vương¦chùa mang chúa
李天琪=Lý Thiên Kỳ¦Lí Thiên Kì
李娜娜=Lí Na Na¦Lý Na Na
李子坚=Lý Tử Kiên¦Lí Tử Kiên
李宗盛=Lý Tông Thịnh¦Jonathan Lee
李寻欢=Lý Tầm Hoan¦lí tầm hoan
李岳灵=Lý Nhạc Linh¦Lí Nhạc Linh
李彦宏=Lý Ngạn Hồng¦Lý Ngạn Hoành
李成桂=Lý Thành Quế¦Yi Seong-gye
李林甫=Lý Lâm Phủ¦Li Linfu
李武通=Lý Vũ Thông¦Lí Vũ Thông
李清照=Lý Thanh Chiếu¦Li Qingzhao¦Lí Thanh Chiếu
李自成=Lý Tự Thành¦Li Zicheng
李解冻=Lý Giải Đống¦Lý Giải Đông
李连杰=Lý Liên Kiệt¦Li Lianjie hay Jet Li
李雪健=Lý Tuyết Kiện¦Li Xuejian
李鸿章=Lý Hồng Chương¦Li Hung-chang hay Li Hongzhang
杜如晦=Đỗ Như Hối¦Du Ruhui¦Đỗ Như Huyên
杜尚别=Dushanbe¦Tam-bốp
杜月笙=Đỗ Nguyệt Sênh¦Đỗ Nguyệt Sanh¦Du Yuesheng
杜美莎=Mỹ Đỗ Toa¦Dumesa
杜蕾斯=Durex¦Durex, một thương hiệu bao cao su
杨国忠=Dương Quốc Trung¦Dương Quốc Trung - Nhân vật lịch sử nhà Đường
杨秀清=Dương Tú Thanh¦Yang Xiuqing
杨露禅=Dương Lộ Thiền¦Dương Lộ Thiện
杰克曼=Jackman¦Kiệt Khắc Mạn
杰克逊维尔=Jacksonville¦Kiệt Khắc Duy Nhĩ
杰勒米=Jeremie¦Gérémy¦Geremy¦Jeremy
杰尼亚=Zegna¦Kiệt Ni Á
杰布森=Jebson¦Kiệt Bố Sâm¦Jepsen
杰拉尔=Gerald¦Gérard¦Jellal
杰拉尔德=Gerald¦Gérald
杰斐逊=Jefferson¦Kiệt Phỉ Tốn
杰罗姆=Jérome¦Jerome
杰诺斯=Janos¦Kiệt Nặc Tư¦Jienuosi¦Genos
杰雷米=Jeremy¦Jérémy
松赞干布=Songzain Gambo¦Songtsen Gampo hay Songzain Gambo¦Tùng Tán Kiền Bố
极阴老祖=Cực Âm Lão Tổ¦Cực Âm lão tổ
枉死城=Uổng Tử Thành¦Uổng Tử thành¦thành Uổng Tử
林允儿=Lâm Doãn Nhi¦Im Yoon-ah
林心如=Lâm Tâm Như¦Ruby Lin
林志玲=Lâm Chí Linh¦Lin Chi-ling
林明子=Hayashi Akiko¦Lâm Minh Tử
林明美=Hayashi Akemi¦Lâm Minh Mỹ
林朝英=Lâm Triều Anh¦Lâm Triêu Anh
林登万=Leader One¦Lâm Đăng Vạn
林雅琪=Lâm Nhã Kỳ¦Lâm Nhã Kì
林青霞=Lâm Thanh Hà¦Brigitte Lin
枯草仙子=Khô Thảo Tiên Tử¦Khô Thảo tiên tử
柏加列=Bakery¦Bách Gia Liệt
柏柏尔=Berber¦Người Berber ở Bắc Phi
柏格森=Bergson¦nhà triết học Pháp.
查克纳=Charquena  ¦Tra Khắc Nạp
查尔斯=Charles¦Tra Nhĩ Tư
查尼斯=Tra Ni Tư¦Chanis
柯尔克孜族=Kyrghiz¦Kha Nhĩ Khắc Tư
柯沃特=Kha Ốc Đặc¦Covert¦Kovart
柯蒂斯=Curtis¦Curtis [Kha Đế Tư]
柳二龙=Liễu Nhị Long¦Liu Erlong
柳梦烟=Liu Mengyan¦Liễu Mộng Yên
格列格=Gregow¦Cách Liệt Cách
格尔斯=Cách Nhĩ Tư¦Gles
格尔木=Golmud¦Golmud hoặc thành phố Ge'ermu¦Cách Nhĩ Mộc
格拉姆=Cách Lạp Mỗ¦Gram
格拉纳达=Granada¦Granada, Tây Ban Nha
格拉芙=Cách Lạp Phù¦Graff¦Graf
格斗大师=Cách Đấu Đại Sư¦cách đấu đại sư
格斗术=Cách Đấu Thuật¦thuật cách đấu¦chiến thuật
格林纳达=Grenada¦Cách Lâm Đạt¦Grê-na-đa
格林顿=Glinton¦Cách Lâm Đốn¦Grinton
格洛斯特=Gloucester¦thành phố Gloucester ở tây nam nước Anh
格温多琳=Gwendolyn Lynn¦Cách Ôn Đa Lâm¦Gwendolin
格罗兹尼=Grozny¦Grozny, thủ đô của Cộng hòa Chechnya, Nga
格罗宁根=Groningen¦Groningen, tỉnh và thành phố ở Hà Lan
格莱特=Cách Lai Đặc¦Gretel¦Grant
格里高利=Gregory¦Gregory hoặc Grigory
格雷尔=Grell¦Cách Lôi Nhĩ¦Gelel¦Grail
格雷格=Gregg¦Cách Lôi Cách¦Greg
格雷西=Cách Lôi Tây¦Gracie
格雷迪=Cách Lôi Địch¦Grady
格鲁吉亚=Georgia¦Cách Lỗ Cát Á¦Gioóc-giơ
桂木华=Katsuragi Hana¦Quế Mộc Hoa
桃太郎=Momotaro¦Momotarō¦Momotarou¦Đào Thái Lang
桃白白=Tàu Pảy Pảy¦Tao Pai Pai
桃花扇=Đào Hoa Phiến¦Đào Hoa Quạt
桃金娘=Myrtle¦hoa hồng myrtle
桑原本因坊=Kuwabara Bản Nhân Phường¦Kuwabara Honinbō
桑尼亚=Tang Ni Á¦Visenya
梁启超=Lương Khải Siêu¦Liang Qichao
梁静茹=Lương Tĩnh Như¦Fish Leong¦Lương Tịnh Như
梅丽娅=Mélia¦Mai Lệ Á
梅丽莎=Melissa¦Mai Lệ Toa¦Fantina
梅兰妮=Mélanie¦Melany¦Melanie
梅兰芳=Mai Lan Phương¦Mei Lanfang
梅恩兰=Mai Ân Lan¦Mainland
梅林娜=Mai Lâm Na¦Melina¦Merlina
梅林达=Mélinda¦Melinda
梅洛迪=Mélodie¦Melody
梅琳娜=Melina¦Mai Lâm Na
梅西亚=Messias¦Mesía
梅里美=Mérimée¦Prosper Mérimée
梦之星=Mộng Chi Tinh [Dream Star]¦Mộng Chi Tinh
梦之星城=Mộng Chi Tinh Thành¦Dream Star City
梦入神机=Mộng Nhập Thần Cơ¦Meng Ru Shen Ji
梵天巫火=Phạn Thiên Vu Hỏa¦Phạm Thiên Vu Hỏa
梵天龙根=Phạn Thiên Long Căn¦Phạm Thiên Long Căn
棒子国=Hàn Quất¦Hàn Quốc
楚庄王=Sở Trang Vương¦Vua Zhuang của Chu
楚江王=Sở Giang Vương¦Sở Giang vương
楚门的世界=The Truman Show¦Chương trình Truman
楞严经=Lăng Nghiêm Kinh¦Lăng Nghiêm kinh
楞伽经=Lăng Già Kinh¦Tên một bộ kinh Phật.
欧力克=Âu Lực Khắc¦Olik
欧文斯=Owens¦Âu Văn Tư
欧洲杯=Euro Cup¦Cúp châu Âu
欧罗巴=Europa¦Europe¦Châu Âu
欧美日=Âu Mỹ Nhật¦Châu Âu và Mỹ
欧莱雅=L'Oréal¦L’oreal¦L'Oreal
欧阳修=Âu Dương Tu¦âu dương tu¦Ouyang Xiu
欧阳治=Âu Dương Trị¦Âu Dương Trì
欧阳疯=Âu Dương Phong¦Âu Dương điên
歌利亚=Goliath¦Ca Lợi Á
此世之恶=Thử Thế Chi Ác¦All of Evil
武夷山=Võ Di Sơn¦núi Wuyi ở Phúc Kiến
武明空=Vũ Minh Không¦Võ Minh Không
武神龙拳=Võ Thần Long Quyền¦Vũ Thần Long Quyền
武经总要=Võ Kinh Tổng Yếu¦Vũ Kinh Tổng Yếu
武莘仙宫=Võ Tân Tiên Cung¦Vũ Sân Tiên Cung
武诸葛=Võ Gia Cát¦Vũ Gia Cát
武魂斗士=Võ Hồn Đấu Sĩ¦Vũ Hồn Đấu Sĩ
死亡之书=Tử Vong Chi Thư¦tử vong chi thư
死亡之谷=Thung lũng Chết¦Tử Vong Chi Cốc
死亡之雾=Tử Vong Chi Vụ¦Tử Vong Sương Mù
死亡波纹=Tử Vong Sóng Gợn¦Death Wave
死寂沼泽=Tử Tịch Chiểu Trạch¦Đầm Lầy Yên Tĩnh¦Tử Tịch Đầm Lầy
死灵法术=Tử Linh Pháp Thuật¦pháp thuật tử linh
死神兽=Tử Thần Thú¦Phantomon
歼灭白书=Annihilatus¦Annihilatus (Tiêm Diệt Bạch Thư)¦Senmetsu Hakusho
残天噬魂=Tàn Thiên Phệ Hồn¦"Tàn Thiên Phệ Hồn"
段千里=Đoạn Thiên Lí¦Đoàn Thiên Lý
段天德=Đoàn Thiên Đức¦Đoạn Thiên Đức
段思平=Đoạn Tư Bình¦Đoàn Tư Bình
段祺瑞=Đoàn Kỳ Thụy¦Duẩn Qirui
母夜叉=Mẫu Dạ Xoa¦chuột chù
毒寡妇=Độc Quả Phụ¦góa phụ độc
毒龙潭=Độc Long Đàm¦Độc Long đầm
比利时=Bỉ¦Belgium
比利沙=Bỉ Lợi Sa¦Belisha¦Berisha
比利牛斯=Pyrénees¦Dãy núi Pyrenees
比勒陀利亚=Pretoria¦Bỉ Lặc Đà Lợi Á¦Prê-to-ri-a
比特纳=Bittner¦Bittner hoặc Büttner
比雷亚=Bỉ Lôi Á¦Birheya
毕夏普=Bishop¦Tất Hạ Phổ¦Bi Sharp
毘沙门天=Vessavaṇa¦Bì Sa Môn Thiên
毛主席=Mao Chủ Tịch¦Mao chủ tịch¦Mao Zedong¦Chủ tịch mao
毛里塔尼亚=Mauritania¦Mô-ri-ta-ni
毛里求斯=Mauritius¦Mao Lí Cầu Tư¦Mô-ri-xơ
气圆斩=Khí Viên Trảm¦Ki-Enzan
氨基比林=Antondine¦a-mi-nô-pi-rin
水乱波=Thủy Loạn Ba¦Suiranha
水无月=Thủy Vô Nguyệt¦Minatsuki¦Minazuki
水火土=Thuỷ Hoả Thổ¦Thủy Hỏa Thổ
水经注=Thuỷ Kinh Chú¦Thủy Kinh Chú
水行侠=Aquaman¦Aquaman, siêu anh hùng truyện tranh DC
水调歌头=Thuỷ Điệu Ca Đầu¦Thủy Điều Ca Đầu
永聚岛=Vĩnh Tụ Đảo¦Vĩnh Tụ Đảo(Evermeet)
永远亭=Vĩnh Viễn Đình¦Eientei¦ Eientei
汉丁顿=Hán Đinh Đốn¦Huntington
汉密尔=Hán Mật Nhĩ¦Hamil
汉弗雷=Humphrey¦Hán Phất Lôi
汉武帝=Hán Vũ Đế¦Hoàng đế Ngô của triều đại nhà Hán
汉献帝=Hán Hiến Đế¦Hoàng đế Tây An của nhà Hán
汉诺威=Hannover¦Doanh thu¦Hán Nặc Uy¦Hanover
汉诺维=Hanover¦Hán Nặc Duy
汤姆克鲁斯=Tom Cruise¦Thang Mỗ Khắc Lỗ Tư
汤显祖=Thang Hiển Tổ¦Tang Xianzu
汪精卫=Uông Tinh Vệ¦Wang Ching-wei
沃尔夫=Wolf¦Wolf, Woolf¦Ốc Nhĩ Phu¦Wulf¦Wolff
沃尔德=Wald¦Ốc Nhĩ Đức
沃尔特=Wœrth¦Walter¦Ốc Nhĩ Đặc
沃恩德=Ốc Ân Đức¦Warnd¦Woande
沈从文=Thẩm Tòng Văn¦Shen Congwen
沈欺霜=Thẩm Khi Sương¦Trầm Khi Sương
沈青云=Thẩm Thanh Vân¦Trầm Thanh Vân
沙奎尔=Sa Khuê Nhĩ¦Shaquill
沙尔娜=Toa Nhĩ Na¦Shalna
沙悟净=Sa Ngộ Tĩnh¦Sha Wujing¦Sa Ngộ Tịnh
沙漠之鹰=Desert Eagle¦sa mạc chi ưng¦Đại bàng sa mạc
沙特夫=Sa Đặc Phu¦Saudiv
沙特阿拉伯=Saudi Arabia¦Ả Rập Saudi¦Ả Rập Xê Út
法兰克=Frank¦người Frank
法兰斯=Fareins¦Pháp
法兰西=Pháp¦Pháp quốc¦Pháp Lan Tây¦France
法切尼=Facini¦Pháp Thiết Ni
法塔赫=Fatah¦Fatah, tổ chức của người Palestine
法塞特=Fasethe¦Pháp Tắc Đặc
法天象地=Pháp Thiên Tượng Địa¦pháp thiên tượng địa
法尔特=Pháp Nhĩ Đặc¦Farth
法属圭亚那=French Guiana¦Guy-an thuộc Pháp
法属波利尼西亚=French Polynesia¦Pô-li-nê-di thuộc Pháp
法布提=Fárbauti¦Farbauti
法拉盛=Flushing¦ Flushing¦Presbyterian¦Khu phố Tàu rực rỡ, khu phố chủ yếu là người Hoa và người Hàn Quốc ở Queens, Thành phố New York
法拉第=Faraday¦Pha-ra-đây¦&Faraday&
法斯特=Faste¦Pháp Tư Đặc [Faster]¦Faster¦Pháp Tư Đặc¦Fast¦Faust
法比奥=Fabio¦Fábio
法洛斯=Fallows¦Pháp Lạc Tư¦Pharos
法特尔=Fartel¦Pháp Đặc Nhĩ
法玛尔=Pháp Mã Nhĩ [Famal]¦Farmar
法瑞特=Valette¦Pháp Thụy Đặc
法赫德=Fahd¦Vua Fahd của Ả Rập Xê Út
法门寺=Pháp Môn Tự¦Pháp môn tự
法鲁克=Farooq¦Pallo¦Farouk của Ai Cập
泡沸石=Phao Phí Thạch¦Fê-ô-lít
泡泡浴=Soapland¦Tắm ngâm bồn
波兹坦=Potsdam¦Potsdam, Đức
波哥大=Bogota¦Ba Ca Đại¦Bô-gô-ta¦Bogotá
波塞冬=Poseidon¦Poseidon, Thần biển trong thần thoại Hy Lạp
波多黎各=Puerto Rico¦Puerto Rico, lãnh thổ chưa hợp nhất tự quản của Hoa Kỳ
波子汽水=Ramune¦Ramune Soda - 1 loại nước có ga lâu đời ở Nhật Bản
波希米亚=Bohemia¦Bohemia, quốc gia lịch sử của Trung Âu¦Bohème
波拉多=Ba Lạp Đa¦Borado
波洛克=Pollock¦Ba Lạc Khắc
波美拉尼亚=Pomerania¦Pomerania, một khu vực lịch sử trên bờ nam của biển Baltic
波西米亚=Bohemian¦Bohemia, quốc gia lịch sử của Trung Âu¦Bohemia
波赛西=Ba Tái Tây¦Bo Sai Xi
泥犁地狱=Nê Lê Địa Ngục¦Địa Ngục Nê Lê
泥菩萨=Nê Bồ Tát¦Bồ tát đất sét
泰伦斯=Thái Luân Tư¦Terrence
泰奥菲尔=Théophile¦Teofil
泰姬陵=Thái Cơ Lăng¦Taj Mahal
泰希斯=Thái Hi Tư¦Tahis
泰戈尔=Tagore¦Thái Qua Nhĩ¦Rabindranath Tagore
泰瑞斯=Tyrese¦Thái Thụy Tư¦Taris
泰西丝=Thái Tây Ti¦Tethys
泰贝莎=Thái Bối Toa¦Tabitha
洁西卡=Jessica¦Khiết Tây Tạp
洛克人=Rockman¦Rockman hoặc Mega Man
洛克斯=Lạc Khắc Tư¦Locks¦Rocks
洛天依=Lạc Thiên Y¦Luo Tianyi
洛贝尔=Lorbeer¦Lạc Bối Nhĩ
津巴布韦=Zimbabwe¦Dimbabue¦Dim-ba-bu-ê
洪秀全=Hồng Tú Toàn¦Kō Shūzen¦Hong Xiuquan hay Hung Hsiu-ch'üan
洪都拉斯=Honduras¦Hondurat¦Ôn-đu-rát
派力司=Palace¦vải pa-lết-xơ
流川枫=Rukawa Kaede¦Lưu Xuyên Phong
流放之城=Lưu Vong Thành¦Exile City
流水峰=Lưu Thủy Phong¦Lưu Thủy phong
流魂街=Rukongai¦Lưu Hồn Nhai
浮空术=Phù Không Thuật¦Phù không thuật
海东青=Hải Đông Thanh¦Gyrfalcon
海伦娜=Helena¦thủ phủ của Montana¦Mỹ.
海克丝=Hải Khắc Ti¦Hex
海克斯科技=Hextech¦công nghệ Hex¦Hyx Technology
海冬青=Hải Đông Thanh¦Cắt Saker
海大少=Hải Đại Thiếu¦Hải Đại Thiểu
海尔莫=Helmer¦Hải Nhĩ Mạc
海尔达=Hải Nhĩ Đạt¦Helda
海德堡=Heidelberg¦Hyde Bảo
海拉尔=Hailar¦Hải Lạp Nhĩ
海森堡=Heisenberg¦Werner Heisenberg¦Hải Sâm Bảo( Heisenberg)
海波东=Hải Ba Đông¦Hai Bo Dong
海洋之城=Ocean City¦Hải Dương Chi Thành
海王星=Neptune¦Sao Hải Vương¦Hải Vương Tinh¦hải vương tinh¦sao hải vương¦Hải vương tinh¦Neptune Shōkaku
海精灵=Hải Tinh Linh¦Elf Biển
海纳斯=Hải Nạp Tư¦Hanass¦Haynes
海耶斯=Chuck Hayes¦Hải Da Tư¦Hayes
海莲娜=Helena¦Hải Liên Na
海贼王=Vua Hải Tặc¦One Piece¦Hải Tặc Vương
涂山容容=Tushan Rongrong¦Đồ Sơn Dung Dung
涂山氏=Đồ Sơn Thị¦Đồ Sơn thị
涂山红红=Tushan Honghong¦Đồ Sơn Hồng Hồng
涂山雅雅=Tushan Yaya¦Đồ Sơn Nhã Nhã
涅法雷姆=Nephalem¦(đài loan)
淮南方=Hoài Nam Phương¦Hoài Nam phương
深渊领主=Thâm Uyên Lĩnh Chủ¦Thâm Uyên Lãnh Chúa¦Lord of the Abyss
混天大圣=Hỗn Thiên Đại Thánh¦Hỗn Thiên đại thánh
清凉殿=Điện Seiryō¦Thanh Lương Điện
清明上河图=Thanh Minh Thượng Hà Đồ¦bức vẽ sông Hoàng Hà thời Minh Thanh
清衍静=Thanh Diễn Tĩnh¦Thanh Diễn Tịnh
清风明月=Thanh Phong Minh Nguyệt¦thanh phong minh nguyệt
渥太华=Ottawa¦Ác Thái Hoa¦Ốt-ta-oa
温尼伯=Winnipeg¦Winnipeg, thủ đô của Manitoba, Canada
温得和克=Windhoek¦Vin-húc
温斯特=Ôn Tư Đặc¦Winston¦Winster¦West
游戏王=Vua Trò Chơi¦Yu-Gi-Oh!
游龙戏凤=Du Long Hí Phượng¦Du Long Hý Phượng
滑铁卢=Waterloo¦Trận Waterloo
满堂彩=Mãn Đường Thải¦phải đứng lên và vỗ tay
满江红=Mãn Giang Hồng¦Mạn Giang Hồng
滴水成冰=Tích Thuỷ Thành Băng¦nước đóng thành băng¦nhỏ giọt thành băng¦lạnh thấu xương¦rét căm căm¦rét buốt¦trời rét cắt da¦trời lạnh thấu xương
漫步者=Walkman¦một người đi dạo về
潘金莲=Phan Kim Liên¦Pan Jinlian
潭柘寺=Đàm Chá Tự¦Đền Tanzhe
澳大利亚=Australia¦Úc
澹台晴=Đạm Đài Tình¦Đạm Thai Tình
澹台晴儿=Đạm Đài Tình Nhi¦Đạm Thai Tình Nhi
澹台震=Đạm Đài Chấn¦Đạm Thai Chấn
火奴鲁鲁=Honolulu¦Honnolulu¦Ho-nô-lu-lu
火德星君=Hoả Đức Tinh Quân¦tinh thần của hành tinh sao hỏa
火焰刀=Hoả Diễm Đao¦hỏa diễm đao¦Hỏa Diễm Đao
火焰风暴=Hỏa Diễm Phong Bạo¦Flame Blast
火焰鸟=Hỏa Diễm Điểu¦Moltres¦hoả diễm điểu
火种源=Hỏa Chủng Nguyên¦Khối Lập Phương - Allspark¦Allspark
火蛇术=Hỏa Xà Thuật¦Hỏa xà thuật
火龙兽=Hỏa Long Thú¦Aldamon
灰烬使者=Tro Tàn Sứ Giả¦Ashbringer
灵武境=Linh Vũ Cảnh¦Linh Vũ cảnh
灵能者=Linh Năng Giả¦Linh năng giả
灵隐寺=Linh Ẩn Tự¦Chùa Linh Ẩn
灼烂歼鬼=Camael¦Chước Lạn Tiêm Quỷ¦¦Shakuran Senki
炎发灼眼=Viêm Phát Chước Nhãn¦Shakugan
炼器室=Luyện Khí Thất¦luyện khí thất
炼金术师=Nhà Giả Kim¦luyện kim thuật sư¦giả kim thuật sư
热拉尔=Gérard¦Gerard
焰光的夜伯=Kaleid Blood¦Diễm Quang Dạ Bá
熔岩城=Dong Nham Thành¦Dung Nham thành¦Dung Nham Thành
熔岩火怪=Dung Nham Hỏa Quái¦Dong Nham Hỏa Quái
熹平石经=Hi Bình Thạch Kinh¦Những tấm bia Xiping, tác phẩm thư pháp trên những tấm bia chạm khắc thời Đông Hán
燕太子丹=Yến Thái Tử Đan¦Hoàng tử Đan của Yan
燕狂徒=Yên Cuồng Đồ¦Yến Cuồng Đồ
燧人氏=Toại Nhân Thị¦Toại Nhân thị¦Suirenshi, người phát minh ra lửa huyền thoại
爆裂拳=Bạo Liệt Quyền¦Dynamic Punch(bạo liệt quyền)
爱丁堡=Edinburgh¦Edinburgh, thủ đô của Scotland
爱丽舍宫=Ái Lệ Xá Cung¦cung Elysée¦điện Élysée
爱之女神=Freyja¦Ái Chi Nữ Thần
爱克莉丝=Alice¦Ái Khắc Lỵ Ti
爱因斯坦=Einstein¦Ái Nhân Tư Thản
爱尔兰=Ireland¦Iceland¦Ai-len¦Ái Nhĩ Lan
爱尔莎=Elsa¦Ái Nhĩ Toa
爱弥儿=Emile¦Ái Di Nhi，¦Emily
爱沙尼亚=Estonia¦E-xtô-ni-a
爱美尼亚=Armenia¦Ái Mỹ Ni Á
爱芬博格=Ái Phân Bác Cách¦Effenberg
爱荷华=Iowa¦I-ô-oa Ai-âu-ơ
爱达荷=Idaho¦I-đa-ô¦Ai-đơ-hâu
牙买加=Jamaica¦Nha Mãi Gia¦Gia-mai-ca¦Cộng hoà Gia-mai-ca
牛郎织女=Ngưu Lang Chức Nữ¦Altair và Vega
牛魔王=Ngưu Ma Vương¦Gyuumao
特丽雅=Teliya¦Đặc Lệ Nhã
特伦索=Troon¦Đặc Luân Tác
特古西加尔巴=Tegucigalpa¦Tê-gu-xi-gan-pa
特洛伊=Troy¦thành phố cổ Troy¦Troia
特雷西=Đặc Lôi Tây¦Tracy
特鲁伊=Trouilh¦Đặc Lỗ Y
特鲁利=Đặc Lỗ Lợi¦Truli
特鲁斯=Teruz¦Đặc Lỗ Tư
状元红=Trạng Nguyên Hồng¦trạng nguyên hồng¦rượu Thiệu Hưng¦lệ chi¦trái vải¦hoa phấn¦tử mạt lệ¦hoa trạng nguyên hồng
狄仁杰=Địch Nhân Kiệt¦Di Renjie
狄俄倪索斯=Dionysus¦Dionysus, thần rượu vang trong thần thoại Hy Lạp
狄更斯=Dickens¦Charles Dickens¦Địch Canh Tư
狩猎之星=Thú Liệp Chi Tinh¦Thú Liệp Tinh
独孤啸天=Độc Cô Tiếu Thiên¦Độc Cô Khiếu Thiên
独孤求败=Độc Cô Cầu Bại¦độc cô cầu bại¦Độc cô cầu bại¦Độc Cô cầu bại
独孤雁=Độc Cô Nhạn¦Dugu Yan
独孤霸=Độc Cô Phách¦Độc Cô Bá
独角兽=Độc Giác Thú¦Unicorn¦thú một sừng
狮驼岭=Sư Đà lĩnh¦Sư Đà Lĩnh
獠牙巨熊=Lão Nha Cự Hùng¦Liêu Nha Cự Hùng
玄铁剑=Huyền Thiết Kiếm¦kiếm huyền thiết
玉天恒=Ngọc Thiên Hằng¦Yu Tianheng
玉清丹=Ngọc Thanh Đan¦Ngọc Thanh đan
玉清殿=Ngọc Thanh Điện¦Ngọc Thanh điện
玉玲珑=Ngọc Linh Lung¦ngọc linh lung
玉皇大帝=Ngọc Hoàng Đại Đế¦Ngọc hoàng đại đế
玉素甫=Yusuf¦Yusuf, tên theo tiếng Ả Rập
玉鼎真人=Ngọc Đỉnh Chân Nhân¦Gyakutei Shinjin¦Master Yuding
王下七武海=Vương Hạ Thất Vũ Hải¦Oka Shichibukai
王世充=Vương Thế Sung¦Wang Shichong
王之军势=Ionioi Hetairoi¦Vương Chi Quân Thế¦Ionioi Hetairoi: Vương Chi Quân Thế
王力宏=Vương Lực Hoành¦Wang Lee-Hom
王天君=Ô Tenkun¦Vương Thiên Quân
王家卫=Vương Gia Vệ¦Wong Kar-Wai
王府井=Vương Phủ Tỉnh¦Vương phủ tỉnh
王母娘娘=Vương Mẫu Nương Nương¦Tây Vương Mẫu¦Vương mẫu nương nương
王熙凤=Vương Hy Phượng¦Vương Hi Phượng
王祖贤=Vương Tổ Hiền¦Joey Wong
王难姑=Vương Nan Cô¦Vương Nạn Cô
玛丽斯=Mariss¦Mã Lệ Tư (Mary)¦Marys¦Maris
玛佩尔=Mã Bội Nhĩ¦Mapel
玛塔沙=Matasha¦Mã Tháp Sa
玛格丽特=Margaret¦Mã Cách Lệ Đặc
玛格特=Mã Cách Đặc¦Margot
玛艾娜=Maéna¦Maena
玛莉娜=Mã Lỵ Na¦Marina
玛迦泰=Majiatai¦Mã Già Thái
环太平洋=Pacific Rim¦vành đai Thái Bình Dương
玻利维亚=Bolivia¦Pha Lợi Duy Á¦Bô-li-vi-a¦Bô-li-vi
珊朵拉=San Đóa Lạp¦Sandora
珍妮弗=Jennifer¦Trân Ny Phất
珠三角=Châu Tam Giác¦Châu thổ sông Châu Giang
珠穆朗玛=Chomolungma¦núi Chomolungma hoặc Qomolangma¦Everest
珠穆朗玛峰=Everest¦đỉnh Chomolungma
班克斯=Fairbanks¦Banks¦Ngân hàng
理想乡=Lý Tưởng Hương¦Avallon
理查德=Richard¦lí tra đức¦Lý Tra Đức
瑞德申=Judesion¦Judesen¦Thụy Đức Thân
瑞恩多德=Ryandod¦Thụy Ân Đa Đức
瑞斯姆=Rasm¦Thụy Tư Mỗ
瑞瓦兰=Thụy Ngõa Lan¦Revalan
璇玑宗=Tuyền Cơ Tông¦Tuyền Ki Tông
瓦伦丁=Valentine¦Valentí¦Valentin
瓦利埃尔=Vallière¦Valier
瓦加杜古=Ouagadougou¦U-a-ga-đu-gu
瓦妮娅=Vania¦Vânia
瓦杜兹=Vaduz¦Va-đu
瓦瑞夫=Ngõa Thụy Phu¦Warriv¦Warif
瓦莱丽=Valérie¦Ngõa Lai Lệ¦Valerie
瓦莱塔=Valletta¦Ngoã Lai Tháp¦Va-lét-ta
瓦莲京娜=Ngõa Liên Kinh Na¦ Valentina
瓦西里=Vasily¦Ngoã Tây Lý¦Vasilii
甘米奇=Gammage¦Cam Mễ Kỳ
生存塔=Sinh Tồn Tháp¦Sinh Tồn tháp
生死桥=Sinh Tử Kiều¦Cầu Sinh Tử
田中丽奈=Điền Trung Lệ Nại¦Tanaka Rena
田归农=Điền Quy Nông¦điền quy nông
田纳西=Tennessee¦Điền Nạp Tây¦Tê-nét-xi¦Tê-nơ-xi
由美子=Yumiko¦Do Mỹ Tử
甲乙丙=Giáp Ất Bính¦A B C
申不害=Thân Bất Hại¦Shen Buhai
申公豹=Thân Công Báo¦Shen Gongbao¦Shinkohyō
电击文库=Dengeki Bunko¦Dengeki Kho Sách
电话虫=Den Den Mushi¦Điện Thoại Trùng
留尼汪=Réunion¦đảo Reunion
疟涤平=Ateborin¦A-tê-bơ-rin
白俄罗斯=Belarus¦Nga Sô¦Bêlarut
白兰地=Brandy¦brandy¦rượu brandy¦rượu bran-đi¦rượu mạnh
白凤凰=Bạch Phượng Hoàng¦White Phoenix
白夜叉=Bạch Dạ Xoa¦Shiroyasha
白头山=Bạch Đầu Sơn¦núi Bạc đầu
白娘子=Bạch Nương Tử¦Bai Niang
白居易=Bạch Cư Dị¦Bai Juyi
白无常=Bạch Vô Thường¦Bạch vô thường¦bạch vô thường
白晴婷=Bạch Tinh Đình¦Bạch Tình Đình
白晶晶=Bạch Tinh Tinh¦trắng tinh¦trắng sáng¦trắng loá
白沙瓦=Peshawar¦Peshawar, thành phố ở phía bắc Pakistan¦Bạch Sa Ngõa
白玉兰=Bạch Ngọc Lan¦bạch ngọc lan¦hoa ngọc lan
白玉楼=Bạch Ngọc Lâu¦Hakugyokuro
白素贞=Bạch Tố Trinh¦Bai Suzhen, từ Madame White Snake
白虎星=Bạch Hổ Tinh¦Bạch Hổ tinh¦người xúi quẩy¦hung thần.
白蛇传=Bạch Xà Truyện¦Rắn trắng Madame
白银城=Bạch Ngân Thành¦thành Bạch Ngân
白银战将=Bạch Ngân Chiến Tướng¦Bạch Ngân chiến tướng
白银祭司=Bạch Ngân Tế Tự¦Bạch Ngân Tư Tế
白马寺=Bạch Mã Tự¦Baima hay White Horse Temple ở Lạc Dương, một trong những ngôi chùa Phật giáo sớm nhất ở Trung Quốc
白鹤漩涡=Vòng Xoáy Bạch Hạc¦Uzumaki Hakutsuru
百事通=Bách Sự Thông¦bách sự thông¦người thông tỏ mọi việc¦người chuyện gì cũng biết
百合子=Yuriko¦Yuriko, tên phụ nữ Nhật Bản
百家争鸣=Bách Gia Tranh Minh¦trăm nhà đua tiếng¦các trào lưu tư tưởng¦trăm nhà tranh minh¦các trào lưu tư tưởng.
百度百科=Baidu Baike¦Bách khoa toàn thư trực tuyến Baidu
百慕达=Bermuda¦Bơ-mu-đa
百里熙=Bách Lý Hi¦Bách Lí Hi
百鬼丸=Bách Quỷ Hoàn¦Hyakkimaru
百鸟朝凤=Bách Điểu Triều Phượng¦tất cả các loài chim trả tiền nhìn lên phượng hoàng¦hòa bình dưới một nhà cai trị khôn ngoan
的卡鲁=Tạp Lỗ¦-Tạp Lỗ
的黎波里=Tripoli¦Tri-pô-li
皇天后土=Hoàng Thiên Hậu Thổ¦hoàng thiên hậu thổ¦trời và đất¦Hoàng Hậu Thổ
皓月城=Hạo Nguyệt Thành¦Hạo Nguyệt thành
皮里斯=Bì Lý Tư¦Pieris
皮里茨=Bì Lý Tì¦Pieritz¦Piriz
盖世太保=Gestapo¦cơ quan mật vụ của Đức Quốc Xã¦ghét-xta-pô
盖尔唐=Gaétan¦Gaëtan
盖波加=Gáe Bulg¦Gapoga
盘古斧=Rìu Bàn Cổ¦Bàn Cổ Phủ
盘尼西林=Penicillin¦Pê-ni-xi-lin
盛装骑手=Thịnh Trang Kỵ Thủ¦Kodeki no Hai
直死魔眼=Trực Tử Ma Nhãn¦Chokushi no Magan
相框里=Tương Khuông Lí¦trong khung ảnh
盾击冲撞=Thuẫn Kích Trùng Chàng¦Shield Clash
真央灵术院=Chân Ương Linh Thuật Viện¦Shin'ō Academy
真奈美=Hiki¦Manami¦Chân Nại Mỹ
真空道=Chân Không Đạo¦Chân Không đạo
眼镜王蛇=Nhãn Kính Vương Xà¦rắn hổ mang chúa
矮脚虎=Ải Cước Hổ¦Hổ chân ngắn
石井新一=Ishii Shin¦Thạch Tỉnh Tân Nhất
石敢当=Thạch Cảm Đương¦tấm bia đá được dựng lên để xua đuổi tà ma
石矶娘娘=Thạch Cơ Nương Nương¦Thạch Ki Nương Nương
石磨地狱=Thạch Ma Địa Ngục¦Địa Ngục Thạch Ma
破虚境=Phá Hư Cảnh¦Phá Hư cảnh
破邪斩=Phá Tà Trảm¦Phá tà trảm
破魔的红蔷薇=Phá Ma Hồng Tường Vi¦Gáe Dearg¦Gae Dearg
破魔箭=Phá Ma Tiễn¦Phá ma tiễn
碟中谍=Mission Impossible¦gián điệp 2 mặt
碧利斯=Bilis¦Bilice¦Bích Lợi Tư
碧昂丝=Beyoncé¦Beyonce
碧昂斯=Beyonce¦Beyoncé
碧螺春=Bích Loa Xuân¦bích loa xuân
祁连山=Kỳ Liên Sơn¦núi Qilian ở Qinhai
神之箭=Thần Chi Tiễn¦Thần Tiễn
神农架=Thần Nông Giá¦Shennongjialin, trực tiếp quản lý khu bảo tồn lâm nghiệp ở đông Hồ Bắc
神圣级=Thần Thánh Cấp¦Thần Thánh cấp
神奈川=Kanagawa¦Kanagawa, Nhật Bản
神威车轮=Gordius Wheel¦Thần Uy Xa Luân¦Gordius Wheel: Thần Uy Xa Luân¦Gordias Wheel
神弃之地=Thần Khí Chi Địa¦Vùng đất bị Thần bỏ rơi
神灭具=Thần Diệt Cụ¦Longinus
神皇产灵尊=Kamimusubi¦Thần Hoàng Sản Linh Tôn
神象镇狱劲=Thần Tượng Trấn Ngục Kình¦Thần Tượng Trấn Ngục Kính
神雕侠侣=Thần Điêu Hiệp Lữ¦thần điêu hiệp lữ¦The Return of the Condor Heroes
祭礼之蛇=Tế Lễ Chi Xà¦Sairei no Hebi
福克西=Foxy¦Phúc Khắc Tây [Fockcy]
福卡林=Phúc Tạp Lâm [Fucarline]¦Phúc Tạp Lâm
福斯特=Foster¦Forst¦Foster hoặc Forster¦Forster
福江岛=đảo Fukue¦Phúc Giang Đảo
福禄寿=phúc lộc thọ¦Phúc Lộc Thọ
秋叶原=Akihabara¦Akihabara, khu vực trung tâm thành phố Tokyo nổi tiếng với các cửa hàng điện tử
科伦坡=Colombo¦Colombus¦Cô-lôm-bô
科兹莫=Cosmo¦Khoa Tư Mạc
科威特=Kuwait¦Cô-oét
科威特市=Kuwait¦Cô-oét
科尔多=Córdoba¦Cordeau
科尔多瓦=Córdoba¦Córdoba, Tây Ban Nha
科尼塞克=Khoa Ni Tắc Khắc¦Koenigsegg
科林斯=Collins¦Corinth¦Khoa Lâm Tư
科比李奥=Khoa Bỉ Lý Áo¦Kobirio
科特迪瓦=Bờ Biển Ngà¦Côte d'Ivoire¦Cốt Đi-voa
科瑞恩=Khoa Thụy Ân¦Corin¦Crane
科纳克里=Conakry¦Cô-na-cri
科维尔=Kewell¦Covey Hill¦Khoa Duy Nhĩ¦Cauville
科里亚=Coria [Khoa Lí Á]¦Coria
科里沃=Corriveau¦Khoa Lý Ốc
科里男蒂亚=Khoa Lí Nam Đế Á¦Khoa Lý Nam Đế Á
科隆多=Khoa Long Đa¦Colondo
秘法塔=Bí Pháp Tháp¦Bí Pháp tháp
秦二世=Tần Nhị Thế¦Qin Ershi
秦天纵=Tần Thiên Tung¦Tần Thiên Túng
秦始皇=Tần Thuỷ Hoàng¦Tần Thủy Hoàng¦Shi Huang Qin
秦少游=Tần Thiểu Du¦Tần Thiếu Du
秦怡宁=Qin Yining¦Tần Di Ninh
秦时明月=Tần Thời Minh Nguyệt¦Tần Thì Minh Nguyệt
秦皇岛=Tần Hoàng Đảo¦Qinhuangdao thành phố cấp tỉnh ở Hà Bắc
移花接木=Di Hoa Tiếp Mộc¦di hoa tiếp mộc¦lập lờ đánh lận con đen¦di chuyển hoa và gỗ
秽土转生=Uế Thổ Chuyển Sinh¦uế thổ chuyển sinh
程志刚=Trình Chí Cương¦Trình Chí Cương-
穆广寒=Mục Quảng Hàn¦Mục Nghiễm Hàn
穆斯林=Muslim¦muslin¦Người Hồi giáo¦tín đồ đạo Hồi¦tín đồ đạo Ít-xlam
穆法沙=Mục Pháp Sa¦Mufasa
究极魔兽=Cứu Cực Ma Thú¦Demon
空手道=Karate¦không thủ đạo¦võ karatê¦karate¦võ Nhật Bản
空气斩=Vô Khí Trảm¦Air Slash¦Air Slash(không khí trảm)
穿山王=Xuyên Sơn Vương¦Sandslash
穿山鼠=Xuyên Sơn Thử¦Sandshrew
窝阔台=Oa Khoát Đài¦Ögedei Khan¦Ogedei
立陶宛=Lithuania¦Lít-va
章子怡=Chương Tử Di¦Zhang Ziyi
竹叶青=Trúc Diệp Thanh¦rắn lục
笆笆拉=Bárbara¦Barbara
笑傲江湖=Tiếu Ngạo Giang Hồ¦tiếu ngạo giang hồ
笛卡尔=Descartes¦René Descartes
第四魔域=Đệ Tứ Ma Vực¦Đệ Tứ  Ma Vực
筋斗云=Cân Đẩu Vân¦Đám mây huyền diệu của Tôn Ngộ Không
筑基篇=Trúc Cơ Thiên¦trúc cơ thiên
篡夺之枪=Queen Diver¦Soán Đoạt Chi Thương (Queen Diver)
米底亚=Media¦Phương tiện truyền thông
米歇勒=Michèle¦Michele
精灵王庭=Tinh Linh Vương Đình¦Elf Vương Đình
精灵球=Poké Ball¦Pokeball
精神之海=Tinh Thần Chi Hải¦tinh thần chi hải
素盏鸣尊=Susanoo no Mikoto¦Tố Trản Minh Tôn¦Susanoo
索伦斯=Sauron¦Tác Luân Tư
索伯尔=Schwimmer¦Tác Bá Nhĩ¦Sobol
索加尔=Solskjaer¦Tác Gia Nhĩ
索哥特=Socatre¦Tác Ca Đặc
索拉格=Sorage¦Tác Lạp Cách
索罗门=Solomon¦Quần đảo Solomon)
索非亚=Sofia¦Xô-phi-a¦Sophia
索马里=Somalia¦Tác Mã Lý¦Xô-ma-li
紫宸殿=Điện Tử Thần¦Điện Shishin¦Tử Thần điện
紫微斗数=Tử Vi Đấu Số¦Zi Wei Dou Shu, một hình thức xem bói của Trung Quốc¦Tử Vi Đấu Sổ
紫心熔火=Tử Tâm Dung Hỏa¦Tử Tâm Dong Hỏa
紫莲花=Tử Liên Hoa¦Purple Lotus
紫藤花=Tử Đằng Hoa¦hoa tử đằng
红·楼梦=Hồng · Lâu Mộng¦Hồng Lâu Mộng
红世魔王=Hồng Thế Ma Vương¦Crimson Lord
红土大陆=Red Line¦Red Line đại lục
红月卡莲=Karen Mặt Trăng Đỏ¦Kozuki Kallen
红枫林=Hồng Phong Lâm¦rừng phong đỏ
红眼黑龙=Red-Eyes Black Dragon¦rồng đen mắt đỏ
红缎带=Red-Ribon¦dây băng đỏ
红高粱=Cao Lương Đỏ¦cao lương đỏ¦Hồng Cao Lương
约斯特=Jost¦Ước Tư Đặc
约瑟芬=Joséphine¦Josephine
约翰内斯堡=Johannesburg¦Ước Hàn Nội Tư¦Giô-ha-nít-xbớc
约翰夫=Ước Hàn Phu (Johanph)¦Johanph
约翰森=Johnson¦Ước Hàn Sâm
约翰逊=Johnson¦Johnson hoặc Johnston
纳兰德=Nạp Lan Đức¦Naland
纳姆哈=Namuha¦Nạp Mỗ Cáp
纳尔逊=Nelson¦Nạp Nhĩ Tốn¦Horatio Nelson
纳尼亚=Narnia¦Narnia, thế giới tưởng tượng của trẻ em trong truyện của C.S. Lewis
纳斯特=Nạp Tư Đặc¦Nast
纳斯里=Nạp Tư Lí¦Nasri¦Naseri
纳特兰=Natreland¦Nạp Đặc Lan
纳珍天尊=Nạp Trân Thiên Tôn¦Nạp Trân thiên tôn
纳米比亚=Namibia¦Nạp Mễ Bỉ Á¦Na-mi-bi-a
纵地金光=Tung Địa Kim Quang¦túng địa kim quang
纽伦堡=Nürnberg¦Nürnberg hoặc Nuremberg, thị trấn ở Bavaria, Đức¦Nuremberg
纽芬兰=Newfoundland¦Đảo Newfoundland, Canada
终南山=Chung Nam Sơn¦Dãy núi Zhongnan, gần Tây An
终焉之剑=Chung Yên Chi Kiếm¦Paverschlev
终结者=Kẻ Hủy Diệt¦kẻ hủy diệt¦kẻ huỷ diệt
绫波丽=Ayanami Rei¦Lăng Ba Lệ
绫濑遥=Ayase Haruka¦Lăng Lại Dao [Ayase Haruka]
维也纳=Vienna¦Viên
维吉尼亚=Virginia¦Virginia, tiểu bang Hoa Kỳ
维吾尔=Duy Ngô Nhĩ¦Nhóm dân tộc Duy Ngô Nhĩ ở Tân Cương
维多利亚=Victoria¦Victòria¦Vích-to-ri-a¦Vitória
维尔纽斯=Vilnius¦Duy Nhĩ Nữu Tư¦Vi-ni-út
维拉丝=Duy Lạp Ti¦Velath
维斯特帕列=Duy Tư Đặc Mạt Liệt¦Vestepale
维纳斯=Venus¦Vénus
绿巨人=Hulk¦Người Khổng lồ xanh (Hulk)¦Người Khổng lồ xanh¦ (Hulk)¦Lục Cự Nhân¦người khổng lồ xanh
缇莉丝=Lizty¦Đề Lỵ Ti
罗得岛=Rhode Island¦Râu Ai-lân
罗斯托夫=Rostov¦Rostov-on-Don, cảng sông của Nga và thủ phủ khu vực gần Biển Azov
罗曼司=Romance¦truyện tình lãng mạn
罗杰里奥=Rogério¦Rogerio
罗格镇=Loguetown¦Logue trấn
罗莎莉亚=Rosaria¦Rosalia¦Rosalía
罗蕾娜=Laurèna¦Lauréna
罗马尼亚=Romania¦Ru-ma-ni¦Lỗ Ma Ni
罗马里奥=Romario¦Romário
美克星=Mỹ Khắc Tinh¦Namek Tinh
美利坚=Hoa Kỳ¦Châu Mỹ
美国队长=Captain America¦Đội trưởng Mỹ
美属萨摩亚岛=American Samoa¦Xa-moa thuộc Hoa Kỳ
美猴王=Mỹ Hầu Vương¦Monkey King
美索不达米亚=Mesopotamia¦Lưỡng Hà
群英会=Quần Anh Hội¦quần anh hội¦hội nghị anh hùng¦Hội Quần Anh
羽化神朝=Vũ Hóa Thần Triều¦Vũ Hóa Thần Triêu
羽林军=Vũ Lâm Quân¦Vũ lâm quân
翠丝丽=Thúy Ti Lệ¦Trislea
翡冷翠=Firenze¦Florence, thành phố ở Ý¦Florence
翼蛇湖=Dực Xà Hồ¦Hồ Dực Xà
老布什=Bush¦lão Howard
耶利米=Jeremiah¦Jeremy hoặc Jeremiah
耶和华=Jehovah¦thần Giehova¦thần Giê-hô-va
耶律大石=Gia Luật Đại Thạch¦Da Luật Đại Thạch
耶律景=Da Luật Cảnh¦Gia Luật Cảnh
耶律贤=Da Luật Hiền¦Gia Luật Hiền
耶律阿保机=Gia Luật A Bảo Cơ¦Ambagyan
耶稣会=Dòng Tên¦Dòng Chúa Jesus¦Hội Chúa Jesus
耶稣基督=Jesus Christ¦Chúa Giêsu Kitô¦Chúa Jesus
耶路撒冷=Jerusalem¦Giê-ru-da-lem
耶里斯=Da Lý Tư¦Jerrishoe
聂卫平=Nhiếp Vệ Bình¦Nie Weiping
聚义厅=Tụ Nghĩa Sảnh¦tụ nghĩa sảnh¦Hội trường Tụ Nghĩa
肯塔基=Kentucky¦Kentucki¦Ken-túc-ki¦Ken-tớc-ki
肯尼亚=Kenya¦Keynia¦Kê-ni-a
胡列娜=Hồ Liệt Na¦Hu Liena
腓尼基=Phoenicia¦Phoenicia, nền văn minh cổ đại dọc theo bờ biển Địa Trung Hải¦Phoenician¦Phoenici
腓特烈=Friedrich¦Frederick¦Phì Đặc Liệt
腾格尔=Đằng Cách Nhĩ¦Tengle¦Tengel¦Tengger
自由之城=Tự Do Chi Thành¦Free City
自由之翼=Tự Do Chi Dực¦Đôi Cánh Tự Do¦Wings of Liberty
舒伯特=Schubert¦Thư Bá Đặc
舒肤佳=Safeguard¦Bảo vệ
舞干戚=Vũ Kiền Thích¦Vũ Cán Thích
色诺芬=Sắc Nặc Phân¦Xenophon
艾一戈=Ngải Nhất Qua¦Ngả Nhất Qua
艾丽娜=Ngải Lệ Na [Ailiena]¦Ngả Lệ Na
艾佛森=Ngả Phật Sâm¦Iverson
艾力克=Eric¦Ngả Lực Khắc¦Erik¦Elric
艾姬儿=Ngả Cơ Nhi¦Aggie Gil
艾尔米塔什=Ermitazh¦Bảo tàng Ermitazh hoặc Hermitage ở St Petersburg
艾尼尔=Anil¦Ngải Ni Nhĩ
艾席拉=Asheara¦Ngả Tịch Lạp
艾弗森=Iverson¦Ngải Phất Sâm¦Ngả Phất Sâm
艾微儿=Avril¦Ngả Vi Nhi
艾德文=Edwin¦Ngả Đức Văn
艾梅丽=Emelie¦Émélie¦Emely¦Amelie
艾泽特=Ngải Trạch Đặc¦Aizete
艾瑞斯=Ngải Thụy Tư¦Murdoch¦Ares¦Ayres¦ Iris
艾米娜=Emina¦Émina¦Amina
艾米莉=Emily¦Emilie¦Ngả Mễ Lỵ
艾维斯=Elvis¦Ewer¦Ngải Duy Tư¦Ewers
艾莉儿=Ngải Lỵ Nhi¦Eryle
艾莉婕=Alizée¦Alizee¦Ngải Lỵ Tiệp¦Ellie
艾莉尔=Ariel¦Ngả Lỵ Nhĩ
艾莲娜=Elena¦Elena [Ngải Liên Na]
艾蒂安=Etienne¦Étienne
艾蒙德=Aymond¦Ngải Mông Đức¦Ormond
芙莉娅=Phù Lỵ Á¦Freya
芬妮娅=Phân Ni Á¦Fania
芭芭拉=Barbara¦Barbara hoặc Barbra
花木兰=Hoa Mộc Lan¦Hua Mulan¦Hoa Mộc Lan, nữ chiến binh huyền thoại
花果山=Hoa Quả Sơn¦(cũng là tên của các ngọn núi ở các vùng khác của Trung Quốc)
苏伊士=Suez¦Kênh đào Su-ê)
苏克雷=Sucre¦Sucre, thủ đô hiến pháp của Bolivia
苏尔特尔=Surtr¦Tô Nhĩ Đặc Nhĩ¦Surtur
苏晓蓉=Tô Hiểu Dong¦Tô Hiểu Dung
苏格拉底=Socrates¦Socrate¦José Sócrates¦Sokrates
苏秋雪=Tô Thu Tuyết¦tô thu tuyết
苏莱曼=Suleiman¦Tướng Michel Suleiman
苏菲亚=Sophia¦Tô Phi Á¦Sophie
苏里曼=Tô Lý Mạn¦Suriman
苏门答腊=Sumatra¦Sumatra, một trong những hòn đảo của Indonesia
苏黎世=Zurich¦Zurich, Thụy Sĩ¦Zürich
苗人凤=Miêu Nhân Phụng¦Miêu Nhân Phượng
英仙座=Anh Tiên Tọa¦chòm sao Anh Tiên¦Perseus
英格兰=Anh¦nước Anh
英格兰人=England¦Anh¦người Anh
英梨梨=Eriri¦Eiriri¦Anh Lê Lê
英特耐雄纳尔=International¦quốc tế
英雄王=Anh Hùng Vương¦King of Heroes
范星露=Fan Xinglō¦Phạm Tinh Lộ
茨木童子=Tỳ Mộc Đồng Tử¦Ibaraki Douji ¦Ibaraki Douji¦Ibaraki-dōji
茱丽叶=Juliette¦Juliet hoặc Juliette
草薙剑=Kusanagi¦Thảo Thế Kiếm¦Kusanagi-no-Tsurugi¦Thảo Thế kiếm¦Kusanagi Kiếm
荧惑古星=Huỳnh Hoặc Cổ Tinh¦Huỳnh Hoặc cổ tinh
荷鲁斯=Horus¦Hà Lỗ Tư
莉安娜=Leona¦Lị An Na
莉梅亚=Riméa¦Rimea
莉维娅=Lỵ Duy Á¦Livia
莉莉雅=Lilia¦Lỵ Lỵ Nhã
莉蒂娅=Lídia¦Lydia¦Lị Đế Á
莎尔娜=Shaina¦Toa Nhĩ Na¦Shalna
莫伊塞斯=Moisés¦Moises
莫古力=Mạc Cổ Lực¦Mocouli
莫奈尔=Mạc Nại Nhĩ¦Monair
莫妮卡=Monica¦Mònica
莫尔斯=Morse¦Mạc Nhĩ Tư¦Mors
莫尔特=Mạc Nhĩ Đặc¦Molet¦Moult
莫尼卡=Mônica¦Monica
莫斯科=Moskva¦Mát-xcơ-va¦Mạc Tư Khoa¦Moscow
莫日根=Mo Rigen¦Mạc Nhật Căn¦Mozogen
莫桑比克=Mozambique¦Mạc Tang Bỉ Khắc¦Mô-dăm-bích
莫比迪克号=tàu Moby Dick¦Moby Dick
莫洛斯=Mạc Lạc Tư¦Molos
莫瑞兹比港=Port Moresby¦Po Mô-xbi
莫索里=Mạc Tác Lý¦Mosari¦Mothory
莫里哀=Mauriat¦Molière
莫里安=Mạc Lý An¦Morian
莫里斯=Maurice¦Morris¦Mạc Lí Tư
莫高雷=Mulgore¦Mạc Cao Lôi
莱恩斯=Lai Ân Tư¦Ryans¦Lyons
莱文特=Lai Văn Đặc¦Levent
莱斯特=Leicester¦Lester¦Leicester, thành phố Anh ở East Midlands
莱比锡=Leipzig¦Leipzig, thành phố thuộc bang Sachsen, Đức
莱索托=Lesotho¦Lê-xô-thô
莱茵特=Lai Nhân Đặc¦Rhine
莱里达=Lleida¦Lérida hoặc Lleida, Tây Ban Nha
菊一文字则宗=Cúc Nhất Văn Tự Tắc Tông¦Kiku-Ichimonji Norimune
菲克斯=Fickers¦Phỉ Khắc Tư
菲利德=Farid¦Freed¦Phỉ Lợi Đức
菲利斯=Feris¦Phỉ Lợi Tư¦Phyllis¦Fellis
菲妮雅=Phinea¦Phỉ Ny Nhã
菲娜斯=Fena¦Phỉ Na Tư
菲尔兹=Fields¦Các trường
菲尔普=Falp¦Phỉ Nhĩ Phổ
菲尔特=Fürth¦Phỉ Nhĩ Đặc¦Fuerth
菲尼克斯=Phoenix¦Phỉ Ni Khắc Tư¦Phi-ních
菲律宾=Philippines¦Phi-li-pin¦Phi Luật Tân
菲拉斯=Phỉ Lạp Tư¦Feralas
菲拉顿=Phỉ Lạp Đốn¦Firraton
菲莉丝=Félicie¦Ferris¦Phyllis
菲里克斯=Félix¦Felix¦Phỉ Lý Khắc Tư
萧月生=Tiêu Nguyệt Sinh¦Tiêu Nguyệt Sanh
萨克拉门托=Sacramento¦Tát Khắc Lạp Thác
萨克斯=Saxo¦kèn
萨克雷=Thackeray¦Tát Khắc Lôi¦Sacre
萨哈托=Sahara¦Tát Cáp Thác
萨尔布吕肯=Saarbrücken¦Saarbrücken, thủ đô Saarland, Đức
萨尔曼=Tát Nhĩ Mạn¦Salman
萨尔瓦多=Salvador¦Tát Ngoã Đa¦El Salvador¦En Xan-va-đo
萨拉姆=Salam¦Tát Lạp Mỗ (Salam)
萨拉戈萨=Zaragoza¦Zaragoza, Tây Ban Nha
萨拉曼卡=Salamanca¦Salamanca, Tây Ban Nha
萨拉热窝=Sarajevo¦Xa-ra-giê-vô
萨拉蒙=Tát Lạp Mông¦Saramon
萨格勒布=Zagreb¦Da-grép
萨特恩=Sartreland¦Tát Đặc Ân
萨瓦拉=Tát Ngõa Lạp¦Savara
萨莉亚=Saizeriya¦Tát Lỵ Á¦Salia¦Sarya
萨达姆=Saddam¦Tát Đạt Mỗ
萨鲁曼=Saruman¦Tát Lỗ Mạn
落宝金钱=Lạc Bảo Kim Tiền¦Lạc Bảo Kim Tiễn
葡萄牙=Bồ Đào Nha¦Portugal
董仲舒=Đổng Trọng Thư¦Dong Zhongshu
蒋丽华=Tianzi¦Jiang Lihua¦Tưởng Lệ Hoa
蒋云山=Tưởng Vân Sơn¦Tương Vân Sơn
蒋云彪=Tưởng Vân Bưu¦Tương Vân Bưu
蒋孔明=Tưởng Khổng Minh¦Tương Khổng Minh
蒙哥马利=Montgomery¦Mông Ca Mã Lợi
蒙大纳=Montana¦Mông-ta-na¦Mon-te-nơ
蒙娜丽莎=Mona Lisa¦nàng mô na Li Sa
蒙巴顿=Mountbatten¦Lãnh chúa Louis Mountbatten, Bá tước Mountbatten thứ nhất của Miến Điện¦Mông Ba Đốn
蒙得维的亚=Montevideo¦Môn-tê-vi-đê-ô
蒙格玛=Mông Cách Mã¦Mongma
蒙特利尔=Montréal¦thành phố Montreal ở Quebec, Canada
蒙罗维亚=Monrovia¦Môn-rô-vi-a
蓝发耳环=Aogami Pierce¦Aogami Pierce (tóc lam khuyên tai)
蔺相如=Lận Tương Như¦Lạn Tương Như
蕾奥妮=Léonie¦Leonie
蕾奥娜=Leona¦Lôi Áo Na¦Leonor
蕾莉娅=Lélya¦Remilia
蕾莉安=Lelianne¦Lôi Lỵ An
蕾蕾安=Leileian¦Lụy Lụy An
薛仁贵=Tiết Nhân Quý¦Xue Rengui
薛定谔=Schrödinger¦Erwin Schrödinger¦Tiết Định Ngạc¦Schrodinger
薛西斯=Xerxes¦Tiết Tây Tư
藏经阁=Tàng Kinh Các¦tàng kinh các
虎刺王=Hổ Thích Vương¦Hổ Thứ Vương
虚夜宫=Las Noches¦Las Noches (Hư Dạ Cung)
虚无之界=Hư Vô Chi Giới¦Hư Vô Giới
虞美人=Ngu Mỹ Nhân¦Hoa anh túc ngô
蛇颈龙=Xà Cảnh Long¦Xà Cảnh long
蜜儿雪=Mật Nhi Tuyết¦Miluse
蝙蝠侠=Batman¦Người dơi, siêu anh hùng trong truyện tranh
融念冰=Dung Niệm Băng¦Rong Nian Bing¦Rong Nianbing
螟虫之母=Minh Trùng Chi Mẫu¦Minh Trùng Mẫu
螳螂拳=Đường Lang Quyền¦một cú đấm
血乌鸦=Huyết Ô Nha¦Huyết quạ đen
血洛世界=Huyết Lạc Thế Giới¦Huyết Lạc thế giới
血色十字军=Huyết Sắc Thập Tự Quân¦Scarlet Crusade
血馒头=Huyết Man Đầu¦bánh bao máu
血骷髅=Huyết Khô Lâu¦Blood Skull
补天石=Bổ Thiên Thạch¦đá vá trời
袁世凯=Viên Thế Khải¦Yuan Shikai
袖白雪=Tụ Bạch Tuyết¦Sode no Shirayuki
袖里乾坤=Tụ Lý Càn Khôn¦tụ lý càn khôn
西兰克=Tây Lan Khắc¦Szilank
西南非=Tây Nam Phi¦miền Tây Nam Châu Phi
西厢记=Tây Sương Ký¦tây sương ký
西双版纳=Tây Song Bản Nạp¦Xishuangbanna¦Tây Song Bản Nạp (Xishuangbanna)
西园寺=Saionji¦Tây Viên Tự
西夫塔=Tây Phu Tháp¦Sifta
西奥多=Theodore¦Tây Áo Đa
西弗吉尼亚=West Virginia¦Tây Phất Cát Á¦Oét Vơ-gi-ni-ơ
西德尼=Sydney¦Sidney hoặc Sydney¦Sidney¦Tây Đức Ni
西游记=Tây Du Ký¦Tây du
西班牙=Tây Ban Nha¦Spain¦Y Pha Nho
西米里安=Tây Mễ Lý An¦Simirian
西菲姆斯=West Philip Williams¦Tây Phỉ Mỗ Tư
西萨摩亚=Western Samoa¦Tây Xa-moa độc lập
西蒙尼=Simeone¦Tây Mông Ni¦Simone
西西里奇=Sicilian¦Sicilian Kỳ
西雅图=Seattle¦Tây Nhã Đồ¦Xi-e-tô
见闻色霸气=Kenbunshoku Haki¦Haki Quan Sát¦Kiến Văn Sắc Haki¦Haki sắc màu
观察使=Quan Sát Sứ¦quan sát sử
观星台=Quán Tinh Đài¦đài thiên văn¦đài quan sát¦đài quan sát thiên văn
观音坐莲=Quan Âm Toạ Liên¦Quan Âm Tọa Liên
观音菩萨=Quan Âm Bồ Tát¦quan âm bồ tát¦phật bà¦phật bà quan âm
觉之啸吟=Giác Chi Khiếu Ngâm¦Kaku no Shōgin
詹姆士=James¦Jenmuse¦Chiêm Mỗ Sĩ
詹姆斯敦=Jamestown¦Giêm-xtao-nơ
誓约胜利之剑=Thệ Ước Thắng Lợi Kiếm¦Thệ Ước Thắng Lợi Chi Kiếm¦Excalibur
诉求的箭书=Tố Cầu Tiễn Thư¦Tố Cầu Tiễn Thư (Phoebus Catastrophe)
诗之蜜酒=Óðrerir¦Óðrerir (Thi Chi Mật Tửu)
诸天万界=Chư Thiên Vạn Giới¦chư thiên vạn giới
诸神黄昏=Chư Thần Hoàng Hôn¦Ragnarök¦Chư Thần Hoàng Hôn (Ragnarök)¦Ragnarok
诸葛裕=Gia Cát Dụ¦Chư Cát Dụ
诸葛雄=Gia Cát Hùng¦Chư Cát Hùng
诸葛青=Gia Cát Thanh¦Zhuge Qing
诺埃尔=Nặc Ai Nhĩ¦Nerlens¦Noel¦Noelle
诺夫哥罗德=Novgorod¦Novgorod, thành phố ở Nga
诺曼底=Normandy¦Normandy, Pháp
诺森德=Northrend¦Nặc Sâm Đức
诺迪拉=Nặc Địch Lạp¦Nodila
谢尔比=Shelby¦Tạ Nhĩ Bỉ
谢尔盖=Sergei¦Sergey¦Tạ Nhĩ Cái¦Konstantin
谢里夫=Tạ Lý Phu¦Sheriff¦Nawaz Sharif¦Sharif
谢霆锋=Tạ Đình Phong¦Tse Ting-Fung hoặc Nicholas Tse
谢静璇=Tạ Tĩnh Tuyền¦Tạ Tịnh Tuyền
豪火灭却=Hào Hỏa Diệt Khước¦Gōka Mekkyaku
贝克尔=Becker¦Baker hoặc Becker¦Baker¦Bối Khắc Nhĩ
贝克汉姆=Beckham¦Beckenham hoặc Beckham
贝内迪克特=Benedict¦Bénédicte
贝卢斯科尼=Berlusconi¦Silvio Berlusconi¦Bối Lô Tư Khoa Ni
贝尔格莱德=Belgrade¦Bê-ô-grát
贝尔法斯特=Belfast¦Belfast, thủ đô của Bắc Ireland
贝尔特=Belt¦Bối Nhĩ Đặc
贝尔特兰=Beltrán¦Bertran
贝尔纳=Bernard¦Bối Nhĩ Nạp¦Berna
贝尔莫潘=Belmopan¦Ben-mô-pan
贝尔金=Belkin¦Bối Nhĩ Kim
贝尼尼=Bénigne¦Benigni
贝恩斯=Bối Ân Tư¦Banes
贝格曼=Bergman¦Bối Cách Mạn
贝索斯=Bezos¦Bối Tác Tư
贝聿铭=Bối Duật Minh¦Pei Ieoh Ming hay I.M. Pei
贝里克=Berick¦Bối Lý Khắc
贝鲁克=Belluc¦Bối Lỗ Khắc¦Beluk
贝鲁特=Beirut¦Bairut¦Bây-rút
贝鲁达=Bối Lỗ Đạt¦Beiruda
贯穿死翔之枪=Quán Xuyên Tử Tường Chi Thương¦Gáe Bolg Alternative: Quán Xuyên Tử Tường Chi Thương¦Gae Bolg Alternative¦Gáe Bolg Alternative
费兰德=Phí Lan Đức¦Ferand
费列克=Feric¦Phí Liệt Khắc
费南德=Fernandez¦Phí Nam Đức¦Fernand
费孝通=Phí Hiếu Thông¦Fei Xiaotong
费尔干纳=Fergana¦thung lũng Ferghana
费雯丽=Vivien Leigh Phí Văn Lệ¦Vivien Leigh¦Phí Văn Lệ
贺兰山=Hạ Lan Sơn¦núi Hạ Lan
贺拉斯=Horace¦Horace, tên đầy đủ Latinh Quintus Horatius Flaccus
贾丽娜=Giả Lệ Na¦Cổ Lệ Na
贾元春=Giả Nguyên Xuân¦Cổ Nguyên Xuân
贾北城=Giả Bắc Thành¦Cổ Bắc Thành
贾婷婷=Giả Đình Đình¦Cổ Đình Đình
贾宝玉=Giả Bảo Ngọc¦Cổ Bảo Ngọc
贾弘道=Giả Hoằng Đạo¦Cổ Hoằng Đạo
贾志宏=Giả Chí Hoành¦Cổ Chí Hoành
贾戴尔=Gardel¦Cổ Đái Nhĩ
贾拉德=Giả Lạp Đức¦Cổ Lạp Đức¦Jurad
贾拉斯=Giả Lạp Tư¦Jaras¦Jarasi¦Cổ Lạp Tư
贾政民=Giả Chính Dân¦Cổ Chính Dân
贾文和=Giả Văn Hòa¦Cổ Văn Hòa
贾文峰=Giả Văn Phong¦Cổ Văn Phong
贾文静=Giả Văn Tĩnh¦Cổ Văn Tĩnh
贾无道=Giả Vô Đạo¦Cổ Vô Đạo
贾梅拉=Giả Mai Lạp¦Cổ Mai Lạp¦Jamella
贾梓凌=Giả Tử Lăng¦Cổ Tử Lăng
贾正道=Giả Chính Đạo¦Giả Chánh Đạo¦Cổ Chính Đạo¦Cổ Chánh Đạo
贾沧海=Giả Thương Hải¦Cổ Thương Hải
贾玉如=Giả Ngọc Như¦Cổ Ngọc Như
贾维尔=Giả Duy Nhĩ¦Cổ Duy Nhĩ¦Javier
贾翰林=Giả Hàn Lâm¦Cổ Hàn Lâm
贾荣丰=Giả Vinh Phong¦Cổ Vinh Phong
贾静雯=Giả Tịnh Văn¦Cổ Tĩnh Văn
贾风流=Giả Phong Lưu¦Cổ Phong Lưu
赛伦斯=Zaerens¦Tái Luân Tư
赛力散=Xeredan¦xê-rê-đan¦thuỷ ngân a-xê-tát
赛博顿=Cyberon¦Tái Bác Đốn
赛巴斯蒂安=Sebastià¦Sebastian
赛西莉亚=Cecilia¦Tái Tây Lỵ Á
赞比亚=Zambia¦Dambia¦Dăm-bi-a
赤卫军=Xích Vệ Quân¦xích vệ quân
赤县神州=Xích Huyện Thần Châu¦Huyện Xích Thần Châu
赤精子=Xích Tinh Tử¦Sekiseishi
赤道几内亚=Guinea Xích Đạo¦Ghi-nê Xích Đạo¦Equatorial Guinea
赤金龙鳞神舟=Xích Kim Long Lân Thần Châu¦Xích Kim Long Lân Thần Chu
赫伯特=Hébert¦Herbert
赫克托=Hèctor¦Hector
赫哲族=Hách Triết¦dân tộc Hách Triết
赫尔曼=Hermann¦Germán¦Herman hoặc Hermann¦Germán ¦Hách Nhĩ Mạn¦Hirschmann
赫尔特=Huerter¦Hách Nhĩ Đặc¦Hult
赫尔辛基=Helsinki¦Hách Nhĩ Tân Cơ¦Hen-xin-ki
赫拉迪=Hera Dich¦Hách Lạp Địch
赫斯特=Hearst¦Hách Tư Đặc¦Herst
赫耳墨斯=Hermes¦Hách Nhĩ Mặc Tư
赫西俄德=Hēsíodos¦Hesiod
赫西奥德=Hesiod¦Hēsíodos
赫连勃勃=Hách Liên Bột Bột¦Helian Bobo
赵子龙=Triệu Tử Long¦Zhao Zilong
赵无极=Triệu Vô Cực¦Zhao Wuji
赵本山=Triệu Bản Sơn¦Zhao Benshan¦Triệu Bổn Sơn
超电磁炮=Railgun¦siêu pháo điện từ
路易斯=Lewis¦Louis¦Lluis¦Louis hoặc Lewis¦Louise
路易斯安那=Louisiana¦Lu-i-di-an¦Lu-i-di-e-nơ
路易斯安那州=Louisiana¦Louisiana, tiểu bang Hoa Kỳ
路易斯维尔=Louisville¦Lộ Dịch Tư Duy Nhĩ
路透社=Reuters¦Hãng tin Reuters
车里雅宾斯克=Chelyabinsk¦thị trấn Chelyabinsk ở sườn phía đông của Ural, trên tuyến đường sắt xuyên Siberia
转生眼=Chuyển Sinh Nhãn¦Tenseigan
转轮圣王=Chuyển Luân Thánh Vương¦Chakravarti raja
转轮王=Chuyển Luân Vương¦Chakravarti raja
轮回眼=Luân Hồi Nhãn¦Rinegan¦Rinnegan
轮转胜利之剑=Luân Chuyển Thắng Lợi Chi Kiếm¦Excalibur Galatine¦Excalibur Gallatin
轻灵术=Khinh Linh Thuật¦Nhẹ Nhàng Thuật
辛特拉=Tân Đặc Lạp¦Cintra¦Sintra
辛蒂娅=Cíntia¦Cynthia
辛西亚=Cynthia¦Tân Tây Á
辛迪亚=Tân Địch Á¦Sindia
辛迪加=Syndicate¦Xanhdica¦Xanh-đi-ca
辟龙大鼓=Ích Long Đại Cổ¦Tịch Long Đại Cổ
达伦斯=Dalence¦Đạt Luân Tư
达克斯=Đạt Khắc Tư¦Dax
达克特=Đạt Khắc Đặc¦Ducat
达利欧=Đạt Lợi Âu¦Dalio
达卡尔=Đạt Tạp Nhĩ¦Ducker
达喀尔=Dakar¦Đạt Khách Nhĩ¦Đa-ca
达尔文=Darwin¦Đác-uyn
达尔马提亚=Dalmatia¦Dalmatie¦Dalmatia, vùng Croatia trên bờ biển phía đông của biển Adriatic
达斡尔=Daur¦Daoatle¦Dân tộc Daur của Nội Mông và Hắc Long Giang
达普拉=Đạt Phổ Lạp¦Dapra¦Dabura
达维安=Đạt Duy An [Davian]¦Davian¦Đạt Duy An
达芙妮=Daphne¦Dafnée
达莲娜=Đạt Liên Na¦Daryna¦Dalena¦Darlene
达达尼尔=Dardanéllia¦Dardanelle
达里奥=Darío¦Daario
还施水阁=Hoàn Thi Thủy Các¦Hoàn Thi Thủy các
远吕智=Viễn Lữ Trí¦Orochi
迪丽热巴=Địch Lệ Nhiệt Ba¦Dilraba
迪丽雅=Địch Lệ Nhã¦Delia
迪亚哥=Diego¦Địch Á Ca
迪亚斯=Dias¦Diaz¦Địch Á Tư
迪兰雅=Diana¦Địch Lan Nhã
迪卡斯=Dikas¦Địch Tạp Tư¦Dukas
迪拉亚=Địch Lạp Á¦Diarra
迪拉姆=Địch Lạp Mỗ¦Dirham
迪斯马克=Deeth Mark¦Địch Tư Mã Khắc
迪瓦约=Di Vaio¦Địch Ngõa Ước
迪莉雅=Delia¦Địch Lỵ Nhã
迷失之城=Mê Thất Chi Thành¦Mê Thất chi thành
迷迭香=Mê Điệt Hương¦Rosemary¦mê điệt hương¦Rosmontis
逆理之裁者=Nghịch Lý Chi Tài Giả¦Gyakuri no Saisha
逍遥游=Tiêu Dao Du¦tiêu dao du
通古斯=Tungus¦nhóm dân tộc Tun-gut
通天山=Thông Thiên Sơn¦Thông Thiên sơn
通天教主=Thông Thiên Giáo Chủ¦Tsūten Kyōshu
通背拳=Thông Bối Quyền¦"Thông Bối Quyền"
通臂猿猴=Thông Tý Viên Hầu¦Thông Tí Viên Hầu
通行证=Thông Hành Chứng¦giấy thông hành¦thẻ thông hành¦giấy lưu hành nội bộ¦giấy tờ lưu hành nội bộ¦tài liệu lưu hành nội bộ¦thẻ
造化之舟=Con Thuyền Tạo Hóa¦Tạo Hóa Chi Thuyền
道德天尊=Đạo Đức Thiên Tôn¦đạo đức thiên tôn¦thiên tôn đạo đức
道德经=Đạo Đức Kinh¦Kinh Nguyệt đạo đức
道心种魔=Đạo Tâm Chủng Ma¦đạo tâm chủng ma
道明寺=Đạo Minh Tự¦Domyōji¦Dōmyōji¦Makoto¦Chùa Đạo Minh
道格里斯=Douglas¦Đạo Cách Lý Tư
遥远的蹂躏制霸=Via Expugnatio¦Diêu Viễn Đích Nhựu Lận Chế Bá
邓丽君=Đặng Lệ Quân¦Teresa Teng
邓加尔=Đặng Gia Nhĩ¦Dúngal
邓志辉=Deng Zhihui¦Đặng Chí Huy
邓氏鱼=Dunkleosteus¦Đặng Thị Ngư¦cá Dunkleosteus
邓紫棋=Đặng Tử Kỳ¦G.E.M.
那美克星=hành tinh Namek¦Namek
那达慕=Nadam¦ngày hội Na-ta-mu
邦美蜀=Buôn Ma Thuột¦Ban Mê Thuột
邱北海=Khưu Bắc Hải¦Khâu Bắc Hải
邱比特=Cupid¦Thần Cupid
邱淑贞=Khưu Thục Trinh¦Khâu Thục Trinh
邵逸夫=Thiệu Dật Phu¦Run Run Shaw
郑伊健=Trịnh Y Kiện¦Ekin Cheng
郑成功=Trịnh Thành Công¦Koxinga
郭敬明=Quách Kính Minh¦Guo Jingming
都御史=Đô Ngự Sử¦đô ngự sử
都柏林=Dublin¦Đô Bách Lâm¦Đơ-blin
配糖物=Glucozid¦Glu-cô-zit
酒吞童子=Tửu Thôn Đồng Tử¦Shitendouji¦Tửu Thôn Đồng Tử (Shuten Douji)¦Shuten-dōji
醉梦楼=Túy Mộng Lâu¦Túy Mộng lâu
释迦摩尼=Thích Ca Mâu Ni¦Thích Già Ma Ni
里卡尔=Lý Tạp Nhĩ¦Ricard¦Ricarl
里士满=Richmond¦Lí Sĩ Mãn
里斯特=Lý Tư Đặc¦Rister
金三角=Tam Giác Vàng¦tam giác vàng¦Tam giác vàng
金仙中期=Kim Tiên Trung Kỳ¦kim tiên trung kỳ
金兀术=Kim Thuật Ngột¦Kim Ngột Thuật
金元宝=Kim Nguyên Bảo¦kim nguyên bảo
金光禅师=Kim Quang Thiện Sư¦Kim Quang Thiền Sư
金凯利=Kim Khải Lợi¦Jim Carrey
金刚山=Kim Cương Sơn¦Khu du lịch Kumgangsan ở phía đông Bắc Triều Tiên
金刚杵=Kim Cương Xử¦kim cương xử¦Vajra
金刚腿=Kim Cương Cước¦Kim Cương Thối
金刚诀=Kim Cương Quyết¦"Kim Cương Quyết"
金喜善=Kim Hỉ Thiện¦Kim Hee-sun
金坷拉=Kim Khả Lạp¦Kim Khả Lạp (thức ăn tăng lực)
金城武=Kim Thành Vũ¦Kaneshiro Takeshi
金太郎=Kintaro¦Kintarō¦Masaka¦Kim Thái Lang
金山寺=Kim Sơn Tự¦Đền Jinshan, nơi Fahai sống
金山银山=Núi Bạc Núi Vàng¦núi vàng núi bạc¦Núi Vàng và Núi Bạc
金斯顿=Kingston¦Kim Tư Đốn¦Kinh-xtơn
金灵圣母=Kim Linh Thánh Mẫu¦Kim Linh thánh mẫu
金玉满堂=Kim Ngọc Mãn Đường¦kim ngọc mãn đường
金球奖=Quả Bóng Vàng¦Giải Quả cầu vàng
金瓶梅=Kim Bình Mai¦Qinmei or the Golden Lotus
金科拉=Kim Khoa Lạp¦Kora vàng
金箍棒=Kim Cô Bổng¦kim cô bổng
金色暗影=Golden Darkness¦Kim Sắc Ám Ảnh
金达莱=Jindalrae¦cung điện vua chúa¦Kindalai
金銮殿=Kim Loan Điện¦điện Kim Loan¦kim điện
金钟罩=Kim Chung Tráo¦kim chung tráo¦kim chung cháo¦Kim chung tráo¦mặt nạ chuông vàng
金霉素=Oreomyxin¦Ô-rê-ô-my-xin¦aureociclina¦aureomykoin
钉头七箭=Đinh Đầu Thất Tiễn¦đinh đầu bảy mũi tên
钟楚红=Chung Sở Hồng¦Cherie Chung
钢铁侠=Iron Man¦Ironman¦Người sắt, siêu anh hùng trong truyện tranh
钮钴禄=Nữu Hỗ Lộc¦nữu cỗ lộc¦niu lộc
钱学森=Tiền Học Sâm¦Qian Xuesen
钱梦琪=Tiền Mộng Kỳ¦Tiễn Mộng Kỳ
铁中棠=Thiết Trung Đường¦Thiết Trung đường
铁木真=Thiết Mộc Chân¦Thành Cát Tư Hãn
铁树地狱=Thiết Thụ Địa Ngục¦Địa Ngục Thiết Thụ
铁炉堡=Thiết Lô Bảo¦Ironforge
铁甲龙=Thiết Giáp Long¦Ironclad Dragon
铁砂掌=Thiết Sa Chưởng¦Thiết sa chưởng
铁碎牙=Thiết Toái Nha¦Tessaiga
铁观音=Thiết Quan Âm¦Trà thiết quan âm
银闪的风姬=Ngân Thiểm Phong Cơ¦Ngân Thiểm Phong Cơ (Silvfrahl)
锡林郭勒=Xilin Gol¦Liên minh Xilin Gol, một phân khu cấp tỉnh của Nội Mông
锦衣卫=Cẩm Y Vệ¦cẩm y vệ¦cấm vệ quân
镀金玫瑰=Hoa Hồng Mạ Vàng¦Độ Kim Mân Côi
镜世界=Kính Thế Giới¦Mirror World
长孙无忌=Trưởng Tôn Vô Kỵ¦Zhangsun Wuji
长岛冰茶=Long Island¦Trà đá Long Island
长生子=Trường Sinh Tử¦Trường Sinh tử
长生果=Trường Sinh Quả¦củ lạc¦đậu phộng¦trường sinh quả
长翼龙=Trường Dực Long¦Wyvern
门巴族=Môn Ba¦dân tộc Môn Ba
闪电术=Thiểm Điện Thuật¦Thiểm điện thuật
闪米特=Semite¦Tiếng Semitic
阳顶天=Dương Đỉnh Thiên¦Dương Đính Thiên
阴阳眼=Âm Dương Nhãn¦Onmyōgan
阿什哈巴德=Ashkhabad¦A-xkha-bát
阿佛洛狄忒=Aphrodite¦Aphrodite, nữ thần tình yêu của Hy Lạp
阿克伦=Akron¦Sông Acheron ở Epirus, Tây Bắc Hy Lạp
阿克拉=Accra¦A Khắc Lạp¦A-cra
阿克萨=Aska¦A Khắc Tát
阿克西=A Khắc Tây¦Aksi
阿兹克=A Tư Khắc¦Azcot¦Azkot
阿列斯=A Liệt Tư¦Ares
阿加塔=Ágata¦Agatha¦Agata
阿卡德=Akkad¦Akkadia¦A Tạp Đức
阿卡普尔科=Acapulco¦Acapulco, thành phố ở Mexico
阿卡狄=A Tạp Địch¦Akady
阿卡西=Akashic¦A Tạp Tây
阿历克=A Lịch Khắc¦Alec
阿古斯丁=Agustín¦Agustin
阿古达=Agoudas¦A Cổ Đạt¦Agoda
阿司匹林=Aspirin¦át-xpi-rin¦aspirin
阿基琉斯=A Cơ Lưu Tư¦Achilles
阿塞拜疆=Azerbaijan¦A Tắc Bái Cương¦A-déc-bai-gian
阿多尼斯=Adonis¦Adonis, nhân vật trong thần thoại Hy Lạp
阿姆斯=A Mỗ Tư¦Ams¦Arms
阿姆斯特丹=Amsterdam¦A Mỗ Tư Đặc Đan¦Am-xtéc-đam
阿姆斯特朗=Armstrong¦họ Armstrong
阿富汗=Afghanistan¦Áp-ga-ni-xtan¦A Phú Hãn
阿尔伯克基=Albuquerque¦A Nhĩ Bá Khắc
阿尔卑斯=Alps¦Alb¦Hãng alps
阿尔卡特=Alcatel¦Alucard¦Alcatel, tên công ty cũ
阿尔及利亚=Algeria¦Angeri¦An-giê-ri
阿尔及尔=Algiers¦Angie¦An-giê
阿尔巴=Alba¦Albà
阿尔梅=Almè¦Armelle
阿尔瓦塞特=Albacete¦Albacete, Tây Ban Nha
阿尔瓦罗=Álvaro¦Alvaro
阿尔萨斯=Alsace¦Alsace, bộ phận tiếng Pháp¦Arthas
阿尼马格斯=Animagus¦thú hóa
阿巴拉契亚=Appalachia¦Appalachian¦Dãy núi Appalachian ở Bắc Mỹ
阿布扎比=Abu Dhabi¦A Bố Trát Bỉ¦A-bu Đa-bi
阿帕奇=Apache¦A Mạt Kỳ
阿帕德=Árpád¦Arpad
阿弥陀=A Di Đà¦đức Phật A-di-đà
阿德莱德=Adelaide¦Adelaide, thủ đô của Nam Úc
阿德里亚娜=Adriana¦ A Đức Lý Á Na
阿托品=Atropine¦a-trô-pin¦atropine
阿拉丁=Aladin¦Aladdin, nhân vật trong một trong những câu chuyện trong Sách Nghìn lẻ một đêm
阿拉伯=Ả Rập¦Ảrập
阿拉善=A Lạp Thiện¦a lạp thiện¦Liên đoàn Alxa, một phân khu cấp tỉnh của Nội Mông Cổ
阿拉巴马=Alabama¦Alabama, tiểu bang Hoa Kỳ
阿拉斯=Arras¦Arras, thị trấn ở miền bắc nước Pháp
阿摩尼亚=Ammonia¦̣̣̣khí a-mô-ni-ắc¦khí amoniac¦NH3¦Amonia
阿斯科=A Tư Khoa¦Ascona
阿斯莫德=Asmodeus¦A Tư Mạc Đức
阿昌族=A Xương¦dân tộc A Xương
阿曼纳塔=Amaunator¦A Mạn Nạp Tháp
阿根廷=Argentina¦Achentina¦Ác-hen-ti-na¦Á Căn Đình
阿比西尼亚=Abyssinia¦Abyssinia, tên lịch sử của Ethiopia¦Ethiopian
阿法尔=Afar¦Người Afar
阿洛菲=Alofi¦A-lô-phi
阿涅丝=Agnès¦Agnes
阿特尔=Artl¦A Đặc Nhĩ¦Attle
阿的平=A Đích Bình¦A-tê-brin¦atebrine
阿皮亚=Apia¦A Bỉ Á¦A-pi-a
阿米尼=A Mễ Ni¦Amini
阿维拉=Avila¦Avila, Tây Ban Nha
阿肯色=Arkansas¦A Khẳng Sắc¦A-căng-xát A-cân-xo
阿育王=A Dục Vương¦Ashoka
阿萨姆=Assam¦Assam, Ấn Độ¦Asam
阿西多拉=Adadora¦hi linh đế quốc¦Asdora¦Ashidala
阿西莫夫=Asimov¦Isaac Asimov¦A Tây Mạc Phu
阿西达=Adamas¦hi linh đế quốc¦Asda¦Ashida
阿诺德=Arnold¦A Nặc Đức
阿达斯=A Đạt Tư¦Adas
阿迪达=A Địch Đạt¦Adidas
阿里不达=Alibuda¦A Lý Bất Đạt
阿里巴巴=Alibaba¦Ali Baba, nhân vật trong The Arabian Nights
阿非利加=Africa¦África¦Châu phi
阿黛勒=Adele¦Adèle
阿黛尔=Adele¦Adèle
阿鼻地狱=A Tỳ Địa Ngục¦a tì địa ngục¦địa ngục A Tì¦A Xìn địa ngục
陆地神仙=Lục Địa Thần Tiên¦lục địa thần tiên
陆正仪=Lục Chính Nghi¦Lục Chánh Nghi
陆行龟=Rùa Lục Hành¦Lục Hành Quy
陈奕迅=Trần Dịch Tấn¦Eason Chan
陈正豪=Trần Chính Hào¦Trần Chánh Hào
陈王氏=Trần Vương Thị¦Trần Vương thị
陈纳德=Chennault¦Chennault, chỉ huy Đội Hổ bay trong Thế chiến II
陈艾阳=Trần Ngả Dương¦Trần Ngải Dương
陈长生=Chen Changsheng¦Trần Trường Sinh
陶渊明=Đào Uyên Minh¦Tao Yuanming
隋文帝=Tuỳ Văn Đế¦Hoàng đế đầu tiên của nhà Tùy
隋炀帝=Tuỳ Dạng Đế¦Tuỳ Dương Đế¦Hoàng đế Yang của Tùy
随身听=Walkman¦máy nghe nhạc kèm theo người
隐匿的圣堂=Crypta¦Crypta (Ẩn Nặc Thánh Đường)
雁来红=Nhạn Lai Hồng¦nhạn lai hồng
雁门关=Nhạn Môn Quan¦Nhạn Môn quan¦ải nhạn
雅加达=Jakarta¦Gia-các-ta
雅戈尔=Youngor¦Nhã Qua Nhĩ
雅诗兰黛=Estée Lauder¦Estee lauder
雪岭双姝=Tuyết Lĩnh Song Xu¦Tuyết Lĩnh Song Thù
雪月花=Setsugetsuka¦Tuyết Nguyệt Hoa
雪蜜儿=Tuyết Mật Nhi¦Shemil
零时迷子=Linh Thời Mê Tử¦Linh Thời Mê Tử (Reiji Maigo)¦Reiji Maigo
雷克斯=Rex¦Lôi Khắc Tư¦Lex
雷克雅未克=Reykjavík¦Reykjavik, thủ đô của Iceland
雷克雅末=Reykjavik¦Rây-ki-a-vích
雷克雅维克=Reykjavík¦Reykjavik, thủ đô của Iceland
雷吉娜=Reghina¦Régina
雷戟千花=Lôi Kích Thiên Hoa¦Lôi Kích Thiên Hoa (Raigeki Senka)
雷斯克=Reske¦Lôi Tư Khắc¦Rex
雷斯林=Raistlin¦Lôi Tư Lâm¦Reislin
雷斯特=Lest¦Rest¦Rexton¦Lôi Tư Đặc¦Resste¦Rast
雷曼兄弟=Lehman Brothers¦Lehman Brothers, ngân hàng đầu tư
雷海之蛇=Lôi Hải Chi Xà¦Lôi Hải Xà
雷特尔=Rethel¦Lôi Đặc Nhĩ
雷纳尔=Lôi Nạp Nhĩ¦Rainer
雷纳德=Rénald¦Reynold¦Lôi Nạp Đức¦Leonard
雷达尔=Lôi Đạt Nhĩ¦Raddatz¦Randall
雷震子=Lôi Chấn Tử¦Raishinshi
震威之结手=Chấn Uy Chi Kết Thủ¦Shin'i no Yuite
霍乱时期的爱情=Tình Yêu Thời Dịch Tả¦Tình yêu thời thổ tả
霍克斯=Hoắc Khắc Tư¦Hawks
霍尔德=Hoắc Nhĩ Đức¦Holder¦Houlder
霍尼亚拉=Honiara¦Hô-ni-a-ra
霍斯特=Horst¦Hoắc Tư Đặc¦Hoster¦Khost¦Cainhurst
霍雨浩=Huo Yuhao¦Hoắc Vũ Hạo
霜之咏叹调=Sương Chi Điệu Vịnh Thán¦Sương Chi Vịnh Thán Điều
霜冻新星=Sương Đống Tân Tinh¦Sương đống tân tinh
露丝雅=Lộ Ti Nhã¦Lucea
露茜娅=Lúcia¦Lucia
霸天位=Bá Thiên Vị¦Phách Thiên Vị
霸王举鼎=Bá Vương Cử Đỉnh¦Phách Vương Cử Đỉnh
霸王别姬=Bá Vương Biệt Cơ¦Farewell My Concubine
霹雳虎=Hổ Sấm Sét¦Phích Lịch Hổ
青丘之国=Thanh Khâu Chi Quốc¦Thanh Khâu Quốc
青木原=Thanh Mộc Nguyên¦Aokigahara
青眼究极龙=Blue-Eyes Ultimate Dragon¦Rồng tối thượng mắt xanh
静夜思=Tịnh Dạ Tư¦Tĩnh Dạ Tứ
静御前=Shizuka Gozen¦Tĩnh Ngự Tiền
顶之座=Đỉnh Chi Tọa¦Itadaki no Kura
顺水推舟=thuận nước đẩy thuyền¦biết thời biết thế
顺风耳=Thuận Phong Nhĩ¦người thính tai¦ống loa¦Thuận Phong nhĩ¦Big Ears¦thuận buồm xuôi gió
须臾空间=Tu Du Không Gian¦Tu Du không gian
顿涅斯克=Donetsk¦Vùng Donetsk của W. Ukraine
顿涅茨克=Donetsk¦Donetsk, thành phố ở Ukraine
颜真卿=Nhan Chân Khanh¦Yan Zhenqing
颜良文丑=Nhan Lương Văn Sú¦Nhan Lương Văn Sửu
额=ngạch¦ách
风信子=Phong Tín Tử¦Lan dạ hương
风暴之锤=Phong Bạo Chi Chùy¦Stormbreaker
风火轮=Phong Hoả Luân¦phong hoả luân¦phong hỏa luân¦bánh xe lửa gió
飞天螳螂=Phi Thiên Đường Lang¦Scyther
飞头蛮=Hitouban¦Phi Đầu Man¦Rokurokubi
飞龙在天=Phi Long Tại Thiên¦phi long tại thiên¦rồng bay trên bầu trời¦con rồng bay trên bầu trời
食尸鬼=Ghoul¦quỷ ăn xác¦thực thi quỷ
食时之城=Thực Thời Chi Thành¦Toki Hami no Shiro
食死徒=Tử Thần Thực Tử¦Tử thần Thực tử¦Tử thần thực tử
食金兽=Thực Kim Thú¦thực kim thú
香巴拉=Shambhala¦Shambhala, địa điểm thần thoại
香榭丽舍=Champs-Élysées¦Champs Élysées
香津美=Katsumi¦Hương Tân Mỹ
马丁内斯=Martínez¦Martinez
马克西米连=Maximilian¦Maximilian hoặc Maximilien
马六甲=Malacca¦Malacca hoặc Melaka
马其顿=Macedonia¦Ma-kê-đô-ni-a
马化腾=Mã Hoá Đằng¦Ma Huateng hay còn gọi là Pony Ma
马塞卢=Maseru¦Ma-xê-ru
马太福音=Phúc Âm Matthew¦Tin Mừng theo Thánh Matthêu
马妮娜=Mã Ny Na¦Marnina
马家军=Mã Gia Quân¦nhóm lãnh chúa Ma ở Cam Túc và Ninh Hạ trong những năm 1930 và 1940
马尔丁=Martí¦Mardin¦Martin
马尔代夫=Maldives¦Cộng hòa Maldives
马德里=Madrid¦Ma-đrít
马扎尔=Magyarok¦người Hungary
马拉加=Malaga¦thành phố Malaga ở Đông Azerbaijan thuộc Iran
马拉奇=Mã Lạp Kì¦Malachi
马拉戈壁=Tiên sư bố nó¦Mã Lạp Qua Bích (Ngựa Qua Sa Mạc)¦Mã Lạp Qua Bích¦mã lặc qua bích
马斯克=Musk¦Elon Musk¦Mã Tư Khắc
马斯喀特=Muscat¦Mã Tư Khách Đặc¦Ma-xcát
马斯顿=Marston¦Mã Tư Đốn
马普托=Maputo¦Ma-pu-tô
马来亚=Mã Lai¦Malaya
马来西亚=Malaysia¦Ma-lai-xi-a¦Mã lai¦Mã Lai Á
马特奥=Matteo¦Mattéo¦Mattheo
马红俊=Mã Hồng Tuấn¦Ma Hongjun
马莱特=Mã Lai Đặc¦Mallet¦Mullet
马萨诸塞=Massachusetts¦Mã Tát Chư Tắc¦Ma-xa-su-xét¦Me-xơ-chu-xít
马达加斯加=Madagasca¦Mã Đạt Gia Tư¦Madagascar¦Ma-đa-ga-xca
马迪亚斯=Madiath¦Mã Địch Á Tư¦Matias¦Mathias
马里奥=Mario¦Mário
驱动=khu động¦khởi động
高句丽=Cao Câu Ly¦Goguryeo¦Cao Ly
高天原=Takama-ga-hara¦Takamagahara¦Cao Thiên Nguyên
高根明=Căn Cao Minh¦Cao Căn Minh
高桥留美子=Takahashi Rumiko¦Takahashi Rumiko, họa sĩ truyện tranh Nhật Bản¦Yashima Kunio
高皇产灵尊=Takamimusubi¦Cao Hoàng Sản Linh Tôn
鬼剑士=Quỷ Kiếm Sĩ¦Ghost Swordsman
鬼头刀=Quỷ Đầu Đao¦quỷ đầu đao
鬼门关=Quỷ Môn Quan¦quỷ môn quan¦cửa âm phủ
魁北克=Quebec¦Tỉnh Quebec, Canada¦Khôi Bắc Khắc¦Québec
魁星岛=Khôi Tinh Đảo¦Khôi Tinh đảo
魏忠贤=Nguỵ Trung Hiền¦Wei Zhongxian¦Ngụy Trung Hiền
魔卡少女樱=Cardcaptor Sakura¦thủ lĩnh thẻ bài Sakura
魔礼寿=Ma Reijyu¦Mo Lishō¦Ma Lễ Thọ
魔礼海=Ma Reikai¦Mo Lihai¦Ma Lễ Hải
魔礼红=Mo Lihong¦Ma Lễ Hồng
魔礼青=Ma Reisei¦Mo Liqing¦Ma Lễ Thanh
魔神公会=Guild Ma Thần¦Ma Thần Công Hội¦Devil Guild
魔音神将=Ma Âm Thần Tướng¦Ma Âm Thần Tương
魔龙一族=Ma Long Nhất Tộc¦Ma Long nhất tộc
鲁道夫=Rudolph¦Rodolfo¦Rudolf¦Lỗ Đạo Phu
鲍尔斯=Bowles¦Bảo Nhĩ Tư¦Bowers
鲍狄埃=Pottier¦Eugène Edine Pottier
鸦天狗=Karasu Tengu¦Nha Thiên Cẩu
鸳鸯刀=Uyên Ương Đao¦uyên ương đao¦dao   100 tuổi
鹤无生=Hạc Vô Sanh¦Hạc Vô Sinh
鹰之武馆=Ưng Chi Võ Quán¦Ưng Chi Vũ Quán
鹿儿岛=Kagoshima¦Kagoshima, tỉnh đảo của Nhật Bản ngoài khơi bờ biển phía nam Kyushu
鹿特丹=Rotterdam¦Rotterdam, thành phố cảng ở Hà Lan
鹿鼎记=Lộc Đỉnh Ký¦lộc đỉnh ký
麦克里=Mc.Culley¦Mạch Khắc Lý
麦尔斯=Myers¦Miles¦Mạch Nhĩ Tư
麦德林=Medellín¦Mendellin¦Medellín, thành phố ở Colombia
麦格温=Mc.Gowan¦Mạch Cách Ôn
麦格雷尼=Mạch Cách Lôi Ni¦Meg Rainey¦McGreyni
麦金莱=Mạch Kim Lai¦McKinley
黄天化=Hoàng Thiên Hóa¦Kō Tenka
黄宗羲=Hoàng Tông Hi¦Huang Zongxi
黄帝内经=Hoàng Đế Nội Kinh¦hoàng đế nội kinh¦Hoàng Đế nội kinh
黄庭经=Hoàng Đình Kinh¦Huangting Jing, một trong những kinh điển chính của Đạo giáo
黄树腓=Hoàng Thụ Phì¦Hoàng Su Phì
黄水仙=Jonquil¦Hoàng Thủy Tiên
黄袍怪=Yellow Robe Demon¦Hoàng Bào Quái
黄连山=Hoàng Liên Sơn¦tỉnh Hoàng Liên Sơn
黄金屋=Hoàng Kim Ốc¦nơi ở sang trọng
黄金狮王=Hoàng Kim Sư Vương¦Golden Lion
黄飞鸿=Hoàng Phi Hồng¦Vương Phi Hùng
黄鹤楼=Hoàng Hạc Lâu¦Hoàng hạc lâu¦lầu Hoàng hạc
黎巴嫩=Lebanon¦Li Băng
黎星刻=Lê Tinh Khắc¦Li Xingke
黑云链=Hắc Vân Liên¦Hắc Vân Liệm
黑凤凰=Hắc Phượng Hoàng¦Hắc phượng hoàng¦Dark Phoenix
黑山共和=Motenegro¦Cộng hòa Montenegro
黑山羊=Hắc Sơn Dương¦Black Goat
黑廷斯=Hasting¦Hắc Đình Tư
黑手党=Mafia¦mafia¦băng đảng tội phạm¦hội bàn tay đen¦đảng Hắc thủ
黑斯廷斯=Heisitingsi¦Hắc Tư Đinh Tư¦Hastings
黑暗之王=Hắc Ám Chi Vương¦Dark Lord
黑暗之神=Hắc Ám Chi Thần¦Hắc Ám Thần
黑暗监狱=Hắc Ám Giam Ngục¦Hắc Ám Ngục Giam
黑武士=Hắc Võ Sĩ¦Darth Vader¦hắc võ sĩ
黑水镇=Hắc Thủy Trấn¦Blackwater
黑猫机关=Grimalkin¦Grimalkin (Hắc Miêu Cơ Quan)
黑白无常=Hắc Bạch Vô Thường¦hắc bạch vô thường¦Hai vị thần, một thấp, một cao, bị xích với nhau ở mắt cá chân, chịu trách nhiệm thưởng cho người tốt và trừng phạt người xấu
黑荆棘=Hắc Kinh Cức¦Blackthorn¦Bụi Gai Đen¦Black thorns
黑非洲=Châu Phi Đen¦lục địa đen
默多克=Murdoch¦Murdock¦Mặc Đa Khắc
黛博拉=Débora¦Deborah¦Debora
黛安芬=Triumph¦Đại An Phân
黛绮丝=Đại Ỷ Ti¦Đại Khỉ Ti¦Đại Ỷ Ty
黯然销魂掌=Ảm Nhiên Tiêu Hồn Chưởng¦ảm nhiên tiêu hồn chưởng
齐内丁=Zinédine¦Zinedine
齐宣王=Tề Tuyên Vương¦Vua Xuân của Tề
齐格飞=Siegfried¦Tề Cách Phi
齐桓公=Tề Hoàn Công¦Công tước Huân của Tề
齐白石=Tề Bạch Thạch¦Qi Baishi
齐眉棍=Tề Mi Côn¦tề mi côn
龙之谷=Long Chi Cốc¦Dragon Nest
龙变梵度天=Long Biến Phạn Độ Thiên¦Long Biến Phạm Độ Thiên
龙啸云=Long Tiếu Vân¦Long Khiếu Vân
龙宝宝=Long Bảo Bảo¦Bagon
龙度梵变楼=Long Độ Phạn Biến Lâu¦Long Độ Phạm Biến Lâu
龙神山=Long Thần Sơn¦Ryuujin sơn
龙舌兰=Tequila¦tenquila¦cây thùa¦long thiệt lan
龙血树=Long Huyết Thụ¦cây máu rồng
龙霸天=Long Phách Thiên¦Long Bá Thiên
