Oh=Oh
三足两耳=ba chân hai tai
两个弟子=hai người đệ tử
亦可自取=cũng có thể tự lấy
亲自过去=tự mình đi qua
传武大师=Truyền Võ Đại sư
儿女的=nhi nữ
其知道者=kì tri đạo giả
别人之道=người khác chi Đạo
剑悲=Kiếm Bi
华夏语言=Hoa Hạ ngôn ngữ
可怕的怪兽=đáng sợ quái thú
吃饭睡觉=ăn và ngủ
四肢百胲=tứ chi bách hài
大地载物=đại địa tái vật
天下会=Thiên Hạ Hội
如神似魔=như thần tự ma
如神铁=như thần thiết
容颜如玉=dung nhan như ngọc
尊神话=tôn thần thoại
快之又快=nhanh lại càng nhanh
扫地杂役=tạp dịch quét rác
曾存在=từng tồn tại
有大恐怖=có đại khủng bố
江玄=Giang Huyền
没有解释=không hề giải thích
海上明月城=Hải Thượng Minh Nguyệt Thành
混乱邪恶=hỗn loạn tà ác
火点燃=hỏa thiêu đốt
独有的=độc hữu/đặc hữu/chỉ mới có/đặc thù
理解不到=lý giải không đến
皲裂=nứt nẻ
省的我=đỡ phải ta
真不公=thật bất công
神光笼罩=thần quang bao phủ
离开地球=rời Địa Cầu
老剑圣=lão Kiếm Thánh
自衬已=tự tôn đã
距离上次=khoảng cách lần trước
踏马=mẹ nó/đạp mã
过于生分=quá xa lạ
这么一个=một cái như vậy
这把刀=thanh đao này
逆生长=nghịch sinh trưởng
遮天界=Già Thiên giới
遮天界的=Già Thiên giới
那些大教=những cái kia đại giáo
难受死了=khó chịu muốn chết
雄霸=Hùng Bá
顶级功法=đỉnh cấp công pháp
鬼尊令=Quỷ Tôn Lệnh
招魂谷=Chiêu Hồn Cốc
轮回转生池=Luân Hồi Chuyển Sinh Trì
六芒鬼尊=Lục Mang Quỷ Tôn
邪冥鬼王=Tà Minh Quỷ Vương
楚墟=Sở Khư
紫府雷法=Tử Phủ Lôi Pháp
天雷宗=Thiên Lôi Tông
楚墟鬼尊=Sở Khư Quỷ Tôn
石像地藏=Thạch Tượng Địa Tạng
千眼万瞳桩=Thiên Nhãn Vạn Đồng Tràng
楚墟真人=Sở Khư chân nhân
中山氏=Trung Sơn Thị
万灵胎膜=Vạn Linh Thai Mô
归真鉴=Quy Chân Giám
冥府鬼王=Minh Phủ Quỷ Vương
转轮鬼王=Chuyển Luân Quỷ Vương
泰山鬼王=Thái Sơn Quỷ Vương
鬼童子=Quỷ Đồng Tử
萍末真人=Bình Mạt Chân Nhân
释门圣僧=Thích Môn Thánh tăng
北宗=Bắc Tông
神思妙想空间=Thần Tư Diệu Tưởng Không Gian
喜财宝宝=Hỉ Tài Bảo Bảo
悬壶神眼=Huyền Hồ Thần Nhãn
随身仙剑=Tùy Thân Tiên Kiếm
善财宝宝=Thiện Tài Bảo Bảo
蜃龙舍利=Thận Long Xá Lợi
旁门真人=Bàng Môn chân nhân
伪帝=Ngụy Đế
锦绣暗卫=Cẩm Tú Ám Vệ
隆光通宝=Long Quang Thông Bảo
恭良通宝=Cung Lương Thông Bảo
正统通宝=Chính Thống Thông Bảo
穿山甲老妖=Xuyên Sơn Giáp Lão Yêu
三毒飞剑=Tam Độc Phi Kiếm
驰于=Trì Vu
天下第四位剑仙=Thiên hạ đệ tứ vị kiếm tiên
轮回剑仙=Luân Hồi Kiếm Tiên
燕太子=Yên Thái Tử
秦王殿=Tần Vương Điện
新生伪帝=Tân Sinh Ngụy Đế
新生帝=Tân Sinh Đế
刺客师徒=Sư đồ thích khách
刺八郎=Thích Bát Lang
新京城=Tân Kinh Thành
德夫子=Đức Phu Tử
老僧地藏=Lão tăng Địa Tạng
枯荣禅院=Khô Vinh Thiền Viện
兵家圣人=Binh Gia Thánh Nhân
狗赖子=Cẩu Lại Tử
郑青云=Trịnh Thanh Vân
中山行述=Trung Sơn Hành Thuật
田老丈=Điền lão trượng
郑青天=Trịnh Thanh Thiên
锦绣使者=Cẩm Tú Sứ Giả
恭良=Cung Lương
刺客老三=Thích khách Lão Tam
冶金家=Dã Kim Gia
湛然心火=Trạm Nhiên Tâm Hỏa
八卦紫金丹炉=Bát Quái Tử Kim Đan Lô
屯田所=Đồn Điền Sở
空谈家=Không Đàm Gia
清源圣僧=Thanh Nguyên Thánh Tăng
金中生火=Kim Trung Sinh Hỏa
先天剑仙=Tiên Thiên Kiếm Tiên
濯根水=Trạc Căn Thủy
聚宝金蛛=Tụ Bảo Kim Chu
北地青罗道脉=Bắc Địa Thanh La Đạo Mạch
惜宝真人=Tích Bảo Chân Nhân
震四方大铁戟=Chấn Tứ Phương Đại Thiết Kích
震四方=Chấn Tứ Phương
阴奉学派=Âm Phụng học phái
司空补天=Tư Không Bổ Thiên
田为民=Điền Vi Dân
百子回归=Bách Tử Quy Hồi
京城之战=Kinh Thành chi chiến
吴光净=Ngô Quang Tịnh
五行道宗=Ngũ Hành Đạo Tông
正统朝廷=Triều đình Chính Thống
五大重关=Năm cửa ải trọng yếu
葛物联=Cát Vật Liên
龙象精元=Long Tượng Tinh Nguyên
旁门联盟=Bàng Môn Liên Minh
和尚圆通=Hòa thượng Viên Thông
梅鹤公=Mai Hạc Công
葛头儿=Cát Đầu Nhi
定水分山兽=Định Thủy Phân Sơn Thú
逝水关前=Trước Thệ Thủy Quan
金乌密卷=Kim Ô Mật Quyển
火凤道友=Hỏa Phượng đạo hữu
乘龙御法=Thừa Long Ngự Pháp
金剪子=Kim Tiễn Tử
金山关=Kim Sơn Quan
陈木关=Trần Mộc Quan
厚德关=Hậu Đức Quan
烈芳关=Liệt Phương Quan
鸟妖=Điểu yêu
青白焰光=Thanh bạch diễm quang
蚁婆神=Nghĩ Bà thần
九凤世家=Cửu Phượng thế gia
狱门神象=Ngục Môn Thần Tượng
破风针=Phá Phong Châm
权书公=Quyền Thư Công
南倾=Nam Khuynh
天倾刃=Thiên Khuynh Nhận
南倾真人=Nam Khuynh chân nhân
汗青公=Hãn Thanh công
九宫门=Cửu Cung môn
六不戒律=Lục Bất Giới Luật
兴霸=Hưng Bá
逝水关山=Thệ Thủy Quan Sơn
西南米巫=Tây Nam Mễ Vu
磁宝天心=Từ Bảo Thiên Tâm
冶兵家主=Diã Binh Gia Chủ
学派真人=Học Phái Chân Nhân
德六艺=Đức Lục Nghệ
青风山岚=Thanh Phong Sơn Lam
新生阵营=Tân Sinh Trận Doanh
鸦公壶=Nha Công Hồ
西南米教=Tây Nam Mễ Giáo
金乌烈焰=Kim Ô Liệt Diễm
先天易经=Tiên Thiên Dịch Kinh
沭阳真人=Thuật Dương Chân Nhân
凌霄白帝=Lăng Tiêu Bạch Đế
七尾龟=Thất Vĩ Quy
顶天白虎=Đỉnh Thiên Bạch Hổ
青龙旗=Thanh Long kỳ
丹融真人=Đan Dung chân nhân
小黄山=Tiểu Hoàng Sơn
眉山文集=Mi Sơn văn tập
朱雀星座=Chu Tước tinh tọa
千波幻鲤刃=Thiên Ba Huyễn Lí Nhận
巫童=Vu Đồng
淑阳真人=Thục Dương chân nhân
周天星罗=Chu Thiên Tinh La
星宿大挪移遁法=Tinh Túc Đại Na Di Độn Pháp
周天如意神游术=Chu Thiên Như Ý Thần Du Thuật
兵主横空=Binh Chủ Hoành Không
君兴霸=Quân Hưng Bá
毛姓小将=Mao tính tiểu tướng
元亨=Nguyên Hanh
利贞=Lợi Trinh
十方天眼=Thập Phương Thiên Nhãn
慧尸=Tuệ Thi
莲花秘镜=Liên Hoa Bí Kính
神足圣僧=Thần Túc Thánh Tăng
净世弥陀=Tịnh Thế Di Đà
无量如来=Vô Lượng Như Lai
愚剑=Ngu Kiếm
金鳌圣僧=Kim Ngao Thánh Tăng
无量如来佛祖=Vô Lượng Như Lai Phật Tổ
雪炎=Tuyết Viêm
护法罗刹=Hộ Pháp La Sát
净世十炎=Tịnh Thế Thập Viêm
果泉圣僧=Quả Tuyền Thánh Tăng
百胜圣僧=Bách Thắng Thánh Tăng
九霄积雷云=Cửu Tiêu Tích Lôi Vân
合欢和尚=Hợp Hoan hòa thượng
蜀中酆都山=Thục Trung Phong Đô Sơn
十殿王者=Thập Điện Vương Giả
生死簿的精气=Tinh khí từ Sổ Sinh Tử
崇阳派=Sùng Dương Phái
尊星派=Tôn Tinh Phái
凤鸣九霄=Phượng Minh Cửu Tiêu
冰清子=Băng Thanh Tử
双炎道宗=Song Viêm đạo tông
平原镇=Trấn Bình Nguyên
火凤真人=Hỏa Phượng chân nhân
明师弟=Minh sư đệ
盗家明三手=Đạo gia Minh Tam Thủ
北方道宗神霄派=Bắc Phương Đạo Tông Thần Tiêu Phái
天皇老子=Thiên Hoàng Lão Tử
神霄派冲雷子=Thần Tiêu Phái Xung Lôi Tử
雷签=Lôi thiêm
明涧秋=Minh Giản Thu
张冠=Trương Quan
北方本处真人=Bắc Phương Bản Xứ chân nhân
明三手=Minh Tam Thủ
阳鼎派=Dương Đỉnh Phái
五气朝元真人=Ngũ Khí Triều Nguyên Chân Nhân
新生朝廷=Tân Sinh Triều Đình
伪丹家之子=Ngụy Đan Gia Chi Tử
卢青真人=Lư Thanh Chân Nhân
兵家主公=Binh Gia chủ công
偃家之子=Yển Gia Chi Tử
八水山道场=Bát Thủy Sơn Đạo Tràng
晶石葫芦=Tinh Thạch Hồ Lô
贫家之子=Bần Gia Chi Tử
霜灵米=Sương Linh Mễ
右丘=Hữu Khâu
逝水关=Thệ Thủy Quan
兵家主=Binh Gia Chủ
释门之子圆通=Thích Môn Chi Tử Viên Thông
大乘圣僧=Đại Thừa Thánh Tăng
通天三足炉=Thông Thiên Tam Túc Lô
云鼎宗=Vân Đỉnh Tông
净世明焰=Tịnh Thế Minh Diễm
尔不复=Nhĩ Bất Phục
释门之子=Thích Môn Chi Tử
绿意老翁=Lục Ý Lão Ông
采风之子=Thải Phong chi tử
月明祖师=Nguyệt Minh Tổ Sư
龙虎炉=Long Hổ Lô
用家=Dụng gia
采风家=Thái Phong Gia
净道之子=Tịnh Đạo chi tử
腾蛇炉=Đằng Xà Lô
惊梦龙虎丹炉=Kinh Mộng Long Hổ Đan Lô
善恶两心炉=Thiện Ác Lưỡng Tâm Lô
十全炉=Thập Toàn Lô
八干山=Bát Can Sơn
殷绝世=Ân Tuyệt Thế
云销雨霁水帘帕=Vân Tiêu Vũ Tễ Thủy Liêm Mạt
七星锥=Thất Tinh Tr錐
隐名咒=Ẩn Danh Chú
荣辱不惊、去留无意=Vinh Nhục Bất Kinh, Khứ Lưu Vô Ý
北斗朝元真人=Bắc Đẩu Triều Nguyên Chân Nhân
纵横之术=Tung Hoành Chi Thuật
孤星坠=Cô Tinh Trụy
南北双子=Nam Bắc Song Tử
凌霄真人=Lăng Tiêu chân nhân
纯阳高徒=Thuần Dương cao đồ
遁天神剑=Độn Thiên Thần Kiếm
八水=Bát Thủy
周天星斗大挪移=Chu Thiên Tinh Đẩu Đại Na Di
蜀中剑派=Thục Trung Kiếm Phái
太虚垂钓术=Thái Hư Thùy Điếu Thuật
八水山洞天=Bát Thủy Sơn động thiên
真空朝元真人=Chân Không Triều Nguyên chân nhân
纯阳火=Thuần Dương hỏa
渔家太虚垂钓术=Ngư gia Thái Hư thùy điếu thuật
丹湘子=Đan Tương Tử
学派之子=Học phái chi tử
三十二金蟒=Tam Thập Nhị Kim Mãng
御兽真人=Ngự thú chân nhân
北方道子=Bắc Phương đạo tử
鹅老大=Nga lão đại
采风门人=Thải Phong môn nhân
狮驼鹅=Sư Đà Nga
白家大姐=Bạch Gia Đại Tỷ
名家堂=Danh Gia Đường
道子尘冲虚=Đạo Tử Trần Xung Hư
南北道子=Nam Bắc Đạo Tử
掌教松竹=Chưởng Giáo Tùng Trúc
地藏老和尚=Địa Tạng Lão Hòa Thượng
真空真人=Chân Không chân nhân
震神锤=Chấn Thần Chùy
五德真人=Ngũ Đức chân nhân
黄山道术=Hoàng Sơn Đạo Thuật
猪戒=Trư Giới
真空道人=Chân Không đạo nhân
诸界无空=Chư Giới Vô Không
北斗真人=Bắc Đẩu chân nhân
周天轮转=Chu Thiên Luân Chuyển
有无相生=Hữu Vô Tương Sinh
星辰陨光=Tinh Thần Vẫn Quang
五德朝元真人=Ngũ Đức Triều Nguyên chân nhân
渡江论道=Độ Giang luận đạo
纯阳道人=Thuần Dương đạo nhân
混洞镜=Hỗn Động kính
君臣圣僧=Quân Thần thánh tăng
神眼僧=Thần Nhãn tăng
万镜横空 无所遁藏=Vạn Kính Hoành Không Vô Sở Độn Tàng
九头大哥=Cửu Đầu đại ca
纯阳狂人=Thuần Dương Cuồng Nhân
八水真人=Bát Thủy Chân Nhân
文通明=Văn Thông Minh
诸天社=Chư Thiên Xã
龙象社=Long Tượng Xã
莲生社=Liên Sinh Xã
金刚社=Kim Cương Xã
千佛梵唱=Thiên Phật Phạm Xướng
觜火猴=Tủy Hỏa Hầu
水神巫支祈=Thủy Thần Vu Chi Kỳ
举父=Cử Phụ
长右=Trường Hữu
净道无明=Tịnh Đạo Vô Minh
梵教合欢=Phạn Giáo Hợp Hoan
白虎第七宿=Bạch Hổ Đệ Thất Túc
许判官=Hứa Phán Quan
生死谱=Sinh Tử Phổ
铁皮蛤蟆=Thiết Bì Cáp Mô
蛤蟆吞天术=Cáp Mô Thôn Thiên Thuật
古铜大鳄=Cổ Đồng Đại Ngạc
多臂人佛=Đa Tí Nhân Phật
千手无量=Thiên Thủ Vô Lượng
方便印=Phương Tiện Ấn
千手宝相=Thiên Thủ Bảo Tướng
邪魔辟易=Tà Ma Tịch Dịch
千江不流盏=Thiên Giang Bất Lưu Trản
风水之子=Phong Thủy Chi Tử
人间三家=Nhân Gian Tam Gia
护法明王=Hộ Pháp Minh Vương
三尊罗刹=Tam Tôn La Sát
定水神针=Định Thủy Thần Châm
巫支祈=Vu Chi Kỳ
火龙瓮=Hỏa Long Úng
归元戳=Quy Nguyên Xúc
寻芳炉=Tầm Phương Lô
河獾=Hà Hoan
熊虎豹=Hùng Hổ Báo
净道普照=Tịnh Đạo Phổ Chiếu
梵教并蒂双尊=Phạn Giáo Tịnh Đế Song Tôn
分水犀=Phân Thủy Tê
北方玄武七宿=Bắc Phương Huyền Vũ Thất Tú
南方朱雀七宿=Nam Phương Chu Tước Thất Tú
西方白虎七宿=Tây Phương Bạch Hổ Thất Tú
轸水蚓=Chẩn Thủy Dẫn
贝妖=Bối yêu
红莲烈火=Hồng Liên Liệt Hỏa
佛光如箭=Phật Quang Như Tiễn
祖庭山=Tổ Đình Sơn
佛道三宗=Phật Đạo Tam Tông
南北真人=Chân nhân Nam Bắc
南北两岸=Nam Bắc Lưỡng Ngạn
南方真人=Chân Nhân Phương Nam
普照圣僧=Phổ Chiếu Thánh Tăng
并蒂双尊=Tịnh Đế Song Tôn
纯阳种子=Thuần Dương Chủng Tử
天河之璧=Thiên Hà Chi Bích
方斗剑仙=Phương Đấu Kiếm Tiên
释子圆通=Thích Tử Viên Thông
碧眼狮子=Bích Nhãn Sư Tử
天帝候选=Thiên Đế Hậu Tuyển
本处真人=Bản Xử Chân Nhân
冶金家之子=Dã Kim Gia Chi Tử
凤血石=Phượng Huyết Thạch
无情灭度=Vô Tình Diệt Độ
凤凰真君=Phượng Hoàng Chân Quân
冲虚道子=Xung Hư Đạo Tử
净道=Tịnh Đạo
帝心小和尚=Tiểu hòa thượng Đế Tâm
百丈红鸾=Bách Trượng Hồng Loan
生辰铁=Sinh Thần Thiết
阴阳髓=Âm Dương Tủy
巫婆神汉=Vu Bà Thần Hán
珠毫剑=Châu Hào Kiếm
名剑篇=Danh Kiếm Thiên
蜀中三大仙剑=Thục Trung Tam Đại Tiên Kiếm
沧海剑=Thương Hải Kiếm
沧海珠=Thương Hải Châu
镇国剑仙方斗=Trấn Quốc Kiếm Tiên Phương Đấu
杜朝化=Đỗ Triều Hóa
斗姆三清=Đẩu Mẫu Tam Thanh
正统皇帝=Chính Thống Hoàng Đế
大白胖子=Đại Bạch Bàn Tử
正统帝=Chính Thống Đế
净子=Tịnh Tử
人皇稻=Nhân Hoàng Đạo
劝农司=Khuyến Nông Tư
迎客馆=Nghênh Khách Quán
神稻=Thần Đạo
南道子=Nam Đạo Tử
大希公=Đại Hy Công
蜀中贵女=Thục Trung Quý Nữ
泰山祭天台=Đài tế trời Thái Sơn
农子=Nông Tử
勾曲山剑仙方斗=Câu Khúc Sơn Kiếm Tiên Phương Đấu
军臣=Quân Thần
凌火阁=Lăng Hỏa Các
厨家=Trù Gia
冶兵家=Dã Binh Gia
南方道子=Nam Phương Đạo Tử
纵横子=Tông Hoành Tử
蜀中白帝剑仙=Thục Trung Bạch Đế Kiếm Tiên
王灵管=Vương Linh Quan
韦陀杵=Chử Vi Đà
关公战秦琼=Quan Công chiến Tần Quỳnh
贤劫诸佛=Hiền kiếp chư Phật
悲华经=Bi Hoa kinh
火部铠甲=Hỏa bộ khải giáp
四方战将=Tứ phương chiến tướng
百家教派=Bách Gia Giáo Phái
雷火斗=Lôi Hỏa Đấu
本初真人=Bản Sơ chân nhân
无漏钟=Vô Lậu Chung
提江真人=Đề Giang Chân Nhân
毒家之子=Độc Gia Chi Tử
商家之子=Thương Gia chi tử
命理家=Mệnh Lý Gia
阴阳家之子=Âm Dương Gia chi tử
苦行家=Khổ Hạnh Gia
行者杖=Hành Giả Trượng
盗家=Đạo Gia
盗家之子=Đạo Gia chi tử
容家=Dung Gia
命理家之子=Mệnh Lý Gia Chi Tử
乐家之子=Nhạc Gia Chi Tử
容家之子=Dung Gia chi Tử
窃影神通=Thiết Ảnh Thần Thông
吞天真气=Thôn Thiên Chân Khí
北山之巅=Bắc Sơn Chi Điên
青山公=Thanh Sơn Công
妙笔公=Diệu Bút Công
牧野战歌=Mục Dã Chiến Ca
青骑公=Thanh Kỵ Công
让骑=Nhượng Kỵ
南方道子丹融=Đạo Tử Đan Dung phương Nam
北方道子尘冲虚=Đạo Tử Trần Xung Hư phương Bắc
仙弈公=Tiên Dịch Công
陆地纵横=Lục Địa Tung Hoành
风水家之子=Phong thủy gia chi tử
纵横之子=Tung Hoành Chi Tử
书万象=Thư Vạn Tượng
太上真君=Thái Thượng Chân Quân
八水山=Bát Thủy Sơn
老火=Lão Hỏa
纵横家之子=Con trai của nhà Tung Hoành
渔家之子=Ngư Gia Chi Tử
厨家之子=Trù Gia Chi Tử
冶兵家之子=Dã Binh Gia Chi Tử
纯阳真人月明=Thuần Dương chân nhân Nguyệt Minh
蜀中仙剑=Thục Trung Tiên Kiếm
名教儒公=Danh Giáo Nho Công
医学家之子=Y học gia chi tử
苟曲山=Cẩu Khúc Sơn
金翅鹏=Kim Sí Bằng
军臣圣僧=Quân Thần Thánh Tăng
色空咖蓝=Sắc Không Già Lam
百子元神=Bách Tử Nguyên Thần
圣米=Thánh Mễ
星官神袍=Tinh Quan Thần Bào
十方世界=Thập Phương Thế Giới
黑白双子=Hắc Bạch Song Tử
昴宿=Mão Tú
卯日星君=Mão Nhật Tinh Quân
米斗空间=Mễ Đấu Không Gian
点星笔=Điểm Tinh Bút
功名榜=Công Danh Bảng
星轨册=Tinh Quỹ Sách
星官长袍=Tinh Quan Trường Bào
天将变=Thiên Tướng Biến
太阳真君=Thái Dương Chân Quân
日轮帝君=Nhật Luân Đế Quân
鉴家之子=Giám Gia chi tử
苦行家之子=Khổ Hành Gia chi tử
行天法杖=Hành Thiên Pháp Trượng
火部天章=Hỏa Bộ Thiên Chương
雷部正法=Lôi Bộ Chính Pháp
斗部神诀=Đấu Bộ Thần Quyết
天闲星=Thiên Nhàn Tinh
地暗星=Địa Ám Tinh
紫胡子仙人=Tử Hồ Tử Tiên Nhân
雷火斗瘟四部=Lôi Hỏa Đấu Ôn Tứ Bộ
地煞七十二=Địa Sát Thất Thập Nhị
地暴星=Địa Bạo Tinh
韦驮天=Vi Đà Thiên
蜀中三位剑仙=Thục Trung Tam Vị Kiếm Tiên
天罡地煞神将=Thiên Cương Địa Sát Thần Tướng
儒公=Nho Công
星宿神兽=Tinh Tú Thần Thú
南斗仙君=Nam Đẩu Tiên Quân
二乌门=Nhị Ô Môn
群贤圣庙=Quần Hiền Thánh Miếu
山主老爷=Sơn chủ Lão gia
女少主=Nữ Thiếu Chủ
拜祭学派=Bái Tế Học Phái
牧野公=Mục Dã Công
百家学派=Bách Gia Học Phái
补天长剑=Bổ Thiên Trường Kiếm
八九金罩=Bát Cửu Kim Tráo
昴宿星官=Mão Túc Tinh Quan
纯火镯子=Vòng tay Thuần Hỏa
丹家之子=Đan gia chi tử
大江之战=Đại Giang chi chiến
佛道菩萨=Phật Đạo Bồ Tát
巫家之子=Vu gia chi tử
玉龙配=Ngọc Long Phối
瘟部神通=Ôn Bộ Thần Thông
鲸袄=Kình Ảo
阴阳双子=Âm Dương song tử
水火星君=Thủy Hỏa tinh quân
鲸袄真人=Kình Áo Chân Nhân
北斗神将=Bắc Đẩu Thần Tướng
佛子圆通=Phật Tử Viên Thông
道子丹融=Đạo Tử Đan Dung
剑仙方斗=Kiếm Tiên Phương Đấu
百丈真人=Bách Trượng chân nhân
秋收大祭=Thu Thu Đại Tế
少年皇帝=Thiếu Niên Hoàng Đế
巡边大臣=Tuần Biên Đại Thần
莫独玉=Mạc Độc Ngọc
山蓍=San Thi
山蓍真人=Sơn Thi chân nhân
女主岛=Nữ Chủ Đảo
慕容露娜=Mộ Dung Lộ Na
方小友=Phương tiểu hữu
短发真人=Đoản Phát Chân Nhân
佩玉真人=Bội Ngọc chân nhân
元磁神光旗=Nguyên từ thần quang kỳ
红铜针=Hồng đồng châm
元磁神光针=Nguyên từ thần quang châm
许斗=Hứa Đấu
血咒玉简=Huyết chú ngọc giản
轮回转生盘=Luân hồi chuyển sinh bàn
方老剑仙=Phương lão kiếm tiên
黄吻岛=Hoàng Vẫn Đảo
左岭=Tả Lĩnh
巢海三雄=Sào Hải Tam Hùng
皇岛国=Hoàng Đảo Quốc
慕容罗娜=Mộ Dung La Na
旋灵岛主=Toàn Linh đảo chủ
销金锉=Tiêu Kim Thoa
二凶=Nhị Hung
三凶=Tam Hung
星官变=Tinh Quan Biến
祖骸=Tổ Hài
至凶鬼面=Chí hung quỷ diện
巢海=Sào Hải
唐鸡可得=Đường Kê Khả Đắc
旋灵岛=Toàn Linh Đảo
肖千帆=Tiêu Thiên Phàm
奇舟道友=Kỳ Chu đạo hữu
主瓶=Chủ Bình
七恶天王=Thất Ác Thiên Vương
唐姓真人=Đường Tính chân nhân
唐姓少年真人=Đường Tính Thiếu Niên Chân Nhân
归光岛主=Quy Quang đảo chủ
乾贝道友=Càn Bối đạo hữu
五路烽烟=Ngũ Lộ Phong Yên
奇舟道人=Kỳ Chu Đạo Nhân
黑瓜老怪=Hắc Qua lão quái
奇月真人=Kỳ Nguyệt chân nhân
古海之地=Cổ Hải Chi Địa
光阴贝=Quang Âm Bối
丑恶天王=Xú Ác Thiên Vương
凶恶天王=Hung Ác Thiên Vương
扶桑爪牙=Phù Tang Trảo Nha
谈兄=Đàm huynh
五恶天王=Ngũ Ác Thiên Vương
天残毒忍=Thiên Tàn Độc Nhẫn
恶天王=Ác Thiên Vương
黄花真人=Hoàng Hoa chân nhân
宝瓶真人=Bảo Bình chân nhân
草舟=Thảo Chu
黑爪邪党=Hắc Trảo tà đảng
海遁=Hải Độn
五鬼宗=Ngũ Quỷ Tông
奇舟=Kỳ Chu
乾贝=Càn Bối
黑爪老怪=Hắc Trảo Lão Quái
地皇阎君=Địa Hoàng Diêm Quân
黄华真人=Hoàng Hoa Chân Nhân
星岛国=Tinh Đảo Quốc
万海盟=Vạn Hải Minh
陆地剑仙=Lục Địa Kiếm Tiên
巢海三凶=Sào Hải Tam Hung
丧魂客=Tang Hồn Khách
兵家之子=Binh Gia Chi Tử
左岭真人=Tả Lĩnh Chân Nhân
女主国=Nữ Chủ Quốc
天瓶岛=Đảo Thiên Bình
东南道主=Đạo chủ Đông Nam
劫主令=Kiếp Chủ Lệnh
方仙剑=Phương Tiên Kiếm
功德寻芳炉=Công Đức Tầm Phương Lô
通天宝扇=Thông Thiên Bảo Phiến
兵主旗=Binh Chủ Kỳ
扶桑秀士=Phù Tang Tú Sĩ
问心剑路=Vấn Tâm Kiếm Lộ
不断桑=Bất Đoạn Tang
太虚神戟=Thái Hư Thần Kích
不休桑=Bất Hưu Tang
卢起=Lư Khởi
乾贝真人=Càn Bối chân nhân
岳尊=Nhạc Tôn
奇舟真人=Kỳ Chu chân nhân
百家天子=Bách Gia Thiên Tử
神目天君=Thần Mục Thiên Quân
代天选帝=Đại Thiên Tuyển Đế
捧日仙君=Bổng Nhật Tiên Quân
博学圣僧=Bác Học Thánh Tăng
显三家=Hiển Tam Gia
名教之子=Danh Giáo chi Tử
龙战于野，其血玄黄=Long chiến vu dã, kỳ huyết huyền hoàng
梦中龙战于野=Mộng Trung Long Chiến Ư Vuã
北斗星将=Bắc Đẩu Tinh Tướng
声闻天=Thanh Văn Thiên
善财天=Thiện Tài Thiên
兵子=Binh Tử
杜山恩=Đỗ Sơn Ân
儒子=Nho Tử
医子=Y Tử
二十四诸天=Nhị Thập Tứ Chư Thiên
散瘟天尊=Tán Ôn Thiên Tôn
帝储=Đế Trữ
方王京=Phương Vương Kinh
尘冲虚=Trần Xung Hư
智慧神象=Trí tuệ thần tượng
荆棘公=Kinh Cức Công
游侠之子=Du Hiệp Chi Tử
求剑叟=Cầu Kiếm Tẩu
文武双星=Văn Võ Song Tinh
一百零八天罡地煞=Nhất Bách Linh Bát Thiên Cương Địa Sát
四正谛=Tứ Chính Đế
珈蓝菩萨=Già Lam Bồ Tát
五德星君=Ngũ Đức Tinh Quân
名家之子=Danh Gia Chi Tử
休天赐=Hưu Thiên Tứ
英招山=Anh Chiêu Sơn
月明真人=Nguyệt Minh chân nhân
