Rebellion=Rebellion
ixa=ixa
kiva=kiva
一到五=một đến năm
一到五号=số một đến năm
一号外挂=số 1 hack
一百斤=năm mươi cân
一辉=Nhất Huy¦Ikki
三号=số 3
三首龙=Tam Thủ Long¦rồng ba đầu
三首龙王=Tam Thủ Long Vương
东界王神=Đông Kaioshin
书文=thư văn
了空中=không trung
二号=số 2
五号外挂=số 5 hack
什么东西绊了下=cái gì đó vấp ngã
六号外挂=số 6 hack
千手老鬼=Senju Lão quỷ
古尔多=Cổ Nhĩ Đa
台阶上=bậc thang bên trên
名明=tên Minh
四号外挂=số 4 hack
基多拉=Ghidorah
声音速度=thanh âm tốc độ
大宣=Đại Tuyên
奈良一族=tộc Nara
女人嘴角=nữ nhân khoé miệng
女人大喜=nữ nhân vui mừng
孙悟饭=Son Gohan
学会了空翻=học xong lộn mèo
富岳大人=Fugaku đại nhân
小宦官=tiểu hoạn quan
小溪上游=dòng suối nhỏ thượng du
山中一族= tộc Yamanaka
巴比迪=Babidi
张九阳=Trương Cửu Dương
抖动了=run run¦đẩu động¦run rẩy
抖动了下=lắc xuống
斧兄=Phủ huynh
春日野一辉=Kasugano Ikki
有多特殊=có bao nhiêu đặc thù
有求必应屋=Hữu Cầu Tất Ứng Phòng
桔梗=Kikyou
玄冥龟=Huyền Minh Quy
申时=giờ Thân
苍桐镇=Thương Đồng trấn
菊次郎的夏天=Mùa hè của Kikujiro
被外挂=bị hack
金角银角=Kim Giác Ngân Giác¦Kinkaku Ginkaku
陈平安=Trần Bình An
陶弘景=Đào Hoằng Cảnh
飞雷神印记=Phi Lôi Thần Ấn Ký
鲁耀兴=Lỗ Diệu Hưng
鹤大宗师=Hạc Đại Tông Sư