虹蓝七侠传=Hồng Lam Thất Hiệp Truyện
华南虎=Hoa Nam Hổ
快螳螂=Khoái Đường Lang
熊猫=Gấu trúc
老七剑=Lão Thất Kiếm
杨戬=Dương Tiễn
俏小龙=Tiếu Tiểu Long
熊猫阿宝=Gấu trúc A Bảo
仙鹤=Tiên Hạc
神龙秘籍=Thần Long Bí Kíp
神龙卷轴=Thần Long Quyển Trục
盖世五侠=Ngũ Hiệp Cái Thế
阿宝=A Bảo
金猴=Kim Hầu
神龙大侠=Thần Long Đại Hiệp
和平谷=Thung lũng Hòa Bình
大龙=Đại Long
翡翠之刃=Phỉ Thúy Chi Nhận
白鹤亮翅=Bạch Hạc Lượng Sí
浣熊大师=Sư phụ Gấu Mèo
刺猬大师=Sư phụ Nhím
翡翠僵尸=Cương thi Ngọc Bích
乌龟大师=Sư phụ Rùa
翡翠宫=Cung điện Ngọc Bích
悍娇虎=Hãn Kiều Hổ
天魔之刃=Thiên Ma Chi Nhận
金蛇剑法=Kim Xà Kiếm Pháp
紫云真气=Tử Vân Chân Khí
黑鹰传书=Hắc Ưng Truyền Thư
神仙迷心丸=Thần Tiên Mê Tâm Hoàn
功夫熊猫=Kung Fu Panda
功夫=Kung Fu
鳄鱼帮=Băng Cá Sấu
二当家=Nhị đương gia
狮吼功=Sư Hống Công
太极拳=Thái Cực Quyền
师爷=Sư Gia
杨过=Dương Quá
小龙女=Tiểu Long Nữ
虹蓝世界=Hồng Lam Thế Giới
功夫熊猫世界=Thế giới Kungfu Panda
酱爆=Tương Bạo
斧头帮=Phủ Đầu Bang
裁缝=Thợ May
苦力强=Khổ Lực Cường
油炸鬼=Du Tạc Quỷ
猪笼城寨=Trư Lung Thành Trại
神雕侠侣=Thần Điêu Hiệp Lữ
琛哥=Sầm Ca
天煞=Thiên Sát
东方神乞=Đông Phương Thần Khất
天魔乱舞神功=Thiên Ma Loạn Vũ Thần Công
上海滩=Bến Thượng Hải
包租公=Bao Thu Công
包租婆=Bao Thu Bà
阿琛=A Sâm
肥仔聪=Phì Tử Thông
火云邪神=Hỏa Vân Tà Thần
金钟罩=Kim Chung Tráo
金顶佛灯=Kim Đỉnh Phật Đăng
楚狂人=Sở Cuồng Nhân
九阳神功=Cửu Dương Thần Công
魔教教主=Ma Giáo Giáo Chủ
降龙神丐=Hàng Long Thần Cái
天香公主=Thiên Hương Công Chúa
达摩洞=Đạt Ma Động
降龙十八掌=Hàng Long Thập Bát Chưởng
丐帮=Cái Bang
武当=Võ Đang
阿星=A Tinh
黑虎帮=Hắc Hổ Bang
吸星大法=Hấp Tinh Đại Pháp
火舞旋风=Hỏa Vũ Toàn Phong
九阳大霹雳=Cửu Dương Đại Phích Lịch
金书=Kim Thư
天魔大霹雳=Thiên Ma Đại Phích Lịch
天魔大化=Thiên Ma Đại Hóa
如来神掌=Như Lai Thần Chưởng
大黑虎佛=Đại Hắc Hổ Phật
金鞭溪=Kim Tiên Khê
雨花剑主=Vũ Hoa Kiếm Chủ
奔雷剑主=Bôn Lôi Kiếm Chủ
旋风剑主=Toàn Phong Kiếm Chủ
十里画廊=Thập Lí Họa Lang
紫云剑主莎丽=Tử Vân Kiếm Chủ Sally
狂刀怒剑=Cuồng Đao Nộ Kiếm
雅典娜一号=Athena 1
哈维拉塞尔=Harvey Russell
鳄鱼利兹=Cá sấu Liz
灰狼拉夫尔=Sói xám Laffer
猩猩乔治=Tinh tinh George
马克48重型线导鱼雷=Ngư lôi dẫn đường hạng nặng Mark 48
格拉斯中校=Trung tá Glass
利兹=Lợi Tư
乔治=Kiều Trị
雷电交加=Lôi Điện Giao Gia
虹蓝=Hồng Lam
雪山派=Tuyết Sơn Phái
天门观想法=Thiên Môn Quan Tưởng Pháp
黑虎大佛=Hắc Hổ Đại Phật
快活林酒坊=Khoái Hoạt Lâm Tửu Phường
黑无情=Hắc Vô Tình
霜之哀伤=Sương Chi Ai Thương
战狼军团=Chiến Lang Quân Đoàn
天魔乱舞大法=Thiên Ma Loạn Vũ Đại Pháp
蝙蝠战团=Biên Bức Chiến Đoàn
破空术=Phá Không Thuật
乾坤圈=Càn Khôn Quyển
射天狼=Xạ Thiên Lang
天魔乱舞=Thiên Ma Loạn Vũ
天魔三噬=Thiên Ma Tam Phệ
快活林=Khoái Hoạt Lâm
紫气东来=Tử Khí Đông Lai
青龙降魔=Thanh Long Hàng Ma
三娘=Tam Nương
雨花剑=Vũ Hoa Kiếm
孝义黑三郎=Hiếu Nghĩa Hắc Tam Lang
五侠=Ngũ hiệp
斩侠大会=Trảm Hiệp Đại Hội
青光剑主=Thanh Quang Kiếm Chủ
百草谷=Bách Thảo Cốc
护法=Hộ Pháp
青光剑=Thanh Quang Kiếm
奔雷剑=Bôn Lôi Kiếm
长虹=Trường Hồng
紫云=Tử Vân
旋风剑=Toàn Phong Kiếm
灵泉宝玉=Linh Tuyền Bảo Ngọc
黑心煞掌=Hắc Tâm Sát Chưởng
天魔真气=Thiên Ma Chân Khí
巨鳄=Cự Ngạc
天狼法杖=Thiên Lang Pháp Trượng
天狼神功=Thiên Lang Thần Công
天狼星=Thiên Lang Tinh
一阳神功=Nhất Dương Thần Công
七剑合璧=Thất Kiếm Hợp Bích
藤甲军团=Đằng Giáp Quân Đoàn
黑虎掏心=Hắc Hổ Đào Tâm
天狼峰=Thiên Lang Phong
天狼堂=Thiên Lang Đường
黑三郎=Hắc Tam Lang
枫叶大阵=Phong Diệp Đại Trận
紫云剑法=Tử Vân Kiếm Pháp
风云天诀=Phong Vân Thiên Quyết
狂雷天牢=Cuồng Lôi Thiên Lao
奔雷=Bôn Lôi
雨花=Vũ Hoa
青光=Thanh Quang
旋风=Toàn Phong
十三太保=Thập Tam Thái Bảo
枫叶武士=Phong Diệp võ sĩ
黑煞=Hắc Sát
白煞=Bạch Sát
母后=Mẫu Hậu
鼠族大祭司=Thử tộc Đại Tế Tư
天外飞仙=Thiên Ngoại Phi Tiên
女娲大神=Nữ Oa Đại Thần
地心之谷=Địa Tâm Chi Cốc
教主=Giáo Chủ
紫玉佩=Tử Ngọc Bội
蛤蟆神功=Cáp Mô Thần Công
大郎=Đại Lang
六阳魁首=Lục Dương Khôi Thủ
圣女=Thánh Nữ
左右护法=Tả Hữu Hộ Pháp
少林=Thiếu Lâm
独孤剑=Độc Cô Kiếm
元极摩柯无量=Nguyên Cực Ma Kha Vô Lượng
嵩山=Tung Sơn
风无相=Phong Vô Tướng
云无常=Vân Vô Thường
湖心小筑=Hồ Tâm Tiểu Trúc
三分归元气=Tam Phân Quy Nguyên Khí
天池十二杀手=Thiên Trì Thập Nhị Sát Thủ
回元血手=Hồi Nguyên Huyết Thủ
纸探花=Chỉ Thám Hoa
狗王=Cẩu Vương
戏宝=Hí Bảo
食为先=Thực Vi Tiên
童皇=Đồng Hoàng
风神腿=Phong Thần Thối
天霜拳=Thiên Sương Quyền
紫衣老大=Tử Y Lão Đại
天池十二煞=Thiên Trì Thập Nhị Sát
孔慈=Khổng Từ
霍步天=Hoắc Bộ Thiên
地极摩诃无量=Địa Cực Ma Kha Vô Lượng
瑞兽凤血=Thụy Thú Phượng Huyết
破日峰=Phá Nhật Phong
万载泪泉=Vạn Tải Lệ Tuyền
仓颉=Thương Hiệt
始皇=Thủy Hoàng
无道狂天=Vô Đạo Cuồng Thiên
泥菩萨=Nê Bồ Tát
摩诃=Ma Ha
文丑丑=Văn Sửu Sửu
云堂主=Vân đường chủ
金木水火土=Kim Mộc Thủy Hỏa Thổ
天邪战鉴=Thiên Tà Chiến Giám
小武=Tiểu Võ
麒麟血=Kỳ Lân Huyết
龙元=Long Nguyên
独孤一方=Độc Cô Nhất Phương
霜儿=Sương Nhi
天照大御神=Thiên Chiếu Đại Ngự Thần
雄霸=Hùng Bá
鬼叉罗=Quỷ Xoa La
十大气忍=Thập Đại Khí Nhẫn
金叉罗=Kim Xoa La
徐福=Từ Phúc
秦始皇=Tần Thủy Hoàng
蓬莱仙岛=Bồng Lai Tiên Đảo
秦皇=Tần Hoàng
五雷化极手=Ngũ Lôi Hóa Cực Thủ
圣心真气=Thánh Tâm Chân Khí
纵意登仙步=Túng Ý Đăng Tiên Bộ
邪血劫=Tà Huyết Kiếp
瑞兽精元=Thụy Thú Tinh Nguyên
北方冰原=Bắc Phương Băng Nguyên
寒冰面具=Hàn Băng Diện Cụ
圣心功=Thánh Tâm Công
五雷化极=Ngũ Lôi Hóa Cực
怒风雷=Nộ Phong Lôi
金灶沐=Kim Táo Mộc
独孤鸣=Độc Cô Minh
火麟剑=Hỏa Lân Kiếm
捕风捉影=Bộ Phong Tróc Ảnh
绝无神宫=Tuyệt Vô Thần Cung
绝天=Tuyệt Thiên
无双城=Vô Song Thành
四大金刚=Tứ Đại Kim Cương
火无定=Hỏa Vô Định
雷无向=Lôi Vô Hướng
大日紫气=Đại Nhật Tử Khí
东瀛紫气宗=Đông Doanh Tử Khí Tông
达摩=Đạt Ma
元极摩诃=Nguyên Cực Ma Ha
他生渡=Tha Sinh Độ
六大魔渡=Lục Đại Ma Độ
释武尊=Thích Võ Tôn
少林寺=Thiếu Lâm Tự
搜神宫=Sưu Thần Cung
皇宫=Hoàng Cung
无神绝宫=Vô Thần Tuyệt Cung
颜盈=Nhan Doanh
幽若=U Nhược
三分教场=Tam Phân Giáo Trường
凤求凰=Phượng Cầu Hoàng
扶我起来我还能继续战斗=Đỡ ta dậy ta vẫn còn có thể tiếp tục chiến đấu
喵绅士=Miêu thân sĩ
胜166=Thắng 166
不喜欢看书的我又来了=Tôi không thích đọc sách lại đến rồi
紫翼魔尊=Tử Dực Ma Tôn
闪闪爱=Lấp lánh yêu
啊尔何求=A Nhĩ Hà Cầu
詹琉璃=Chiêm Lưu Li
幽冥界八云易=U Minh Giới Bát Vân Dịch
凤兮凤兮归故乡=Phượng hề phượng hề quy cố hương
遨游四海求其凰=Ngao du tứ hải cầu kỳ hoàng
乐山=Lạc Sơn
神州=Thần Châu
剑圣=Kiếm Thánh
天剑无名=Thiên Kiếm Vô Danh
无极拈花指=Vô Cực Niêm Hoa Chỉ
姣罗刹=Giảo La Sát
铁梯神煞=Thiết Thê Thần Sát
碎天绝手=Toái Thiên Tuyệt Thủ
老天皇=Lão Thiên Hoàng
惊云=Kinh Vân
南麟剑首断帅=Nam Lân Kiếm Thủ Đoạn Soái
北饮狂刀聂人王=Bắc Ẩm Cuồng Đao Nhiếp Nhân Vương
龙脉=Long Mạch
乐山大佛=Lạc Sơn Đại Phật
排云掌=Bài Vân Chưởng
蚀日剑法=Thực Nhật Kiếm Pháp
轩辕黄帝=Hiên Viên Hoàng Đế
黄帝=Hoàng Đế
武家=Võ Gia
武慧=Võ Tuệ
血祖=Huyết Tổ
劫王=Kiếp Vương
天命=Thiên Mệnh
穹天之怒=Khung Thiên Chi Nộ
佛门=Phật Môn
贪狼剑=Tham Lang Kiếm
天刃刀=Thiên Nhận Đao
天山=Thiên Sơn
中原=Trung Nguyên
千秋大劫=Thiên Thu Đại Kiếp
僧皇=Tăng Hoàng
灭世魔身=Diệt Thế Ma Thân
天极摩诃=Thiên Cực Ma Kha
移天神诀=Di Thiên Thần Quyết
剑二十三=Kiếm Nhị Thập Tam
锐金剑气=Nhuệ Kim Kiếm Khí
唯识剑意=Duy Thức Kiếm Ý
七无绝境=Thất Vô Tuyệt Cảnh
岷江=Mân Giang
神行太保=Thần Hành Thái Bảo
步氏神族=Bộ Thị Thần Tộc
东瀛宣化号=Đông Doanh Tuyên Hóa Hiệu
六当家=Lục đương gia
七当家=Thất đương gia
步渊亭=Bộ Uyên Đình
神将=Thần Tướng
百晓狂生=Bách Hiểu Cuồng Sinh
笑傲世=Tiếu Ngạo Thế
剑山=Kiếm Sơn
剑宗=Kiếm Tông
剑慧=Kiếm Tuệ
破军=Phá Quân
莫名剑法=Mạc Danh Kiếm Pháp
一剑成名=Nhất Kiếm Thành Danh
莫名其妙=Mạc Danh Kỳ Diệu
名动一时=Danh Động Nhất Thời
悲痛莫名=Bi Đau Mạc Danh
无上剑道=Vô Thượng Kiếm Đạo
无形道=Vô Hình Đạo
拳道神=Quyền Đạo Thần
断帅=Đoạn Soái
聂人王=Nhiếp Nhân Vương
白露=Bạch Lộ
黑寒=Hắc Hàn
冰魄=Băng Phách
断桥=Đoạn Kiều
绝无神=Tuyệt Vô Thần
西湖=Tây Hồ
雷峰塔=Tháp Lôi Phong
于楚楚=Vu Sở Sở
麒麟臂=Kỳ Lân Tý
傲天=Ngạo Thiên
傲夫人=Ngạo Phu Nhân
剑魔=Kiếm Ma
温驽=Ôn Nô
冷胭=Lãnh Yên
剑池=Kiếm Trì
武无二=Võ Vô Nhị
云顶天=Vân Đỉnh Thiên
五行领域=Ngũ Hành Lĩnh Vực
剑蝎纵横行=Kiếm Hạt Túng Hoành Hành
剑蝎=Kiếm Hạt
魔统真道=Ma Thống Chân Đạo
四方魔渡行=Tứ Phương Ma Độ Hành
九空为一念，九空无界是意念的世界，在这里可以能外界之不能=Cửu Không Vi Nhất Niệm, Cửu Không Vô Giới Thị Ý Niệm Đích Thế Giới, Tại Giá Lý Khả Dĩ Năng Ngoại Giới Chi Bất Năng
十强武道=Thập Cường Võ Đạo
十方皆灭=Thập Phương Giai Diệt
剑扫乾坤=Kiếm Tảo Càn Khôn
天魔九噬=Thiên Ma Cửu Phệ
众生由我灭=Chúng Sinh Do Ngã Diệt
强极十道=Cường Cực Thập Đạo
玄冰护体=Huyền Băng Hộ Thể
心剑=Tâm Kiếm
大黑暗天法象=Đại Hắc Ám Thiên Pháp Tượng
剑晨=Kiếm Thần
玄阴十二剑=Huyền Âm Thập Nhị Kiếm
乾坤任我行=Càn Khôn Nhậm Ngã Hành
玄阴剑甲=Huyền Âm Kiếm Giáp
铸剑池=Chú Kiếm Trì
明台桥=Minh Đài Kiều
隼人天隐=Thổn Nhân Thiên Ẩn
万道森罗=Vạn Đạo Sâm La
四大皆凶=Tứ Đại Giai Hung
混天四绝=Hỗn Thiên Tứ Tuyệt
拜月=Bái Nguyệt
蛰雷拳势=Triết Lôi Quyền Thế
四大瑞兽=Tứ Đại Thụy Thú
龙龟=Long Quy
惊瑞之期=Kinh Thụy Chi Kỳ
天门=Thiên Môn
拜剑山庄=Bái Kiếm Sơn Trang
小龙夺金刀=Tiểu Long Đoạt Kim Đao
败亡之剑=Bại Vong Chi Kiếm
雪饮狂刀=Tuyết Ẩm Cuồng Đao
绝世好剑=Tuyệt Thế Hảo Kiếm
神石=Thần Thạch
大邪王=Đại Tà Vương
始皇剑=Thủy Hoàng Kiếm
天魔双刃=Thiên Ma Song Nhận
铁心岛=Thiết Tâm Đảo
水神岛=Thủy Thần Đảo
水神王=Thủy Thần Vương
火麒麟=Hỏa Kỳ Lân
慕应雄=Mộ Ứng Hùng
冰皇=Băng Hoàng
神龙=Thần Long
宣化号=Tuyên Hóa Hiệu
长生不死之神=Trường Sinh Bất Tử Chi Thần
神武纪=Thần Võ Kỷ
凤血=Phượng Huyết
浑天四绝=Hỗn Thiên Tứ Tuyệt
地极摩诃=Địa Cực Ma Kha
无名=Vô Danh
英雄剑=Anh Hùng Kiếm
摩柯无量=Ma Kha Vô Lượng
傲剑山庄=Ngạo Kiếm Sơn Trang
断浪=Đoạn Lãng
绝心=Tuyệt Tâm
步惊云=Bộ Kinh Vân
钟眉=Chung Mi
歩渊亭=Bộ Uyên Đình
铁神=Thiết Thần
笑三笑=Tiếu Tam Tiếu
神龙岛=Thần Long Đảo
玄阴剑晨=Huyền Âm Kiếm Thần
魔魁=Ma Khôi
剑岳=Kiếm Nhạc
大魔神=Đại Ma Thần
武无敌=Võ Vô Địch
神舞=Thần Vũ
天魔六欲五行破灭大混洞妙法=Thiên Ma Lục Dục Ngũ Hành Phá Diệt Đại Hỗn Động Diệu Pháp
陆惊天=Lục Kinh Thiên
天下会=Thiên Hạ Hội
天下第一楼=Thiên Hạ Đệ Nhất Lâu
秦霜=Tần Sương
聂风=Nhiếp Phong
麒麟套装=Kỳ Lân Sáo Trang
凌云窟=Lăng Vân Quật
天哭经=Thiên Khốc Kinh
黑暗之门=Hắc Ám Chi Môn
元天剑诀=Nguyên Thiên Kiếm Quyết
九空无界=Cửu Không Vô Giới
剑界=Kiếm Giới
万剑归宗=Vạn Kiếm Quy Tông
黑白双煞=Hắc Bạch Song Sát
鳄魔兵团=Ngạc Ma Binh Đoàn
小虎=Tiểu Hổ
黑虎洞=Hắc Hổ Động
鼠后=Thử Hậu
大祭司=Đại Tế Tư
白鼠谷=Bạch Thử Cốc
盘古开天斧=Bàn Cổ Khai Thiên Phủ
盘古开天阵=Bàn Cổ Khai Thiên Trận
五行晶石=Ngũ Hành Tinh Thạch
千年老树妖=Thiên Niên Lão Thụ Yêu
蜈蚣精=Ngô Công Tinh
白蛇=Bạch Xà
白蛇缘起=Bạch Xà Duyên Khởi
许仙=Hứa Tiên
右国师府=Hữu Quốc Sư phủ
太阴宗=Thái Âm Tông
杀生石=Sát Sinh Thạch
玉龙阴狐和合功=Ngọc Long Âm Hồ Hòa Hợp Công
五通邪神=Ngũ Thông Tà Thần
五通镇=Ngũ Thông trấn
五通神=Ngũ Thông Thần
五通庙=Ngũ Thông miếu
山君庙=Sơn Quân miếu
郭北县=Quách Bắc huyện
黑山君=Hắc Sơn Quân
姜太公=Khương Thái Công
黑山镇=Hắc Sơn Trấn
山君=Sơn Quân
白夫人=Bạch phu nhân
拿山君庙=Ná Sơn Quân Miếu
郭北镇=Quách Bắc Trấn
树妖姥姥=Thụ Yêu Lão Lão
南无阿弥陀佛=Nam Mô A Di Đà Phật
法海=Pháp Hải
僵尸王=Cương Thi Vương
金轮法王=Kim Luân Pháp Vương
千年僵尸王=Thiên Niên Cương Thi Vương
金蜈火毒=Kim Ngô Hỏa Độc
鬼王九尾狐=Quỷ Vương Cửu Vĩ Hồ
太阴玄冰阵=Thái Âm Huyền Băng Trận
太阴门=Thái Âm Môn
兰若寺=Lan Nhược Tự
阴阳法王=Âm Dương Pháp Vương
千年尸魔=Thiên Niên Thi Ma
宝青坊主=Bảo Thanh Phường Chủ
太阴上人=Thái Âm Thượng Nhân
蛇母=Xà Mẫu
国师=Quốc sư
宝青坊=Bảo Thanh Phường
大乾王朝=Đại Càn Vương Triều
文皇帝=Văn Hoàng Đế
乾皇=Càn Hoàng
大乾=Đại Càn
玄阴=Huyền Âm
钦天监=Khâm Thiên Giám
太史令=Thái Sử Lệnh
太冲=Thái Xung
五行先天功=Ngũ Hành Tiên Thiên Công
涂山=Đồ Sơn
杜牧=Đỗ Mục
韩偓=Hàn Ác
乾国=Càn Quốc
黑山=Hắc Sơn
枉死城=Uổng Tử Thành
聂小倩=Nhiếp Tiểu Thiện
昆仑派=Côn Lôn phái
赤炎火龙阵=Xích Diễm Hỏa Long Trận
峨眉派=Nga Mi phái
左千户=Tả Thiên Hộ
燕赤霞=Yến Xích Hà
知秋一叶=Tri Thu Nhất Diệp
麒麟甲=Kỳ Lân Giáp
梓诉=Tử Tố
天悬白练=Thiên Huyền Bạch Luyện
达达=Đạt Đạt
达夫人=Đạt phu nhân
小鹿=Tiểu Lộc
大黑暗天=Đại Hắc Ám Thiên
聚元宝鼎=Tụ Nguyên Bảo Đỉnh
养心殿=Dưỡng Tâm Điện
鼠族=Thử Tộc
雪岛=Tuyết Đảo
水牢=Thủy Lao
地牢=Địa Lao
蛤蟆功=Cáp Mô Công
四神兽=Tứ Thần Thú
冰魄剑=Băng Phách Kiếm
七剑=Thất Kiếm
蛟龙=Giao Long
龙魂=Long Hồn
凤舞天际=Phượng Vũ Thiên Tế
紫兔=Tử Thỏ
邪蛟=Tà Giao
雪晶珠=Tuyết Tinh Châu
月魔族=Nguyệt Ma Tộc
雪琪儿=Tuyết Kỳ Nhi
玉兔仙子=Ngọc Thố Tiên Tử
钱江大坝=Tiền Giang Đại Bá
灵山渡=Linh Sơn Độ
灵山引=Linh Sơn Dẫn
灵山掌=Linh Sơn Chưởng
灵山门主=Linh Sơn môn chủ
黑龙剑=Hắc Long Kiếm
雪山族=Tuyết Sơn Tộc
莫仇=Mạc Cừu
凌云十八骑=Lăng Vân Thập Bát Kỵ
火山族=Hỏa Sơn Tộc
天目山=Thiên Mục Sơn
莫将=Mạc Tương
火云=Hỏa Vân
魔主=Ma Chủ
怒剑=Nộ Kiếm
狂刀=Cuồng Đao
白梨=Bạch Lê
阿木=A Mộc
怒剑狂刀=Nộ Kiếm Cuồng Đao
雪舍利=Tuyết Xá Lợi
雪岛上人=Tuyết Đảo Thượng Nhân
白猫=Bạch Miêu
帝释天=Đế Thích Thiên
大当家=Đại Đương Gia
七侠虹猫=Thất Hiệp Hồng Miêu
科目三=Khoa mục 3
莎丽=Sa Lệ
马三娘=Mã Tam Nương
紫云剑=Tử Vân Kiếm
二郎=Nhị Lang
金鞭溪客栈=Kim Tiên Khê Khách Sạn
长虹剑=Trường Hồng Kiếm
紫云剑主=Tử Vân Kiếm Chủ
六嫂=Lục Tẩu
小镜子=Tiểu Kính Tử
灵儿=Linh Nhi
风云世界=Thế giới Phong Vân
倩女幽魂世界=Thế giới Thiện Nữ U Hồn
逗逗=Đậu Đậu
诸世纪=Các thế kỷ
八大恶魔=Bát Đại Ác Ma
八大魔气=Bát Đại Ma Khí
八大不死神明=Bát Đại Bất Tử Thần Minh
十二生肖动物=Thập Nhị Sinh Tiếu Động Vật
十二符咒=Thập Nhị Phù Chú
圣主符咒=Thánh Chủ Phù Chú
八大恶魔篇=Bát Đại Ác Ma Thiên
十二生肖动物篇=Thập Nhị Sinh Tiếu Động Vật Thiên
鬼影军团篇=Quỷ Ảnh Quân Đoàn Thiên
八大魔气篇=Bát Đại Ma Khí Thiên
布莱克警长=Cảnh trưởng Blake
黑影王国=Vương quốc Bóng tối
潘库=Phan Khố
大自然灵心=Đại Tự Nhiên Linh Tâm
港岛=Cảng Đảo
尼嘉将军=Tướng quân Ni Gia
恶龙=Ác Long
洛佩=Lạc Bội
林氏王朝=Lâm Thị vương triều
恐怖大王=Khủng Bố Đại Vương
张果老=Trương Quả Lão
铁拐李=Thiết Quải Lý
韩湘子=Hàn Tương Tử
汉钟离=Hán Chung Ly
曹国舅=Tào Quốc Cữu
何仙姑=Hà Tiên Cô
拉里=Lạp Lí
山之恶魔波刚=Ác ma núi Bagan
东瀛四岛=Bốn đảo Đông Doanh
蝰蛇武装直升机=Trực thăng vũ trang Viper
M4尾翼稳定贫铀穿甲弹=Đạn xuyên giáp ổn định cánh đuôi M4 bằng uranium nghèo
帝国恶魔攻略计划=Kế hoạch chinh phục ác ma đế quốc
巨山相扑超魔兽=Quái thú Sumo Siêu Ma Núi Lớn
埃菲尔铁塔=Tháp Eiffel
白气=Bạch Khí
大力神发射井=Giếng phóng Đại Lực Thần
睡熊猛醒=Thụy Hùng Mãnh Tỉnh
小鱼水中游=Tiểu Ngư Thủy Trung Du
首相=Thủ tướng
黑山神拳=Hắc Sơn Thần Quyền
黑山老妖=Hắc Sơn Lão Yêu
血月=Huyết Nguyệt
周瑟=Chu Sắt
塔拉=Tháp Lạp
鬼影兵团=Quỷ Ảnh Binh Đoàn
东京湾=Vịnh Tokyo
雷电恶魔中苏=Lôi Điện Ác Ma Trung Tô
亚洲=Châu Á
欧洲=Châu Âu
非洲=Châu Phi
美洲=Châu Mỹ
吕洞宾=Lã Động Tân
布莱克=Bố Lại Khắc
帕克=Mạt Khắc
橄榄之国弗朗机=Nước Olive Phlang Cơ
潘普洛纳古城=Cổ thành Pamplona
蓝采和=Lam Thái Hoà
坤卦=Quẻ Khôn
月之恶魔=Ác ma mặt trăng
水之恶魔=Ác ma nước
雷电恶魔=Ác ma sấm sét
风之恶魔=Ác ma gió
五色神光=Ngũ Sắc Thần Quang
魔刀=Ma Đao
黑气=Hắc Khí
腐国=Phủ Quốc
袋鼠=Chuột túi
鸵鸟=Đà điểu
亚拉伦拉府=Government House
澳国总统=Tổng thống Úc
米国总统=Tổng thống Mỹ
牛战士=Ngưu Chiến Sĩ
乌鲁鲁巨岩=Uluru Cự Nham
黑手帮=Hắc Thủ Bang
旧金山=Cựu Kim Sơn
虎头佛母森多玛=Hổ Đầu Phật Mẫu Sâm Đa Mã
东瀛=Đông Doanh
方大法师=Phương Đại Pháp Sư
神明战甲=Thần minh chiến giáp
欧若拉之眼=Đôi mắt của Aurora
路长官=Lộ trưởng quan
小蛇=Tiểu Xà
龙小组=Long Tiểu Tổ
冲绳色=Màu Okinawa
加州金色=Màu vàng California
暗夜精灵=Tinh linh bóng đêm
伊卡将军=Tướng quân Yka
潘库宝盒=Hộp Bàn Khố
波士顿芬威球场=Sân vận động Fenway Park Boston
芬威球场=Sân vận động Fenway
月球=Mặt Trăng
空谷罪犯感化院=Trại cải huấn tội phạm Thung lũng Không
罗马斗兽场=Đấu trường La Mã
波刚=Ba Cương
地魁=Địa Khôi
瓦龙=Ngõa Long
拉苏=Lạp Tô
西木=Tây Mộc
芭莎=Ba Toa
中苏=Trung Tô
啸风=Khiếu Phong
咒蓝=Chú Lam
十三区=Khu 13
米国=Nước Mỹ
龙叔=Long Thúc
恶魔小龙=Ác Ma Tiểu Long
金门大桥=Cầu Cổng Vàng
阿奋=A Phấn
阿福=A Phủ
圣主=Thánh Chủ
小龙=Tiểu Long
老山羊=Lão Sơn Dương
刀龙=Đao Long
特鲁妈妈=Mẹ Tulu
圣斗士=Thánh Đấu Sĩ
埃尔斯巨岩=Tảng đá khổng lồ Els
岁月史书=Sử Thư Tuế Nguyệt
老爹=Lão cha
特鲁=Trư Lỗ
成龙=Thành Long
成龙历险记】=Những cuộc phiêu lưu của Thành Long
八仙=Bát Tiên
黑暗空间=Không gian Hắc Ám
鬼影王国=Quỷ Ảnh Vương Quốc
迷魂台=Mê Hồn Đài
凤凰大典=Phượng Hoàng Đại Điển
灵山=Linh Sơn
鬼影军团=Quỷ Ảnh Quân Đoàn
天音门=Thiên Âm Môn
天音宫=Thiên Âm Cung
钱江=Tiền Giang
天音老人=Thiên Âm lão nhân
天音谷=Thiên Âm Cốc
凤凰=Phượng Hoàng
金忍者=Kim Ninja
土忍者=Thổ Ninja
红烧牛肉面=Mì bò kho tàu
鬼影忍者=Quỷ Ảnh Ninja
战狼=Chiến Lang
鳄魔=Ngạc Ma
黑鹰=Hắc Ưng
五行忍者=Ngũ Hành Nhẫn Giả
普渡慈航=Phổ Độ Từ Hàng
龙角=Long Giác
五行元气=Ngũ Hành Nguyên Khí
巨魔兵=Cự Ma Binh
巨魔团=Cự Ma Đoàn
鬼影巨魔=Quỷ Ảnh Cự Ma
刺刃团=Thứ Nhận Đoàn
黑风=Hắc Phong
黑雨=Hắc Vũ
灵山门=Linh Sơn Môn
天命圣教=Thiên Mệnh Thánh Giáo
玉蟾宫=Ngọc Thiềm Cung
天音寺=Thiên Âm Tự
黑龙=Hắc Long
怪兽行星=Hành tinh quái vật
妖星格拉斯=Yêu tinh Grass
小哥斯拉=Tiểu Godzilla
大哥斯拉=Đại Godzilla
小美人=Tiểu mỹ nhân
机械哥斯拉=Mecha Godzilla
虹猫蓝兔=Hong Mao Lan Tu
伏斯亚人=Người Exif
蓝星=Lam Tinh
火星=Hỏa Tinh
伏斯亚=Phục Tư Á
虹猫仗剑走天涯=Hồng Miêu Trượng Kiếm Tẩu Thiên Nhai
天狼门=Thiên Lang Môn
魔教=Ma Giáo
七侠=Thất Hiệp
血人=Huyết Nhân
猫女=Miêu Nữ
马克50战甲=Áo Giáp Mark 50
绿魔飞行器=Phi Thuyền Lục Ma
蜘蛛侠=Người Nhện
钢铁侠=Người Sắt
绿魔=Lục Ma
棕发女=Tóc Nâu Nữ
金发男=Tóc Vàng Nam
马克50=Mark 50
绿巨人=Người Khổng Lồ Xanh
X战警：第一战=X-Men: Thế Hệ Đầu Tiên
塞巴斯蒂安—肖=Sebastian Shaw
金狼百兽王=Kim Lang Bách Thú Vương
金镛=Kim Dung
铁鬃灰熊=Thiết Tông Hôi Hùng
马克50钢铁战甲=Áo giáp sắt Mark 50
三郎=Tam Lang
黑心虎=Hắc Tâm Hổ
摩诃无量=Ma Ha Vô Lượng
X战警=X Chiến Cảnh
万磁王=Vạn Từ Vương
塞巴斯蒂安肖=Sebastian Shaw
刀疤=Đao Ba
武大强=Võ Đại Cường
苍白=Thương Bạch
快乐星猫=Happy Star Cat
善恶平衡器=Thiện Ác Bình Hành Khí
十二星座战士=Thập Nhị Tinh Tọa chiến sĩ
天界法庭=Thiên Giới Pháp Đình
星座战士=Tinh Tọa Chiến Sĩ
天兵队长=Đội trưởng Thiên Binh
狗将军=Cẩu Tướng Quân
天神星乐园化计划=Kế hoạch Lạc Viên hóa Thiên Thần Tinh
十二星座装甲=Thập Nhị Cung Tinh Tọa Trang Giáp
天神星防护罩=Thiên Thần Tinh Phòng Hộ Tráo
大力猫=Đại Lực Miêu
天界判官=Thiên Giới Phán Quan
白羊虚影=Bạch Dương Hư Ảnh
星座装甲=Tinh Tọa Trang Giáp
白羊座=Bạch Dương Tọa
白羊武士=Bạch Dương Võ Sĩ
水瓶座=Thủy Bình Tọa
黑云巨人=Hắc Vân Cự Nhân
摩羯座=Ma Kết Tọa
磁力小丑=Từ Lực Tiểu Sửu
双鱼座=Song Ngư Tọa
双子座=Song Tử Tọa
双子飞碟=Song Tử Phi Điệp
金牛座=Kim Ngưu Tọa
金牛战车=Kim Ngưu Chiến Xa
天蝎座=Thiên Yết Tọa
霸王装甲=Bá Vương Trang Giáp
天秤座=Thiên Xứng Tọa
华丽贵族=Hoa Lệ Quý Tộc
巨蟹座=Cự Giải Tọa
神盾巨蟹=Thần Thuẫn Cự Giải
狮子座=Sư Tử Tọa
烈火狮王=Liệt Hỏa Sư Vương
射手座=Nhân Mã Tọa
巨人骑士=Cự Nhân Kỵ Sĩ
处女座=Xử Nữ Tọa
净化天使=Tịnh Hóa Thiên Sứ
太白老爹=Thái Bạch Lão Đệ
天使光环=Thiên Sứ Quang Hoàn
魔化天使=Ma Hóa Thiên Sứ
魔化大天神=Ma Hóa Đại Thiên Thần
小丹=Tiểu Đan
葫芦娃大战变形金刚=Hồ Lô Oa đại chiến Biến Hình Kim Cương
上单狗头=Đường trên Đầu Chó
闰土=Nhuận Thổ
大天神=Đại Thiên Thần
水瓶判官=Thủy Bình Phán Quan
双鱼判官=Song Ngư Phán Quan
深海幽灵=Thâm Hải U Linh
天使=Thiên Sứ
天秤判官=Thiên Xứng Phán Quan
摩羯判官=Ma Kết Phán Quan
白羊判官=Bạch Dương Phán Quan
星猫=Tinh Miêu
欧应万=Âu Ứng Vạn
黑魔王=Hắc Ma Vương
太平洋=Thái Bình Dương
大奔=Đại Bôn
虹猫=Hồng Miêu
雪晶夫人=Tuyết Tinh phu nhân
蓝兔=Lam Thỏ
雪儿=Tuyết Nhi
雪晶=Tuyết Tinh
太白=Thái Bạch
仙剑奇侠传=Tiên Kiếm Kỳ Hiệp Truyện
神族=Thần Tộc
梁武帝=Lương Vũ Đế
浮空岛=Phù Không Đảo
神将飞蓬=Thần Tướng Phi Bồng
北海幼儿园=Bắc Hải Nhà trẻ
唯清=Duy Thanh
仙风云体术=Tiên Phong Vân Thể Thuật
天剑=Thiên Kiếm
剑神=Kiếm Thần
七星剑=Thất Tinh Kiếm
摄天剑=Nhiếp Thiên Kiếm
风雷妖鸟=Phong Lôi Yêu Điểu
青龙=Thanh Long
白虎=Bạch Hổ
朱雀=Chu Tước
玄武=Huyền Vũ
姜国=Khương Quốc
天妖皇=Thiên Yêu Hoàng
南诏国=Nam Chiếu Quốc
白苗=Bạch Miêu
水灵珠=Thủy Linh Châu
创界山=Sáng Giới Sơn
天神殿=Thiên Thần Điện
灰太狼=Hôi Thái Lang
沙福林=Sa Phúc Lâm
牛爷爷=Ngưu Gia Gia
里蜀山=Lý Thục Sơn
红葵=Hồng Quỳ
蓝葵=Lam Quỳ
溪风=Khê Phong
天魔国=Thiên Ma Quốc
天魔城=Thiên Ma Thành
天帝伏羲=Thiên Đế Phục Hy
天魔=Thiên Ma
迦楼罗族=Gia Lâu La Tộc
夜叉族=Dạ Xoa Tộc
罗刹族=La Sát Tộc
修罗族=Tu La Tộc
龙众=Long Chúng
天魔女葵羽=Thiên Ma Nữ Quỳ Vũ
黑苗=Hắc Miêu
白苗族=Bạch Miêu Tộc
九幽魔界=Cửu U Ma Giới
专职消防员=Lính cứu hỏa chuyên trách
景菁=Cảnh Tinh
元气弹=Nguyên Khí Đạn
靳韵翠=Cận Vận Thúy
南天门=Nam Thiên Môn
祝炎=Chúc Viêm
四天玄男=Tứ Thiên Huyền Nữ
春滋泉=Xuân Tư Tuyền
照胆神剑=Chiếu Đảm Thần Kiếm
炎波血刃=Viêm Ba Huyết Nhận
盘螭神云枪=Bàn Si Thần Vân Thương
伏羲剑=Phục Hy Kiếm
天玄神刃=Thiên Huyền Thần Nhận
唯敬=Duy Kính
苗疆=Miêu Cương
女娲血玉=Nữ Oa Huyết Ngọc
麒麟=Kỳ Lân
女娲庙=Miếu Nữ Oa
圣姑=Thánh Cô
京城=Kinh Thành
唯识=Duy Thức
神界=Thần Giới
夕瑶玄女=Tịch Dao Huyền Nữ
虎魄=Hổ Phách
雷土灵珠=Lôi Thổ Linh Châu
太古魔兽=Thái Cổ Ma Thú
魔尊重楼=Ma Tôn Trọng Lâu
人间=Nhân Gian
伏羲=Phục Hy
建木=Kiến Mộc
春滋神泉=Xuân Tư Thần Tuyền
清微=Thanh Vi
魔剑=Ma Kiếm
永安当=Vĩnh An Đương
唐家堡=Đường Gia Bảo
蜀锦=Thục Cẩm
古姜国=Cổ Khương Quốc
龙阳=Long Dương
葵羽玄女=Quỳ Vũ Huyền Nữ
景天=Cảnh Thiên
茂茂=Mậu Mậu
飞蓬=Phi Bồng
临安=Lâm An
神农=Thần Nông
蚩尤=Xi Vưu
林业平=Lâm Nghiệp Bình
玄道观=Huyền Đạo Quán
锁妖塔=Tỏa Yêu Tháp
雷魔兽=Lôi Ma Thú
灵珠=Linh Châu
古藤林=Cổ Đằng Lâm
雷州=Lôi Châu
云霆=Vân Đình
安溪海底城=An Khê Hải Để Thành
水碧=Thủy Bích
临安城=Lâm An Thành
魔界=Ma Giới
炎波泉=Viêm Ba Tuyền
神农鼎=Thần Nông Đỉnh
鬼界=Quỷ Giới
火鬼王=Hỏa Quỷ Vương
凌霄神殿=Lăng Tiêu Thần Điện
唐雪见=Đường Tuyết Kiến
照胆泉=Chiếu Đảm Tuyền
徐长卿=Từ Trường Khanh
九天玄女=Cửu Thiên Huyền Nữ
风魔兽=Phong Ma Thú
神树=Thần Thụ
盘古=Bàn Cổ
南疆=Nam Cương
天蛇杖=Thiên Xà Trượng
人间界=Nhân Gian Giới
圣灵披风=Thánh Linh Phi Phong
神界天池=Thiên Trì Thần Giới
神魔之井=Giếng Thần Ma
雷灵珠=Lôi Linh Châu
土魔兽=Thổ Ma Thú
土灵珠=Thổ Linh Châu
镇妖剑=Trấn Yêu Kiếm
邪剑仙=Tà Kiếm Tiên
蜀山=Thục Sơn
顾留芳=Cố Lưu Phương
至净法=Chí Tịnh Pháp
蜀山灵脉=Thục Sơn linh mạch
盘古之心=Bàn Cổ chi tâm
蜀山派=Thục Sơn phái
五灵珠=Ngũ linh châu
圣灵珠=Thánh linh châu
水火土风雷=Thủy Hỏa Thổ Phong Lôi
三皇=Tam Hoàng
仙剑世界=Tiên Kiếm thế giới
虹猫蓝兔七侠传世界=Hồng Miêu Lam Thố Thất Hiệp Truyện thế giới
毕鲁萨鲁多=Tất Lỗ Tát Lỗ Đa
六9书吧=Lục 9 thư ba
天帝=Thiên Đế
女娲=Nữ Oa
重楼=Trọng Lâu
青儿=Thanh Nhi
夕瑶=Tịch Dao
葵羽=Quỳ Vũ
木星=Mộc Tinh
毕鲁萨鲁多族长=Tộc trưởng Bilusaldo
迪迦奥特曼世界=Thế giới Ultraman Tiga
炎魔战士基里艾洛德人二代=Chiến binh Quỷ Lửa Kirieloid II
炎魔战士基里艾洛德人=Chiến binh Quỷ Lửa Kirieloid
基里艾洛德之神=Thần Kirieloid
变种人黑皇=Dị nhân Black King
陈太太=Trần thái thái
仙剑的世界=Thế giới Tiên Kiếm
地球和平联合组织=Tổ chức Liên hợp Hòa bình Trái Đất
远东总部=Tổng bộ Viễn Đông
蒙平原=Mông Bình Nguyên
黑暗的支配者加坦杰厄=Kẻ thống trị bóng tối Gatanothor
行星斯菲亚=Hành tinh Sphia
飞燕一号=Phi Yến 1
水魔兽=Thủy Ma Thú
火魔兽=Hỏa Ma Thú
迪拉修姆光流=Dira Shium Quang Lưu
火焰哥尔赞=Hỏa Diễm Gorzam
贝琉多拉=Belial Dora
成龙历险记=Câu Chuyện Về Thành Long
半边神=Bán Biên Thần
戴拿奥特曼=Đái Nạp Áo Đặc Mạn
新麦克斯炮=Tân Mạch Khắc Tư Pháo
黄金行星=Hoàng Kim Hành Tinh
毕鲁萨鲁多人=Tất Lỗ Tát Lỗ Đa Nhân
久良良岛屿=Cửu Lương Lương Đảo屿
石化怪兽加库玛=Thạch Hóa Quái Thú Gia Khố Mã
飞燕二号=Phi Yến Nhị Hào
引妖香=Dẫn Yêu Hương
精灵球=Tinh Linh Cầu
重力球=Trọng Lực Cầu
神奇宝贝=Thần Kỳ Bảo Bối
菊石兽=Cúc Thạch Thú
加库玛阿尔法=Gia Khố Mã An Nhĩ Pháp
加库玛贝塔=Gia Khố Mã Bối Tháp
铁血星球=Thiết Huyết Tinh Cầu
南太平洋=Nam Thái Bình Dương
佐斯星系=Hệ sao Zoss
泽井=Trạch Tỉnh
兰帕尔特光弹=Đạn Ánh Sáng Rampart
露露耶=Lộ Lộ Gia
铁血星人=Người Sắt Máu
克里莫斯群岛=Quần đảo Kremos
宇宙球体斯菲亚=Quả Cầu Vũ Trụ Sphia
戴西斯星系=Hệ Daiysis
昆仑=Côn Lôn
宇宙钢铁龙=Long thép vũ trụ
吉纲参谋长=Tham mưu trưởng Kitsuna
无限麦克斯系统=Hệ thống Max vô hạn
宇宙钢铁龙古瓦木=Long thép vũ trụ Guwamu
斯菲亚球体=Hình cầu Sphia
戴西斯星人=Người Dessis
斯菲亚生命体=Thực thể sống Sphia
胜利飞燕号=Victory Flier
基里艾洛德预言家=Nhà tiên tri Kiri-elod
炎魔战士=Chiến binh Yan Ma
昆仑山=Núi Côn Lôn
铁血星=Tinh cầu Thiết Huyết
火影世界=Thế giới Naruto
六道仙人=Lục Đạo Tiên Nhân
地爆天星=Địa Bạo Thiên Tinh
地球=Địa Cầu
水遁=Thủy độn
土遁=Thổ độn
火遁=Hỏa độn
风遁=Phong độn
雷遁=Lôi độn
阴遁=Âm độn
阳遁=Dương độn
龙珠=Dragon Ball
迪迦世界=Thế giới Tiga
胜利飞燕一号=Victory Phi Yến 1
胜利飞燕二号=Victory Phi Yến 2
德克萨斯炮=Đức Khắc Tát Tư Pháo
木叶旋风=Konoha Senpū
六勾玉轮回眼=Lục Câu Ngọc Luân Hồi Nhãn
玲珑宝塔=Linh Lung Bảo Tháp
辛辣天塞=Shinra Tensei
阿瑞斯号战舰=Chiến hạm Ares
铠甲勇士刑天=Khải Giáp Dũng Sĩ Hình Thiên
骷髅女=Khô Lâu Nữ
飞龙再生=Phi Long Tái Sinh
沙漠死神内瑟斯=Sa Mạc Tử Thần Nasus
阿瑞斯号=Ares Hào
哥布纽=Gobu Nu
奥古玛=Áo Cổ Mã
知树=Tri Thụ
塞迪克科技公司=Công ty Khoa học Kỹ thuật Sedic
迪迦奥特曼=Ultraman Tiga
泽井总监=Tổng giám đốc Sawai
吉纲参谋=Tham mưu trưởng Yoshitsugu
苍月奥特曼=Ultraman Trăng Xanh
幽怜=U Liên
钢甲铁面人=Người Mặt Sắt Bọc Thép
宗方副队长=Đội trưởng phó Munakata
无限麦克斯动力系统=Hệ thống động lực Max Vô Hạn
邪迪=Tà Diga
宿那山=Núi Sukuna
宿那鬼=Ác quỷ Sukuna
居间惠=Yumiya Megumi
黑暗行星古兰斯菲亚=Hành tinh Hắc ám Guransufia
虎魄刀=Đao Hổ Phách
达摩克利斯之剑=Thanh kiếm Damocles
合成兽达兰比尔=Quái thú tổng hợp Daranbir
格兰雷恩=Gran Reign
真田良介=Chân Điền Lương Giới
艾勃隆=Ngải Bột Long
希特拉=Hi Tạp Lạp
达拉姆=Đạt Lạp Mỗ
卡蜜拉=Tạp Mật Lạp
希尔巴贡=Hi Nhĩ Ba Cống
哉佩利敖光线=Tái Bội Lợi Ngao Quang Tuyến
TPC远东总部=Tổng bộ Viễn Đông TPC
亚克迪斯号=Tàu Yacdes
八尾博士=Tiến sĩ Yawei
黑暗迪迦=Diga Bóng Tối
基加哥布纽=Giga Gebonew
胜利队=Đội Chiến Thắng
德拉姆车=Xe Dram
自杀仙人=Tiên Nhân Tự Tử
时空界=Giới Thời Không
古兰斯菲亚=Goulud Sphire
海帕杰顿=Hyper Zetton
彩虹魔境=Cầu Vồng Ma Cảnh
银龙希尔巴贡=Ngân Long希尔巴贡
森美队=Sâm Mỹ Đội
异次元魔神艾塔尔加=Dị Thứ Nguyên Ma Thần艾塔尔加
时空城=Thời Không Thành
野瑞=Dã Thụy
宗方=Tông Phương
新城=Tân Thành
迪迦=Địch Gia
强哥=Cường Ca
黑皇=Hắc Hoàng
崛井=Quật Tỉnh
机械岛=Cơ Giới Đảo
虎魄魔刀=Hổ Phách Ma Đao
狮子树海=Sư Tử Thụ Hải
大古=Đại Cổ
丽娜=Lệ Na
美森队=Đội Mĩ Sâm
金龙=Kim Long
珠穆朗玛峰=Đỉnh Everest
马里亚纳海沟=Rãnh Mariana
金龙戈尔德拉斯=Kim Long Goldras
贝利亚奥特曼=Belial Ultraman
庚伮金刚杵=Geng Nu Kim Cang Chử
奥特赛文=Ultra Seven
奥特之父=Ultra Father
安培拉星人=Người ngoài hành tinh Empera
雷德王=Red King
布莱克王=Black King
南无迪迦古佛=Nam mô Địch Gia Cổ Phật
迪迦古佛=Địch Gia Cổ Phật
光之国=Quốc gia Ánh sáng
南无初代奥特曼至尊佛=Nam mô Sơ Đại Ultraman Chí Tôn Phật
南无沙福林佛=Nam mô Sa Phước Lâm Phật
南无奥特佛之父=Nam mô Ultraman Chi Phụ
赛文奥特曼=Seven Ultraman
M87至尊佛光=M87 Chí Tôn Phật Quang
奥特大力龙象飞踢=Ultraman Đại Lực Long Tượng Phi Thích
天空魔=Thiên Không Ma
卡拉法尔大帝=Karafar Đại Đế
蓝色行星的爱=Tình Yêu Hành Tinh Xanh
奥特签名=Chữ ký Ultraman
雷布朗多星人=Người Reiblando
奥特兄弟=Anh em Ultra
M87光线=Tia M87
哈马行星=Hành tinh Hama
虹猫蓝兔七侠传=Hồng Miêu Lam Thố Thất Hiệp Truyện
光头强哥=Quang Đầu Cường Ca
正木敬吾=Masaki Keigo
卡文=Tắc mạch văn
黑虎崖=Hắc Hổ Nhai
白素贞=Bạch Tố Trinh
风云=Phong Vân
圣教=Thánh Giáo
仙剑=Tiên Kiếm
倩女幽魂=Thiện Nữ U Hồn
小白=Tiểu Bạch
小玉=Tiểu Ngọc
小青=Tiểu Thanh
紫萱=Tử Huyên
龙葵=Long Quỳ
倩女世界=Thế giới Thiện Nữ
虹猫蓝兔世界=Thế giới Hồng Miêu Lam Thỏ
虎魄空间=Không gian Hổ Phách
黑小虎=Hắc Tiểu Hổ
牛旋风=Ngưu Toàn Phong
猪无戒=Trư Vô Giới
丽莎=Lệ Toa
跳跳=Khiêu Khiêu
玄武号飞船=Phi thuyền Huyền Vũ
蝎子女=Thiết Nữ
超兽神=Siêu Thú Thần
元空间=Nguyên Không Gian
蝎子王龙莹=Hạt Tử Vương Long Oánh
狮王=Sư Vương
青龙族=Thanh Long Tộc
白龙族=Bạch Long Tộc
龙莹=Long Oánh
暗黑魔铠装=Ám Hắc Ma Khải Trang
奥特曼世界=Thế Giới Ultraman
超兽战队=Siêu Thú Chiến Đội
蝎子王=Bọ Cạp Vương
柏林=Bá Lâm
天神星=Thiên Thần Tinh
黑海深渊=Hắc Hải Thâm Uyên
玄冥黑洞=Huyền Minh Hắc Động
雷遁星云=Lôi Độn Tinh Vân
Lisa姐=Lisa tỷ
babobo一族=Tộc Babobo
baboo族=Tộc Baboo
暗黑三叉戟=Ám Hắc Tam Xoa Kích
亡月劫=Vong Nguyệt Kiếp
第七平行宇宙=Vũ trụ song song thứ bảy
白虎一族=Bạch Hổ nhất tộc
狼族=Lang tộc
baboo一族=bộ tộc Baboo
第五平行宇宙=Vũ trụ song song thứ năm
云蝠=Vân Bức
元正=Nguyên Chính
第四平行宇宙=Vũ trụ song song thứ tư
鲸鲨族=Kình Sa Tộc
元正长老=Nguyên Chính trưởng lão
鲸鲨王=Kình Sa Vương
夜枭子=Dạ Kiêu Tử
云蝠阵=Vân Bức trận
云蝠神=Vân Bức Thần
金象族=Kim Tượng tộc
龙戬=Long Tiễn
泰雷=Thái Lôi
超兽武装=Siêu Thú Vũ Trang
星云体=Tinh Vân Thể
白虎族=Bạch Hổ Tộc
超兽战士=Siêu Thú Chiến Sĩ
苗条俊=Miêu Điều Tuấn
圣界=Thánh Giới
冥界=Minh Giới
玄武号=Huyền Vũ Hào
云蝠军团=Vân Bức Quân Đoàn
baboo星球=Tinh cầu Baboo
雪皇=Tuyết Hoàng
圣辉星云=Tinh vân Thánh Huy
鬼王=Quỷ Vương
鬼谷=Quỷ Cốc
风耀=Phong Diệu
玄冥之棺=Huyền Minh Chi Quan
冥王=Minh Vương
风影=Phong Ảnh
路虎=Lộ Hổ
天羽=Thiên Vũ
玄易子=Huyền Dịch Tử
火麟飞=Hỏa Lân Phi
夜凌云=Dạ Lăng Vân
元空灭=Nguyên Không Diệt
云蝠盾=Vân Bức Thuẫn
第六平行宇宙=Vũ trụ song song thứ sáu
第一平行宇宙=Vũ trụ song song thứ nhất
第二平行宇宙=Vũ trụ song song thứ hai
第三平行宇宙=Vũ trụ song song thứ ba
主神空间=Không Gian Chủ Thần
诸天之门=Chư Thiên Chi Môn
诸天：从破坏之王开始=Chư Thiên: Bắt đầu từ Vua Phá Hoại
