No=No
Or=Or
丹巴林=Tambarin
些小妖崽子=mấy tiểu yêu tể tử
人的声音=người thanh âm
仙人的声音=tiên nhân thanh âm
关帝像=Quan Đế tượng
国王大人=Quốc Vương đại nhân
大魔王大人=Đại Ma Vương đại nhân
弱小的=nhỏ yếu/nhược tiểu
拉蒂斯=Raditz
掏干=móc rỗng
武天师父=Quy lão
武天爷爷=Quy lão gia gia
清风送爽=Thanh Phong Tống Sảng
白同学=Bạch đồng học
白苍术=Bạch Thương Thuật
的局势=cục thế
种水准=loại cấp độ
萧史乘龙=Tiêu Sử Thừa Long
蓝琪=Lam Kỳ/Launch
辛巴鲁=Simbaru
陆克=Luke
饺子=sủi cảo/bánh chẻo/Chiaotzu
高贵的=cao quý
龟仙人说道=Quy tiên nhân nói
龟仙屋=Quy Tiên Ốc
006号=Số 006
006号复仇者=Avenger số 006
084号基地=Căn Cứ Số 084
084基地=Base 084
1989年=Năm 1989
1994年=Năm 1994
20号泰坦=Titan số 20
21世纪贝尔电话公司=Công ty điện thoại Bell thế kỷ 21
72柱魔神=72 Pillars Demons
76号猎魔特工=Đặc vụ săn quỷ số 76
A.I.M-先锋科技=A.I.M - Công nghệ Tiên phong
A.I.M基地=Căn cứ A.I.M
Aqua Cure=Aqua Cure
Avada Kedavra=Avada Kedavra
A网=Mạng A
Black Halo=Black Halo
Blood Stone=Blood Stone
Bảo Hộ Tán=Bảo Hộ Tán
C-17区=Khu C-17
C-53星球=Hành Tinh C-53
C-6区=Khu C-6
Cửu Đầu Xà phu nhân=Phu nhân Hydra
D-1区=Khu D-1
DX-1118 C=DX-1118 C
Expecto Patronum=Expecto Patronum
G型完美强化体=Cường hóa thể hoàn hảo G
Hail Hydra=Hail Hydra
Incendio=Incendio
J特工=Đặc vụ J
K特工=Agent K
Legilimens=Legilimens
Lạp Nhĩ Sâm phu nhân=Phu nhân Larson
Mai Lâm tiên sinh=Tiên sinh Merlin
Mr. Sinister=Mr. Sinister
M特工=Đặc vụ M
N.Y.P.D.=Sở Cảnh Sát Thành Phố New York
Obliviate=Obliviate
Plan B=Kế hoạch B
Project Pegasus=Project Pegasus
Raccoon City=Raccoon City
S.D.O.L.D.=S.D.O.L.D.
SSS血清=Huyết thanh SSS
SST实验型攻城哨卫=SST Siege Sentry thử nghiệm
Strategic Scientific Reserve=Khu Dự trữ Khoa học Chiến lược
Supernatural Defense Observation and Logistics Department=Sở Quan Sát và Hậu Cần Phòng Thủ Siêu Nhiên
The One=The One
Thung Lũng Tiểu Thành ở Colorado=Thung lũng tiểu thành ở Colorado
Thần Thuẫn=Thần Thuẫn
Thủy Ngân=Thủy Ngân
Transfiguration=Transfiguration
T血清=Huyết thanh T
U.S.S. Lawton=U.S.S. Lawton
Uy Đức=Wade
X基因=Gen X
X教授查尔斯=Giáo sư X Charles
X武器=Vũ Khí X
X武器计划=Dự án Vũ khí X
X武器试验=Thí nghiệm Vũ khí X
X计划=Dự án X
Z先生=Z tiên sinh
Z特工=Đặc vụ Z
nacui=Quốc xã
《危险生物实验管制条约》=Hiệp ước Kiểm soát Thí nghiệm Sinh học Nguy hiểm
《变种人注册法案》=《Đạo luật Đăng ký Dị nhân》
《地狱生物图鉴》=Sách hướng dẫn về sinh vật địa ngục
《夜行者条约》=《Hiệp ước Dạ hành giả》
《夜行者条约简史》=《Lược sử Hiệp ước Dạ hành giả》
《尖端黑魔法解密》=Giải mã Hắc Ma Pháp Cấp cao
《异类权力与义务管理法案》=《Đạo luật Quản lý Quyền và Nghĩa vụ của Dị loại》
《怪男巫的疯狂魔法》=《Phép thuật điên cuồng của phù thủy quái dị》
《星球日报》=Nhật báo Ngôi Sao
《神奇生物在哪里》="Sinh vật huyền bí ở đâu"
《给年轻猎魔人的建议》=《Lời khuyên cho Thợ săn Quỷ trẻ tuổi》
《超级英雄注册法案》=《Đạo luật Đăng ký Siêu anh hùng》
《野兽之书》=《Sách Quái Thú》
《霍格沃茨，一段校史》=《Hogwarts, một đoạn hiệu sử》
七海之王=Vua Bảy Biển
七海王国=Vương quốc Bảy Biển
七灯军团=Seven Lantern Corps
万机之神=Vạn Cơ Chi Thần
万磁王埃里克=Magneto Eric
万磁王埃里克.兰榭尔=Magneto Erik Lehnsherr
万磁王的兄弟会=Huynh đệ Biến chủng của Magneto
三凶魔=Tam Hung Ma
三叉戟大厦=Tòa nhà Trident
三叉戟大楼=Tòa nhà Trident
三宫之子=Tam Cung Chi Tử
三宫维度=Không gian Tam Cung
三宫魔=Tam Cung Ma
三进制=Tam phân
三魔器=Tam Ma Khí
三魔头=Ba Ác Ma
上古之躯=Thân xác cổ đại
不死之王德古拉=Dracula - Bất Tử Chi Vương
不死女王夏坷垃=Nữ hoàng Bất Tử Hạ Khắc Lạp
世界之脊=Sống núi của thế giới
世界安全理事会=Hội Đồng Bảo An Thế Giới
东二环带哥=Đông Nhị Hoàn Đới Ca
东海岸=Bờ Đông
丧尸恶魔=Zombie Ác Ma
中国大剧院=Nhà hát lớn Trung Quốc
中央城=Central City
丹尼尔.霍特霍尔=Daniel Whitehall
丹尼尔大厦=Daniel Building
丽亚娜.拉廷普斯=Liana Lantimpos
丽亚娜.拉斯普廷=Ly Á Na Rasputin
丽亚娜·拉廷普斯=Liana Latimprus
丽亚娜女王=Nữ hoàng Liana
丽雅娜=Ly Á Na
乌托邦岛=Đảo Utopia
乌托邦群岛=Quần đảo Utopia
乌鸦先生=Ông Quạ
乌鸦阁下=Lord Raven
乔.韦斯特=Joe West
乔治.伯恩斯=George Burns
乔治.塔尔顿=Kiều Trị. Tháp Nhĩ Đốn
乔纳森.斯通=Jonathan Storm
乔纳森.肯特=Jonathan Kent
乔茜=乔茜
乔茜酒=Josie's Bar
乔茜酒吧=Josie's Bar
九个世界=Cửu Cá Thế Giới
九大王国=Cửu Giới
九头蛇夫人=Madam Hydra
九头蛇鞭=Cửu Đầu Xà Tiên
九界之战=Chiến Tranh Cửu Giới
亚克西之印=Ấn Yakshi
亚克西法印=Dấu hiệu Aard
亚历山大.皮尔斯=Alexander Pierce
亚历山德拉.查莉娅诺娃=Alexandra Zaryanova
亚历山德拉少校=Thiếu tá Alexandra
亚特兰娜王后=Nữ hoàng Atlanna
亚瑟.库瑞=Arthur Curry
亚瑟.摩根=Arthur Morgan
亚瑟.韦斯莱=Arthur Weasley
亚瑟先生=Arthur tiên sinh
亚马逊岛=Đảo Amazon
亨利.艾伦=Henry Allen
亨利先生=Henry tiên sinh
亨利夫妇=Vợ chồng Henry
伊丽莎白.卡利多尼亚.艾什=Elizabeth. Caledonia. Ash
伊丽莎白.巴托里=Elizabeth Báthory
伊丽莎白.布拉多克=Elizabeth Braddock
伊丽莎白女伯爵=Nữ Bá tước Elizabeth
伊内兹.坦普=Inez Temple
伊卡洛斯.莱利=Icarus. Riley
伊格尼斯法印=Ấn Ignis
伊法魔尼魔法学校=Trường Phù Thủy Ilvermorny
伊莱亚斯.斯塔尔=Elias Starr
伍尔沃斯大楼=Tòa nhà Woolworth
传奇吸血鬼=Legendary Vampire
伦敦圣所=Luân Đôn Thánh Sở
伦敦城=Thành phố Luân Đôn
伦敦警察局=Sở cảnh sát Luân Đôn
伦敦警局=Sở cảnh sát Luân Đôn
伦纳德.麦肯齐=Leonard McKenzie
伯宁.扎纳=Birnin Zana
伯尔尼州=Bang Bern
伯恩斯上校=Đại tá Burns
佛斯特博士=Tiến sĩ Foster
佩吉.卡特=Peggy Carter
佩吉姑妈=Aunt Peggy
佩尔修女=Sơ Perl
佩珀.波兹=Pepper Potts
侏罗纪世界=Thế Giới Kỷ Jura
俄罗斯帮派=Băng đảng Nga
俄罗斯黑帮=Mafia Nga
保护伞制药公司=Công ty dược phẩm Umbrella
保罗神父=Cha Paul
假弗瑞=Fury Giả
傲慢女王=Nữ hoàng Kiêu Hãnh
傲罗=Thần Sáng
傲罗乌鸦=Thần Sáng U Quạ
傲罗埃辛努斯=Thần Sáng Esinus
克林特.巴顿=Clint Barton
克林特.弗朗西斯.巴顿=Clint Francis Barton
克里人勇.罗格=Kree Yon-Rogg
克里人战争=Chiến tranh Kree
克里人玛.威尔=Kree Mar-Vell
克里星际战队=Đội chiến đấu liên sao Kree
全明星超人=Toàn Minh Tinh Siêu Nhân
兰达博士=Tiến sĩ Randa
兰达教授=Giáo sư Randa
兰道夫博士=Tiến sĩ Randolph
关七=Quan Thất
内化州=Nội Hóa Châu
内华达沙漠=Sa mạc Nevada
内科罗达慕斯=Nội Khoa La Đạt Mộ Tư
冥府半神夜豺=Bán Thần Địa Ngục Dạ Sài
冥神西索恩=Elder God Chthon
冬兵=Winter Soldier
冬兵巴基=Winter Soldier Bucky
冰人巴比=Iceman Bobby
冰妖精=Yêu tinh băng
凡妮莎小姐=Cô Vanessa
凯因.马可=Cain Marko
凯奇先生=Cage tiên sinh
凯拉.派翠茜=Keira Patricia
凶兆先生=Sinister tiên sinh
列奥纳多.迪.皮耶罗.达.芬奇=Leonardo di Piero da Vinci
利维亚的杰洛特=Geralt xứ Rivia
加利福尼亚海湾=Vịnh California
加布里尔.莱耶斯=Gabriel Reyes
努巴尼工业区=Khu công nghiệp Numbani
努巴尼工业园=Khu công nghiệp Numbani
努巴尼智能塔=Tháp thông minh Numbani
努巴尼智能工业园=Khu công nghiệp thông minh Numbani
劳顿号=Tàu Lawton
匕首坦迪.博文=Dao Găm Tandy Bowen
匕首小姐=Cô Dao Găm
北冰洋海域=Vùng biển Bắc Băng Dương
北极冰川A-15号发掘场=Khu khai quật A-15 tại sông băng Bắc Cực
北美大地=Bắc Mỹ Đại Địa
北美巫师=Phù thủy Bắc Mỹ
北美政府=Chính phủ Bắc Mỹ
北美英雄协会=Hiệp hội Anh hùng Bắc Mỹ
北美血族长老会=Hội đồng Trưởng lão Huyết tộc Bắc Mỹ
北美西海岸=Bờ biển Tây Bắc Mỹ
北美魔法国会=Hội đồng Pháp thuật Bắc Mỹ
十戒帮=Băng Thập Giới
午夜夜总会=Câu lạc bộ đêm Midnight
午夜酒吧=Quán bar Midnight
半魔戴蒙=Bán Ma Damon
华盛顿周报=Tuần báo Washington
卑鄙的海尔波=Herpo the Foul
南亚次大陆=Tiểu lục địa Nam Á
南极州=Nam Cực Châu
南达尔巴特城=Thành phố Nam Dalbert
南达尔巴特训练营=Trại huấn luyện Nam Darbata
卡尔.卢卡斯=Carl Lucas
卡尔弗大学=Đại học Culver
卡尔顿.德雷克=Carlton Drake
卡拉.艾尔=Kara El
卡拜指环=Nhẫn Kabai
卡明小姐=Cô Kaming
卡森部长=Secretary Carson
卡特.佩吉=Carter. Peggy
卡特.史雷=Carter Slade
卡特女士=Bà Carter
卡特庄园=Trang viên Carter
卡特长官=Director Carter
卡珊卓女士=Quý cô Cassandra
卡米尔小镇=Kamil Town
卡罗尔.丹佛斯=Carol Danvers
卡罗尔.丹弗斯=Carol Danvers
卡罗尔·丹弗斯=Carol Danvers
卡罗尔主母=Mẫu thân Carol
卡罗尔女士=Quý bà Carol
卡罗尔阿姨=Dì Carol
卡莲.泽莫=Karen Zemo
卢克.凯奇=Luke Cage
卢恩符文=Chữ Rune
卢瑟先生=Luthor tiên sinh
卤蛋头=Trứng cút
厄尔.古斯塔夫=Earl Gustav
原罪之锤=Nguyên Tội Chi Chùy
原罪战锤=Original Sin Hammer
双王地狱=Địa ngục song vương
反弹球=Phản Đạn Cầu
变种人兄弟会=Brotherhood of Mutants/Hội Huynh Đệ Dị Nhân
变种人掠夺者狂攻=Kẻ cướp dị nhân Onslaught
古一大师=Cổ Nhất đại sư
古古=Gu Gu
古巴危机=Khủng hoảng Cuba
古巴导弹危机=Khủng hoảng tên lửa Cuba
史崔克少将=Thiếu tướng Stryker
史蒂夫.罗杰斯=Steve Rogers
史蒂芬.斯特兰奇=Stephen Strange
史蒂芬医生=Bác Sĩ Stephen
叶奈法女士=Nữ sĩ Yennefer
吉布斯当铺=Cửa hàng cầm đồ Gibbs
吉德罗.哈洛特=Gilderoy Harrott
吉德罗.洛哈特=Gilderoy Lockhart
吉米.吴=Jimmy Wu
吉迪恩.马利克=Gideon Malick
吉迪恩先生=Gideon tiên sinh
君王星人=Người Quân Vương Tinh
吞星=Thôn Tinh
吸血鬼小姐水银=Vampire Miss Mercury
吸血鬼教廷=Giáo đình Ma cà rồng
吸血鬼水银=Vampire Quicksilver
吸血鬼猎人=Thợ săn вампир
吸血鬼猎人刀锋=Blade the Vampire Hunter
吸血鬼至高家族=Gia tộc tối cao Ma cà rồng
告死女士=Nữ tử báo tử
命运之矛=Thương Mệnh Vận
咕咕大人=Quạ Quạ đại nhân
哈利.波特=Harry Potter
哈利.詹姆.波特=Harry James Potter
哈林区=Khu Harlem
哈莉.奎因=Harley Quinn
哥伦比亚牙科医学院=Trường Y Nha khoa Columbia
哥谭体育场=Sân vận động Gotham
哥谭城区=Quận Gotham
哥谭日报=Nhật báo Gotham
哥谭歌剧场=Nhà hát Opera Gotham
唐纳德.布莱克=Donald Blake
嗨曼=Hey man
嘉莹=Gia Oánh
嘉莹家族=Gia tộc Gia Doanh
噩梦维度=Chiều Không Ác Mộng
四等马润=Private First Class Marine
国土战略防御攻击=Phòng thủ Tấn công Chiến lược Quốc thổ
国土战略防御攻击与后勤保障局=Cục Phòng thủ, Tấn công và Hậu cần Chiến lược Quốc thổ
国王行动=Chiến dịch Nhà Vua
国防部第七区=Khu vực Bảy của Bộ Quốc phòng
国际魔法联合会=International Confederation of Wizards
图勒社团=Hội Thule
图恩湖=Hồ Thun
土伦之战=Trận chiến Toulon
圣.彼得=Thánh Peter
圣凡冈萨之力=Sức mạnh của San Venganza
圣凡冈萨地狱=Địa ngục Thánh Venganza
圣凡冈萨契约=Khế ước San Venganza
圣奥斯汀=Saint Austin
圣殿骑士组织=Tổ chức Hiệp sĩ Templar
圣洁会=Hội Thánh Khiết
圣盾兄弟会=Brotherhood of the Shield
圣米迦勒=Saint Michael
圣艾格尼丝=St. Agnes
圣艾格尼丝修道院=Tu viện St. Agnes
圣艾格尼丝孤儿院=Trại trẻ Thánh Agnes
圣芒戈魔法伤病医院=St. Mungo's Hospital for Magical Maladies and Injuries
圣诞节惨案=Vụ thảm sát Giáng sinh
圣马修=St. Matthew
圣马修教堂=Nhà thờ Saint Matthew
地下蜂巢基地=Căn cứ Tổ Ong dưới lòng đất
地狱之女萨塔娜=Địa Ngục Chi Nữ Satana
地狱之子=Địa Ngục Chi Tử
地狱使徒=Tông đồ Địa ngục
地狱厨房街区=Khu phố Hell's Kitchen
地狱大君=Đại quân địa ngục
地狱大君马尔杜克=Đại quân địa ngục Marduk
地狱狂犬=Địa Ngục Cuồng Khuyển
地狱神探=Thám tử Địa Ngục
地狱维度=Chiều Không Địa Ngục
地狱蝎狮=Bọ cạp sư tử địa ngục
地狱邪魔=Ác ma Địa ngục
地狱风暴=Địa Ngục Phong Bạo
地狱魔王贝雷特=Địa Ngục Ma Vương Berith
地球防卫军团=Earth Defense Force
坦迪.博文=Tandy Bowen
埃利奥特.兰道夫=Elliot Randolph
埃及九柱神=Ennead của Ai Cập
埃及九荣神=Ai Cập Cửu Vinh Thần
埃辛努斯=埃辛努斯
埃迪.布洛克=Eddie Brock
埃迪.布鲁克=Eddie Brock
埃迪·布洛克=Eddie Brock
埃里克.兰榭尔=Erik Lehnsherr
埃里克.兰谢尔=Erik Lehnsherr
埃里克.史蒂文森=Eric Stevenson
埃里克.布鲁克斯=Eric Brooks
塔克小哥=Tiểu ca Tucker
塔西提岛=Đảo Tahiti
塞伯坦人=Người Cybertron
塞伯坦方舟=Phương Thuyền Cybertron
塞勒姆女巫审判案=Vụ án xét xử phù thủy Salem
塞巴蒂斯安.肖=Sebastian Shaw
塞维尔城=Thành phố Seville
塞维尔大学=Đại học Seville
塞缪尔.G.寇豪格=Samuel G. Kouhough
塞缪尔大巫师=Đại pháp sư Samuel
士兵76=Soldier: 76
复仇之灵=Linh Hồn Báo Thù
复仇者1号=Biệt đội Báo thù số 1
夏坷垃=Hạ Kha Lạp
夏坷垃公主=Công chúa Hạ Khắc Lạp
夏坷垃大帝=Đại đế Shakura
夏坷垃家族=Gia tộc Shakkela
夏坷垃王朝=Vương triều Hạ Khắc Lạp
多拉米吉=Dora Milaje
多拉米吉卫队=Dora Milaje Vệ Đội
多洛雷斯.乌姆里奇=Dolores Umbridge
夜祺=Dạ Kỳ
夜豺=Dạ Sài
夜豺女士=Lady Nightjackal
夜豺拉赞=Dạ Sài Lạp Tán
大三角星系=Hệ Ngân hà Đại Tam Giác
大卫.查尔斯.哈勒=David Charles Haller
大天使加百列=Đại thiên sứ Gabriel
大天使屠杀者=Đại Thiên Sứ Đồ Sát Giả
大天使然德基尔=Đại thiên sứ Raziel
大学区=khu Đại học
大暗黑天=Đại Ám Hắc Thiên
大炎魔=Đại Viêm Ma
大猩猩温斯顿=Khỉ đột Winston
大符文塔=Đại Phù Văn Tháp
大艾玛=Emma Frost
大蛇库尔=Đại Xà Kul
大鱼人=Người Cá Lớn
天之声=Thiên Chi Thanh
天使小姐=Miss Angel
天使沃伦=Thiên Thần Warren
天使艾伦=Angel Alan
天使路德=Thiên sứ Luther
天后弗莉嘉=Thiên Hậu Frigga
天后陛下=Bệ Hạ Thiên Hậu
天球交汇=Thiên cầu giao hội
天眼会=Tổ chức Thiên Nhãn
天马计划=Dự Án Pegasus
头马特工作室=Headmart Studio
奎因集团=Tập đoàn Quinn
奥丁之子=Odin chi Tử
奥古斯都二世=Augustus II
奥尼克财团=Tập đoàn Onik
奥尼克集团=Tập đoàn Onic
奥尼卡财团=Tập đoàn Onika
奥尼卡集团=Tập đoàn Onika
奥巴代亚.斯坦=Obadiah Stane
奥德莱德实验室=Phòng thí nghiệm Audelaide
奥德莱恩实验室=Odreien Laboratory
奥托.冈瑟.奥克塔维斯=Otto Gunther Octavius
奥拉宝珠=Ngọc Cầu Orra
奥斯本工业=Công nghiệp Osborn
奥斯本生物研究实验室=Phòng thí nghiệm nghiên cứu sinh học Osborn
奥斯本财团=Tập đoàn Osborn
奥斯本集团=Tập đoàn Osborn
奥西里斯大神=Thần Osiris
奥西里斯阁下=Osiris các hạ
奥贝武夫=Obe Wulf
奥里西斯大神=Đại Thần Osiris
奥黛丽小姐=Cô Audrey
奥黛丽芙.奥丁斯多蒂亚=Audreyv. Odinsdottir
女半神=Nữ bán thần
女武神战甲=Valkyrie Suit
女男爵=Nữ Nam tước
女贞路4号=Số 4 đường Privet
女贞路四号=Số 4 đường Privet
女超人=Nữ Siêu Nhân
女超人卡拉=Supergirl Kara
女骑士杰西卡=Nữ hiệp sĩ Jessica
妖精商会=Thương hội Yêu Tinh
妮莎.玛基诺斯=Nissa Marinos
妮莎大公=Đại công tước Nissa
威尔逊.斯莱德=Wilson Slade
威尔逊.菲斯克=Wilson Fisk
威廉.史崔克=William Stryker
威廉.罗林斯=William Rawlins
威斯康星州=Tiểu bang Wisconsin
威斯康星州水牛县=Hạt Buffalo, Tiểu bang Wisconsin
娜塔莎.罗曼诺夫=Natasha Romanoff
娜塔莎·罗曼诺夫=Natasha Romanoff
孟加拉湾=Bay of Bengal
孟达塔=Mạnh Đạt Tháp
孤岛监狱=Nhà tù Đảo Cô Độc
孤独堡垒=Pháo đài Cô đơn
孤礁牛魔=Guar Trơ Trọi
宇宙长老=Trưởng Lão Vũ Trụ
守护忍=Người Bảo Vệ Nhẫn Giả
守望小组=Nhóm Watchdog
守望小队=Đội Overwatch
守誓河=Sông Thệ Ước
安娜.科尔森=Anna Coulson
安德鲁.加纳=Andrew Garner
安托万.崔普利特=Antoine Triplett
宋.哈娜=Song. Hana
宋哈娜=Song Hana
密歇根湖=Hồ Michigan
富兰克林.理查兹=Franklin Richards
富兰克林.霍尔=Franklin Hall
富兰克林.霍尔博士=Tiến sĩ Franklin Hall
富吉来梅林=Franklin "Foggy" Nelson
寒冬之匣=Hộp Mùa Đông
寒冬女神=Nữ thần mùa đông
寒冬女神斯卡蒂=Nữ Thần Mùa Đông Skadi
寒冬权杖=Quyền Trượng Mùa Đông
寒冰之匣=Hộp băng giá
寒霜圣殿=Đền thờ Băng giá
寡妇蛰=Widow's Bite
寻宝鼹鼠=Chuột Chũi Kho Báu
小万磁王=Tiểu Vạn Từ Vương
小丑女哈莉.奎因=Harley Quinn
小亚瑟=Arthur bé
小埃里克=Eric bé
小巴蒂.克劳奇=Barty Crouch Jr.
小巴里=Tiểu Barry
小幽灵=Little Ghost
小弗兰克=Frank Jr.
小洛娜=Lorna nhỏ
小矮妖多比=Yêu tinh nhỏ Dobby
小红后=Hồng Hậu nhỏ
小艾娃=Ava bé nhỏ
小艾达=Little Aida
小莱利=Little Riley
小詹姆斯.戈登=Little James Gordon
小赫敏=Little Hermione
小辣椒.波兹=Tiểu ớt Pepper Potts
小辣椒波兹小姐=Cô Pepper Potts
小马特=Tiểu Matt
尖啸魔峡谷=Tiêm Khiếu Ma Hạp Cốc
尤利西斯.克劳=Ulysses Klaue
尤利西斯.血石=Ulysses Bloodstone
尤思图的绿铃=Lục Linh của Justo
尤里.奥洛夫=Yuri Orlov
尼克.尼古拉斯.弗瑞=Nick Nicholas Fury
尼克.弗瑞=Nick Fury
尼克.梅勒=Nicolas Flamel
尼斯湖水怪=Quái vật hồ Loch Ness
岛田半藏=Shimada Hanzo
岛田家=Gia Tộc Shimada
岛田源=Shimada Genji
崔坦=Thôi Thản
崔普特工=Đặc vụ Tripp
巨凶兽=Quái Thú Hung Ác
巫师界=Thế giới phù thủy
巫毒之王=Voodoo King
巫毒术士午夜=Phù thủy Voodoo Midnight
巫毒术士罗本=Thầy phù thủy Voodoo Robben
巴伯特.血石=Babette Blaviken
巴基.巴恩斯=Bucky Barnes
巴塞洛缪.艾伦=Bartholomew Allen
巴斯特女神=Nữ thần Bast
巴特农神庙=Đền Parthenon
巴里.艾伦=Barry Allen
巴顿.克林特=Barton Clint
巴顿.布雷泽=Barton Blaze
布丽吉塔.林德霍姆=Brigitte Lindholm
布利克街117A号=Số 117A Phố Bleecker
布利克街177A号=Số 177A Phố Bleecker
布利克街177号=Số 177 Phố Bleecker
布斯巴顿魔法学院=Học viện Pháp thuật Beauxbatons
布朗克斯区=Quận Bronx
布洛克.朗姆洛=Brock Rumlow
布莱克卡德.伯特刚=Blackagar Boltagon
布里恩茨湖=Hồ Brienz
布鲁克海文大学=Đại học Brookhaven
布鲁斯.班纳=Bruce Banner
希.特.勒=Adolf Hitler
希佩里.希恩.夏坷垃=Hipperi. Hien. Shakura
希尔指挥官=Chỉ huy Hill
希尔特唱片店=Cửa hàng băng đĩa Hilt
希思罗机场=Sân bay Heathrow
希斯罗机场=Sân bay Heathrow
希芙将军=Tướng Sif
希里雅公主=Công chúa Cirilla
希阿帝国=Đế chế Shi'ar
帕伽索斯基地=Căn cứ Pegasus
帕尔默.克里斯汀=Palmer Christine
帕米尔高原=Cao nguyên Pamir
帕米拉.莉莲.爱丽丝=Pamela Lillian Isley
帕米拉.莉莲.艾斯利=Pamela Lillian Isley
帝国高中=Trường trung học Đế Chế
帝王计划=Dự án Đế Vương
幻影猫凯瑟琳=Shadowcat Katherine
幽灵基地=Căn cứ Bóng ma
幽灵特工=Đặc vụ bóng ma
幽灵监狱=Nhà tù Ghost
幽魂梅林=Hồn Ma Merlin
应天眼会=Ứng Thiên Nhãn Hội
废土东南部=Phế Thổ Đông Nam Bộ
废土之王=Phế Thổ Chi Vương
废土地狱=Địa Ngục Hoang Phế
康斯坦丁侦探=Thám tử Constantine
康斯坦丁酒吧=Constantine's Bar
康纳.肯威=Connor Kenway
建筑者=Người Xây Dựng
异人城市阿提兰=Thành phố Inhuman Attilan
异人王后美杜莎=Nữ hoàng Inhuman Medusa
异人王室=Inhuman Royal Family
异人王朝=Vương triều Inhuman
异人组织来世=Tổ chức Inhuman Afterlife
异类保留区=Khu bảo tồn dị nhân
异类审判庭=Tòa án xét xử Dị loại
弗兰克.卡索尔=Frank Castle
弗兰克林.霍尔=Franklin Hall
弗农.德思礼=Vernon Dursley
弗瑞局长=Giám đốc Fury
弗瑞特工=Đặc vụ Fury
弹弓基地=Căn cứ Slingshot
强尼.布雷泽=Johnny. Blaze
彼得.帕克=Peter Parker
彼得比尔特389卡车=Xe tải Peterbilt 389
德古拉的坟墓=Lăng mộ Dracula
心形草=Heart-Shaped Herb
忍者大师拉尔斯.艾尔.古尔=Ra's al Ghul
怒河=Sông Nộ
怒河守誓河=Nộ Hà Thủ Thệ Hà
怨河苦恼河=Oán Hà Khổ Não Hà
恐惧之物=Vật thể Kinh Hoàng
恐惧大蛇=Rắn Lớn Kinh Hoàng
恐惧大蛇库尔=Rắn lớn Kur
恩乔布=恩乔布
恶灵骑士强尼=Ác Linh Kỵ Sĩ Johnny
惊天雷=Starscream
惊奇队长.群星元年=Captain Marvel. Năm đầu của các vì sao
愤怒战戟=Chiến Kích Phẫn Nộ
慈恩港=Cảng Mercy
戈登先生=Gordon tiên sinh
戈登警长=Cảnh sát trưởng Gordon
战争圣堂=Thánh đường Chiến tranh
战略危机干预与后勤谍报处=Cục Tình báo, Hậu cần và Can thiệp Khủng hoảng Chiến lược
战略危机干预与谍报后勤处=Strategic Crisis Intervention and Intelligence Logistics Division
战略危险干预与谍报后勤处=Cục Hậu cần Tình báo và Can thiệp Nguy hiểm Chiến lược
战矛的女武士=Nữ chiến binh Valkyrie với cây giáo
戴安娜女士=Quý cô Diana
戴斯蒙德.迈尔斯=Desmond Miles
戴米安少爷=Thiếu gia Damian
戴肯.彰弘=Daken. Akihiro
戴蒙.地狱风暴=Daimon Hellstrom
戴蒙·地狱风暴=戴蒙·赫尔斯托姆
扎坦娜=扎坦娜
扎坦娜.扎塔拉=Zatanna. Zatara
扎尔文.约翰逊=Zalwen Johnson
托多洛夫大楼=Tòa nhà Todorov
托尔.奥丁森=Thor Odinson
托尔王子=Hoàng tử Thor
托尼.斯塔克=Tony Stark
托尼.斯塔克先生=Tony Stark tiên sinh
托德山=Todd Sơn
托比昂.林德霍姆=Torbjörn Lindholm
托比昂·林德霍姆=Torbjörn Lindholm
托马斯.韦恩=Thomas Wayne
托马斯老爷=Lão gia Thomas
拉尔斯.艾尔.古尔=Ra's al Ghul
拉尔斯·艾尔·古尔=Ra's al Ghul
拉尔森夫人=Bà Larson
拉梦达王后=Nữ hoàng Ramonda
拉赞=Lạp Tán
拉赞小姐=Cô Lạp Tán
拟形魔咒=Mimic Spell
持闪电的巴拉基勒=Barakiel mang theo tia chớp
指挥型空天母舰=Hàng không mẫu hạm trên không kiểu chỉ huy
指挥官勇=Chỉ huy Dũng
挪威海域=Vùng biển Na Uy
挪威海峡=Eo biển Na Uy
捍卫者联盟=Liên minh Người bảo vệ
摄魂怪之吻=Nụ hôn Giám ngục
摩根菲勒=Morgan Philare
摩金夫人长袍店=Cửa hàng áo choàng của Madam Malkin
撒拉路之池=Hồ Lazarus
撒旦之女=Con gái của Satan
撒旦之女萨塔娜=Satan chi Nữ Satana
撒旦地狱=Địa ngục Satan
撒旦王座=Ngai Vàng Satan
撒迪厄斯.E.罗斯=Thaddeus E. Ross
撒迪厄斯.罗斯=Thaddeus Ross
斗篷和匕首=Cloak and Dagger
斗篷泰隆=Cloak Tyrone
斗篷泰隆.约翰逊=Áo Choàng Tyrone Johnson
斩魂者=Trảm Hồn Giả
斯卡蒂战锤=Chiến chùy Skadi
斯塔克先生=Stark tiên sinh
斯塔克家族=Stark Family
斯塔克豪宅=Dinh thự Stark
斯塔滕岛=Đảo Staten
斯库诺弗将军=Tướng Skornov
斯库鲁人=Người Skrull
斯库鲁女皇=Nữ hoàng Skrull
斯特兰奇医生=Bác sĩ Strange
斯科尔奇.兰道夫=Skurge Randolph
斯科鲁=斯科鲁
斯科鲁人=Người Skrull
斯科鲁女皇=Nữ hoàng Skrull
斯莱德.威尔逊=Tư Lai Đức. Uy Nhĩ Tốn
斯蒂芬.斯特兰奇=Stephen Strange
斯蒂芬妮.马利克=Stephanie Malick
新手村村长泰帕尔兄弟=Trưởng Làng Tân Thủ Thôn Tạp Nhĩ huynh đệ
新星军团=Tân Tinh Quân Đoàn
新氟化物=New Fluoride
方舟能源堆=Lò phản ứng hồ quang
施法者公会=Hội Pháp sư
无光海=Biển Vô Quang
无尽家族=Gia tộc Vô Tận
无眼人戈登=Gordon vô nhãn
无限之石=Đá Vô Cực
无限公式=Công thức Vô hạn
日本陆军=Lục quân Nhật Bản
日间女妖=Nữ yêu ban ngày
旧金山码头=Bến tàu San Francisco
旺达.姜戈.马克西莫夫=Wanda Django Maximoff
昆因法印=Ấn Quinn
星啸=Tinh Khiếu
星球日报=Tòa soạn Nhật Báo Hành Tinh
晨星阁下=Chúa tể Sao Mai
普卢克斯星区=Prux Sector
智慧启蒙=Khai sáng trí tuệ
智械中枢=Trí Hạch Trung Tâm
智械天灾=Thiên Tai Trí Giác
智械岛=Đảo Trí Giác
智械管家=Quản gia Omnic
智械计划=Dự án Omnic
智能塔=Tháp thông minh
智能工业园=Khu công nghiệp thông minh
暗影斗篷=Áo Choàng Bóng Tối
暗星号=Dark Aster
暴影号=Shadow Striker
曼哈顿第五大道=Đại lộ số 5 Manhattan
未来科技=Khoa học công nghệ tương lai
未来科技基金会=Quỹ Công nghệ Tương lai
末日火山口=Miệng núi lửa Ngày tận thế
末日的铁拳=Bàn Tay Sắt Ngày Tận Thế
本.帕克=Ben Parker
本.格瑞姆=Ben Grimm
本先生=Ben tiên sinh
朱莉.诺伊斯=Julie Noyes
机械姬=Cơ Giới Cơ
机械姬伊卡洛斯=Cơ Giáp Cơ Icarus
机械姬洛拉=Mechanical Girl Lola
机械宫殿=Cung điện Cơ giới
机械贤者亚当=Hiền giả Máy móc Adam
机械贤者雷格纳=Machine Sage Reginar
机魂神降=Giáng cơ hồn
杜朋德=Đỗ Bằng Đức
杜根特工=Đặc vụ Dugan
来世小镇=Thị trấn Kiếp sau
来世组织=Tổ chức Afterlife
杰克.吉布斯=Jack Gibbs
杰克.莫里斯=Jack Morrison
杰克.莫里森=Jack Morrison
杰克.默多克=Jack Murdock
杰克·吉布斯=Jack Gibbs
杰哈.拉克瓦=Gérard Lacroix
杰森.伍德=Jason Wood
杰森.托德=Jason Todd
杰森乔=Jason Qiao
杰西.麦克雷=Jesse McCree
杰西卡.琼斯=Jessica Jones
杰西卡.琼斯小姐=Cô Jessica Jones
杰迈玛.卡明=Jemima. Kaming
林肯.坎贝尔=Lincoln Campbell
林肯特工=Đặc vụ Lincoln
查尔斯.弗朗西斯.泽维尔=Charles Francis Xavier
查尔斯.泽维尔=Charles Xavier
查尔斯·弗朗斯西·泽维尔=Charles Francis Xavier
查尔斯先生=Charles tiên sinh
查尔斯博士=Tiến sĩ Charles
查尔斯老头=Old Man Charles
查德.玛基诺斯=Chad. Maginos
查德.玛诺=Chad. Mano
查德.马诺=Chad. Mano
查斯.钱德勒=Chas. Chandler
查林十字路口=Charing Cross
查莉.沃特森=Charlie Watson
标准咒语.中级=Standard Spells. Intermediate
标准咒语.初级=Standard Spellbook for Beginners
树蜂血清=Huyết thanh Ong Bắp Cày
格瓦尼.约翰.扎塔拉=Giovanni John Zatara
格蕾.琴=Jean Grey
桑塔利亚州=Bang Santaria
桔光=Quất Quang
桥梁隧道管理局=Cơ quan Quản lý Đường hầm Cầu
梅.莱利=May Riley
梅女士=Bà Mei
梅家里=Nhà Meili
梅林.尼克拉斯.格兰特=Merlin Nicholas Grant
梅林.莱利=Merlin. Riley
梅林.莱利特=Merlin Riley
梅林先生=Merlin tiên sinh
梅林宅邸=Dinh thự Merlin
梅林小组=Đội Merlin
梅林爵士团=Order of Merlin
梅琳达.梅=Melinda May
梦之砂=Mộng Chi Sa
梦境之王=Vua Giấc Mơ
梵.达克=梵.达克
欧洲分部=Phân bộ Châu Âu
欧洲魔法部=Bộ Pháp thuật Châu Âu
欧米伽级=Omega Level
死亡战士计划=Deathlok Program
死亡轨迹=Tử Vong Quỹ Tích
死侍韦德=Deadpool Wade
死局峡谷=Deadlock Canyon
死局帮=Deadlock Gang
死神泰瑞昂=Death Tyrion
死神莱耶斯=Thần Chết Reyes
毁灭女神=Nữ Thần Hủy Diệt
比利.巴特森=Billy Batson
比利.鲁索=Billy Russo
比利牛斯山脉=Dãy núi Pyrenees
比基尼环礁=Bikini Atoll
比尔.佛斯特=Bill Foster
比尔.佛斯特博士=Tiến sĩ Bill Foster
比尔.韦斯莱=Bill Weasley
比尔先生=Bill tiên sinh
比尔博士=Tiến sĩ Bill
比尔教授=Giáo sư Bill
氪星人克拉克=Người Krypton Clark
氪石拳刺=Nắm đấm Kryptonite
水牛县=Hạt Buffalo
水蛭病毒=Virus Leach
水银小姐=Miss Mercury
永夜神殿=Điện Vĩnh Dạ
永恒之岩=Rock of Eternity
永恒之战=Chiến tranh vĩnh hằng
永恒之火=Ngọn Lửa Vĩnh Hằng
汉克.皮姆=Hank Pym
汉克.麦考伊=Hank McCoy
汉克·麦考伊=Hank McCoy
汉克博士=Dr. Hank
汤姆.库瑞=Tom Curry
沃伦.韦迪克=Warren Vidic
沃尔普及斯骑士=Hiệp sĩ Walpurgis
沃德特工=Đặc vụ Ward
沃斯卡娅工业区=Volskaya Industrial District
沃纳.莱因哈特=Werner Reinhardt
沃辛顿家族=Gia tộc Worthington
沙赞超人=Shazam Superman
波兹女士=Bà Potts
波兹小姐=Cô Potts
波波卡特佩特火山=Núi lửa Popocatépetl
泰坦智械=Trí tuệ Cơ giới Titan
泰帕尔=Thai Pal
泰瑞昂.黎明之刃=Tyrion Dawnblade
泰隆.约翰逊=Tyrone Johnson
泽维尔变种人学院=Xavier's School for Gifted Youngsters
泽维尔城堡=Lâu đài Xavier
泽维尔天赋少年学院=Trường Xavier dành cho những người trẻ tuổi tài năng
泽维尔学院=Học viện Xavier
泽维尔家族=Gia tộc Xavier
泽维尔家族墓地=Nghĩa trang gia tộc Xavier
泽维尔家族庄园=Trang viên Gia tộc Xavier
泽维尔庄园=Xavier's Mansion
泽芹士郎=Zerqin Shirou
泽西市=Thành phố Jersey
洛基.劳菲森=Loki Laufeyson
洛基.奥丁森=Loki Odinson
洛娜.丹恩=Lorna Dane
洛根先生=Logan tiên sinh
洞察母舰=Mẫu hạm Insight
海克娜煎药=Thuốc sắc Haikena
海妖之舌=Lưỡi Nàng Tiên Cá
海拉冥界=Địa Ngục Hela
海沟族=Hải Câu Tộc
海王亚特兰=Hải Vương Atlan
涅柔国=Vương quốc Nereus
深层强化=Cường hóa sâu
深渊之神纳尔=Thần vực thẳm Nul
深潜者1号=Deep Diver 1
深红主宰赛托拉克=Thâm Hồng Chúa Tể Setorak
深红之鸦=Quạ Đỏ Thẫm
深红宝石=Hồng Ngọc Đỏ Thẫm
深红束带=Crimson Bands
深红维度=Chiều Không Gian Đỏ Thẫm
深红领域=Crimson Domain
清浸百货公司=Purge & Dowse Ltd.
清算行动=Chiến dịch Thanh trừng
渔夫国=Ngư Phu Quốc
渡鸦之灵维克特=Linh hồn quạ Victor
渡鸦先生=Quạ tiên sinh
渡鸦大君=Độ Nha Đại Quân
渡鸦大师=Đại Sư Quạ
渡鸦导师=Đạo sư Quạ
渡鸦战甲=Bộ giáp Raven
渡鸦穆宁=Quạ Muninn
渡鸦维克特=Raven Victor
渣康=Zha Kang
温蒂.劳森=Wendy Lawson
温蒂.劳森博士=Tiến sĩ Wendy Lawson
滑流=Hoạt Lưu
漂亮男孩=Pretty Boy
漓江塔=Lệ Giang Tháp
潘乔酒吧=潘乔酒吧
激流之刃=Lưỡi dao Bão táp
激进变种人收容基地=Cơ sở Giam giữ Dị nhân Cực đoan
火焰之地=Vùng đất lửa
火焰之王苏尔特尔=Vua lửa Surtur
火箭浣熊=Rocket Raccoon
灰烬平原=Ash Plain
灰色雄鹰=Gray Eagle
热破=Hot Rod
熊学派=Bear School
熔岩虫=Sâu dung nham
熔渣平原=Đồng bằng xỉ
物部布度=Mononobe Budo
特工X=Agent X
特工学院=Agent Academy
特拉古星球=Planet Tralgo
特查卡=特查卡
特查卡国王=Vua T'Chaka
特查拉王子=Hoàng tử T'Challa
特莱玛卡国家公园=Vườn quốc gia Telemark
犸格莫斯世界=Thế giới Mag Mell
犹大之银=Bạc Judas
狂犬莫里斯=Mad Dog Morris
狂鼠詹米森=Junkrat Jamison
狄肯.弗瑞斯特=Deacon Frost
狄肯.弗罗斯特=Deacon Frost
狗先生=Chó tiên sinh
狮鹫学派=Trường phái Griffin
狼叔=Lang Thúc
狼学派=Wolf School
猎魔特工=Đặc vụ săn quỷ
猎魔猴哈奴曼=Khỉ săn quỷ Hanuman
猫学派=Trường phái Mèo
玄兰=Huyền Lan
玄兰老师=Huyền Lan lão sư
王后陛下=Bệ hạ Vương hậu
玛丽.居里=Marie Curie
玛丽.帕克=Mary Parker
玛利亚.兰博=Maria Rambeau
玛利亚.卡索尔=Maria Caso
玛利亚.希尔=Maria Hill
玛利亚·兰博=Maria Rambeau
玛利亚农场=Nông trại Maria
玛利亚家农场=Trang trại nhà Maria
玛利亚少尉=Thiếu úy Maria
玛吉修女=Sơ Maggie
玛基诺斯大公=Đại công tước Marginos
玛基诺斯老大公=Đại công tước Makinos
玛莎.韦恩=Martha Wayne
玛莎夫人=Bà Martha
玛达戈猫=Mèo Kneazle
环地球轨道=Quỹ đạo quanh Trái Đất
珍妮特.范.戴因=Janet van Dyne
班纳博士=Tiến sĩ Banner
理查德.帕克=Richard Parker
琴.格蕾=Jean Grey
琴泽博士=Tiến sĩ Qinze
瑞雯·莱利=Raven Riley
瑞雯小姐=Cô Raven
瑞雯阁下=Quý cô Raven
瓦图姆权杖=Quyền Trượng của Watoomb
生命基金会=Tổ chức Life Foundation
生命法庭=Living Tribunal
由迦可汗=Yuga Khan
疯泰坦=Mad Titan
痛苦之屋=House of Pain
白狼大师=Bạch Lang đại sư
白狼杰洛特=Geralt Bạch Lang
白皇后艾玛=Emma Frost
皇后区17街=Phố 17, Queens
皇后区警局=Sở cảnh sát Queens
皮奥特.尼古拉耶维奇.拉斯普廷=Piotr Nikolaievich Rasputin
皮奥特.拉廷普斯=Piotr Rasputin
皮姆.汉克=Pym Hank
皮姆博士=Tiến sĩ Pym
皮姆科技=Pym Technologies
皮姆科技大厦=Tòa nhà Pym Technologies
皮姆粒子=Hạt Pym
皮尔斯·辛克尼斯=Piers Sinkness
皮尔斯长官=Director Pierce
皮尔斯阁下=Pierce các hạ
皮特罗.姜戈.马克西莫夫=Pietro Django Maximoff
盎格鲁.撒克逊人=Người Anglo-Saxon
盖塔罗家族=Gia tộc Getao
盖塔罗集团=Tập đoàn Gettaro
盲眼先知=Nhà Tiên Tri Mù
直布罗陀港=Cảng Gibraltar
真言套索=Lasso of Truth
矢志田工业=Yashida Industries
石化女妖=Nữ Yêu Hóa Đá
破釜=Leaky Cauldron
破釜酒吧=Quán Cái Vạc Lủng
硫磺港=Cảng Lưu Huỳnh
磁带军团=Quân đoàn băng cassette
社会保障部=Bộ An sinh Xã hội
祖狼=Ông Kẹ
祖狼罗慕路斯=Romulus Tổ Lang
神之长子=Con trai cả của Thần
神力人=Người có sức mạnh siêu nhiên
神力人卢克.凯奇=Luke Cage Thần Lực
神圣恩典姐妹会=Hội Chị Em Ân Điển Thần Thánh
神父保罗=Cha Paul
神王寝宫=Tẩm cung Thần Vương
神盾学院=Học viện S.H.I.E.L.D.
神盾局三叉戟大厦=Tòa nhà Trident của SHIELD
神盾局三叉戟大楼=Tòa nhà Triskelion của S.H.I.E.L.D.
神盾局特工=Agents of S.H.I.E.L.D.
神盾局超自然事务监控防御与后勤保证部=Bộ phận Giám sát, Phòng thủ và Bảo đảm Hậu cần các Vấn đề Siêu nhiên của S.H.I.E.L.D.
神盾战争堡垒=S.H.I.E.L.D. War Fortress
神盾指挥舰=Tàu chỉ huy SHIELD
神盾猎魔人=Thợ săn quỷ SHIELD
神秘屋=Nhà Huyền Bí
神秘屋钥匙=Chìa khóa Ngôi nhà Bí ẩn
神速力=Speed Force
禁止滥用麻瓜用品司=Sở Cấm Lạm Dụng Đồ Vật Muggle
福克斯魔法用品店=Cửa hàng đồ dùng ma thuật Fox
福灵剂=Felix Felicis
福特肌肉车Galaxie 500=Ford Galaxie 500
科尔森农场=Nông trại Coulson
科尔森夫人=Bà Coulson
科尔森特工=Agent Coulson
科尔森部长=Minister Coulson
秘巫=Mật Vu
秘银堡=Mithril Burg
穿刺公=Người xuyên tạc
符文塔=Tháp Rune
第11街=Phố 11
第6街=Phố 6
第7街=7th Street
第七街=Seventh Street
简.佛斯特=Jane Foster
米修尔.卡森=Mishur Carson
米克小馆=Quán Mick
米兰达.戈沙克=Miranda Goshawk
米勒娃.麦格=Minerva McGonagall
粉碎小姐=Cô Nghiền Nát
索命咒=Bùa Avada Kedavra
紫人=Purple Man
紫心勋章=Huân chương Trái tim Tím
紫罗兰笔友会=Hội những người bạn qua thư Violet
红后艾丽西亚=Red Queen Alicia
红坦克=Red Hulk
红石金星戒=Red Stone Golden Star Ring
红罐=Red Can
红翼=Hồng Dực
红蝎子=Bọ Cạp Đỏ
红骷髅=Red Skull
红骷髅施密特=Red Skull Schmidt
红魔鬼=Red Devil
红魔鬼阿萨佐=Red Devil Azazel
约克郡城堡=Lâu đài Yorkshire
约瑟夫.道格朗斯=Joseph Doug Langs
约翰.加特勒=John Galtler
约翰.威克=John Wick
约翰.康斯坦丁=John Constantine
约翰逊医生=Bác sĩ Johnson
约翰逊夫妇=Vợ chồng Johnson
纳撒尼尔.理查兹=Nathaniel Richards
纽特.斯卡曼德=Newt Scamander
纽特阁下=Ngài Newt
纽约S.D.O.L.D.=S.D.O.L.D. New York
纽约城=Thành phố New York
纽约旧城区=Khu phố cổ New York
纽约桥梁隧道管理局=New York Bridge and Tunnel Authority
纽约皇后区=Queens, New York
纽约至圣所=Thánh đường New York
纽约英雄协会=Hiệp hội Anh hùng New York
纽约警局=Sở Cảnh Sát New York
纽约魔法国会=Hội Pháp thuật New York
终极否决者=Ultimate Nullifier
终极母盒=Mother Box
绯红女巫旺达=Scarlet Witch Wanda
维克多.冯.杜姆=Victor Von Doom
维克多.豪特利=Victor Howlett
维多克.冯.杜姆=Victor Von Doom
维多利亚.毕博=Victoria Biber
维多利亚.汉德=Victoria Hand
维尔顿.莱利=Wilton Riley
维罗妮卡病毒=Virus Veronica
维罗妮卡血清=Huyết thanh Veronica
绿茵园=Vườn Lục Địa
绿茵园养老院=Viện dưỡng lão Lục Nhân Viên
绿铃=Lục Linh
绿铃银轮=Green Bell Silver Wheel
缅因州=Tiểu bang Maine
罗克森石油公司=Công ty Dầu mỏ Roxxon
罗斯福总统=Tổng thống Roosevelt
罗珊.辛普森=Roshan Simpson
羊头酒吧=Quán rượu Đầu Cừu
美国国家安全局=Cục An ninh Quốc gia Hoa Kỳ
美国队长史蒂夫.罗杰斯=Captain America Steve Rogers
美国魔法国会=Quốc hội Pháp thuật Hoa Kỳ
美国魔法议会=Quốc hội Phù thủy Hoa Kỳ
美杜莎利斯.阿玛奎琳.波尔塔甘=Medusalith Amaquelin Boltagon
美杜莎女士=Bà Medusa
美杜莎王后=Nữ hoàng Medusa
美洲13家族=13 Gia tộc Châu Mỹ
美洲血族13长老会=Hội đồng trưởng lão 13 gia tộc ma cà rồng Châu Mỹ
美洲血族长老会=Hội đồng trưởng lão Ma cà rồng Châu Mỹ
美洲长老会=Hội đồng Trưởng lão Châu Mỹ
群星中的女皇=Nữ hoàng trong các vì sao
群星战争=Chiến tranh giữa các vì sao
翻倒巷=Hẻm Knockturn
翻斗巷=Hẻm Fandou
老兰道夫=Randolph già
老史蒂夫=Steve già
老司机一号=Tài xế già số một
老司机二号=Tài xế già số hai
老惠斯勒=Whistler già
老托比昂=Old Torbjörn
老斯坦=Ông già Stan
老肯特=Lão Kent
老阿福=Quản gia Alfred
老马丁=Lão Martin
联合国组织=Tổ chức Liên Hợp Quốc
肯尼迪国际机场=Sân bay quốc tế Kennedy
肯特农场=Kent Farm
胡佛水坝=Hoover Dam
能量电池=Pin Năng Lượng
脑波强化机=Máy tăng cường sóng não
至圣所=Chí Thánh Sở
至尊法师=Pháp Sư Tối Thượng
至尊法师古一=Pháp sư tối thượng Gu Yi
至高大公=Đại Công Tối Cao
至高女大公=Nữ Đại công tước Tối cao
至高女大公妮莎=Đại công tước tối cao Nissa
至高家族=Gia tộc Tối Cao
至高庄园=Trang viên Tối Cao
至高指控者=Supreme Accuser
至高智慧=Supreme Intelligence
艾什家族=Gia tộc Ashe
艾什小姐=Tiểu thư Ash
艾伦兄弟=Anh em nhà Allen
艾伦夫妇=Vợ chồng Allen
艾克恩之形=Hình thái Ekon
艾兴瓦尔德工业区=Khu công nghiệp Eichenwalde
艾兴瓦尔德智能工业园=Khu công nghiệp thông minh Eichenwalde
艾娃.斯塔尔=Ava Starr
艾尔家族=Gia tộc El
艾尔莎.血石=Elsa Bloodstone
艾尔莎小姐=Cô Elsa
艾玛.弗罗斯特=Emma Frost
艾瑞克.沙维格=Erik Selvig
艾瑞斯.韦斯特=Iris West
艾米丽.拉克瓦=Emilie Lacroix
艾米丽.拉瓦克=Emilie Lavaux
艾西斯战机=Máy bay chiến đấu Isis
艾里萨.玛基诺斯=Erysa Maginos
芭比.迈尔斯=Bobbi Morse
芭比特工=Babbit Agent
芭芭拉.‘芭比’.莫尔斯=Barbara 'Bobbi' Morse
芭芭拉.摩尔斯=Barbara “Barbie” Morse
芹泽博士=Tiến sĩ Serizawa
芹泽士郎=Serizawa Shirou
苏珊.斯通=Susan Storm
苏珊博士=Tiến sĩ Susan
苏珊女士=Bà Susan
苏睿=苏睿
苏睿公主=Công chúa Shuri
苏黎世大学=Đại học Zurich
苦思高塔=Khổ Tư Cao Tháp
英国女王=Nữ hoàng Anh
英国巫师协会=British Wizarding Association
英国海军=Hải quân Anh
英国魔法部=Bộ Pháp thuật Anh
莉莲.艾米丽=Lị Liên. Ái Mễ Lệ
莉莲小姐=Cô Lillian
莎伦.卡特=Sharon Carter
莎伦小姐=Cô Sharon
莎伦特工=Đặc vụ Sharon
莫丽.韦斯莱=Molly Weasley
莫丽夫人=Bà Molly
莫丽女士=Bà Molly
莫伊拉.奥德莱恩=Moira O'Deorain
莫伊拉博士=Tiến sĩ Moira
莫伊拉女士=Bà Moira
莫度法师=Pháp sư Mordo
莫纳岛=Đảo Mona
莫蒂默.汤因比=Mortimer Toynbee
莱克医生=Bác sĩ Lake
莱克斯.卢克=Lex Luthor
莱克斯.卢瑟=Lex Luthor
莱克斯集团=Tập đoàn Lex
莱利夫人=Phu nhân Riley
莱利家族=Gia tộc Riley
菲利克斯.布莱克=Felix Blake
菲利普.J.科尔森=Phillip J. Coulson
菲尔.科尔森=Phil Coulson
萨克巨人=Scorponok
萨塔娜.地狱风暴=Satana Hellstorm
蒙哥马利2000=Montgomery 2000
蒙奇D飞羽=Monkey D. Fei Yu
蓝猫汤姆=Tom Cat
蕾拉.哈桑=蕾拉·哈桑
薇薇安.葛拉罕=Vivian Graham
薇薇安博士=Tiến sĩ Vivian
薇薇安小姐=Cô Vivian
薛西斯王=Vua Xerxes
虚荣之王=Vua Phù Hoa
虚荣大君=Đại quân hư vinh
蛇学派=Trường phái Rắn
蜂巢基地=Hive Base
血之屋=Huyết Chi Ốc
血族长老会=Hội đồng Trưởng lão Ma cà rồng
血石夫人=Phu nhân Bloodstone
血石家族=Bloodstone Family
血石小姐=Tiểu thư Huyết thạch
衔尾蛇组织=Tổ chức Ouroboros
西伯利亚的大脚怪=Quái vật Bigfoot Siberia
西印度群岛=Tây Ấn
西蒙斯探员=Đặc vụ Simmons
西蒙斯熟食店=Cửa hàng Delicatessen Simmons
西蒙斯特工=Agent Simmons
西藏雪人=Người tuyết Tây Tạng
西部利亚=Tây Siberia
角魔帮=Giác Ma Bang
詹姆斯.戈登=James Gordon
詹姆斯.科尔森=James Coulson
詹姆斯.豪特利=James Howlett
詹姆斯.邦德=James Bond
詹米森.法尔克斯=Jamison Fawkes
诺恩之石=Đá Norn
诺拉.艾伦=Nora Allen
诺拉夫人=Mrs. Nora
诺贝尔和平奖=Giải Nobel Hòa bình
豪特利家族=Gia tộc Howlett
豪特利庄园=Điền trang Howlett
贝克街=Baker Street
贝尔电话公司=Công ty Điện thoại Bell
贝拉特里克斯.莱斯特兰奇=Bellatrix Lestrange
贝斯赛达医疗基地=Căn cứ Y tế Bethesda
贝斯赛达治愈中心=Trung tâm điều trị Bethesda
贝特霍尔德.斯腾伯格=Berthold Sternberg
贝蒂.罗斯=Betty Ross
贝蒂·罗斯=Betty Ross
贝蒂小姐=Cô Betty
贪婪者玛门=Kẻ Tham Lam Mammon
贾帕斯.希特维尔=Jasper Sitwell
贾斯帕.希尔维特=Jasper Sitwell
贾斯帕.希特维尔=Jasper Sitwell
赛伯.霍克=Cyber ​​Hawk
赛博坦人=Người Cybertron
赛托拉克束带=Dải băng Cyttorak
赫希底里群岛黑龙=Rồng Đen Hebridean
超级英雄注册法案=Đạo luật Đăng ký Siêu anh hùng
超级马克=Siêu Mark
超级马克战甲=Giáp Siêu Mark
超脑人乔治=Siêu não nhân George
超自然事务接触者保护条例=Điều lệ Bảo vệ Người tiếp xúc với các Vấn đề Siêu nhiên
超自然事务防御观察与后勤部=Bộ phận Phòng thủ, Quan sát và Hậu cần Sự vụ Siêu nhiên
跃马酒吧=Quán Ngựa Vằn
路易斯安纳州=Tiểu bang Louisiana
路西法.晨星=Lucifer Morningstar
路西法大君=Chúa tể Lucifer
路霸=Roadhog
路霸马克=Roadhog Marc
路霸马可=Roadhog Marco
跳跃者巴托克=Jumper Batroc
边境女王=Nữ hoàng biên giới
边境女王丽亚娜=Biên Cảnh Nữ Vương Liana
达伦.克劳斯=Darren Cross
达利.德思礼=Dudley Dursley
达姆弹.杜根=Dum Dum Dugan
达姆弹.杜根特工=Đặc vụ Dum Dum Dugan
达里尔.布罗姆菲尔德=Darryl Bromfield
迈克创=Mike Chuang
迈克尔.乔恩.卡特=Michael Jon Carter
迈格创=Mã Y Cách Sáng
迈格创终结者=Megatron Terminator
进阶超能人类联合研究团=Nhóm Nghiên cứu Liên hợp về Siêu Nhân Nâng cao
远古三魔=Viễn Cổ Tam Ma
远古塞伯坦方舟=Tàu vũ trụ Cybertron cổ đại
迪克.格雷森=Dick Grayson
逐天战机=Chiến Cơ Tận Trời
道奇挑战者=Dodge Challenger
道格朗斯=Doug Rous
道格朗斯博士=Tiến sĩ Doug Langs
邪神蜂巢=Thần ác Hive
郑尚奇=Zheng Shangqi
酒神金=rượu thần Kim
醴泉兄弟=Lễ Tuyền huynh đệ
里德.理查兹=Reed Richards
里德先生=Reed tiên sinh
里德博士=Tiến sĩ Reed
里德奈落岛=Đảo Narrows
野兽先生=Beast tiên sinh
野兽汉克=Beast Hank
量子世界=Thế giới lượng tử
量子之海=Quantum Sea
金刚狼洛根=Wolverine Logan
金加隆=Kim Galleon
金妮.韦斯莱=Ginny Weasley
金宫卫士=Kim cung vệ sĩ
金宫大殿=Đại sảnh Cung điện Vàng
金宫守卫=Vệ binh Kim Cung
金宫武器库=Kho Vũ Khí Kim Cung
金属鎓=Kim loại Ông
金山大桥=Cầu Cổng Vàng
钟塔隐修会=Tu viện Clock Tower
钢力士皮奥特=Colossus Piotr
钢铁武士=Chiến binh thép
钻心咒=Bùa Cruciatus
铁人托尼.斯塔克=Iron Man Tony Stark
银弹先生=Mr. Silver Bullet
银弹特工=Silver Bullet Agent
银河中部=Trung Tâm Ngân Hà
银西可=Bạc Sickle
锤头鲨=Cá Mập Đầu Búa
镭射眼萨默斯=Cyclops Summers
长牙之夜=Đêm Nanh Dài
门徒.怀特霍尔=Môn đồ. Whitehall
阿不思.邓布利多=Albus Dumbledore
阿兹卡班魔法监狱=Nhà tù Azkaban
阿卡姆疯人院=Bệnh viện Tâm thần Arkham
阿厉克斯.血石=Alec Bloodstone
阿坎.奥古迪姆=A Khản. Áo Cổ Địch Mỗ
阿宾.苏=Abin Sur
阿尔伯特.威斯克=Albert Wesker
阿尔伯特·威斯克=Albert Wesker
阿尔弗雷德·潘尼沃斯=Alfred Pennyworth
阿尔贝特.惠斯勒=Albert Whistler
阿尼姆.佐拉=Arnim Zola
阿布斯泰戈公司=Công ty Abstergo
阿布斯泰戈制药公司=Abstergo Pharmaceuticals
阿戈莫托之眼=Mắt Agamotto
阿拉伯半岛=Bán đảo Ả Rập
阿拉伯战争=Chiến tranh Ả Rập
阿拉斯加的巴罗基地=Căn cứ Barrow ở Alaska
阿斯加德死神=Thần Chết Asgard
阿斯顿.马丁=Aston Martin
阿方索.麦肯锡=Alfonso Mackenzie
阿曼达.沃勒=Amanda Waller
阿福思.邓布利多=Albus Dumbledore
阿萨佐=A Tát Tá
阿萨辛信条=Assassin's Creed
阿迪玛斯.赵=Amadeus Cho
陈文君=Trần Văn Quân
陌客=Khách Lạ
雇佣英雄公司=Công ty Anh hùng Thuê
雪佛兰科尔维特=Chevrolet Corvette
雷吉.西蒙斯=Reggie Simmons
雷吉.西蒙斯特工=Reggie Simmons
雷霆特攻队=Đội đặc nhiệm Thunder
雾之国=Xứ sở sương mù
霍华德.斯塔克=Howard Stark
霍华德先生=Howard tiên sinh
霍华德夫妇=Vợ chồng Howard
霍拉斯.斯拉格霍恩=Horace. Slughorn
霍普.范.戴恩=Hope van Dyne
霍普小姐=Cô Hope
霍林德姆.托比昂=Hollindeum. Tobion
霍格斯的上古之躯=Hoggoth's Ancient Bodies
霍格沃茨魔法学院=Học viện Pháp thuật Hogwarts
霜巨人之王劳菲=Vua băng giá Laufey
露易丝.莲恩=Lois Lane
露易丝·莲恩=Lois Lane
霸王赛伯=Overlord Cyb
霹雳罗斯=Thunderbolt Ross
韦德.威尔逊=Wade Wilson
韦恩企业=Wayne Enterprises
韦恩大厦=Tòa nhà Wayne
韦恩家族=Gia tộc Wayne
韦恩工业=Wayne Industries
韦恩庄园=Wayne Manor
韦恩集团=Tập đoàn Wayne
风暴女奥罗罗=Storm Ororo
风暴女巫=Storm Witch
风暴巨人=Người khổng lồ bão
飞狮学派=Trường phái Phi Sư
飞路网=Mạng Floo
飞过山=Fly Over Mountain
马克.吐温=Mark Twain
马可.拉特莱奇=Mako Rutledge
马可博士=Tiến sĩ Marko
马尔杜克地狱=Địa ngục Marduk
马尔杜克大君=Maldurk Đại Quân
马尔福山谷=Thung lũng Malfoy
马尔福庄园=Trang viên Malfoy
马泽法克尔=Ma trạch pháp Khắc Nhĩ
马特.默多克=Matt Murdock
马龙.麦克连恩=Malone MacLean
骷髅之书=Sách Đầu Lâu
骷髅岛=Đảo Đầu Lâu
骷髅巨蜥=Khủng long Đầu Lâu khổng lồ
高天尊=Cao Thiên Tôn
高等雷霆=Cao Lôi Đình
魅影陌客=Phantom Stranger
魅魔曼迪=Succubus Mandy
魔人安东尼=Majin Anthony
魔多城=Thành Mordor
魔形女瑞雯=Mystique Raven
魔怪大都会=Đô thị Quái vật
魔法国会=Hội đồng Pháp thuật
魔药入门=Introduction to Potions
鲍威尔博士=Tiến sĩ Powell
鲜血疆域=Lãnh Địa Máu
鲜血街=Phố Máu
鲜血骑士=Hiệp sĩ Máu
鹰眼克林特=Hawkeye Clint
鹰眼女士=Hawkeye Nữ sĩ
鹰眼小姐艾什=Cô nàng Hawkeye Ash
鹰眼巴顿=Hawkeye Barton
鹳鸟俱乐部=Câu lạc bộ Stork
鹿头林精=Lộc Đầu Lâm Tinh
鹿首精药剂=Poción Leshy
麦格尼特=Magneto
麦格尼特先生=Magneto tiên sinh
麦迪逊中学=Trường trung học Madison
麦迪逊医院=Bệnh viện Madison
麦迪逊县区=Madison County
麦迪逊大道=Đại lộ Madison
麦迪逊市=Madison City
麦迪逊街头=Phố Madison
麻瓜保护法=Luật Bảo Vệ Muggle
黄昏之塔=Tháp Hoàng Hôn
黄昏塔=Tháp Hoàng Hôn
黄蜂骑士=Wasp Knight
黑亚当=Black Adam
黑人总统=Tổng thống Da đen
黑光投资公司=Công ty Đầu tư Ánh sáng Đen
黑光血清=Huyết thanh Blacklight
黑寡妇娜塔莎=Black Widow Natasha
黑尔.J.格兰特=Hale J. Grant
黑巫师内科罗达慕斯=Hắc phù thủy Necrodamus
黑影小妹妹=Cô bé Bóng Đen
黑影小姐=Cô Shadow
黑心王子=Hắc Tâm Vương Tử
黑暗渡鸦=Dark Raven
黑暗神书=Hắc Ám Thần Thư
黑暗联军=Liên quân bóng tối
黑暗金刚狼=Hắc Ám Kim Cang Lang
黑暗金刚狼戴肯=Dark Wolverine Daken
黑木湖=Black Lake
黑爪佣兵团=Đoàn lính đánh thuê Black Talon
黑爵士=Hiệp Sĩ Đen
黑百合=Black Widow
黑百合艾米丽=Widowmaker Amélie
黑石之门=Cánh cổng Hắc Thạch
黑石城墙=Hắc Thạch Thành Tường
黑色高塔=Cao Tháp Đen
黑蝠王=Black Bolt
黑豹之神巴斯特=Thần Báo Đen Bast
黑豹特查卡=Black Panther T'Chaka
黑雾阁下=Lord Black Mist
黛茜.约翰逊=Daisy Johnson
黛茜.露易丝=Daisy Louise
齐格勒医生=Tiến sĩ Ziegler
龙皮包=Túi da rồng
李家嫂子=Lý gia tẩu tử
红云大将军=Hồng Vân Đại Tướng Quân
岳都城=Nhạc Đô Thành
祥瑞谱=Tường Thụy Phổ
闻教友=Văn Giáo Hữu
卤猪舌=Lư Trư Thiệt
经堂大师兄=Kinh Đường đại sư huynh
彭师傅=Bành sư phó
朗婆婆=Lãng bà bà
虎姑婆=Hổ cô bà
江南七县=Giang Nam thất huyện
下马盗=Hạ Mã Đạo
郎婆婆=Lang bà bà
蔡知味=Thái Tri Vị
喜娃=Hỉ Oa
柳翠=Liễu Thúy
金鸡桩=Kim Kê thọc
夏侯剑客=Hạ Hầu Kiếm Khách
虎大王=Hổ Đại Vương
娴娘=Hiền Nương
姜家庄园=Khương Gia trang viên
小云姐=Tiểu Vân tỷ
三恶道=Tam Ác Đạo
畜面之法=Súc Diện Chi Pháp
石僧=Thạch Tăng
孙氏甜醴=Tôn Thị Điềm Lễ
孙屠夫=Tôn Đồ Phu
大汉奇烈=Đại Hán Kỳ Liệt
戒西=Giới Tây
喜运斋=Hỷ Vận Trai
多宝堂=Đa Bảo Đường
去疾=Khứ Tật
弃病=Khí Bệnh
施药罗汉=Thi Dược La Hán
袈裟僧=Ca Sa Tăng
红袍僧=Hồng Bào Tăng
灰袍僧=Hôi Bào Tăng
风流果二郎=Phong Lưu Quả Nhị Lang
唐家小姐=Đường gia tiểu thư
真业师父=Chân Nghiệp sư phụ
真业大师=Chân Nghiệp đại sư
唐宅=Đường Trạch
大猴子=Đại Hầu Tử
二猴子=Nhị Hầu Tử
二龙子=Nhị Long Tử
方正主持=Phương Chính trụ trì
小比丘=Tiểu Tỳ Khưu
秘药工坊=Bí Dược Công Phường
毗卢帽=Tỳ Lư Mạo
罗汉鞋=La Hán Hài
妙色王求法偈=Diệu Sắc Vương Cầu Pháp Kệ
牟尼环=Mâu Ni hoàn
谛听神贝=Đế Thính Thần Bối
韵达=Vận Đạt
会稽郡城=Hội Kê quận thành
透骨浆=Thấu Cốt Tương
炼气丹=Luyện Khí Đan
寂寂还真，呼阖抱阳=Tịch Tịch Hoàn Chân, Hô Hạp Bão Dương
气行则通，气滞则停=Khí Hành Tắc Thông, Khí Trệ Tắc Đình
感之者众，食之者寡=Cảm Chi Giả Chúng, Thực Chi Giả Quả
一气不生，万法无明=Nhất Khí Bất Sinh, Vạn Pháp Vô Minh
三瘸子=Tam Què
西域大雪山=Tây Vực Đại Tuyết Sơn
雪斑灵蚕=Tuyết Ban Linh Tằm
盐枭王转轮=Diêm Kiêu Vương Chuyển Luân
游侠奇烈=Du Hiệp Kỳ Liệt
杜狂禽=Đỗ Cuồng Cầm
无名怪僧=Vô Danh Quái Tăng
紙幻=Chỉ Huyễn
鐵風車=Thiết Phong Xa
纸幻=Chỉ Huyễn
地行者=Địa Hành Giả
晋陵七县=Tấn Lăng Thất Huyện
摧山客=Tồi Sơn Khách
鬼鸩=Quỷ Trấm
经堂=Kinh Đường
观音寺=Quan Âm Tự
六组坛经=Lục Tổ Đàn Kinh
驴谦=Lư Khiêm
y-u=y-u
县令大老爷=Huyện lệnh đại lão gia
粉金坊=Phấn Kim Phường
乔东=Kiều Đông
虫老头=Trùng lão đầu
苦水桥=Khổ Thủy Kiều
关家嫂子=Quan gia tẩu tử
富贵家的=Phú Quý gia đích
小宝儿=Tiểu Bảo Nhi
郭七=Quách Thất
宋夫子=Tống phu tử
方参将=Phương Tham tướng
孙副将=Tôn phó tướng
陆文生=Lục Văn Sinh
青蚨母=Thanh Phù Mẫu
和老头=Hòa Lão Đầu
望月台=Vọng Nguyệt Đài
闵太守=Mẫn thái thú
孙参将=Tham tướng Tôn
萧门甄氏=Tiêu Môn Chân Thị
祁连世家=Kỳ Liên Thế Gia
祁连秀=Kỳ Liên Tú
向御使=Hướng Ngự Sử
蜮婆婆=Vực Bà Bà
祁连县=Kỳ Liên Huyện
崇圣心法=Sùng Thánh Tâm Pháp
斗百毒=Đấu Bách Độc
大金袍=Đại Kim Bào
引香寻踪=Dẫn Hương Tầm Tung
纸幻术=Chỉ Huyễn Thuật
御兽术=Ngự Thú Thuật
驱鬼术=Khu Quỷ Thuật
冠洗=Quan Tẩy
山阳学院=Học viện Sơn Dương
泰山神=Thái Sơn Thần
清平镇=Trấn Thanh Bình
文入道=Văn Nhập Đạo
赖秀才=Lại Tú Tài
獬豸令=Giải Trãi lệnh
五通神庙=Miếu Ngũ Thông Thần
琉璃心境=Lưu Ly Tâm Cảnh
收魂袋=Thu Hồn Túi
马妖=Mã Yêu
异种豆兵=Dị Chủng Đậu Binh
同光帝=Đồng Quang Đế
黄山隐修=Hoàng Sơn ẩn tu
道童百丈=Đạo Đồng Bách Trượng
药师寺=Dược Sư Tự
胶东郡=Giao Đông quận
入京僧团=Nhập Kinh Tăng Đoàn
穆森=Mục Sâm
鲁大汉=Lỗ Đại Hán
綦毋隐士=Cơ Vô ẩn sĩ
八公山隐士=Ẩn sĩ Bát Công Sơn
罗大汉=La Đại Hán
果二郎=Quả Nhị Lang
黄山道宗=Hoàng Sơn Đạo Tông
飞剑奴=Phi Kiếm Nô
持正=Trì Chính
松竹道士=Tùng Trúc đạo sĩ
易阳县=Dịch Dương huyện
沐富成=Mộc Phú Thành
沐财主=Mộc tài chủ
星蛊=Tinh Cổ
三尾守宫=Tam Vĩ Thủ Cung
斩妖咒=Trảm Yêu Chú
祁连县令=Huyện lệnh Kỳ Liên
刺星部=Thích Tinh Bộ
铜鼎部=Đồng Đỉnh Bộ
马信郎=Mã Tín Lang
灵屋山=Linh Ốc Sơn
三娃子=Tam Oa Tử
大青骡=La Xanh Lớn
牛饮渡=Ngưu Ẩm Độ
张狗娃=Trương Cẩu Oa
赤焰沙=Xích Diễm Sa
火孟尝=Hỏa Mạnh Thường
辟火飞甲=Tích Hỏa Phi Giáp
烈风客=Liệt Phong Khách
奇烈方斗=Kỳ Liệt Phương Đấu
火器精要=Hỏa Khí Tinh Yếu
铁风车=Thiết Phong Xa
丹火雷珠=Đan Hỏa Lôi Châu
火器门=Hỏa Khí Môn
太极八卦道袍=Thái Cực Bát Quái Đạo Bào
山鬼符召=Sơn Quỷ Phù Triệu
药辛子=Dược Tân Tử
明珢=Minh Ngân
区青鹤=Khu Thanh Hạc
挂印真人=Quải Ấn Chân Nhân
彩雉=Thải Trĩ
乔叔=Kiều Thúc
黄山松竹道士=Hoàng Sơn Tùng Trúc Đạo Sĩ
南宫山=Nam Cung Sơn
晋南武安山=Tấn Nam Võ An Sơn
天平山=Thiên Bình Sơn
花岩山=Hoa Nham Sơn
琉璃眼=Lưu Ly Nhãn
心火朱雀=Tâm Hỏa Chu Tước
鬼哭愁云大阵=Quỷ Khốc Sầu Vân Đại Trận
天王殿罗汉=Thiên Vương Điện La Hán
盛叔=Thịnh Thúc
晋南世家=Tấn Nam Thế Gia
侯六哥=Hầu Lục Ca
千机盘=Thiên Cơ Bàn
鬼哭愁云=Quỷ Khốc Sầu Vân
聚魂幡=Tụ Hồn phan
赤火旗=Xích Hỏa Kỳ
紫气东来旗=Tử Khí Đông Lai Kỳ
金钱旗=Kim Tiền Kỳ
管头儿=Quản Đầu Nhi
江门廖氏=Giang Môn Liêu Thị
江三公子=Giang tam công tử
严思贤=Nghiêm Tư Hiền
向光明=Hướng Quang Minh
江正道=Giang Chính Đạo
江家二少=Giang gia Nhị Thiếu
江三少=Giang Tam Thiếu
江家三少爷=Tam thiếu gia Giang gia
存异道长=Tồn Dị đạo trưởng
中平观=Trung Bình Quan
廖五=Liêu Ngũ
肾水玄武=Thận Thủy Huyền Vũ
南火朱雀=Nam Hỏa Chu Tước
六神厌术=Lục Thần Yếm Thuật
章老祖=Chương Lão Tổ
青丘纯狐=Thanh Khâu Thuần Hồ
墨林院=Mặc Lâm Viện
饕餮食客=Thao Thiết Thực Khách
青龙大街=Thanh Long Đại Nhai
白虎大街=Bạch Hổ Đại Nhai
昴宿区=Mão Túc Khu
长庚星=Sao Trường Canh
临信锦妃=Lâm Tín Cẩm Phi
赶尸道人=Người đuổi xác
三尸升天图=Tam Thi Thăng Thiên Đồ
彭踞=Bành Cứ
彭踬=Bành Chí
彭蹻=Bành Kiêu
庚申日=Ngày Canh Thân
祭天坛广场=Quảng trường Tế Thiên Đàn
三尸守神法=Tam Thi Thủ Thần Pháp
睡尸=Thụy Thi
不动如山真明王=Bất Động Như Sơn Chân Minh Vương
荆地=Kinh Địa
淮地=Hoài Địa
孔九变=Khổng Cửu Biến
神农陵=Thần Nông Lăng
刑部天牢=Hình Bộ Thiên Lao
扶天华表=Phù Thiên Hoa Biểu
隆光=Long Quang
玄武镇天赐=Huyền Vũ Trấn Thiên Tứ
道琴=Đạo Cầm
青玖师兄=Thanh Cửu sư huynh
裁缝剑法=Tài Phùng Kiếm Pháp
风尘师叔=Phong Trần sư thúc
青词=Thanh từ
海渊法师=Hải Uyên pháp sư
明皋法师=Minh Cao pháp sư
麻衣道人=Ma y đạo nhân
仙娥=Tiên Nga
青龙脉=Thanh Long Mạch
天堕湖=Thiên Đọa Hồ
西南剑仙=Tây Nam Kiếm Tiên
屠龙阵=Đồ Long Trận
镇脉金人=Trấn Mạch kim nhân
神行草鞋=Thần Hành thảo hài
火锅郎=Lẩu Lang
过去现在未来无漏佛眼=Quá Khứ Hiện Tại Vị Lai Vô Lậu Phật Nhãn
大衍神算=Đại Diễn Thần Toán
刑天杖=Hình Thiên trượng
剑阁栈道=Kiếm Các Sạn Đạo
邵家主=Thiệu Gia Chủ
禁咒司=Cấm Chú Tư
青铜剑=Thanh đồng kiếm
鳄灵=Ngạc Linh
鸩灵=Chẩm Linh
五脏庙=Ngũ Tạng Miếu
钢鞭道士=Cương Tiên Đạo Sĩ
阴老鬼=Âm Lão Quỷ
丧老鬼=Tang Lão Quỷ
九阴鬼尊=Cửu Âm Quỷ Tôn
五行大磨盘=Ngũ Hành Đại Ma Bàn
五行天堕=Ngũ Hành Thiên Đọa
正反磨盘卸劫大阵=Chính Phản Ma Bàn Tá Hiếp Đại Trận
明觉道长=Minh Giác đạo trưởng
三大夜叉=Tam Đại Dạ Xoa
地形夜叉=Địa Hình Dạ Xoa
水行夜叉=Thủy Hành Dạ Xoa
六目四臂=Lục Mục Tứ Tý
郎七=Lang Thất
王转轮=Vương Chuyển Luân
明彦=Minh Ngạn
荼老祖=Đồ Lão Tổ
紫府神雷=Tử Phủ Thần Lôi
大五行流转秘录=Đại Ngũ Hành Lưu Chuyển Bí Lục
紫府五行六神秘炼正篇=Tử Phủ Ngũ Hành Lục Thần Bí Luyện Chính Thiên
五行内炼=Ngũ Hành Nội Luyện
炼宝决=Luyện Bảo Quyết
分光化影禁制=Phân Quang Hóa Ảnh Cấm Chế
苗疆刺星部=Miêu Cương Thích Tinh Bộ
七星索命=Thất Tinh Tác Mệnh
鲁迭尔=Lỗ Điệt Nhĩ
松竹老道士=Tùng Trúc lão đạo sĩ
綦毋坐忘=Cơ Vô Tọa Vong
山中教院=Sơn Trung Giáo Viện
掌教老爷=Chưởng giáo lão gia
周天一炁还章=Chu Thiên Nhất Khí Hoàn Chương
食气法=Thực Khí Pháp
云符小挪移=Vân Phù Tiểu Na Di
周天遁法=Chu Thiên Độn Pháp
云雾腾飞术=Vân Vụ Đằng Phi Thuật
鸟篆云符周天转轮诀=Điểu Triện Vân Phù Chu Thiên Chuyển Luân Quyết
罗汉汀=La Hán Đinh
紫府正篇=Tử Phủ Chính Thiên
杨桃藤=Dương Đào Đằng
孙大掌柜=Tôn đại chưởng quỹ
乌巢林=Ô Sào Lâm
朱雀神=Chu Tước Thần
孙二掌柜=Tôn Nhị chưởng quầy
桃胶=Đào giao
善佑=Thiện Hữu
善佑老道士=Thiện Hữu lão đạo sĩ
雷击木林=Lôi Kích Mộc Lâm
黄山道藏=Hoàng Sơn Đạo Tàng
东南道宗=Đông Nam Đạo Tông
桃山观=Đào Sơn Quán
柳条子街=Liễu Điều Tử Nhai
欲乐无极=Dục Lạc Vô Cực
狈掌柜=Bại Chưởng Quỹ
尤叔=Vưu thúc
石心秘术=Thạch Tâm Bí Thuật
叱咤一炁=Sất Trá Nhất Khí
十八姐=Thập Bát tỷ
十七姐=Thập Thất tỷ
重阳大阵=Trùng Dương đại trận
桑木弓=Cung Tang Mộc
桑木长枪=Thương Dài Tang Mộc
五木之精=Ngũ Mộc Chi Tinh
桑柳榆桃槐=Tang Liễu Du Đào Hòe
青丘谣=Thanh Khâu Dao
青丘楼=Thanh Khâu Lâu
狐妖三姐=Hồ Yêu Tam Tỷ
颜无双=Nhan Vô Song
雷击桃木=Lôi kích đào mộc
狐族老祖=Hồ tộc lão tổ
黄山主峰=Đỉnh chính Hoàng Sơn
百丈大佛=Bách Trượng Đại Phật
天圣观=Thiên Thánh Quan
火浣观=Hỏa Hoán Quan
华阳观=Hoa Dương Quan
元符观=Nguyên Phù Quan
玉泉观=Ngọc Tuyền Quan
金豆兵=Kim Đậu Binh
鹤首钢杖=Hạc Thủ Cương Trượng
传承道箓=Truyền Thừa Đạo Lục
玉佛脂=Ngọc Phật Chi
避火阵=Tị Hỏa Trận
空中火=Không Trung Hỏa
紫金丹炉=Tử Kim Đan Lô
龙门异术=Long Môn Dị Thuật
叶庆=Diệp Khánh
极乐城=Cực Lạc Thành
凤玄道士=Phượng Huyền đạo sĩ
法力僧=Pháp Lực Tăng
乌铁环=Ô Thiết Hoàn
鸟篆云符=Điểu Triện Vân Phù
小转轮诀=Tiểu Chuyển Luân Quyết
一炁=Nhất Khí
斗百毒心法=Đấu Bách Độc Tâm Pháp
蛊王珠=Cổ Vương Châu
山川潜行术=Sơn Xuyên Tiềm Hành Thuật
腾云驾雾诀=Đằng Vân Giá Vụ Quyết
星宿挪移术=Tinh Túc Na Di Thuật
云雾飞腾术=Vân Vụ Phi Đằng Thuật
朱雀火雷=Chu Tước Hỏa Lôi
六心老人=Lục Tâm Lão Nhân
姚青藤=Diêu Thanh Đằng
欧阳瓠=Âu Dương Hỗ
颜太守=Nhan Thái Thú
风玄=Phong Huyền
三吉观=Tam Cát Quan
丹芝山=Đan Chi Sơn
萧乐师=Tiêu Nhạc Sư
梅山道巫=Mai Sơn Đạo Vu
名教大儒=Danh Giáo Đại Nho
百家家主=Bách Gia Gia Chủ
丹阳黄山=Đan Dương Hoàng Sơn
教储=Giáo Trữ
江西封云山=Giang Tây Phong Vân sơn
恶虎道长=Ác Hổ đạo trưởng
南明观=Nam Minh Quan
闽西=Mân Tây
伏波道长=Phục Ba Đạo Trưởng
石青道长=Thạch Thanh Đạo Trưởng
三清符钱=Tiền phù Tam Thanh
符剑=Phù kiếm
岳阳道长=Đạo trưởng Nhạc Dương
清心符咒=Thanh tâm phù chú
章明老祖=Chương Minh Lão Tổ
左子扇=Tả Tử Phiến
玄心道长=Huyền Tâm Đạo Trưởng
苗家月=Miêu Gia Nguyệt
神鸡爷爷=Thần Kê gia gia
神鸡寨=Thần Kê Trại
金鸡诀=Kim Kê Quyết
玄武小镇=Huyền Vũ Tiểu Trấn
警醒红线=Cảnh Tỉnh Hồng Tuyến
杞子圣贤=Kỷ Tử Thánh Hiền
邵子灵=Thiệu Tử Linh
晋陵=Tấn Lăng
豹子妖=Báo Tử Yêu
金鸡体=Kim Kê Thể
戊土精气=Mậu Thổ Tinh Khí
饮火老人=Ẩm Hỏa Lão Nhân
赵芒=Triệu Mang
焰霄居=Diệm Tiêu Cư
薛小娘子=Tiết Tiểu Nương Tử
桑村学派=Tang Thôn Học Phái
小方大师=Tiểu Phương đại sư
薛娘子=Tiết nương tử
羊小五=Dương Tiểu Ngũ
雄蛟妖王=Hùng Giao Yêu Vương
豹将军=Báo tướng quân
野猪将军=Lợn Rừng tướng quân
昭日仙君=Chiêu Nhật Tiên Quân
蜘蛛妖=Nhện Yêu
血玉蛛丝=Huyết Ngọc Chu Ti
金针婆婆=Kim Châm bà bà
维扬太守=Dương Châu thái thú
幻蜃珠=Huyễn Thận Châu
桑夫子=Tang Phu Tử
圣僧本源=Thánh Tăng Bản Nguyên
烩龙卵=Hối Long Noãn
娜迦龙王=Na Già Long Vương
枣木戒尺=Tảo Mộc Giới Xích
天龙念法=Thiên Long Niệm Pháp
窃寿蝉=Thiết Thọ Thiền
妖王大殿=Yêu Vương Đại Điện
猞猁将军=Hồ Ly tướng quân
维扬妖王=Duy Dương Yêu Vương
雄蛟大王=Hùng Giao Đại Vương
地煞天兵=Địa sát thiên binh
广林牛鼻子=Quảng Lâm Ngưu Tị Tử
地煞天音=Địa Sát Thiên Âm
七龙女=Thất Long Nữ
小貂儿=Tiểu Điêu Nhi
穿山甲将军=Tướng quân Tê tê
雄蛟=Hùng Giao
蜘蛛林=Rừng Nhện
道袍怪僧=Đạo bào quái tăng
地煞大手印=Địa Sát Đại Thủ Ấn
血髓蛛丝=Huyết tủy tri chu ti
风尘老儿=Phong Trần lão nhi
凌霄锋=Lăng Tiêu Phong
白帝门人=Bạch Đế Môn Nhân
女妖王=Nữ Yêu Vương
龙菩萨=Long Bồ Tát
天庐=Thiên Lư
朝元真人=Triều Nguyên Chân Nhân
金招=Kim Chiêu
白帝山=Bạch Đế Sơn
莲花山丘=Liên Hoa Sơn Khâu
佘山主=Xa Sơn Chủ
雪顶山三老=Tuyết Đỉnh Sơn Tam Lão
独脚叟=Độc Cước Tẩu
白帝门=Bạch Đế Môn
张磨李炼=Trương Ma Lý Luyện
提灯鬼=Đề Đăng Quỷ
子母鬼=Tử Mẫu Quỷ
百鬼图鉴=Bách Quỷ Đồ Giám
学舌鬼=Học Thiệt Quỷ
百鬼同游=Bách Quỷ Đồng Du
役鬼书=Dịch Quỷ Thư
三大罗刹=Tam Đại La Sát
犬灵=Khuyển Linh
地行罗刹=Địa Hành La Sát
游鬼大阵=Du Quỷ Đại Trận
白骨古筝=Bạch Cốt Cổ Tranh
入蜀=Nhập Thục
少山主=Thiếu Sơn Chủ
白金吐息=Bạch Kim Thổ Tức
冥童子=Minh Đồng Tử
犬鬼=Khuyển Quỷ
杜忠=Đỗ Trung
虹洞山=Hồng Động Sơn
铁穗子=Thiết Tuệ Tử
绿玉山=Lục Ngọc Sơn
钧天师兄=Quân Thiên sư huynh
万象剑演阵母=Vạn Tượng Kiếm Diễn Trận Mẫu
绿玉十杰=Lục Ngọc Thập Kiệt
孔雀剑阵=Khổng Tước Kiếm Trận
刃轮剑阵=Nhận Luân Kiếm Trận
徐祖=Từ Tổ
雪顶联盟=Liên minh Tuyết Đỉnh
毒心三煞=Độc Tâm Tam Sát
毒地陀=Độc Địa Đà
贪毒地煞=Tham Độc Địa Sát
戊土地煞=Mậu Thổ Địa Sát
七星煞气=Thất Tinh Sát Khí
荼老鬼=Đồ Lão Quỷ
千头鬼云=Thiên Đầu Quỷ Vân
巫山雾罩=Vu Sơn Vụ Tráo
庚金地煞=Canh Kim Địa Sát
鱼非江=Ngư Phi Giang
青铜飞剑=Thanh Đồng Phi Kiếm
雪顶=Tuyết Đỉnh
七星地煞=Thất Tinh Địa Sát
五行精煞=Ngũ Hành Tinh Sát
鬼将军=Quỷ tướng
辛金地煞=Tân Kim Địa Sát
五大鬼尊=Ngũ Đại Quỷ Tôn
涉川=Thiệp Xuyên
还婴=Hoàn Anh
莲花山剑法=Liên Hoa Sơn Kiếm Pháp
妙法莲华=Diệu Pháp Liên Hoa
素因圣僧=Tố Nhân Thánh Tăng
性空=Tính Không
宗河=Tông Hà
夜冥鬼尊=Dạ Minh Quỷ Tôn
黑火鬼王=Hắc Hỏa Quỷ Vương
还婴鬼王=Hoàn Anh Quỷ Vương
北氓=Bắc Mang
凌霄一剑=Lăng Tiêu Nhất Kiếm
冥府鬼都=Minh Phủ Quỷ Đô
望帝杜鹃=Vọng Đế Đỗ Quyên
凌霄飞剑=Lăng Tiêu Phi Kiếm
仙剑碎片=Tiên Kiếm Toái Phiến
蒲头=Bồ Đầu
丘望月=Khâu Vọng Nguyệt
斩鬼大祭=Trảm Quỷ Đại Tế
鳄龙鬼王=Ngạc Long Quỷ Vương
镇国剑仙空自若=Trấn Quốc Kiếm Tiên Không Tự Nhược
黑池鬼王=Hắc Trì Quỷ Vương
青城少渔翁=Thanh Thành Thiếu Ngư Ông
宗河鬼尊=Tông Hà Quỷ Tôn
涉川鬼尊=Thiệp Xuyên Quỷ Tôn
还婴鬼尊=Hoàn Anh Quỷ Tôn
冥河血遁=Minh Hà Huyết Độn
忘川不返遁=Vong Xuyên Bất Phản Độn
鬼王城=Quỷ Vương Thành
气味鬼王=Khí Vị Quỷ Vương
紫金天罡=Tử Kim Thiên Cương
金召=Kim Triệu
柏灌=Bách Quán
鱼凫=Ngư Phù
蒲头鬼王=Bồ Đầu Quỷ Vương
凌霄剑法=Lăng Tiêu kiếm pháp
白帝剑法=Bạch Đế kiếm pháp
蚕丛授丝=Tàm Tùng thụ ti
离合之道=Ly Hợp chi đạo
蒋道理=Tưởng Đạo Lý
蚕丛=Tàm Tùng
西山炼剑池=Tây Sơn Luyện Kiếm Trì
书生袁养正=Thư sinh Viên Dưỡng Chính
张磨=Trương Ma
李炼=Lý Luyện
雪顶山=Tuyết Đỉnh Sơn
谭家婆婆=Đàm gia bà bà
西南巫师=Vu sư Tây Nam
金环巫师=Vu sư Kim Hoàn
蚁水巫师=Nghĩ Thủy Vu sư
莱莱巫师=Lai Lai Vu sư
蜀中剑仙=Thục Trung Kiếm Tiên
黎古巫师=Lê Cổ Vu sư
邙山鬼修=Mang Sơn Quỷ Tu
七大巫王=Thất Đại Vu Vương
十二都天神魔大阵=Thập Nhị Đô Thiên Thần Ma Đại Trận
新巫祖讲道=Tân Vu Tổ Giảng Đạo
万巫起源=Vạn Vu Khởi Nguyên
灵米巫经=Linh Mễ Vu Kinh
赤巫经=Xích Vu Kinh
钱高师=Tiền Cao Sư
泰山君=Thái Sơn Quân
赤苗巫师=Xích Miêu Vu Sư
剑狱天动大转轮=Kiếm Ngục Thiên Động Đại Chuyển Luân
毁天灭地覆灭章=Hủy Thiên Diệt Địa Phúc Diệt Chương
赤苗=Xích Miêu
赤巫王=Xích Vu Vương
晓月观主=Hiểu Nguyệt Quan Chủ
铁脚罗汉=Thiết Cước La Hán
天罡丹余=Thiên Cương Đan Dư
地煞广林=Địa Sát Quảng Lâm
戒严大师=Giới Nghiêm đại sư
僧院=Tăng viện
戒平=Giới Bình
护法夜叉=Hộ Pháp Dạ Xoa
僧院主事=Tăng Viện Chủ Sự
西沱寺=chùa Tây Đà
苍水主持=Trụ trì Thương Thủy
本源老和尚=Bản Nguyên lão hòa thượng
销金山=Tiêu Kim Sơn
血蚕丝=Huyết Tàm Ti
红花山=Hồng Hoa Sơn
金蚕袈裟=Kim Tàm Ca Sa
血蚕僧袍=Huyết Tàm Tăng Bào
江汉儒生=Giang Hán Nho Sinh
封朗=Phong Lãng
冰火剑=Băng Hỏa Kiếm
北方四灵道宗=Đạo tông Tứ Linh phương Bắc
四灵内景大开宫真法=Tứ Linh Nội Cảnh Đại Khai Cung Chân Pháp
北方真水玄功=Bắc Phương Chân Thủy Huyền Công
于秋暮=Vu Thu Mộ
方丈主持=Phương trượng trụ trì
三大剑派=Tam Đại Kiếm Phái
戒行=Giới Hành
玄武童子=Huyền Vũ Đồng Tử
玄霆神雷=Huyền Đình Thần Lôi
玄武神雷=Huyền Vũ Thần Lôi
普照大阵=Phổ Chiếu Đại Trận
曹洞穴=Tào Động Huyệt
天庐剑阵=Thiên Lư Kiếm Trận
曹洞玄=Tào Động Huyền
雀儿山=Tước Nhi Sơn
天炉剑阵=Thiên Lô Kiếm Trận
剑狱天动正反大转轮=Kiếm Ngục Thiên Động Chính Phản Đại Chuyển Luân
金鸡元神=Kim Kê Nguyên Thần
玄武元神=Huyền Vũ Nguyên Thần
玄武镇=Huyền Vũ Trấn
古泉观=Cổ Tuyền Quán
小柴=Tiểu Sài
崇安=Sùng An
太乙山洞天=Thái Ất Sơn Động Thiên
紫微道脉=Tử Vi Đạo Mạch
成礼爵=Thành Lễ Tước
星辰道宗=Tinh Thần Đạo Tông
太微道脉=Thái Vi Đạo Mạch
名优道人=Danh Ưu Đạo Nhân
道乐司=Đạo Nhạc Tư
非相=Phi Tướng
黄山本宗=Hoàng Sơn bản tông
天下四京十三州=Thiên hạ tứ kinh thập tam châu
侯勋=Hầu Huân
金天义=Kim Thiên Nghĩa
荀秃子=Tuân trọc tử
天河水妖=Thiên Hà thủy yêu
佘御冲=Xa Ngự Xung
麻飞灵=Ma Phi Linh
空行=Không Hành
枯荣妙法=Khô Vinh Diệu Pháp
三头罗刹=Tam Đầu La Sát
圆通和尚=Viên Thông hòa thượng
菩提枯荣=Bồ Đề Khô Vinh
金甲客=Kim Giáp Khách
昆仑十二金仙=Côn Lôn Thập Nhị Kim Tiên
鱼羊公=Ngư Dương Công
米斗=Mễ Đấu
杞子=Kỷ Tử
阴阳望气术=Âm Dương Vọng Khí Thuật
真空五德=Chân Không Ngũ Đức
素真师叔=Tố Chân Sư Thúc
风恶真人=Phong Ác chân nhân
天罡法坛=Thiên Cương pháp đàn
地煞道冠=Địa Sát đạo quan
大五行天轮剑狱=Đại Ngũ Hành Thiên Luân kiếm ngục
罡煞天书=Cương Sát thiên thư
广利真人=Quảng Lợi chân nhân
阳神遍知=Dương Thần Biến Tri
明皋掌教=Minh Cao chưởng giáo
黄山丹融=Hoàng Sơn Đan Dung
会稽明皋=Hội Kê Minh Cao
天市道脉=Thiên Thị đạo mạch
龙象经院=Long Tượng Kinh Viện
六晦师叔=Lục Hối sư thúc
避光咒=Tị Quang chú
障目诀=Chướng Mục quyết
乐青羊=Lạc Thanh Dương
无明师兄=Vô Minh sư huynh
三善道=Tam Thiện Đạo
阿修罗战体=A Tu La Chiến Thể
人相=Nhân Tướng
八臂陀罗=Bát Tí Đà La
麻不仁=Ma Bất Nhân
五德宗=Ngũ Đức Tông
金服=Kim Phục
道乐宗=Đạo Nhạc Tông
西升=Tây Thăng
四方道宗=Tứ Phương Đạo Tông
会稽挂印观=Hội Kê Quải Ấn Quán
烈火遁=Liệt Hỏa Độn
烈火门=Liệt Hỏa Môn
金玄宗=Kim Huyền Tông
水灵道脉=Thủy Linh Đạo Mạch
饮海=Ẩm Hải
小云雾术=Tiểu Vân Vụ Thuật
照孽镜=Chiếu Nghiệt Kính
南北道宗=Nam Bắc đạo tông
荷芳=Hà Phương
枯荣寺=Khô Vinh Tự
六合总揽天地翻覆大阵=Lục Hợp Tổng Lãm Thiên Địa Phiên Phúc Đại Trận
沉鉴浮稷=Trầm Giám Phù Tắc
枯木黄冠=Khô Mộc Hoàng Quan
道家四真人=Đạo gia Tứ Chân Nhân
旁门五真人=Bàng Môn Ngũ Chân Nhân
磨转真人=Ma Chuyển Chân Nhân
斟海玉斗=Châm Hải Ngọc Đấu
磨转=Ma Chuyển
大念真人=Đại Niệm chân nhân
易醍醐=Dịch Đề Hồ
半鋒真人=Bán Phong Chân Nhân
三大劍仙=Tam Đại Kiếm Tiên
朝元=Triều Nguyên
鎮國劍仙空自若=Trấn Quốc Kiếm Tiên Không Tự Nhược
破滅真玉=Phá Diệt Chân Ngọc
天方真人=Thiên Phương chân nhân
丹阳九华寺=Đan Dương Cửu Hoa Tự
表里山河=Biểu Lý Sơn Hà
饮海真人=Ẩm Hải chân nhân
玉斗=Ngọc Đấu
金枝真人=Kim Chi chân nhân
浮稷=Phù Tắc
龙固=Long Cố
罡煞门=Cương Sát môn
丹余=Đan Dư
五旬道士=Đạo sĩ ngũ tuần
后土道脉=Hậu Thổ Đạo Mạch
龙固真人=Long Cố chân nhân
麻教教储=Ma Giáo Giáo Trữ
北斗勾命诀=Bắc Đẩu Câu Mệnh Quyết
浮稷真人=Phù Tắc chân nhân
半锋=Bán Phong
沉鉴真人=Trầm Giám chân nhân
广林=Quảng Lâm
童心和尚=Đồng Tâm hòa thượng
漓江道脉=Li Giang đạo mạch
祁连太师=Kỳ Liên thái sư
凤德=Phượng Đức
五德道宗=Ngũ Đức đạo tông
黄石道士=Hoàng Thạch đạo sĩ
伏波道士=Phục Ba đạo sĩ
牟陀=Mâu Đà
沉鉴=Trầm Giám
江岸边=Bờ sông
缚魂结=Phược Hồn Kết
定元神=Định Nguyên Thần
旗门阵=Kỳ Môn Trận
何卷帘=Hà Quyển Liêm
五宝金花=Ngũ Bảo Kim Hoa
在世明王=Tại thế Minh Vương
十方无量=Thập Phương Vô Lượng
穆帘将军=Mục Liêm tướng quân
应娘=Ứng Nương
真空道尊=Chân Không Đạo Tôn
四大方面神将=Tứ Đại Phương Diện Thần Tướng
北面神将=Bắc Diện Thần Tướng
南面神将=Nam Diện Thần Tướng
罗家军=La gia quân
吴佳琪=Ngô Giai Kỳ
明王僧珈蓝=Minh Vương Tăng Già Lam
西面神将=Tây Diện Thần Tướng
玉环县=Ngọc Hoàn huyện
穆帘=Mục Liêm
金钹僧=Kim Bạt Tăng
丹阳石佛山=Đan Dương Thạch Phật Sơn
东面神将=Đông Diện Thần Tướng
江口县=Huyện Giang Khẩu
翁景玉=Ông Cảnh Ngọc
佘赤心=Xà Xích Tâm
彭石匠=Bành Thạch Tượng
候六哥=Hầu Lục Ca
丹阳释门=Đan Dương Thích Môn
金刚护法=Kim Cương Hộ Pháp
明王军=Minh Vương Quân
四面神将=Tứ Diện Thần Tướng
明忝=Minh Thiểm
钢鞭道人=Cương Tiên Đạo Nhân
胜圣僧=Thắng Thánh Tăng
千秋社=Thiên Thu Xã
凤玄=Phượng Huyền
珠毫=Châu Hào
帝子剑=Đế Tử Kiếm
樊湘=Phàn Tương
七星剑印=Thất Tinh Kiếm Ấn
车迟老儿=Xa Trì lão nhi
晋陵郡=Tấn Lăng quận
丹融道士=Đan Dung đạo sĩ
无弱前辈=Vô Nhược tiền bối
无弱=Vô Nhược
九命枯禅功=Cửu Mệnh Khô Thiền Công
青河县=Thanh Hà huyện
戊戌年=Mậu Tuất niên
晋陵福元寺=Tấn Lăng Phúc Nguyên Tự
丹阳道家=Đan Dương đạo gia
黄山掌教=Hoàng Sơn chưởng giáo
西极轮=Tây Cực Luân
东流海=Đông Lưu Hải
六英=Lục Anh
八雄=Bát Hùng
三大天骄=Tam Đại Thiên Kiêu
雪顶少主=Tuyết Đỉnh Thiếu Chủ
蜀道口=Thục Đạo Khẩu
米长顾=Mễ Trường Cố
邙山鬼尊=Mang Sơn Quỷ Tôn
维扬郡=Duy Dương Quận
雪顶三老=Tuyết Đỉnh Tam Lão
青城兆瑶芝=Thanh Thành Triệu Dao Chi
兆瑶芝=Triệu Dao Chi
双轮海=Song Luân Hải
僧珈蓝=Tăng Già Lam
千叶等=Thiên Diệp đẳng
良亲王=Lương Thân Vương
本源圣僧=Bản Nguyên Thánh Tăng
斩仙神剑=Trảm Tiên Thần Kiếm
鸡大师=Kê đại sư
酆都山=Phong Đô Sơn
重六=Trọng Lục
珠毫飞剑=Châu Hào Phi Kiếm
罗云纱=La Vân Sa
勾曲山洞天=Câu Khúc Sơn Động Thiên
丹生=Đan Sinh
白老汉=Bạch Lão Hán
白家山=Bạch Gia Sơn
喜高义=Hỉ Cao Nghĩa
水妖大王=Thủy Yêu Đại Vương
蛤蟆妖=Hà Mô Yêu
关中水妖=Quan Trung Thủy Yêu
奇烈=Kỳ Liệt
新间真人=Tân Gian chân nhân
空玄子=Không Huyền Tử
海渊圣僧=Hải Uyên thánh tăng
福严寺=Phúc Nghiêm tự
金鳞王=Kim Lân Vương
蓝异真人=Lam Dị chân nhân
黑水妖王=Hắc Thủy yêu vương
天河大妖=Thiên Hà Đại Yêu
白三才=Bạch Tam Tài
方剑仙=Phương Kiếm Tiên
金鸡内丹=Kim Kê Nội Đan
盛执令=Thịnh Chấp Lệnh
晋南地区=Khu vực Tấn Nam
神蟾会=Thần Thiềm Hội
郭大力=Quách Đại Lực
郭财主=Quách Tài Chủ
神蟾=Thần Thiềm
山岳巨猿=Sơn Nhạc Cự Viên
噬火狻猊=Phệ Hỏa Toan Nghê
蜀中三剑仙=Thục Trung Tam Kiếm Tiên
风婆=Phong Bà
金蟾钱=Kim Thiềm Tiền
罡煞道冠=Cương Sát Đạo Quan
广寒之地=Quảng Hàn Chi Địa
圣僧分身圆通=Thánh Tăng Phân Thân Viên Thông
儒生袁养正=Nho Sinh Viên Dưỡng Chính
镇国剑仙=Trấn Quốc Kiếm Tiên
钱公=Tiền Công
谭功曹=Đàm Công Tào
半锋真人=Bán Phong chân nhân
轻影钱=Khinh Ảnh Tiền
会稽郡=Hội Kê Quận
明皋=Minh Cao
蜀中凌霄城=Thục Trung Lăng Tiêu Thành
青城剑仙=Thanh Thành Kiếm Tiên
少渔翁=Thiếu Ngư Ông
白帝剑仙=Bạch Đế Kiếm Tiên
袁天河=Viên Thiên Hà
钱婆=Tiền Bà
圣僧圆通=Thánh tăng Viên Thông
黑水王=Hắc Thủy Vương
天听兽=Thiên Thính Thú
光明精舍=Quang Minh Tinh Xá
老坛真人=Lão Đàn chân nhân
蜀中剑修=Thục Trung kiếm tu
日月鳌=Nhật Nguyệt Ngao
挂印观=Quải Ấn quan
巫山云=Vu Sơn Vân
米教=Mễ giáo
鲤三郎=Lý Tam Lang
震天雷鼓=Chấn Thiên Lôi Cổ
铜山玉磬=Đồng Sơn Ngọc Khánh
天弦瑶琴=Thiên Huyền Dao Cầm
北斗道宗=Bắc Đẩu Đạo Tông
先天阴阳易经=Tiên Thiên Âm Dương Dịch Kinh
阴阳家主=Âm Dương Gia Chủ
白虎衔尸图=Bạch Hổ Hàm Thi Đồ
公无病=Công Vô Bệnh
蜀中三大剑仙=Thục Trung Tam Đại Kiếm Tiên
积雷云=Tích Lôi Vân
避雷诀=Tị Lôi Quyết
南方道宗=Nam Phương Đạo Tông
北方道宗=Bắc Phương Đạo Tông
利空真人=Lợi Không Chân Nhân
道家真人=Đạo gia chân nhân
天河群妖=Thiên Hà quần yêu
捧日司晨仙君=Phụng Nhật Tư Thần tiên quân
捧日宫司晨仙殿=Phụng Nhật Cung Tư Thần tiên điện
钧天锋=Quân Thiên Phong
北方真人=Bắc Phương chân nhân
陈空虚=Trần Không Hư
太玄生=Thái Huyền Sinh
九头怪鸟=Cửu Đầu Quái Điểu
金眼雕=Kim Nhãn Điêu
凌霄剑仙=Lăng Tiêu Kiếm Tiên
三大剑仙=Tam Đại Kiếm Tiên
三仙境=Tam Tiên Cảnh
太乙山=Thái Ất Sơn
枯木黄芽=Khô Mộc Hoàng Nha
萍末=Bình Mạt
牛武=Ngưu Vũ
隆光爷=Long Quang Gia
恭良爷=Cung Lương Gia
齐聚勾曲山=Tề tụ Câu Khúc Sơn
佛诞节=Phật Đản Tiết
恭良帝=Cung Lương Đế
隆光帝=Long Quang Đế
白衣佛兵=Bạch Y Phật Binh
红头贼=Hồng Đầu Tặc
黄芽真人=Hoàng Nha chân nhân
眉山公=Mi Sơn Công
冠子清=Quan Tử Thanh
鸡鸣庙=Kê Minh miếu
道士丹融=Đạo sĩ Đan Dung
风尘真人=Phong Trần chân nhân
真空道宗=Chân Không đạo tông
丹余真人=Đan Dư chân nhân
明觉真人=Minh Giác chân nhân
十方无量经=Thập Phương Vô Lượng Kinh
修天赐=Tu Thiên Tứ
金线蛟=Kim Tuyến Giao
星樽=Tinh Tôn
吴光真人=Ngô Quang chân nhân
净角真人=Tịnh Giác chân nhân
梓笔真人=Tử Bút chân nhân
方玉京=Phương Ngọc Kinh
空剑仙=Không Kiếm Tiên
黄冠真人=Hoàng Quan chân nhân
吴光=Ngô Quang
广林真人=Quảng Lâm chân nhân
蜀中三家=Thục Trung Tam Gia
空自若=Không Tự Nhược
丹阳郡=Đan Dương quận
福元寺=Phúc Nguyên Tự
石佛山=Thạch Phật Sơn
黄山小洞天=Hoàng Sơn Tiểu Động Thiên
丹融=Đan Dung
袁养正=Viên Dưỡng Chính
方斗=Phương Đấu
黄山道脉=Hoàng Sơn Đạo Mạch
麻教=Ma Giáo
勾曲山=Câu Khúc Sơn
