01=01
45号(水牛古朗基)=Số 45
Agito=Agito
Agit欧米茄=Agit Omega
AgtiΩ=AgtiΩ
ArcleApple=Arcle Apple
Arcle盖亚记忆体=Arcle Gaia Memory
Arcle记忆体=Arcle Memory
Armored Rider=Armored Rider
AttackRide=AttackRide
B1=B1
B1号=Số B1
BIG MACHINE=Cỗ máy Lớn
BOARD=BOARD
BOARD研究所=Viện nghiên cứu BOARD
Bad Apple=Bad Apple
BadApple=BadApple
Baron巴隆=Baron/Ba-ron
Batta=Batta
Beast=Beast
BlackApple=Black Apple
Blade=Blade
Blay=Blay
Blue Spader(绀蓝黑桃)=Blue Spader
Build=Build
Chalice=Chalice
ClayDoll=ClayDoll
ClayDoll（泥娃娃）=ClayDoll
Clock Up=Clock Up
Core Switch=Core Switch
Cyclone=Cyclone
DCD事务=Công việc DCD
DCD事务所=Văn phòng DCD
DJ相良=DJ Sagara
Dark Kiva=Dark Kiva
De-De-De-Decade=De-De-De-Decade
Decade=Decade
Decade时空=Không gian Decade
Decade驱动器=Decade Driver
Decade驾驭表头=Decade Ridewatch
Diend=Diend
Dragon Arms！=Dragon Arms!
Dragon——Lock On！=Dragon——Lock On!
Drive驾驭表头=Drive Gia Ngự Biểu Đầu
Dummy=Dummy
Elek=Elek
Faiz=Faiz
Fang=Fang
Fang(獠牙)=Fang
Fangire=Fangire
Final AttackRide=Final AttackRide
Fourze=Fourze
Fourze世界=Thế giới Fourze
Fourze驱动器=Fourze Driver
G1=G1
G1装甲=Áo giáp G1
G3=G3
G3-X=G3-X
G3-X系统=Hệ thống G3-X
G3-X装甲=Giáp G3-X
G3小组=Tổ G3
G3小队=Đội G3
G3挂车移动指挥室=Phòng chỉ huy di động xe moóc G3
G3系统=Hệ thống G3
G3装甲=Áo giáp G3
G3训练室=Phòng Huấn luyện G3
G4=G4
G4装甲=Áo giáp G4
G4计划=Kế hoạch G4
GS-03=GS-03
GX-05=GX-05
GX机枪=Súng Máy GX
Gaim铠武=Gaim/Kaimu
Garren=Garren
Garren觉醒器(醒枪)=Garren Awakener
Geiz=Geiz
Gigant=Gigant
Gills=Gills
Gills劫掠者=Gills Raider
Go集团=Tập đoàn Go
Gridon=Gridon
G挂车=Xe kéo G
G系列=Dòng G
G系统=Hệ thống G
Heat=Heat
Henshin～=Henshin～
Ichigo Arms！=Ichigo Arms!
Ichigo——Lock On！=Ichigo - Lock On!
JACK=JACK
JOKER=JOKER
Joker=Joker
Joker(王牌)=Joker
Kamen Rider=Kamen Rider
KamenRide=KamenRide
King=Vua
KingForm=KingForm
Kiva=Kiva
Kiva-la=Kivala
Kivat=Kivat
Kivat三世=Kivat III
Leangle=Leangle
Lisa姐=Lisa tỷ
Lock On=Lock On
Lock On！=Lock On!
Luna=Luna
M4尾翼稳定贫铀穿甲弹=Đạn xuyên giáp ổn định cánh đuôi M4 bằng uranium nghèo
M87光线=Tia M87
M87至尊佛光=M87 Chí Tôn Phật Quang
MAGI MAGI MAGIC=MAGI MAGI MAGIC
Masquerade=Masquerade
Metal=Metal
Me集团=Tập đoàn Me
Nasca=Nasca
Nasca（纳斯卡）=Nasca
N集团=Tập đoàn N
OOO=OOO
OOO驱动器=Driver OOO
One=One
Orange=Orange
Orange Arms=Orange Arms
Pine=Pine
PolePole=PolePole
PolePoleコーヒー馆=Quán cà phê PolePole
PolePole咖啡馆=Quán cà phê PolePole
Power=Power
Queen=Queen
Ra集团=Tập đoàn Ra
Rider Kick=Rider Kick
Rocket On=Rocket On
Ryugen（龙玄）=Ryugen
SIC=SIC
Sid（西德）=Sid
Skull=Skull
Smilodon=Smilodon
Soiya=Soiya
Soiya！=Soiya!
TPC远东总部=Tổng bộ Viễn Đông TPC
Taboo=Taboo
Taboo（禁忌）=Taboo
Taka=Taka
Terror=Terror
Terror（恐惧）=Terror
Three=Three
Tora=Tora
TrialB=TrialB
Trigger=Trigger
TryChaser2000=TryChaser2000
TryChaser2000(试验追迹者2000)=TryChaser 2000
TryChaser2000A=TryChaser2000A
Two=Two
UltApple=Ult Apple
UltChaser=UltChaser
UltChaser(究极追迹者)=UltChaser
Undead=Undead
Unknown=Unknown
V带扣=Khóa V
Weather=Weather
Wizard=Wizard
W世界=Thế giới W
W基地=Căn cứ W
W的世界=Thế giới W
W硬汉号=Hardboilder
W驱动器=W Driver
X战警：第一战=X-Men: Thế Hệ Đầu Tiên
X财团=Tập đoàn X
Yummy=Yummy
Zangetsu=Zangetsu
Zi-O=Zi-O
ZiO=Zi-O
ZiO世界=Thế giới ZiO
ZiO二阶=Zi-O Nhị Giai
Zio=Zio
Zu集团=Zu Group
babobo一族=Tộc Babobo
baboo一族=bộ tộc Baboo
baboo族=Tộc Baboo
baboo星球=Tinh cầu Baboo
kawagen=Kawagen
kivatⅢ世=Kivat Đệ Tam
zio=Zio
Ⅲ世=Thế hệ thứ 3
ダグバ=Daguba
一条先生=Ichijo tiên sinh
一条薫=Ichijo Kaoru
一条薰=Ichijo Kaoru
一条警官=Thanh tra Ichijo
一阳神功=Nhất Dương Thần Công
丁香花粉=Bột đinh hương
七侠虹猫=Thất Hiệp Hồng Miêu
七剑合璧=Thất Kiếm Hợp Bích
七大上神尊者=Thất Đại Thượng Thần Tôn Giả
万寿王=Vạn Thọ Vương
万相仙人=Vạn Tướng Tiên Nhân
万载泪泉=Vạn Tải Lệ Tuyền
三云咲子=Mikumo Sakiko
三井会社=Công ty Mitsui
三分教场=Tam Phân Giáo Trường
三十三天神力=Tam Thập Tam Thiên Thần Lực
三小只=ba đứa nhỏ
三摩地=Tam Ma Địa
三浦智子=Miura Tomoko
三田総合病院=Bệnh viện Tổng hợp Mita
三连城=Tam Liên Thành
三首万相=Tam Thủ Vạn Tướng
上主=Thượng Chủ
上主梵天=Thượng Chủ Phạm Thiên
上主那罗延=Thượng Chủ Narayana
上单狗头=Đường trên Đầu Chó
上城睦月=Kamijō Mutsuki
上翔一=Tsukasa Shouichi
不喜欢看书的我又来了=Tôi không thích đọc sách lại đến rồi
不幸女神【耶瑟陀】=Nữ thần bất hạnh [Yeshetha]
不死苏摩=Bất Tử Tô Ma
不要笑话=không nên cười
专职消防员=Lính cứu hỏa chuyên trách
世尊大梵天=Thế Tôn Đại Phạm Thiên
世尊梵天=Thế Tôn Phạm Thiên
世界树塔=Thế Giới Thụ Tháp
世界树财团=Yggdrasil Corporation
世界树集团=Yggdrasil Corporation
世界的破坏者Decade=Kẻ hủy diệt thế giới Decade
世纪王影月=Thế Kỷ Vương Kageyama
业果神=Nghiệp Quả Thần
业果神娑尼=Nghiệp Quả Thần Sa Ni
东·德盖亚=Đông · Đức Cái Á
东京站=Ga Tokyo
东京若叶保育员=Nhân viên trông trẻ Wakaba, Tokyo
东京警视厅=Sở Cảnh sát Thủ đô Tokyo
东京都警察厅=Sở Cảnh sát Thủ đô Tokyo
东光国=Đông Quang Quốc
东弗婆提=Đông Phất Bà Đề
东弗婆提洲=Đông Phất Bà Đề Châu
东方神乞=Đông Phương Thần Khất
东杜毗=Đông Đỗ Tì
东瀛四岛=Bốn đảo Đông Doanh
东瀛宣化号=Đông Doanh Tuyên Hóa Hiệu
东瀛紫气宗=Đông Doanh Tử Khí Tông
两三天时间=hai ba ngày thời gian
两个就可=hai cái liền có thể
两人目=hai người mắt
两人说道=hai người nói
两师兄弟=hai sư huynh đệ
中央区马喰町站=Ga Bakurocho, quận Chuo
中苏=Trung Tô
丰岛区=Toshima
临多=Rinto
临多部落=bộ lạc Rinto
丹巴=Đan Ba
久保川大厦=Tòa nhà Kubokawa
久良良岛屿=Cửu Lương Lương Đảo
之至阴=chí âm
乌丸启=Karasuma Hajime
乌格罗坦瓦=Ugrotanva
乌格罗迦=Ugroka
乌玛=Uma
乌贼古朗基=Unizaurus Gurongi
乌贼恶魔=Ác Ma Mực
乌辫若旋釜，恒河溅玉飞！=Ô biện nhược toàn phủ, Hằng hà tiên ngọc phi!
乌鲁鲁巨岩=Uluru Cự Nham
乌鸦尊者=Lord Crow
乌鸦种属=Crow Genus
乌龟大师=Sư phụ Rùa
乔·吉布肯=Joe Gibken
乔斯图跋=Jostubha
乔斯图跋宝石=Jewel Kaustubha
乔答摩=Gautama
乔答摩仙人=Kiều Đáp Ma tiên nhân
九空为一念，九空无界是意念的世界，在这里可以能外界之不能=Cửu Không Vi Nhất Niệm, Cửu Không Vô Giới Thị Ý Niệm Đích Thế Giới, Tại Giá Lý Khả Dĩ Năng Ngoại Giới Chi Bất Năng
九郎岳=Kurougatake
九郎岳遗迹=Di tích Kurogatake
九郎岳遺跡=Di tích Kurogatake
九郎岳陨坑事件=Sự kiện Hố thiên thạch Cửu Lang Nhạc
九阳大霹雳=Cửu Dương Đại Phích Lịch
乾坤任我行=Càn Khôn Nhậm Ngã Hành
乾燥枪=Dryer Gun
乾皇=Càn Hoàng
乾达摩陀那山=Càn Đạt Ma Đà Na Sơn
亀山=Kameyama
了他的心脏=hắn tâm tạng
二分时代=Nhị Phân Thời Đại
云无常=Vân Vô Thường
云神——娑罗尼尤=Vân Thần - Sāraṇyū
云神娑罗尼尤=Vân Thần Toa La Ni Vưu
云蝠=Vân Bức
云蝠军团=Vân Bức Quân Đoàn
云蝠盾=Vân Bức Thuẫn
云蝠神=Vân Bức Thần
云蝠阵=Vân Bức trận
云霆=Vân Đình
五代稔=Godai Minoru
五代雄介=Godai Yusuke
五子阿修罗=Ngũ Tử A Tu La
五行先天功=Ngũ Hành Tiên Thiên Công
五行忍者=Ngũ Hành Nhẫn Giả
五行晶石=Ngũ Hành Tinh Thạch
五行领域=Ngũ Hành Lĩnh Vực
五连者=Gorenger
五通庙=Ngũ Thông miếu
五通邪神=Ngũ Thông Tà Thần
五通镇=Ngũ Thông trấn
五雷化极手=Ngũ Lôi Hóa Cực Thủ
亚克迪斯号=Tàu Yacdes
亚刻=Ark
亚古鲁前辈=Aguru tiền bối
亚古鲁灵石=Aguile Stone
亚古鲁符印=Agul Rune
亚古鲁腰带=Arcle Đai Lưng
亚拉伦拉府=Government House
亚极陀=Agito
亚极陀(AgitΩ)=Agito
亚极陀捕获计划=Kế hoạch bắt giữ Agito
亚玛达姆灵石=Amadam Linh Thạch
亚穆纳河=Yamuna
亡月劫=Vong Nguyệt Kiếp
交手一番=giao thủ một cái
亲娘舅=cậu ruột
人狮=Nhân Sư
人狮那罗辛哈=Nhân Sư Na La Tân Ha
仁藤攻介=Nitou Kousuke
仓田剑二=Kurata Kenji
他日之因=ngày khác chi Nhân
他生渡=Tha Sinh Độ
仙剑的世界=Thế giới Tiên Kiếm
仙贝汤=Bánh gạo Senbei súp
仙风云体术=Tiên Phong Vân Thể Thuật
任何男子=bất kỳ người đàn ông nào
伊卡将军=Tướng quân Yka
伊狩凯=Ikari Gai
伊罗=Ila
伏斯亚=Phục Tư Á
伏斯亚人=Người Exif
伐兰妮=Phạt Lan Ni
伐摩那=Phạt Ma Na
伐楼那=Phạt Lâu Na
伐楼那之力=Phạt Lâu Na Chi Lực
伐楼那天=Phạt Lâu Na Thiên
伐樓那=Varuna
伐由=Phạt Do
伐由之力=Phạt Do Chi Lực
伐由天=Phạt Do Thiên
众友=Chúng Hữu
众友仙人=Chúng Hữu Tiên Nhân
众生由我灭=Chúng Sinh Do Ngã Diệt
众车苑=Chúng Xa Uyển
优多摩=Ưu Đa Ma
优多摩仙人=Ưu Đa Ma Tiên Nhân
伽亭=Già Đình
伽内什=Già Nội Thập
伽利玛=Galima
伽多鲁=Gadoru
伽奢南=Già Xa Nam
伽奢南达=Già Xa Nam Đà
伽旃延妮=Già Chiên Diên Ni
伽旃延那=Già Chiên Diên Na
伽罗尼米=Già La Ni Mễ
伽美戈=Gamego
伽陀神杵=Gada Thần Xử
伽陀神锤=Chùy Gada
伽雅泽=Gayaza
佐斯星系=Hệ sao Zoss
俏小龙=Tiếu Tiểu Long
修卡=Shocker
俱卢之野=Câu Lư Chi Dã
俱卢族=Kaurava
倩女世界=Thế giới Thiện Nữ
倩女幽魂世界=Thế giới Thiện Nữ U Hồn
假面骑士1号=Kamen Rider 1
假面骑士2号=Kamen Rider 2
假面骑士Abyss=Kamen Rider Abyss
假面骑士Beast=Kamen Rider Beast
假面骑士Blade=Kamen Rider Blade
假面骑士Chalice=Kamen Rider Chalice
假面骑士Chalice(卡利斯)=Kamen Rider Chalice
假面骑士Decade=Kamen Rider Decade
假面骑士Decade(帝骑)=Kamen Rider Decade
假面骑士Diend=Kamen Rider Diend
假面骑士Fourze=Kamen Rider Fourze
假面骑士Garren(格连)=Kamen Rider Garren
假面骑士Geiz=Kamen Rider Geiz
假面骑士Ixa=Kamen Rider Ixa
假面骑士J=Kamen Rider J
假面骑士Kiva=Kamen Rider Kiva
假面骑士Kiva-la=Kamen Rider Kiva-la
假面骑士Kuuga=Kamen Rider Kuuga
假面骑士Nadeshiko=Kamen Rider Nadeshiko
假面骑士OOO=Kamen Rider OOO
假面骑士RX=Kamen Rider RX
假面骑士Skull=Kamen Rider Skull
假面骑士W=Kamen Rider W
假面骑士Wizard=Kamen Rider Wizard
假面骑士ZiO=Kamen Rider Zi-O
假面骑士kiva-la=Kamen Rider Kivala
假面骑士一号=Kamen Rider 1
假面骑士亚古鲁=Giả Diện Kỵ Sĩ A Cổ Lỗ
假面骑士亚极陀=Kamen Rider Agito
假面骑士响鬼=Kamen Rider Hibiki
假面骑士巴隆=Kamen Rider Baron
假面骑士帝骑=Kamen Rider Decade
假面骑士斩月=Kamen Rider Zangetsu
假面骑士甲斗=Kamen Rider Kabuto
假面骑士电王=Kamen Rider Den-O
假面骑士空我=Kamen Rider Kuuga
假面骑士部=Câu lạc bộ Kamen Rider
假面骑士铠武=Kamen Rider Gaim
假面骑士魔法师=Kamen Rider Wizard
假面骑士龙玄=Kamen Rider Ryugen
假面骑士龙骑=Kamen Rider Ryuki
傲剑山庄=Ngạo Kiếm Sơn Trang
傲慢之弓=Cung Ngạo Mạn
僧皇=Tăng Hoàng
元极摩柯无量=Nguyên Cực Ma Kha Vô Lượng
元正长老=Nguyên Chính trưởng lão
元空灭=Nguyên Không Diệt
元空间=Nguyên Không Gian
先天之法=Tiên Thiên chi pháp
光之力=Power of Light
光之国=Quốc gia Ánh sáng
光夏海=Hikari Natsumi
光头强哥=Quang Đầu Cường Ca
光实=Mitsuzane
光氏秘技笑穴指=Tuyệt kỹ Tiếu Huyệt Chỉ của dòng họ Hikari
光照相馆=Hiệu ảnh Hikari
光荣次郎=Hikari Eijiro
克劳恰=Khắc Lao Xa
克莱西斯要塞=Pháo đài Crisis
克里莫斯群岛=Quần đảo Kremos
全胜祭=Toàn Thắng Tế
全能型空我=Mighty Form Kuuga
全能形态=Dạng toàn năng
全能空我=Ultimate Kuuga
全能骑士踢=Đá Hiệp sĩ Toàn năng
八代蓝=Yashiro Ai
八哥鸟=chim sáo
八大不死神明=Bát Đại Bất Tử Thần Minh
八大恶魔=Bát Đại Ác Ma
八大恶魔篇=Bát Đại Ác Ma Thiên
八大魔气=Bát Đại Ma Khí
八大魔气篇=Bát Đại Ma Khí Thiên
八尾博士=Tiến sĩ Yawei
八王子区=Khu Hachioji
八王子驻地研究所=Viện nghiên cứu thường trú Hachioji
八部金刚功=Bát Bộ Kim Cương Công
六勾玉轮回眼=Lục Câu Ngọc Luân Hồi Nhãn
六阳魁首=Lục Dương Khôi Thủ
兰巴=Lamba
兰巴阿修罗=Lan Ba A Tu La
兰帕尔特光弹=Đạn Ánh Sáng Rampart
关东医大病院=Bệnh viện Đại học Y Kanto
关谷真澄=Quan Cốc Chân Trừng
养着伤=dưỡng thương
兽主=Thú Chủ
兽主法宝=Thú Chủ Pháp Bảo
内既有气=thể nội có khí
冈村可奈=Okamura Kana
冈村小姐=Cô Okamura
冥府之斧=Minh Phủ Chi Phủ
冰川城=Hikawa Makoto
冰川诚=Hikawa Makoto
冲绳色=Màu Okinawa
冷胭=Lãnh Yên
净化天使=Tịnh Hóa Thiên Sứ
净流=Tịnh Lưu
凄厉战士=Chiến binh kinh hoàng
凌云十八骑=Lăng Vân Thập Bát Kỵ
凌霄神殿=Lăng Tiêu Thần Điện
凤兮凤兮归故乡=Phượng hề phượng hề quy cố hương
凤凰大典=Phượng Hoàng Đại Điển
凤歌笑九天=phượng ca tiếu cửu thiên
凤舞天际=Phượng Vũ Thiên Tế
凯罗帕=Kairoppa
凯老师=Gai-sensei
刀龙=Đao Long
切换者=Switcher
创世王=Sáng Thế Vương
创世王影月=Vua Sáng Thế Kageyama
创世纪驱动器=Sáng Thế Kỷ Khu Động Khí
创界山=Sáng Giới Sơn
初生究极空我=Growing Ultimate Kuuga
初生空我=Growing Form Kuuga
利吉迦=Lợi Cát Ca
利吉迦仙人=Lợi Cát Già Tiên Nhân
刺刃团=Thứ Nhận Đoàn
刺猬大师=Sư phụ Nhím
刺血=Thứ Huyết
刺豚斗罗=Thứ Đồn Đấu La
剑岳=Kiếm Nhạc
剑崎=Kenzaki
剑崎一真=Kenzaki Kazuma
剑川虹=Kengawa Koji
剑扫乾坤=Kiếm Tảo Càn Khôn
剑立一真=Tachibana Kazuma
剑蝎=Kiếm Hạt
剑蝎纵横行=Kiếm Hạt Túng Hoành Hành
力量之主=Lực Lượng Chi Chủ
功夫熊猫世界=Thế giới Kungfu Panda
加古川飞流=Kakogawa Hiryu
加州金色=Màu vàng California
加库玛贝塔=Gia Khố Mã Bối Tháp
加库玛阿尔法=Gia Khố Mã An Nhĩ Pháp
劫掠者摩托车=Mô tô Cướp Bóc
劫掠者机车=Raider Motorcycle
劫末之火=Kiếp Mạt Chi Hỏa
劫王=Kiếp Vương
勇莲=Dũng Liên
包子山=núi Paozu
北俱卢=Bắc Câu Lô
北方冰原=Bắc Phương Băng Nguyên
北条警官=Cảnh sát Hojo
北条透=Hojo Toru
北海幼儿园=Bắc Hải Nhà trẻ
北饮狂刀聂人王=Bắc Ẩm Cuồng Đao Nhiếp Nhân Vương
匠神=Tượng Thần
匠神毗首羯磨=Vishwakarma
十二星座战士=Thập Nhị Tinh Tọa chiến sĩ
十二星座装甲=Thập Nhị Cung Tinh Tọa Trang Giáp
十二生肖动物=Thập Nhị Sinh Tiếu Động Vật
十二生肖动物篇=Thập Nhị Sinh Tiếu Động Vật Thiên
十二符咒=Thập Nhị Phù Chú
十大气忍=Thập Đại Khí Nhẫn
十字戏=Thập Tự Hí
十车=Thập Xa
十车王=Dasharatha
十里画廊=Thập Lí Họa Lang
十首=Thập Thủ
十首罗刹=Thập Thủ La Sát
十首罗波那=Thập Thủ La Bà Na
千叶站=Ga Chiba
千年僵尸王=Thiên Niên Cương Thi Vương
千年老树妖=Thiên Niên Lão Thụ Yêu
千本=ngàn bản/senbon
千眼的大神=Vị thần ngàn mắt
千首蛇王舍沙=Thiên Thủ Xà Vương Xá Sa
升华之力=Sức mạnh Thăng Hoa
升华天马弩=Rising Pegasus Bowgun
升华天马空我=Rising Pegasus Kuuga
升华泰坦剑=Rising Titan Sword
升华究极空我=Siêu việt Ultimate Kuuga
华丽贵族=Hoa Lệ Quý Tộc
卑弥乌=Bimyuu
南儋部州=Jambudvipa
南无初代奥特曼至尊佛=Nam mô Sơ Đại Ultraman Chí Tôn Phật
南无奥特佛之父=Nam mô Ultraman Chi Phụ
南无希瓦=Namo Shivaya
南无沙福林佛=Nam mô Sa Phước Lâm Phật
南无迪迦古佛=Nam mô Địch Gia Cổ Phật
南笛=Nam Địch
南阎浮提=Nam Diêm-phù-đề
南阎浮提州=Nam Diêm Phù Đề Châu
南阎浮提洲=Nam Diêm Phù Đề Châu
南麟剑首断帅=Nam Lân Kiếm Thủ Đoạn Soái
博物馆组织=Tổ Chức Bảo Tàng
卜洛=Bốc Lạc
卡多=Gatou/Tạp Đa
卡尼拉=Tạp Ni Lạp
卡拉法尔大帝=Karafar Đại Đế
卡玛苏尔=Tạp Mã Tô Nhĩ
卢茜尼=Lư Tây Ni
卢西檀=Lư Tây Đàn
原桑=Hara-san
友邻=Hữu Lân
友邻王=Hữu Lân Vương
双子怪盗=Song Tử Quái Đạo
双子飞碟=Song Tử Phi Điệp
双重驱动器=Double Driver
双马童=Song Mã Đồng
双马童天=Song Mã Đồng Thiên
双鱼判官=Song Ngư Phán Quan
变种人黑皇=Dị nhân Black King
古兰斯菲亚=Goulud Sphire
古姜国=Cổ Khương Quốc
古政贺男=Komassa Heo Nam
古昔仙人=Gu Xi Xianren
古朗基之王=Vua Gurongi
古朗基之王达古巴=Vua Gurongi Daguva
古藤林=Cổ Đằng Lâm
古贺政男=Koga Masao
古鲁达=Guruda
可奈=Kana
可奈酱=Kana-chan
台场=Odaiba
右国师府=Hữu Quốc Sư phủ
合成兽达兰比尔=Quái thú tổng hợp Daranbir
吉什金陀=Kishkindha
吉古罗=Cát Cổ La
吉吉迦=Kikasa
吉提迦=Cát Đề Ca
吉祥之音=Âm thanh cát tường
吉祥女神=Cát Tường Nữ Thần
吉纲参谋=Tham mưu trưởng Yoshitsugu
吉纲参谋长=Tham mưu trưởng Kitsuna
吉罗娑=Cát La Sa
吐浑=Tuhan
吠琉璃=Phệ Lưu Li
吠陀女神=Nữ thần Veda
吠陀守护者=Người bảo vệ Veda
吠陀守护者因陀罗=Thần Indra Người bảo vệ Veda
吠陀智人=Phệ Đà Trí Nhân
吴岛光实=Kureshima Mitsuzane
吴岛贵虎=Kureshima Takatora
员工掺杂体=Nhân Viên Tham Tạp Thể
周瑟=Chu Sắt
和平谷=Thung lũng Hòa Bình
咒蓝=Chú Lam
咻咻地——Spark！=Shushu di - Spark!
品川区=Quận Shinagawa
品红色=Màu đỏ tía
品红骑士=Hiệp sĩ Crimson
哈奴曼耆特=Hanuman
哈姆萨=Hamsa
哈斯底=Hastin
哈维拉塞尔=Harvey Russell
哈马行星=Hành tinh Hama
响尾蛇怪人=Quái nhân Rắn đuôi chuông
哑女=cô gái câm
哥布纽=Gobu Nu
哥莱姆=Golem
哥莱姆灵石=Golem Stone
唯敬=Duy Kính
唯清=Duy Thanh
商吉婆尼=Sanjivani
商吉婆尼之咒=Thương Cát Bà Ni Chi Chú
商吉婆尼咒=Chú Thương Cát Bà Ni
商波尊=Shambhu
商波罗=Shambala
啊尔何求=A Nhĩ Hà Cầu
善心之甲=Thiện Tâm Chi Giáp
善恶平衡器=Thiện Ác Bình Hành Khí
善见城=Thiện Kiến Thành
喜天仙人=Hỷ Thiên Tiên Nhân
喜林苑=Hỷ Lâm Uyển
喵绅士=Miêu thân sĩ
嗡拿马西瓦=Om Namah Shivaya
嘉应市=Gia Ứng thị
噬欲怪=Yummy
四大瑞兽=Tứ Đại Thụy Thú
四天玄男=Tứ Thiên Huyền Nữ
四方魔渡行=Tứ Phương Ma Độ Hành
四部吠陀=Tứ Bộ Vệ Đà
回元血手=Hồi Nguyên Huyết Thủ
回旋冲刺者号=Cyclone Dasher
因陀罗之弓=Cung Indra
因陀罗之矢=Mũi tên Indra
因陀罗之轮=Luân xa của Indra
因陀罗尼=Nhân Đà La Ni
因陀罗尼耶=Indraniye
因陀罗耆特=Nhân Đà La Kỳ Đặc
园咲=Sonozaki
园咲冴子=Sonozaki Saeko
园咲家=Gia tộc Sonozaki
园咲府邸=Dinh thự Sonozaki
园咲来人=Sonozaki Raimon
园咲琉兵卫=Sonozaki Ryubee
园咲若菜=Viên Tiếu Nhược Thái
园咲集团=Tập đoàn Sonozaki
园咲雾彦=Sonozaki Kirihiko
土忍者=Thổ Ninja
土魔兽=Thổ Ma Thú
圣主符咒=Thánh Chủ Phù Chú
圣城迦尸=Thánh Thành Ca Thi
圣心功=Thánh Tâm Công
圣心真气=Thánh Tâm Chân Khí
圣灵披风=Thánh Linh Phi Phong
圣辉星云=Tinh vân Thánh Huy
地之上神=Địa chi Thượng Thần
地之天使=Thiên sứ Đất
地之石=Đá Đất
地心之谷=Địa Tâm Chi Cốc
地极摩诃无量=Địa Cực Ma Kha Vô Lượng
地母昔弥=Địa Mẫu Tích Di
地狱大使=Đại sứ Địa ngục
地球之井=Giếng Trái Đất
地球和平联合组织=Tổ chức Liên hợp Hòa bình Trái Đất
地球图书馆=Thư viện Địa Cầu
地球巫女=Vu nữ Địa Cầu
地魁=Địa Khôi
坂田区=Khu Sakata
坟头草=cỏ mộ
坦达瓦=Tandava
埃尔斯巨岩=Tảng đá khổng lồ Els
城北大学=Đại học Johoku
城南大学=Đại học Jounan
城堡破坏者=Kẻ Phá Hoại Thành Trì
基加哥布纽=Giga Gebonew
基博隆=Kiboron
基基鲁=Gegiru
基基鲁游戏=Gegiru Game
基德隆=Kidlon
基德隆灵石=Linh thạch Kidoron
基德隆腰带=Gedoron Belt
基德鲁=Gegiru
基德鲁腰带=Đai lưng Gegeru
基里艾洛德之神=Thần Kirieloid
基里艾洛德预言家=Nhà tiên tri Kiri-elod
堤口夫人=Phu nhân Tsutsumiguchi
堤口惠美子=Tsutsumiguchi Emiko
塞巴斯蒂安—肖=Sebastian Shaw
塞巴斯蒂安肖=Sebastian Shaw
塞迪克科技公司=Công ty Khoa học Kỹ thuật Sedic
壳生女神=Xác Sinh Nữ Thần
复活者驾驭表头=Revive RideWatch
夏亚=Hạ Á/Char
夏海=Natsumi
夏目实加=Natsume Mika
夏目実加=Natsume Mika
夏目教授=Giáo sư Natsume
夏蜜柑=Natsumikan
夕瑶玄女=Tịch Dao Huyền Nữ
外浦海岸=Urakaigan
外祖母悖论=Nghịch lý bà ngoại
多刹迦=Đa Sát Ca
多摩市=Thành phố Tama
多摩市警察部=Sở Cảnh sát thành phố Tama
多摩江=Sông Tama
夜凌云=Dạ Lăng Vân
夜枭子=Dạ Kiêu Tử
夜柔吠陀=Yajurveda
大BOSS=Trùm Cuối
大修卡=Dai Shocker
大修卡城堡=Lâu đài Đại Tu Tạp
大修卡组织=Tổ chức Dai-Shocker
大兜虫=Kabutomushi/Bọ hung lớn
大力猫=Đại Lực Miêu
大力神发射井=Giếng phóng Đại Lực Thần
大力罗摩=Đại Lực La Ma
大哥斯拉=Đại Godzilla
大哥赎罪啊=Đại ca tha tội a
大地女神昔弥=Đại Địa Nữ Thần Tích Di
大天=Đại Thiên
大天之子=Đại Thiên Chi Tử
大天湿婆=Đại Thiên Shiva
大天生子=Đại Thiên Sinh Tử
大帝王=Đại Đế Vương
大文字隼=Daimonji Shun
大日琉璃诀=Đại Nhật Lưu Li Quyết
大杉忠太=Osugi Chuta
大橙丸=Daidaimaru
大残虐=Dai-Zangyack
大残虐军团=Đại Tàn Bạo Quân Đoàn
大残虐帝国=Great Zangyack Empire
大自然灵心=Đại Tự Nhiên Linh Tâm
大迦那主=Đại Ca Na Chủ
大黑暗天=Đại Hắc Ám Thiên
大黑暗天法象=Đại Hắc Ám Thiên Pháp Tượng
大黑虎佛=Đại Hắc Hổ Phật
天之川=Thiên Chi Xuyên
天之川学园=Học viện Amanogawa
天之川学园都市=Thiên Chi Xuyên Học Viện Đô Thị
天之川高校=Trường trung học Amanogawa
天亮号=Thiên Lượng Hào
天亮号事件=Sự kiện tàu Tenrei
天使光环=Thiên Sứ Quang Hoàn
天兵队长=Đội trưởng Thiên Binh
天命圣教=Thiên Mệnh Thánh Giáo
天帝伏羲=Thiên Đế Phục Hy
天帝因陀罗=Thiên Đế Indra
天帝神殿=Thiên Đế Thần Điện
天帝阿耆尼=Thiên Đế Agni
天悬白练=Thiên Huyền Bạch Luyện
天授海螺=Thiên Thụ Hải Loa
天文开关=Công tắc thiên văn
天池十二杀手=Thiên Trì Thập Nhị Sát Thủ
天狼堂=Thiên Lang Đường
天狼法杖=Thiên Lang Pháp Trượng
天狼神功=Thiên Lang Thần Công
天狼门=Thiên Lang Môn
天玄神刃=Thiên Huyền Thần Nhận
天王路=Tennouji
天王路博史=Tennouji Hiroshi
天界判官=Thiên Giới Phán Quan
天界法庭=Thiên Giới Pháp Đình
天界警备队=Thiên Giới Cảnh Bị Đội
天真之主=Thiên Chân chi chủ
天神星乐园化计划=Kế hoạch Lạc Viên hóa Thiên Thần Tinh
天神星防护罩=Thiên Thần Tinh Phòng Hộ Tráo
天秤判官=Thiên Xứng Phán Quan
天空魔=Thiên Không Ma
天蛇杖=Thiên Xà Trượng
天蝎座使徒=Scorpio Zodiarts
天装战队=Tensou Sentai
天装战队护星者=Thiên Trang chiến đội Hộ Tinh Giả
天门观想法=Thiên Môn Quan Tưởng Pháp
天音老人=Thiên Âm lão nhân
天音谷=Thiên Âm Cốc
天音门=Thiên Âm Môn
天香公主=Thiên Hương Công Chúa
天马弩=Pegasus Bowgun
天马形态=Pegasus Form
天马空我=Pegasus Form Kuuga
天魔三噬=Thiên Ma Tam Phệ
天魔之刃=Thiên Ma Chi Nhận
天魔九噬=Thiên Ma Cửu Phệ
天魔乱舞大法=Thiên Ma Loạn Vũ Đại Pháp
天魔六欲五行破灭大混洞妙法=Thiên Ma Lục Dục Ngũ Hành Phá Diệt Đại Hỗn Động Diệu Pháp
天魔国=Thiên Ma Quốc
天魔大化=Thiên Ma Đại Hóa
天魔大霹雳=Thiên Ma Đại Phích Lịch
天魔女葵羽=Thiên Ma Nữ Quỳ Vũ
太古魔兽=Thái Cổ Ma Thú
太平二丁目富永公司总部大厦=Trụ sở chính Tòa nhà Công ty TNHH Tominaga, Taito 2-chome
太牙=Taiga
太白仙人=Thái Bạch tiên nhân
太白老爹=Thái Bạch Lão Đệ
太阳神甲=Thái Dương Thần Giáp
太阳神苏利耶=Thần Mặt Trời Surya
太阳神马=Thái Dương Thần Mã
太阴上人=Thái Âm Thượng Nhân
太阴宗=Thái Âm Tông
太阴玄冰阵=Thái Âm Huyền Băng Trận
头提头颅者=Đầu Đề Đầu Lư Giả
奇车王=Kỳ Xa Vương
奈奈=Nana
奈奈酱=Nana-chan
奈雀儿=Natsue
奔雷剑=Bôn Lôi Kiếm
奔雷剑主=Bôn Lôi Kiếm Chủ
奢耶=Jaya
奥古玛=Áo Cổ Mã
奥特之父=Ultra Father
奥特大力龙象飞踢=Ultraman Đại Lực Long Tượng Phi Thích
奥特曼世界=Thế Giới Ultraman
奥特签名=Chữ ký Ultraman
奥特赛文=Ultra Seven
女娲大神=Nữ Oa Đại Thần
女娲血玉=Nữ Oa Huyết Ngọc
女王乌鸦尊者=Nữ Vương Quạ Tôn Giả
女王蚂蚁尊者=Nữ Vương Kiến Tôn Giả
好好吃饭=ăn cơm thật ngon
如意神树=Như Ý Thần Thụ
如意神牛=Như Ý Thần Ngưu
如月弦太朗=Gentaro Kisaragi
妖星格拉斯=Yêu tinh Grass
妙光=Diệu Quang
妙相仙人=Diệu Tướng Tiên Nhân
妙竹=Diệu Trúc
妙见=Diệu Kiến
妙见神轮=Diệu Kiến Thần Luân
妙项=Diệu Hạng
娑尼=Sa Ni
娑底耶=Ta Để Gia
娑摩吠陀=Samaveda
娑罗室伐底女神=Nữ thần Sarasvati
娑罗室伐底女神之力=Ta Bà Thất Phạt Để Nữ Thần Chi Lực
娑罗室伐底河=Sông Toa La Thất Phạt Để
娑罗尼尤=Salarinju
娑羅室伐底=Sa La Thất Phạt Để
娜迦之王=Na Già Chi Vương
娜迦蛇王=Naga Xà Vương
婆力古=Bhrigu
婆毗文=Bà Tỳ Văn
婆罗多=Bharata
婆罗娑罗摩=Parashurama
孙尼塔=Sunita
孙跋=Tôn Bạt
孙跋阿修罗=Tôn Bạt A-tu-la
孝义黑三郎=Hiếu Nghĩa Hắc Tam Lang
孤阴不长=cô âm bất trường
宁三叉戟=Ninh Tam Xoa Kích
宇宙球体斯菲亚=Quả Cầu Vũ Trụ Sphia
宇宙钢铁龙=Long thép vũ trụ
宇宙钢铁龙古瓦木=Long thép vũ trụ Guwamu
安伽=An Già
安伽城=An Già Thành
安奢那=Anjana
安溪海底城=An Khê Hải Để Thành
安陀迦=Andhaka
安陀迦那=An Đà Ca Na
宗方副队长=Đội trưởng phó Munakata
宗武海岸=Bãi biển Munetake
定锁种子=Lock Seed
宝青坊=Bảo Thanh Phường
宝青坊主=Bảo Thanh Phường Chủ
审判之杖=Trượng Phán Quyết
室利因陀罗=Thất Lợi Nhân Đà La
室利那罗延=Sri Narayana
室建陀=Skanda
宿那山=Núi Sukuna
宿那鬼=Ác quỷ Sukuna
寒冰面具=Hàn Băng Diện Cụ
对方外出=đối phương ra ngoài
封印之石=Phong Ấn Thạch
小冴=Sae
小太牙=Tiểu Taiga
小李=Tiểu Lý/Lee
小泽澄子=Ozawa Sumiko
小渡=Wataru
小短腿=chân ngắn nhỏ
小稔=Minoru
小稔稔=Komu Minoru
小象神伽内什=Thần Voi Ganesha
小野寺雄介=Onodera Yusuke
小鱼水中游=Tiểu Ngư Thủy Trung Du
尘云=Trần Vân
尸之刀=Corpse Blade
尼嘉将军=Tướng quân Ni Gia
尼奢陀=Nishaadha
尼婆多迦婆遮=Ni Bà Đa Già Bà Che
尼孙跋=Ni Tôn Bạt
尼迦斯=Ni Ca Tư
尾上巧=Onoue Takumi
尾室隆弘=Omiro Takahiro
山之恶魔波刚=Ác ma núi Bagan
山北町立花小学=Yamakita Tachibana Elementary School
山君庙=Sơn Quân miếu
岗村老师=Thầy Okamura
岛升=Shima Noboru
岡村可奈=Okamura Kana
岩浆掺杂体=Nham Tương Tham Tạp Thể
崇皇时王=Grand Zi-O
崛井=Quật Tỉnh
崩德罗迦=Paundraka
崴尔兹=Wels
崴尔兹·吉尔=Warz Gill
川原=Kawahara
川原一步=Kawahara Ayumu
川原一路=Kawahara Ichiro
川原先生=Kawahara tiên sinh
川原愿=Kawahara Negai
川原正=Kawahara Tadashi
左翔太郎=Hidari Shotaro
巨人骑士=Cự Nhân Kỵ Sĩ
巨大吼声=cự đại tiếng rống
巨山相扑超魔兽=Quái thú Sumo Siêu Ma Núi Lớn
巨马战舰=Tàu chiến Kyoma
巨魔兵=Cự Ma Binh
巨魔团=Cự Ma Đoàn
巴乎迦=Ba Hô Già
巴夏=Basshaa
巴格达(baguda)=Baghdad
巴湿伽罗=Ba Thấp Già La
巴贝鲁=Baberu
布湿波迦=Bùshī bōjiā
布莱克警长=Cảnh trưởng Blake
布陀=Budha
布雷多兰=Buredoran
希特拉=Hi Tạp Lạp
帕媚陀拉妮=Patumtara
帕尔瓦蒂女神=Nữ thần Parvati
帕罗格=Paroga
帝国恶魔攻略计划=Kế hoạch chinh phục ác ma đế quốc
帝王石=Kingstone
帝骑=Decade/Đế Kỵ
常在仙人=Chang Zai Xianren
常磐庄吾=Tokiwa Sougo
干燥之雷=Khô Táo Chi Lôi
幻景酒店=Khách sạn Mirage
幽冥界八云易=U Minh Giới Bát Vân Dịch
幽怜=U Liên
幽灵螳螂=Bọ ngựa ma
广濑义人=Hirose Yoshito
广濑先生=Ông Hirose
广濑栞=Hirose Shiori
广袤神=Quảng Mậu Thần
广袤神阿迦奢=Quảng Mậu Thần A-ca-xá
广袤阿迦奢天=Quảng Mậu A Già Xa Thiên
庄吾=Trang Ngô
床界山=Sàng Giới Sơn
库摩兰妮=Kumolanani
底提=Dethius
底提之子=Đế Đề Chi Tử
底提耶=Ditiye
庚伮金刚杵=Geng Nu Kim Cang Chử
度母=Độ Mẫu
康纳基=Connarky
异域者=Inves
异域者游戏=Trò chơi Inves
异次元魔神艾塔尔加=Dị Thứ Nguyên Ma Thần艾塔尔加
异界伐楼那=Dị Giới Phạt Lâu Na
异界伐由=Dị Giới Phạt Do
异界因陀罗=Dị Giới Nhân Đà La
异界梵天=Phạm Thiên Dị Giới
异界毗湿奴=Tỳ Thấp Nô Dị Giới
异界毗首羯磨=Dị Giới Tỳ Thủ Yết Ma
异界苏利耶=Dị Giới Tô Lợi Gia
异界阿耆尼=Dị Giới A Kỳ Ni
异类Build=Another Build
异类Decade=Another Decade
异类ZiO=Another Zi-O
异类ZiO二阶=Another Zi-O Nhị Giai
异类亚极陀=Another Agito
异类大橙丸=Another Daidai Maru
异类甲斗=Another Kabuto
异类电王=Another Den-O
异类铠武=Another Gaim
引妖香=Dẫn Yêu Hương
弗栗多=Vritra
张凌雪=Trương Lăng Tuyết
弥娜迦=Menaka
弥提罗国=Mithila
弥那迦山=Di Na Ca Sơn
弦太朗桑=Gentaro-san
强生健体=cường sinh kiện thể
彩虹魔境=Cầu Vồng Ma Cảnh
影子=cái bóng/Ảnh Tử/hình bóng/ảnh tử/bóng dáng/bóng/dáng/hình/ấn tượng/hình ảnh mờ nhạt
影子将军=Tướng Quân Bóng Tối
御殿场线=Gotenba Line
德伐波罗=Dvapara
德伽=Dogga
德克萨斯炮=Đức Khắc Tát Tư Pháo
德兰龙城堡=Lâu đài Doran
德拉姆车=Xe Dram
德髻=Đức Kế
心中一震=chấn động trong lòng
心水=Tâm Thủy
快乐星猫=Happy Star Cat
快活林酒坊=Khoái Hoạt Lâm Tửu Phường
快螳螂=Khoái Đường Lang
忿怒之塔=Tháp Phẫn Nộ
怒剑=Nộ Kiếm
怒剑狂刀=Nộ Kiếm Cuồng Đao
怔愣=sững sờ/giật mình
怛特罗=Đát Đặc La
怛罗=Tara
怛罗女神=Tara
怛（da）罗女神=Đát La Nữ Thần
怜悯之弓=Cung Thương Xót
怨嗟之堕=Oán Ta Chi Đọa
怪兽行星=Hành tinh quái vật
总武本线=Tổng Vũ Bản Tuyến
恐怖大王=Khủng Bố Đại Vương
恐惧掺杂体=Terror Dopant
恐惧沼泽=Đầm lầy Khủng bố
恐惧记忆体=Terror Memory
恒河女神=Hằng Hà Nữ Thần
恩·达古巴·杰巴=N-Daguva-Zeba
恰雅=Qià yǎ
恶鬼迦娜=Ác Quỷ Ca Na
恶魔小龙=Ác Ma Tiểu Long
悉多梵=Sita Phạm
悟饭=Gohan
悠悠然地道=khoan thai nói
悠木=Yuki
悲痛莫名=Bi Đau Mạc Danh
情欲阿修罗=Tình Dục A-tu-la
惊异全能空我=Amazing Mighty Kuuga
惊瑞之期=Kinh Thụy Chi Kỳ
感觉中医=cảm giác Trung y
愤怒之塔=Tháp Phẫn Nộ
戈冥=Gormin
戈冥战斗员=Chiến binh qua minh
成龙历险记】=Những cuộc phiêu lưu của Thành Long
我儿=ta nhi
我望光明=Garou Izumi
我等大师你=ta đợi Đại Sư ngươi
战极凌马=Chiến Cực Lăng Mã
战极驱动器=Sengoku Driver
战狼军团=Chiến Lang Quân Đoàn
战神迦希吉夜=Chiến Thần Già Hi Cát Dạ
戳眼者=Người Chọc Mắt
戴西斯星人=Người Dessis
戴西斯星系=Hệ Daiysis
所谓好坏的=cái gọi là tốt và xấu
手打=Teuchi/tay đánh
手持雷杵=Vajra-Holder
扶我起来我还能继续战斗=Đỡ ta dậy ta vẫn còn có thể tiếp tục chiến đấu
投山仙人=Đầu Sơn Tiên Nhân
护世神=Hộ Thế Thần
护世神毗湿奴=Hộ Thế Thần Tỳ Thấp Nô
护星红=Hộ Tinh Đỏ
拄着手杖=dựa vào thủ trượng
拉伊哈罗巴舞=Lai Haroba
拉克什米=Lakshmi
拉克什米女神=Lakshmi
拉集团=Nhóm Ra
拘湿伽=Câu Thấp Già
拘湿迦=Câu Thấp Ca
拘魂套索=Câu Hồn Sáo Tác
拟似记忆体=Giả Lập Memory
拿山君庙=Ná Sơn Quân Miếu
持金刚杵者=Trì Kim Cương Chử Giả
接龙=chơi đô-mi-nô/chơi domino
掺杂体=Dopant
提婆希那=Đề Bà Hi Na
提毗波=Dvipa
提迭=Die
提迭希那=Đề Điệt Hi Na
搀杂体=Dopant
搭帕=Đát Mạt
摄天剑=Nhiếp Thiên Kiếm
摩伽婆=Ma Già Bà
摩伽罗=Makara
摩伽罗之剑=Ma Già La Chi Kiếm
摩利坎杜=Marikandu
摩厘耶梵山=Ma Lị Gia Phạn Sơn
摩喜施末底=Mahishmati
摩多梨=Matali
摩奴=Manu
摩根德耶=Ma Căn Đức Gia
摩梨伽尸罗=Ma Lê Già Thi La
摩磋=Matsya
摩羯判官=Ma Kết Phán Quan
摩羯罗=Makara
摩耶之光=Ma Da Chi Quang
摩耶之力=Ma Da Chi Lực
摩耶城=Ma Da Thành
摩耶幻力=Maya Ảo Lực
摩耶幻术=Ma Da Huyễn Thuật
摩耶智慧=Trí tuệ Maya
摩耶苍穹=Ma Gia Thương Khung
摩耶迷宫=Ma Da Mê Cung
摩耶阿修=Ma Da A Tu La
摩耶阿修罗=Ma Gia A Tu La
摩西妮=Mohini
摩西沙=Moshisha
摩西沙阿修罗=Ma Tây Sa A Tu La
摩西湿=Ma Tây Thấp
摩诃因陀罗=Ma Ha Nhân Đà La
摩诃班达=Ma Ha Ban Đà
摩诃迦梨=Ma Ha Ca Lỵ
摩诃钵利=Ma Ha Bát Lợi
摩诃阿底提耶=Ma Ha A Để Đề Gia
摩鲁特=Marut
撒旦军刀=Satan Saber
敝衣=Bế Y
敝衣仙=Tệ Y Tiên
敝衣仙人=Tệ Y Tiên Nhân
文尼=Vinny
文底耶山=Vindhya
斗争时代=Đấu Tranh Thời Đại
斗真=Touma
斗真(Theos)=Tōma
斩侠大会=Trảm Hiệp Đại Hội
斩那牟质=Namuchi-Slayer
斯沃鲁兹=Swartz
斯菲亚球体=Hình cầu Sphia
斯菲亚生命体=Thực thể sống Sphia
新宿站=Ga Shinjuku
新宿警局=Sở cảnh sát Shinjuku
新日本桥站=Ga Shin-Nihombashi
新麦克斯炮=Tân Mạch Khắc Tư Pháo
方位者=Phương vị Giả
方块10=Rô 10
方块A=Rô A
方块K=Rô K
方大法师=Phương Đại Pháp Sư
旋风剑主=Toàn Phong Kiếm Chủ
无双军刀=Musou Saber
无形道=Vô Hình Đạo
无忧妙=Vô Ưu Diệu
无所谓好坏的=không quan trọng nó tốt hay xấu
无效卡=Thẻ Vô Hiệu
无极拈花指=Vô Cực Niêm Hoa Chỉ
无限麦克斯动力系统=Hệ thống động lực Max Vô Hạn
无限麦克斯系统=Hệ thống Max vô hạn
日出山=Nhật Xuất Sơn
日落山=Nhật Lạc Sơn
旱魔弗栗多=Hạn Ma Phất Lật Đa
时劫者=Time Jackers
时夜=Thời Dạ
时夜女神=Thời Dạ Nữ Thần
时空之力=Sức mạnh Thời Không
时空之壁=Bức tường Không-Thời gian
时空城=Thời Không Thành
时空界=Giới Thời Không
时空驱动器=Ziku-Driver
时间极限剑=Saikyo Girade
时间降临=Thời Gian Giáng Lâm
时间降临卡牌=Thẻ Thời Gian Giáng Lâm
明光院盖茨=Myōkōin Geiz
明台桥=Minh Đài Kiều
明度贝=Mindobe
昔弥=Tích Di
昔弥天=Tích Di Thiên
昔弥女神=Tích Di Nữ Thần
星之碎片=Mảnh vỡ Ngôi sao
星云体=Tinh Vân Thể
星座使徒=Apostle Chòm sao
星座使徒开关=Zodiac Astro Switch
星座开关=Astro Switches
星座战士=Tinh Tọa Chiến Sĩ
星座装甲=Tinh Tọa Trang Giáp
星徒开关=Công tắc Stardust
星猫=Tinh Miêu
星盘阵=Tinh Bàn Trận
星目阿修罗=Tinh Mục A Tu La
星辰母=Mẹ của Các Vì Sao
春滋泉=Xuân Tư Tuyền
春滋神泉=Xuân Tư Thần Tuyền
昴星女神=Mão Tinh Nữ Thần
昴星神=Pleiades
昴星高校=Subaru High School
普罗曼=Phổ La Mạn
普罗米斯=Prometheus
普里提=Phổ Lí Đề
普鲁沙=Phổ Lỗ Sa
景菁=Cảnh Tinh
晴人=Haruto
智人=Trí Nhân
智人迦玛帕拉=Trí Nhân Già Ma Ba Lạp
暗之力=Sức mạnh Bóng tối
暗夜牙血鬼=Fangire Bóng Đêm
暗黑Kiva=Dark Kiva
暗黑三叉戟=Ám Hắc Tam Xoa Kích
暗黑魔铠装=Ám Hắc Ma Khải Trang
暴力掺杂体=Bạo Lực Tham Tạp Thể
暴太郎战队=Avataro Sentai Donbrothers
暴躁因陀罗=Bạo Táo Nhân Đà La
暴躁苏利耶=Bạo Táo Tô Lợi Gia
暴风战戟=Storm Halberd
曜星=Diệu Tinh
曲女城=Khúc Nữ Thành
曼妲=Manda
曼度陀里=Mạn Độ Đà Lí
曼罗迦=Manasa
曼荼罗山=Mạn Đồ La Sơn
曼迦勒=Mạn Già Lặc
曼陀罗山=Mạn Đà La Sơn
曼陀罗山脉=Dãy núi Mandara
月之恶魔=Ác ma mặt trăng
月影信彦=Tsukikage Nobuhiko
月桂叶=Lá nguyệt quế
月神之子【布陀】=Con trai của Thần Mặt Trăng [Budha]
月神苏摩=Nguyệt Thần Soma
月铃母=Nguyệt Linh Mẫu
月魇=Nguyệt Yểm
月魇之刀=Nguyệt Yểm Chi Đao
有喜仙人=You Xi Xianren
朝比奈奈奈=Asahina Nana
木橘叶=Mộc Quất Diệp
木野先生=Ngài Kino
木野熏=Kino Kaoru
木野熏AgtiΩ=Kaoru Kino Agito
木野薫=Kino Kaoru
木野薰=Kino Kaoru
未晴=Misora
未来核心硬币=Huy chương Cốt lõi Tương lai
未来逢魔时王=Oma Zi-O tương lai
未知生命体=Unknown Lifeform
未知生命体对策组=Nhóm Biện pháp Đối phó Sinh vật Chưa biết
未确认生命体=Unidentified Life Form
未确认生命体22号=Sinh vật sống chưa xác định số 22
未确认生命体37号=Sinh vật chưa xác nhận số 37
未确认生命体42号=Unidentified Lifeform Số. 42
未确认生命体46号=Sinh vật sống chưa xác định số 46
未确认生命体47号=Sinh vật chưa xác nhận số 47
未确认生命体4号=Sinh vật chưa xác định số 4
未确认生命体事件=Vụ án sinh vật chưa xác định
未确认生命体档案=Hồ sơ Sinh vật chưa xác nhận
未确认生命体联合搜查总部=Tổng bộ điều tra liên hợp vật thể sống chưa xác định
未确认生命体联合搜查本部=Trụ sở Điều tra Liên hợp Sinh vật Chưa xác định
未确认生命体联合搜查部=Bộ phận Điều tra Chung về Sinh vật Sống Chưa được Xác nhận
未確認生命体=Unidentified Life Form
本金书=bản kim thư
机械冲天号=Machine Meteorstar
机械十年号=Machine Decader
机械哥斯拉=Mecha Godzilla
机械龙卷者=Machine Tornado
杀弗栗多=Vritra-Slayer
杂林苑=Tạp Lâm Uyển
杉田=Sugita
杉田警官=Thanh tra Sugita
李雾龙=Lý Vụ Long
杜兰塔克=Đỗ Lan Tháp Khắc
杜尔迦玛=Đỗ Nhĩ Già Ma
杜尔迦马=Durgama
杜摩陀耆尼=Đỗ Ma Đà Kỳ Ni
杜浑陀=Đỗ Hỗn Đà
杜鲁刚=Đỗ Lỗ Cương
杰克将军=Tướng Quân Jack
東都=Tokyo
杵瘤=Xử Lựu
松仓=Matsukura
松仓先生=Ông Matsukura
松仓贞雄=Sadao Matsukura
松仓部长=部長松倉
松倉=Matsukura
板桥区=Quận Itabashi
极光帷幕=Màn cực quang
极裕仙人=Vasishtha
极限疾风王牌=Cyclone Joker Xtreme
林业平=Lâm Nghiệp Bình
林氏王朝=Lâm Thị vương triều
林迦=Linga
林迦柱=Lâm Già Trụ
枫叶大阵=Phong Diệp Đại Trận
枫叶武士=Phong Diệp võ sĩ
柯尔=Kha Nhĩ/Cole/Cora
柯尔·沃克=Cole Walker
柳橙定锁种子=Orange Lock Seed
栃木县=Tỉnh Tochigi
栗原天音=Kurihara Amane
栗原遥香=Kurihara Haruka
核心开关=Hạch Tâm Khai Quan
核心硬币=Core Medal
根组织=Root
根部忍者=Root ninja
格兰雷恩=Gran Reign
格拉斯中校=Trung tá Glass
桑娜提=Tang Na Đề
桑布提=Sambūti
桔梨箩柚=Quất Lê La Dữu
梅花A=Chuồn A
梅花K=Chuồn K
梅花Q=Chuồn Q
梓诉=Tử Tố
梨俱吠陀=Rigveda
梨多=Rita
梵力=Phạm Lực
梵卵=Brahmanda
梵天之颅=Sọ Phạm Thiên
梵天界=Phạm Thiên Giới
梵湖=Phạm Hồ
梵颅=Phạn Lô
棕发女=Tóc Nâu Nữ
森美队=Sâm Mỹ Đội
棱镜耀光（剑与盾）=Prism Bicker
椿先生=Ông Tsubaki
椿医生=Bác sĩ Tsubaki
椿秀一=Tsubaki Shuichi
楞伽城=Lăng Già Thành
榊亚纪=Sakaki Aki
榎田=Enokida
榎田光=Enokida Hikari
榎田女士=Enokida-san
榎田教授=Giáo sư Enokida
樱井警官=Cảnh sát Sakurai
橄榄之国弗朗机=Nước Olive Phlang Cơ
橘朔也=Tachibana Sakuya
橘纯=Tachibana Jun
檀奴=Danu
檀奴之子=Đàn Nô Chi Tử
檀奴克=Đàn Nô Khắc
檀奴迦=Đàn Nô Già
檀那婆=Đàn Na Bà
檀那婆族=Đàn Na Bà Tộc
檀那婆普罗曼=Đàn Na Bà Phổ La Mạn
檀那婆王=Đàn Na Bà Vương
檀那婆王普罗曼=Vua Danava Proman
欧布=Uub
欧帕兹研究所=Viện Nghiên cứu Ooparts
欧应万=Âu Ứng Vạn
欧若拉之眼=Đôi mắt của Aurora
歌星贤吾=Utahoshi Kengo
正法之神=Chính Pháp Chi Thần
正法之网=Lưới Chánh Pháp
正法战士=Chiến binh chính pháp
正法神=Chính Pháp Thần
正理经=Chánh Lý Kinh
步氏神族=Bộ Thị Thần Tộc
武器掺杂体=Arms Dopant
武大强=Võ Đại Cường
武神Fourze=Vũ Thần Fourze
武神OOO=Vũ Thần OOO
武神W=Vũ Thần W
武神Wizard=Vũ Thần Wizard
武神铠武=Vũ Thần Gaim
武神骑士=Vũ Thần Rider
歩渊亭=Bộ Uyên Đình
死神博士=Doctor Shinigami
死神套索=Dây thòng lọng Thần Chết
死神阎摩=Tử Thần Diêm Ma
残虐军队=Zangyack Army
残虐帝国=Đế quốc Zangyack
残虐干部=Zangyack Cadre
比那迦=Pinaka
比那迦神弓=Pinaka
毕鲁萨鲁多=Tất Lỗ Tát Lỗ Đa
毕鲁萨鲁多人=Tất Lỗ Tát Lỗ Đa Nhân
毕鲁萨鲁多族长=Tộc trưởng Bilusaldo
毗奢密多罗=Vishwamitra
毗奢耶=Vijaya
毗娜达=Tỳ Na Đạt
毗娜迦=Pinaka
毗娜迦之弓=Cung Pinaka
毗娜迦神弓=Cung thần Pinaka
毗婆罗吉提=Tỳ Bà La Cát Đề
毗尸罗婆=Tỳ Thi La Bà
毗德尔跋=Vidarbha
毗恭吒=Tỳ Cung Tra
毗毗陀迦树=cây Vibhitaka
毗波制底=Tỳ Ba Chế Để
毗湿奴之力=Tỳ Thấp Nô Chi Lực
毗湿摩=Bhishma
毗罗=Tỳ La
毗羚陀=Tỳ Lăng Đà
毗老师=Thầy Tỳ
毗诃波提=Tỳ Ha Ba Đề
毗贡吒=Vaikuntha
毗达斯=Vitas
毗那夜迦=Vinayaka
毗里妮=Virini
毗首羯磨=Tỳ Thủ Yết Ma
毗首羯磨之妻=Tỳ Thủ Yết Ma Chi Thê
毫无灵智=không có trí thông minh
水之上神=Thủy chi Thượng Thần
水之天使=Thiên sứ Nước
水之恶魔=Ác ma nước
水元公园=Công viên Mizumoto
水城史朗=Mizushiro Shiro
水持=Svadhisthana
水星神=Thủy Tinh Thần
水母Undead=Undead Sứa
水泽水上乐园=Công viên nước Mizusawa
水火土风雷=Thủy Hỏa Thổ Phong Lôi
水牛古朗基=Gurongi Trâu Nước
水牛尊者=Minotaur Lord
水瓶判官=Thủy Bình Phán Quan
水神伐楼那=Thủy Thần Phạt Lâu Na
水神岛=Thủy Thần Đảo
水神王=Thủy Thần Vương
永安当=Vĩnh An Đương
永童仙人=Yong Tong Xianren
汉堡套餐=Hamburger Set
汉塔克=Hantake
江东区=Quận Koto
江東区=Koto
汪静=Uông Tĩnh
沙利耶迦=Sa Lợi Da Ca
沙漠死神内瑟斯=Sa Mạc Tử Thần Nasus
沙福林=Sa Phúc Lâm
沙罗宝多迦=Sa La Bảo Đa Ca
沢芽市=Zawame City
河野=Kouno
河野警官=Cảnh sát Kawano
泉比奈=Hina Izumi
法医鉴定科=Khoa Giám định Pháp y
波刚=Ba Cương
波士顿芬威球场=Sân vận động Fenway Park Boston
波罗跋娑=Ba La Bạt Sa
波陀罗=Patala
波陀罗之界=Patala Giới
波陀罗界=Ba Đà La Giới
泥犁=Nê lê
泥犁若=Nê lê nhược
泰坦剑=Titan Sword
泰坦形态=Titan Form
泰坦空我=Titan Kuuga
泰雷=Thái Lôi
泽井=Trạch Tỉnh
泽井总监=Tổng giám đốc Sawai
泽木=Sawaki
泽木先生=Ông Sawaki
泽木哲也=Sawaki Tetsuya
泽木雪菜=Sawaki Yukina
泽渡小姐=Cô Zawa-do
泽渡樱子=Sawatari Sakurako
洛佩=Lạc Bội
洛摩巴陀=Lạc Ma Ba Đà
津上=Tsugami
津上先生=Tsugami
津上家=Gia tộc Tsugami
津上府邸=Dinh thự Tsugami
津上翔一=Tsugami Shoichi
津奈姐姐=Tsuna tỷ tỷ
津奈美=Tsunami/Tân Nại Mỹ
洪呼王=Hồng Hô Vương
流浪武士=lang thang Samurai
浑天四绝=Hỗn Thiên Tứ Tuyệt
浑陀=Hỗn Đà
浣熊大师=Sư phụ Gấu Mèo
海蛇古朗基=Hải Xà Gurongi
海豚泳馆=Hồ bơi Dolphin
海贼战队=Kaizoku Sentai
海贼战队豪快红=Kaizoku Sentai Gokaiger
涉谷区=Shibuya-ku
涉谷站=Ga Shibuya
深海里沙=Risa Fukami
深蓝圆舞曲=Thâm Lam Viên Vũ Khúc
渡津者=Độ Tân Giả
温驽=Ôn Nô
港区东京塔=Tháp Tokyo khu Minato
港口公寓=Căn hộ Cảng
湿婆神力=Thấp Bà Thần Lực
湿润之雷=Ướt Át Chi Lôi
溺爱阿修罗=Nịch Ái A Tu La
滋集团=Nhóm Zuu
漆黑JOKER=Black Joker
漆黑空我=Kuga đen
潘库=Phan Khố
潘库宝盒=Hộp Bàn Khố
潘普洛纳古城=Cổ thành Pamplona
澤木哲也=Sawaki Tetsuya
澳国总统=Tổng thống Úc
火之上神普罗米斯=Hỏa chi Thượng Thần Prometheus
火之天使=Hỏa Chi Thiên Sứ
火天使=Thiên Sứ Lửa
火无定=Hỏa Vô Định
火星曼迦勒=Hỏa Tinh Mạn Già Lặc
火焰军刀=Kiếm lửa
火焰哥尔赞=Hỏa Diễm Gorzam
火神阿耆尼=Hỏa Thần A Kỳ Ni
火舞旋风=Hỏa Vũ Toàn Phong
火野映司=Eiji Hino
火鬼王=Hỏa Quỷ Vương
火魔兽=Hỏa Ma Thú
火麟飞=Hỏa Lân Phi
火龙果定锁种子=Dragon Fruit Lock Seed
灭世班达=Diệt Thế Ban Đà
灯熔山=Núi Touyou
灯熔山遗迹=Di tích núi Torō
灰狼拉夫尔=Sói xám Laffer
灵山引=Linh Sơn Dẫn
灵山掌=Linh Sơn Chưởng
灵山渡=Linh Sơn Độ
灵山门=Linh Sơn Môn
灵山门主=Linh Sơn môn chủ
灵泉宝玉=Linh Tuyền Bảo Ngọc
灵鱼摩蹉=Linh Ngư Ma Tha
灵龟库尔玛=Linh Quy Khố Nhĩ Mã
炎东省=Viêm Đông tỉnh
炎国联盟=Viêm Quốc Liên Minh
炎拳=Viêm Quyền
炎波泉=Viêm Ba Tuyền
炎波血刃=Viêm Ba Huyết Nhận
炎魔战士=Chiến binh Yan Ma
炎魔战士基里艾洛德人=Chiến binh Quỷ Lửa Kirieloid
炎魔战士基里艾洛德人二代=Chiến binh Quỷ Lửa Kirieloid II
烈火凤凰=Inferno Phoenix
烈火狮王=Liệt Hỏa Sư Vương
烟目=Yên Mục
烟目阿修罗=Yên Mục A Tu La
照井龙=Terui Ryu
照胆泉=Chiếu Đảm Tuyền
熊猫阿宝=Gấu trúc A Bảo
燕尾蝶牙血鬼=Fangire Bướm đuôi én
爱姆=Ahim
爱婆罗多=Airavata
爱神迦摩=Thần Tình Yêu Kama
爱罗婆多=Ai La Bà Đa
爱罗婆多主神庙=Ái La Bà Đa Chủ Thần Miếu
爱罗婆多神庙=Đền Airavata
爱罗婆罗=Ái La Bà La
片平久雄=Katahira Hisao
片平真由美=Katahira Mayumi
牙兰=Galan
牙查苏=Tô Răng Hô
牙蝙蝠族=Tộc Răng Dơi
牙血鬼=Fangire
牙血鬼之王=Chúa tể Fangire
牛战士=Ngưu Chiến Sĩ
牛节=Ngưu Tiết
牛节望=Uchchaihshravas
牛节王=Ngưu Tiết Vương
牟质=Mưu Chất
特命战队=Tokumei Sentai
特里库=Đặc Lí Khố
特雷达=Treta
特鲁妈妈=Mẹ Tulu
犀牛古朗基=Rhino Gurongi
狂刀怒剑=Cuồng Đao Nộ Kiếm
狂野Chalice(卡利斯)=Wild Chalice
狂野斩击者=Wild Slasher
狂雷天牢=Cuồng Lôi Thiên Lao
狗将军=Cẩu Tướng Quân
狗都不当=chó cũng không làm
独眼乌鸦尊者=Quạ Một Mắt Chúa Tể
独角仙噬欲怪=Bọ Cánh Cứng Phệ Dục Quái
独角兽座星座使徒=Unicorn Zodiarts
独阳不生=độc dương bất sinh
狮子树海=Sư Tử Thụ Hải
狮面=Sư Diện
狮面阿修罗=Sư Diện A Tu La
狼族古朗基=Gurongi tộc Sói
狼族古朗基之王=Vua Gurongi tộc sói
狼蛛Undead=Undead Nhện sói
狼鱼=Cá sói
猎户座星座使徒=Orion Zodiarts
猎犬座星座使徒=Canis Minor Zodiarts
猎隼尊者=Falcon Lord
猩猩乔治=Tinh tinh George
猪笼城寨=Lồng Heo Thành Trại
猪笼草异域者=Inves Cây Nắp Ấm
猫头鹰古朗基=Cú Guronji
猫头鹰尊者=Owl Lord
猴国=Hầu Quốc
獠牙x王牌=FangJoker
獠牙王牌=Fang Joker
玄冥之棺=Huyền Minh Chi Quan
玄冥黑洞=Huyền Minh Hắc Động
玄冰护体=Huyền Băng Hộ Thể
玄易子=Huyền Dịch Tử
玄武号=Huyền Vũ Hào
玄武号飞船=Phi thuyền Huyền Vũ
玄道观=Huyền Đạo Quán
玄阴剑晨=Huyền Âm Kiếm Thần
玉兔仙子=Ngọc Thố Tiên Tử
玉兔舱=Khoang Thỏ Ngọc
玉蟾宫=Ngọc Thiềm Cung
玉龙阴狐和合功=Ngọc Long Âm Hồ Hòa Hợp Công
王中因陀罗=Vương Trung Nhân Đà La
玛贝拉斯=Marvelous
玫瑰女=Nữ Hoa Hồng
珍珠贝牙血鬼=Pearl Fangire
班苏里笛=Ban Tô Lý Địch
班达阿修罗=Ban Đạt A Tu La
理论研究=lí luận nghiên cứu
瑞兽凤血=Thụy Thú Phượng Huyết
瑞兽精元=Thụy Thú Tinh Nguyên
瓦龙=Ngõa Long
甘蔗族=Cam Giá Tộc
甘陀利=Cam Đà Lợi
甚至已经=thậm chí đã
生主达刹=Sinh Chủ Đạt Sát
田崎秀二=Tasaki Shuji
甲斗=Kabuto
甲虫牙血鬼=Fangire bọ cánh cứng
电环=Điện Hoàn
畏怖尊=Bhairava
疾风王牌=Cyclone Joker
疾风王牌黄金极限形态=Phong Tật Vương Bài Hoàng Kim Cực Hạn Hình Thái
白井农场=Nông trại Shirai
白井虎太郎=Shirai Kotaro
白发乌鸦尊者=White-haired Raven Lord
白暗游戏=Trò chơi Hakuan
白暗阶段=Giai đoạn trắng đen
白神普罗米斯=Hakushin Prometheus
白羊判官=Bạch Dương Phán Quan
白羊武士=Bạch Dương Võ Sĩ
白羊虚影=Bạch Dương Hư Ảnh
白色2号=White No. 2
白色保命形态=màu trắng Growing Form
白色初生形态=màu trắng Growing Form
白色初生空我=White Proto Kuuga
白色小蝙蝠=Dơi trắng nhỏ
白苗族=Bạch Miêu Tộc
白蛇缘起=Bạch Xà Duyên Khởi
白象之王=Bạch Tượng Chi Vương
白象爱罗婆多=Bạch Tượng Ai La Bà Đa
白鼠谷=Bạch Thử Cốc
白龙族=Bạch Long Tộc
百祭=Bách Tế
百草谷=Bách Thảo Cốc
盎伽=Áng Già
盖世五侠=Ngũ Hiệp Cái Thế
盖亚记忆体=Gaia Memory
盖图跋=Cái Đồ Bạt
盖达跋=Cái Đạt Bạt
盗取鲜花者=Kẻ trộm hoa
盘螭神云枪=Bàn Si Thần Vân Thương
相川始=Aikawa Hajime
相良克彦=Sagara Katsuhiko
真剑者=Shinkenger
真嗣=Shinji
真夜=Maya
真岛浩二=Majima Koji
真島浩二=Mashima Koji
真田良介=Chân Điền Lương Giới
真鱼=Mana
真鱼小姐=Tiểu thư Mana
真鱼酱=Mana-chan
睡熊猛醒=Thụy Hùng Mãnh Tỉnh
睦月安纱美=Mutsuki Asami
瞻巴拉=Chiêm Ba Lạp
瞿陀尼=Cù Đà Ni
知树=Tri Thụ
知秋一叶=Tri Thu Nhất Diệp
石乙=Thạch Ất
石化怪兽加库玛=Thạch Hóa Quái Thú Gia Khố Mã
石天雨=Thạch Thiên Vũ
破空术=Phá Không Thuật
破里剑者=Hurricaneger
碎天绝手=Toái Thiên Tuyệt Thủ
碳叶=Thán Diệp
磁力小丑=Từ Lực Tiểu Sửu
礼貌天帝=Thiên Đế Lễ Phép
礼赞三相神=Lễ tán Tam tướng thần
礼赞上主=Lễ tán Thượng chủ
礼赞仁慈的天帝=Ca ngợi Thiên Đế nhân từ
礼赞大天=Lễ tán Đại Thiên
礼赞天神=Lễ Tán Thiên Thần
礼赞持金刚杵者=Ca ngợi người giữ Kim Cang Chử
礼赞耶瑟陀=Lễ tán Da Sắt Đà
礼赞迦叶波仙人=Lễ Tán Ca Diệp Ba Tiên Nhân
礼赞那罗~那罗延=Lễ tán Nara~Narayana
神仙迷心丸=Thần Tiên Mê Tâm Hoàn
神光棒=Thần Quang Bổng
神光神波罗跋娑=Thần Quang Thần Ba La Bạt Ta
神劈=Thần Phách
神宫海藏=Jingu Kaizo
神将飞蓬=Thần Tướng Phi Bồng
神山中学=Thần Sơn trung học
神崎士郎=Shirō Kanzaki
神崎昭二=Kanzaki Shoji
神崎老师=Thầy Kanzaki
神明战甲=Thần minh chiến giáp
神武纪=Thần Võ Kỷ
神牛南笛=Nandi
神犬萨罗摩=Thần Khuyển Tát La Ma
神界天池=Thiên Trì Thần Giới
神盾巨蟹=Thần Thuẫn Cự Giải
神矛阿摩迦=Thần Mâu A Ma Già
神经断裂弹=Đạn cắt thần kinh
神象之王=Thần Tượng Chi Vương
神马高耳=Thần Mã Cao Nhĩ
神龙卷轴=Thần Long Quyển Trục
神龙秘籍=Thần Long Bí Kíp
祭主=Tế Chủ
祭主仙=Tế Chủ Tiên
祭主仙人=Tế Chủ Tiên Nhân
禁忌掺杂体=Cấm kỵ tạp chất
禁忌记忆体=Taboo Memory
福泽大厦=Tòa nhà Fukuzawa
秃顶乌鸦尊者=Bald Raven Lord
秃鹫古朗基=Gryphon Grongi
秋叶原站=Ga Akihabara
科学怪人族=Quái vật Frankenstein
科学警察研究所=Viện Nghiên Cứu Khoa Học Cảnh Sát
科技大厦=Tòa nhà Khoa học Công nghệ
科目三=Khoa mục 3
科警研=Viện Nghiên cứu Khoa học Cảnh sát
秦王绕柱=Tần vương nhiễu trụ
穆俱昆陀=Mukunda
穆湿伽=Mushika
究极之暗=Cực Hạn Hắc Ám
究极初生=Ultimate Born
究极初生空我=Ultimate Beginning Kuuga
究极力量=Sức mạnh Tối thượng
究极升华空我=Ultimate Rising Kuuga
究极形态=Ultimate Form
究极空我=Ultimate Kuuga
究极追迹者=Ultimate Chaser
究极黑暗=Ultimate Darkness
究极黑暗空我=Cực Ám Không Ngã
空我=Kuuga/ Không Ngã
空我世界=Thế giới Kuuga
空谷罪犯感化院=Trại cải huấn tội phạm Thung lũng Không
第一平行宇宙=Vũ trụ song song thứ nhất
第七平行宇宙=Vũ trụ song song thứ bảy
第三平行宇宙=Vũ trụ song song thứ ba
第二平行宇宙=Vũ trụ song song thứ hai
第五平行宇宙=Vũ trụ song song thứ năm
第六平行宇宙=Vũ trụ song song thứ sáu
第四平行宇宙=Vũ trụ song song thứ tư
笹山=Sasayama
笹山望见=Sasayama Nozomi
筏罗诃=Varaha
筱原佐惠子=Shinohara Saeko
篮紫光芒=xanh tím quang mang
米国总统=Tổng thống Mỹ
粗恶苑=Thô Ác Uyển
紗綾香=Sayaka
索兰达=Solanda
紫云剑主=Tử Vân Kiếm Chủ
紫云剑主莎丽=Tử Vân Kiếm Chủ Sally
紫云剑法=Tử Vân Kiếm Pháp
紫云真气=Tử Vân Chân Khí
紫兔=Tử Thỏ
紫玉佩=Tử Ngọc Bội
紫翼魔尊=Tử Dực Ma Tôn
红冠=Hồng Quán
红心A=Át cơ
红心K=Già cơ
红心K幽灵螳螂=Bọ ngựa ma cơ K
红渡=Wataru Kurenai
红烧牛肉面=Mì bò kho tàu
红色全能形态=màu đỏ Mighty Form
红色全能空我=màu đỏ Mighty Kuuga
红色空我=Kuuga đỏ
红花粉=Bột hồng hoa
红葵=Hồng Quỳ
红音也=Otoya Kurenai
约尼=Ước Ni
纱绫香=Sayaka
纳斯卡掺杂体=Nazca tạp chất
纳斯卡记忆体=Nazca Memory
纵意登仙步=Túng Ý Đăng Tiên Bộ
细胞硬币=Cell Medal
绫香=Ayaka
维摩纳斯=Vimanas
维摩那斯=Duy Ma Na Tư
维毗沙那=Vibhishana
维纳琴=Đàn Vina
绿色形态=Form màu lục
绿魔飞行器=Phi Thuyền Lục Ma
缚罪者=Phược Tội Giả
罗刹之王=La Sát Chi Vương
罗刹之王罗波那=La Sát Vương Ravana
罗刹十首=La Sát Thập Thủ
罗岚=La Lan/Raran
罗岚的=La Lan/Raran
罗延=La Duyên
罗怙=La Hộ
罗毗=La Tỳ
罗睺星=Sao La Hầu
罗睺计都=Rahu Ketu
罗蒂=Rati
罗辛哈=Narasimha
羊面=Dương Diện
美咲抚子=Misaki Nadeshiko
美杉=Misugi
美杉义彦=Misugi Yoshihiko
美杉太一=Misugi Taiichi
美杉家=Misugi Gia
美杉教授=Misugi Giáo sư
美森队=Đội Mĩ Sâm
群山之翼=Cánh núi non
翔一=Shoichi
翔太郎=Shotaro
翡翠之刃=Phỉ Thúy Chi Nhận
翡翠僵尸=Cương thi Ngọc Bích
耀光圣盾=Bicker Shield
老七剑=Lão Thất Kiếm
老了=già rồi/già
老天皇=Lão Thiên Hoàng
老山羊=Lão Sơn Dương
老虎古朗基=Tiger Gurongi
耶瑟陀=Gia Sắt Đà
耶瑟陀女神=Gia Sắt Đà Nữ Thần
联合搜查部=Bộ phận Điều tra Liên hợp
聚元宝鼎=Tụ Nguyên Bảo Đỉnh
肥仔聪=Phì Tử Thông
胜166=Thắng 166
胜利队=Đội Chiến Thắng
胜利飞燕号=Victory Flier
胡狼尊者=Jackal Lord
自杀仙人=Tiên Nhân Tự Tử
至净法=Chí Tịnh Pháp
舍沙=Shesha
舍波罗=Shebala
舍脂=Xá Chi
舍脂之主=Xá Chi Chi Chủ
舞空术=Vũ Không Thuật
般度族=Pandava
艾勃隆=Ngải Bột Long
芦河翔一=Ashikawa Shoichi
芭璐芭=Baluba
花尾=Hoa Vĩ
花道On Stage=Hanamichi On Stage
苇原=Ashihara
苇原先生=Ngài Ashihara
苇原凉=Ryo Ashihara
苇轭=Veeyoga
苍月奥特曼=Ultraman Trăng Xanh
苍穹下的孤狼=Cang Qiong Xia De Gu Lang/Con sói cô độc dưới bầu trời
苏利耶之子=Tô Lợi Da Chi Tử
苏利耶之子娑尼=Tô Lợi Gia Chi Tử Sa Ni
苏利耶天=Tô Lợi Da Thiên
苏摩天=Tô Ma Thiên
苏摩耶=Tô Ma Gia
苏摩酒=rượu Soma
苏维妮=Suvini
苏羯罗=Sukra
苏羯罗仙人=Tiên nhân Sukra
苏羯罗导师=Đạo sư Tô Yết La
苏羯里婆=Sugriva
苏羯（jie）罗=Sukra
苏陀罗=Sutala
苏陀罗之王=Tô Đà La Chi Vương
苏陀罗之界=Tô Đà La Chi Giới
苏陀罗界=Tô Đà La Giới
苗条俊=Miêu Điều Tuấn
若叶幼儿园=Nhà trẻ Wakaba
若菜公主=Công chúa Wakana
苦力强=Khổ Lực Cường
英武天神=Valiant Deva
茂茂=Mậu Mậu
草莓定锁种子=Hạt giống Lock Strawberry
草莓装甲=Strawberry Armor
荒川区=Quận Arakawa
莫仇=Mạc Cừu
莫将=Mạc Tương
莱奴迦=Lai Nô Già
莲目=Liên Mục
菊石兽=Cúc Thạch Thú
萧旸=Tiêu Dương
萨克蒂=Sakti
萨克蒂之力=Tát Khắc Đế Chi Lực
萨克蒂女神=Nữ Thần Shakti
萨奇帕提=Tát Kỳ Mạt Đề
萨罗摩=Tát La Ma
葛·伽多鲁·巴=Ge Garudoruba
葛·伽雅泽·基=Ge-Gayaza-Gi
葛·卜洛·古=Ge-Buroru-Gu
葛·巴达·巴=Ge Badada Ba
葛·查查璐·巴=Ge Chachiru Ba
葛兰花=Hoa Kanak Champa
葛叶纮太=Kazuraba Kouta
葛叶纮汰=Katsuraba Kouta
葛集团=Tập đoàn Ge
葛集团最强三人=The Strongest Three of the Ge Group
葛饰2号=Katsushika Số 2
葛饰区=Quận Katsushika
葦原涼=Ashihara Ryo
葫芦娃大战变形金刚=Hồ Lô Oa đại chiến Biến Hình Kim Cương
葵羽=Quỳ Vũ
葵羽玄女=Quỳ Vũ Huyền Nữ
蒙平原=Mông Bình Nguyên
蒙达苏尔=Mông Đạt Tô Nhĩ
蓝兔=Lam Thỏ
蓝色行星的爱=Tình Yêu Hành Tinh Xanh
蓝花楹咖啡店=Tiệm cà phê Jacaranda
蓝葵=Lam Quỳ
藤甲军团=Đằng Giáp Quân Đoàn
虎头佛母森多玛=Hổ Đầu Phật Mẫu Sâm Đa Mã
虎魄刀=Đao Hổ Phách
虎魄空间=Không gian Hổ Phách
虎鲸天使=Thiên thần Orca
虎鲸尊者=Hổ Kình Tôn Giả
虬藤翻潦浪，灿然额前辉！=Cù đằng phiên lạo lãng, Sán nhiên ngạch tiền huy!
虹猫=Hồng Miêu
虹猫仗剑走天涯=Hồng Miêu Trượng Kiếm Tẩu Thiên Nhai
虹猫蓝兔=Hồng Miêu Lam Thố
虹猫蓝兔七侠传世界=Hồng Miêu Lam Thố Thất Hiệp Truyện thế giới
虹猫蓝兔世界=Thế giới Hồng Miêu Lam Thỏ
虹蓝=Hồng Lam
虹蓝七侠传=Hồng Lam Thất Hiệp Truyện
蚁蛭=Nghĩ Điệt
蚁蛭仙人=Nghĩ Điệt Tiên Nhân
蚂蚁女王尊者=Nữ hoàng kiến Tôn giả
蚂蚁尊者=Ant Lord
蛇女曼罗迦=Xà Nữ Mạn La Già
蛇床=Xà Sàng
蛇床者=Xà sàng giả
蛇母=Xà Mẫu
蛇母迦德卢=Xà Mẫu Ca Đức Lâu
蛇王婆苏吉=Xà Vương Vasuki
蛇王舍沙=Xà Vương Xá Sa
蜀山灵脉=Thục Sơn linh mạch
蜘蛛古朗基=Gourongi Nhện
蜜瓜=Melon
蜜瓜能量=Năng lượng Dưa lưới
蜜瓜防御盾=Khiên phòng ngự Dưa lưới
蜥蜴尊者=Lizard Lord
蝎子女=Thiết Nữ
蝎子尊者=Bọ Cạp Tôn Giả
蝎子王龙莹=Hạt Tử Vương Long Oánh
蝗虫古朗基=Gurongi Châu Chấu
蝘蜓座星座使徒=Chamaeleon Zodiarts
蝙蝠古朗基=Dơi Gurongi
蝙蝠战团=Biên Bức Chiến Đoàn
蝰蛇武装直升机=Trực thăng vũ trang Viper
蝶野润一=Chouno Junichi
螳螂古朗基=Gurongi Bọ ngựa
螳螂古朗基伽利玛=Mantis Gurongi Garima
螳螂噬欲怪=Bọ Ngựa Phệ Dục Quái
螳螂尊者=Đường Lang Tôn Giả
血种阿修罗=Asura Huyết Chủng
行政部长=Bộ trưởng hành chính
行星斯菲亚=Hành tinh Sphia
补卢山=Bổ Lư Sơn
补卢罗婆娑=Bổ Lư La Bà Sa
补米伽=Bhumika
补罗私底耶=Bổ La Tư Để Da
袖浦海岸=Bãi biển Sodegaura
被缚者=Người bị trói
西工厂=Nhà máy phía Tây
西方水域=Thủy Vực Phương Tây
西木=Tây Mộc
西瓜定锁种子=Watermelon Lock Seed
西瞿陀尼=West Godhaniya
解脱者=Giải Thoát Giả
詹巴拉=Chiêm Ba Lạp
詹琉璃=Chiêm Lưu Li
警卫追迹者=Người theo đuổi bảo vệ
警察部=Bộ phận Cảnh sát
警視庁=Sở Cảnh sát
警视庁=Sở Cảnh sát
讫利多=Krita
许显纯=Hứa Hiển Thuần
设阇卢祇那=Shatrughna
诃利=Hari
诃利阿修罗=Hà Lợi A Tu La
诃德莉=Ha Đức Lị
诃拉=Ha Lạp
诃拉诃拉=Halahala
诃拉诃拉之毒=Độc Hala Hala
诃拉诃拉之箭=Mũi tên Hala Hala
诃耶羯里婆=Ha Da Yết Lí Bà
试验追迹者=Thí Nghiệm Truy Tích Giả
试验追迹者2000=Thí Nghiệm Người Truy Đuổi 2000
诸世纪=Các thế kỷ
诸天之门=Chư Thiên Chi Môn
诸天：从破坏之王开始=Chư Thiên: Bắt đầu từ Vua Phá Hoại
谢拉德=Sherard
谷峨站=Gaga Station
象面=Tượng Diện
象魔=Tượng Ma
象魔阿修罗=Tượng Ma A Tu La
豪快三叉戟=Gokai Trident
豪快变身=Gokai Change
豪快戟=Gokai Spear
豪快手机=Gokai Cellular
豪快手枪=Gokai Gun
豪快粉=Gokai Pink
豪快红=Gokai Red
豪快绿=Gokai Green
豪快者=Gokaiger
豪快蓝=Gokai Blue
豪快银=Gokai Silver
豪快飞船=Gokai Galleon
豪快马刀=Gokai Saber
豪快黄=Gokai Yellow
豪猪古朗基=Porcupine Gurongi
豹尊者=Báo Tôn Giả
豹尾脚=Báo Vĩ Cước
贝琉多拉=Belial Dora
财团X=Tổ chức X
财富女神拉克什米=Nữ thần Tài Lộc Lạp Khắc Thập Mễ
财神俱毗罗=Thần Tài Kubera
贤吾=Kengo
贪欲者=Greeed
贪欲阿修罗=Tham Dục A-tu-la
贪狼剑=Tham Lang Kiếm
赛亚人=người Saiyan
赤炎火龙阵=Xích Diễm Hỏa Long Trận
赫尔兹=Herz
赫尔海姆之森=Heim Helheim Forest
起始之夜=Đêm Khởi Đầu
起源之女=Maiden of Beginning
超兽战士=Siêu Thú Chiến Sĩ
超兽战队=Siêu Thú Chiến Đội
超兽武装=Siêu Thú Vũ Trang
超兽神=Siêu Thú Thần
超能力研究所=Viện nghiên cứu siêu năng lực
超越Gills=Exceed Gills
超越形态=Beyond Form
超银河王=Siêu Ngân Hà Vương
跃动追迹者=Rising Chaser
跋伽=Bạt Già
跋兰妮=Bạt Lan Ni
跋录吉=Bạt Lục Cát
跋陀罗=Bhadra
路长官=Lộ trưởng quan
身披金闪衣=Golden-Clad
车底国=Nước Chedi
辛希嘉=Tân Hi Gia
辛杜拉=Tân Đỗ La
辛辣天塞=Shinra Tensei
辩才天女=Biện Tài Thiên Nữ
辰巳真嗣=Tatsumi Shinji
达兹纳=Tazuna
达刹=Daksha
达尔蒂=Đạt Nhĩ Đế
达尔蒂·玛塔=Đạt Nhĩ Đế · Mã Tháp
达录那=Daruna
达拉姆=Đạt Lạp Mỗ
达摩洞=Đạt Ma Động
达摩衍蒂=Damayanti
达湿罗=Đạt Thấp La
达玛鲁=Damaru
达玛鲁鼓=Đạt Ma Lỗ Cổ
达达=Đạt Đạt
达陀利耶=Đạt Đà Lợi Da
远东总部=Tổng bộ Viễn Đông
连者钥匙=Ranger Key
迦利=Già Lợi
迦叶波=Ca Diếp Ba
迦叶波仙人=Ca Diếp Ba Tiên Nhân
迦娄陀=Ca Lâu Đà
迦尔吉=Kalki
迦尸=Già Thi
迦尸之城=Ca Thi Chi Thành
迦尸城=Ca Thi Thành
迦希吉夜=Kashyapa
迦德卢=Kadru
迦拘吒迦=Ca Câu Tra Ca
迦旃延妮=Ca Chiên Diên Ni
迦旃延那=Katyayana
迦梨女神=Nữ thần Kali
迦梨时代=Ca Lỵ Thời Đại
迦楼罗=Già Lâu La/Garuḍa/Garuda
迦楼罗族=Gia Lâu La Tộc
迦玛帕拉=Già Ma Mạt Lạp
迦罗尼弥=Ca La Ni Di
迦陵频迦鸟=Ca Lăng Tần Già Điểu
迦频奢罗鸟=Ca Tần Xa La Điểu
迪利波=Địch Lợi Ba
迪迦世界=Thế giới Tiga
迪迦奥特曼世界=Thế giới Ultraman Tiga
迷失驱动器=Lost Driver
迷魂台=Mê Hồn Đài
追迹者=TryChaser
追迹者2000=Tracer 2000
通道=thông đạo/đường giao thông/đường qua lại/lối đi/đường nối/đường cái
逢魔=Oma
達古巴=Daguba
遨游四海求其凰=Ngao du tứ hải cầu kỳ hoàng
遮那迦=Janaka
那兰奇=Na Lan Kỳ
那吒俱伐罗=Na Tra Câu Phạt La
那牟质=Na Mâu Chất
那罗=Nara
那罗延=Narayana
那罗辛哈=Narasimha
那罗迦=Na La Ca
那罗陀=Narada
那罗陀仙人=Narada Tiên nhân
邪蛟=Tà Giao
邪血劫=Tà Huyết Kiếp
邪迪=Tà Diga
郭北镇=Quách Bắc Trấn
酱爆=Tương Bạo
里婆蒂=Lý Bà Đế
里莲华=Lí Liên Hoa
里蜀山=Lý Thục Sơn
重力球=Trọng Lực Cầu
重名者钵利=Trùng Danh Giả Bát Lợi
野猪化身=Dã Trư Hóa Thân
野猪筏罗诃=Dã Trư Phiệt La Ha
野瑞=Dã Thụy
量产型特殊摩托车TryChaser2000A=Mô tô đặc chủng sản xuất hàng loạt TryChaser 2000A
金书中的内容=kim thư bên trong nội dung
金刚菩提子=Kim Cương Bồ Đề Tử
金刚身阿修罗=Kim Cang Thân Asura
金叉罗=Kim Xoa La
金发男=Tóc Vàng Nam
金床=Kim Sàng
金床阿修罗=Kim Sàng A Tu La
金忍者=Kim Ninja
金星之神=Kim Tinh Chi Thần
金星仙人=Tiên nhân Kim Tinh
金毛恶鬼=Ác quỷ tóc vàng
金灶沐=Kim Táo Mộc
金牛战车=Kim Ngưu Chiến Xa
金狼百兽王=Kim Lang Bách Thú Vương
金目和金床=Kim Mục và Kim Sàng
金目阿修罗=Kim Mục A Tu La
金目阿修罗王=Kim Mục A Tu La Vương
金翅鸟迦楼罗=Kim Sí Điểu Già Lâu La
金蜈火毒=Kim Ngô Hỏa Độc
金象族=Kim Tượng tộc
金铜龟尊者=Kim Đồng Quy Tôn Giả
金鞭溪=Kim Tiên Khê
金鞭溪客栈=Kim Tiên Khê Khách Sạn
金龙戈尔德拉斯=Kim Long Goldras
钢之蕾=Nụ Thép
钢甲铁面人=Người Mặt Sắt Bọc Thép
钢铁之针=Kim châm sắt
钱江大坝=Tiền Giang Đại Bá
钵利=Bát Lợi
钵利王=Bát Lợi Vương
钵利阿修罗王=Bát Lợi A Tu La Vương
钵底=Bát Để
钵罗诃罗陀=Bát La Ha La Đà
钵那=Bát-Na
钵那阿修罗=Bát Na A Tu La
铁心岛=Thiết Tâm Đảo
铁血星=Tinh cầu Thiết Huyết
铁血星人=Người Sắt Máu
铁血星球=Thiết Huyết Tinh Cầu
铁首=Thiết Thủ
铁鬃灰熊=Thiết Tông Hôi Hùng
铃木深央=Suzuki Mio
铅白豹尊者=Tôn giả Báo trắng chì
铠武=Gaimu
铠武街舞团=Đội nhảy đường phố Gaimu
铠甲勇士刑天=Khải Giáp Dũng Sĩ Hình Thiên
银铜龟尊者=Ngân Đồng Quy Tôn Giả
银龙希尔巴贡=Ngân Long希尔巴贡
铸剑池=Chú Kiếm Trì
链隙=Crack
锐金剑气=Nhuệ Kim Kiếm Khí
锯锹Undead=Undead Bọ Que Cưa
锹螳蝗联组=Kuwagata Kamakiri Batta Combo
長野県=Nagano
长崎公园=Công Viên Nagasaki
长暗仙人=Trường Ám Tiên Nhân
长生不死之神=Trường Sinh Bất Tử Chi Thần
长野县=Tỉnh Nagano
长野县九郎岳=Núi Kurou thuộc tỉnh Nagano
长野县警察部=Sở cảnh sát tỉnh Nagano
长野县警视厅=Sở cảnh sát tỉnh Nagano
长野県=Tỉnh Nagano
长颈鹿锯锹=Bọ Que Cưa Hươu Cao Cổ
関東医大病院=Bệnh viện Y khoa Kanto
门矢=Kadoya
门矢士=Kadoya Tsukasa
门矢小夜=Sayo Kadoya
闪耀亚极陀=Shining Agito
闪耀王剑=Shining Calibur
闪闪爱=Lấp lánh yêu
闭关这么久=bế quan lâu như vậy
闰土=Nhuận Thổ
阎摩使=Sứ giả Diêm Ma
阎摩判官=Diêm Ma Phán Quan
阎摩城=Diêm Ma Thành
阎摩天=Diêm Ma Thiên
阎浮提树=Cây Jambu
阎浮树=Cây Diêm Phù
阎浮树叶=Diêm Phù Thụ Diệp
阎蜜=Diêm Mật
阔怕=sợ hãi
阿修罗女舍脂=A Tu La Nữ Xá Chi
阿修罗导师=Đạo sư A Tu La
阿修罗王金目=A Tu La Vương Kim Mục
阿修罗王钵利=Asura Vương Bali
阿修罗神殿=A Tu La Thần Điện
阿修罗蒙达苏尔=A Tu La Mông Đạt Tô Nhĩ
阿修罗金床=Giường Vàng Asura
阿修罗阿鲁纳=A Tu La Aruna
阿修罗陀罗迦=Asura Taraka
阿利耶迦=A Lợi Da Ca
阿努波=A Nậu Ba
阿奋=A Phấn
阿奴苏耶=A Nô Tô Gia
阿娑妮=A Sa Ni
阿婆罗=A Bà La
阿尼罗=Anila
阿布婆=A Bố Bà
阿库德斯=Akudosu
阿库德斯吉尔=Akudos Gill
阿底=Adi
阿底利=A Để Lợi
阿底利仙人=Atri tiên nhân
阿底提=Adieti
阿底提耶=A Để Đề Gia
阿拉克什米=A Lạp Khắc Thập Mễ
阿摩迦=A Ma Già
阿摩迦之矛=A Ma Già Chi Mâu
阿斯多山=A Tư Đa Sơn
阿格尼亚=Agniya
阿沃索希=A-wo-suo-xi
阿特曼林迦=Atman Linga
阿玛达姆=Amadam
阿瑞斯号=Ares Hào
阿瑞斯号战舰=Chiến hạm Ares
阿耆=A Kỳ
阿耆尼=A Kỳ Ni
阿耆尼之影=A Kỳ Ni Chi Ảnh
阿耆尼天=A Kỳ Ni Thiên
阿耆（qi）尼=Agini
阿莉西亚=Alicia
阿诃利耶=A Kha Lợi Gia
阿诃姆=Aham
阿达婆吠陀=Atharvaveda
阿迈=A Mại/Amai
阿迦=A Già
阿迦奢=A Già Xa
阿迦奢之力=A Già Xá Chi Lực
阿迦提耶=A Ca Đề Da
阿迦沙耶=Akasha
阿迪湿婆=A Địch Thấp婆
阿迪瑜吉=A Địch Du Già
阿逾陀=Ayodhya
阿逾陀国=A Du Đà Quốc
阿逾陀城池=Thành A Du Đà
阿那罗=Anala
阿闼婆吠陀=Atharvaveda
阿鲁纳=A Lỗ Nạp
阿鲁诺=Aruna
陀兰那=Đà Lan Na
陀娑羯里婆=Đà Sa Yết Lí Bà
陀提遮=Đà Đề Già
陀提遮仙人=Đà Đề Già Tiên Nhân
陀罗迦=Draka
陀罗迦阿修罗=Tu La Đà La Ca
陆惊天=Lục Kinh Thiên
降龙神丐=Hàng Long Thần Cái
院长出手=viện trưởng ra tay
除障者伽内什=Trừ Chướng Giả Già Nội Thập
隅田公园=Công viên Sumida
隐连者=Kakuranger
难胜=Nan Thắng
雄介=Yusuke
雄贤=Hùng Hiền
雅典娜一号=Athena 1
雨花剑=Vũ Hoa Kiếm
雨花剑主=Vũ Hoa Kiếm Chủ
雪山女神=Tuyết Sơn Nữ Thần
雪山族=Tuyết Sơn Tộc
雪山王=Tuyết Sơn Vương
雪山神女=Tuyết Sơn Thần Nữ
雪山神女帕尔瓦蒂=Nữ thần Tuyết Sơn Parvati
雪岛上人=Tuyết Đảo Thượng Nhân
雪晶夫人=Tuyết Tinh phu nhân
雪舍利=Tuyết Xá Lợi
雷克萨斯游泳学校=Trường bơi Lexus
雷土灵珠=Lôi Thổ Linh Châu
雷姆·康纳基=Rem Kannagi
雷无向=Lôi Vô Hướng
雷杵阵=Lôi Xử Trận
雷电交加=Lôi Điện Giao Gia
雷电恶魔=Ác ma sấm sét
雷电恶魔中苏=Lôi Điện Ác Ma Trung Tô
雷遁星云=Lôi Độn Tinh Vân
雷魔兽=Lôi Ma Thú
雾岛拓=Kirishima Taku
霍丽嘉=Holiqa
露兜花=Hoa Lộ Đâu
露卡=Luka
露卡·米露菲=Luka Millfy
露露耶=Lộ Lộ Gia
霸王装甲=Bá Vương Trang Giáp
青光剑=Thanh Quang Kiếm
青光剑主=Thanh Quang Kiếm Chủ
青光大盛=thanh quang đại thịnh
青木原森林=Rừng Aokigahara
青颈=Thanh Kình
青颈之主=青颈之主 - Chúa tể cổ xanh
青龙形态=Dragon Form
青龙族=Thanh Long Tộc
青龙棍=Thanh Long Côn/Dragon Rod
青龙空我=Dragon Form Kuuga
青龙降魔=Thanh Long Hàng Ma
静修林=Tĩnh Tu Lâm
革命进行曲=Bản hành khúc Cách mạng
靳韵翠=Cận Vận Thúy
鞋拔子脸=mặt sừng giày
韩偓=Hàn Ác
音效卡=Thẻ Âm Thanh
顶礼那罗延=Đỉnh Lễ Na La Diên
须摩利=Sumali
须藤雾彦=Sudo Kirihiko
顾留芳=Cố Lưu Phương
颜盈=Nhan Doanh
風谷真魚=Kazaya Mana
风之上神=Phong chi Thượng Thần
风之恶魔=Ác ma gió
风云天诀=Phong Vân Thiên Quyết
风早小学=Trường Tiểu học Kazahaya
风神伐由=Phong Thần Phạt Do
风群之主=Phong Quần Chi Chủ
风耀=Phong Diệu
风谷小姐=Cô Phong Cốc
风谷教授=Giáo sư Kazaya
风谷真鱼=Kazaya Mana
风谷老师=Thầy Kazatani
风都=Fuuto
风都久保川=Kubokawa Futo
风都塔=Futo Tower
风都电台=Đài Phát Thanh Fuuto
风雷妖鸟=Phong Lôi Yêu Điểu
风魔兽=Phong Ma Thú
飞燕一号=Phi Yến 1
飞燕二号=Phi Yến Nhị Hào
飞龙再生=Phi Long Tái Sinh
食为先=Thực Vi Tiên
食人鱼古朗基=Gurongi cá hổ piranha
食人鱼古朗基「魅·比婪·基」=Gurongi cá hổ Piranha "Me·Biran·Gi"
食火仙人=Thực Hỏa Tiên Nhân
饰玉=Kazutama
饰玉三郎=Osamu Saburo
饰玉店长=Quản lý tiệm trang sức ngọc
饰玉老爹=Ông già Shodama
香醉山=Hương Túy Sơn
马三娘=Mã Tam Nương
马修诺=Mã Tu Nặc
马克48重型线导鱼雷=Ngư lôi dẫn đường hạng nặng Mark 48
马克50=Mark 50
马克50战甲=Áo Giáp Mark 50
马克50钢铁战甲=Áo giáp sắt Mark 50
马喰町站=Ga Bakurochō
马提迦婆多=Matika婆多
马特斯亚=Mattysia
马首阿修罗=Mã Thủ A Tu La
驱纹戒斗=Kumen Kaito
驾驭表头=Rider Watch
驾驭贩卖号=Ride Vendor
骄生=Kiêu Sinh
骄生阿修罗=Kiêu Sinh A Tu La
骄罗毗耶=Kiêu La Tỳ Da
骑士卡盒剑=Kiếm hộp thẻ Rider
骑士指环=Nhẫn Hiệp Sĩ
骷髅女=Khô Lâu Nữ
骸之镰=Hài Chi Liêm
高司舞=Takatsukasa Mai
高耳=Cao Nhĩ
鬈发城=Quyền Phát Thành
鬼叉罗=Quỷ Xoa La
鬼影兵团=Quỷ Ảnh Binh Đoàn
鬼影军团=Quỷ Ảnh Quân Đoàn
鬼影军团篇=Quỷ Ảnh Quân Đoàn Thiên
鬼影巨魔=Quỷ Ảnh Cự Ma
鬼影忍者=Quỷ Ảnh Ninja
鬼影王国=Quỷ Ảnh Vương Quốc
鬼王九尾狐=Quỷ Vương Cửu Vĩ Hồ
魅集团=Nhóm Me
魅集团古朗基=Me Group Gurongi
魔化大天神=Ma Hóa Đại Thiên Thần
魔化天使=Ma Hóa Thiên Sứ
魔怪诃拉诃拉=Ma quái Hô-la-hô-la
魔法连者=Magiranger
魔王金垫子=Quỷ vương Đệm Vàng
魔王金眼睛=Quỷ vương Mắt Vàng
魔皇之铠=Áo giáp Ma Hoàng
鱼人族=Người cá
鲨鱼古朗基=Guarongi Cá Mập
鲸鲨族=Kình Sa Tộc
鲸鲨王=Kình Sa Vương
鳄魔=Ngạc Ma
鳄魔兵团=Ngạc Ma Binh Đoàn
鳄鱼利兹=Cá sấu Liz
鳄鱼帮=Băng Cá Sấu
鸣海事务所=Văn phòng Narumi
鸣海亚树子=Narumi Akiko
鸣海侦探事务所=Văn phòng thám tử Narumi
鸣海庄吉=Narumi Soukichi
鸯耆罗=Angiras
鸯耆罗仙人=Angiras
鹰虎蝗联组=Taka Tora Batta Combo
鹰雀鹫联组=Taka Kujaku Condor Combo
麒麟套装=Kỳ Lân Sáo Trang
麒麟甲=Kỳ Lân Giáp
麻生冬美=Aso Fuyumi
麻鹬山=Ma Úc Sơn
黄泉之镋=Hoàng Tuyền Chi Đảng
黄金太阳神甲=Hoàng Kim Thái Dương Thần Giáp
黄金山羊=Hoàng Kim Sơn Dương
黄金极限=Gold Xtreme
黄金果实争夺战=Hoàng Kim Quả Thực Tranh Đoạt Chiến
黄金行星=Hoàng Kim Hành Tinh
黑三郎=Hắc Tam Lang
黑云巨人=Hắc Vân Cự Nhân
黑小虎=Hắc Tiểu Hổ
黑山神拳=Hắc Sơn Thần Quyền
黑影王国=Vương quốc Bóng tối
黑手帮=Hắc Thủ Bang
黑无情=Hắc Vô Tình
黑暗星云=Tinh vân Hắc ám
黑暗的支配者加坦杰厄=Kẻ thống trị bóng tối Gatanothor
黑暗蝗虫=Dark Hopper
黑暗蝗虫号=Dark Hopper
黑暗行星古兰斯菲亚=Hành tinh Hắc ám Guransufia
黑暗迪迦=Diga Bóng Tối
黑暗金属=Dark Metal
黑桃A=Bích A
黑桃K=Bích K
黑海深渊=Hắc Hải Thâm Uyên
黑目=Hắc Mục
黑神斗真=Kurokami Touma
黑神话=Hắc Thần Thoại
黑色2号=Black No. 2
黑色究极空我=Hắc Sắc Cứu Cực Không Ngã
黑色空我=Kuga Đen
黑虎大佛=Hắc Hổ Đại Phật
黑虎崖=Hắc Hổ Nhai
黑虎洞=Hắc Hổ Động
黑魔王=Hắc Ma Vương
黑鹰传书=Hắc Ưng Truyền Thư
黑龙剑=Hắc Long Kiếm
鼠后=Thử Hậu
鼠族大祭司=Thử tộc Đại Tế Tư
龙小组=Long Tiểu Tổ
龙莹=Long Oánh
龙飨仪式=Long Hưởng nghi thức/Nghi thức Long hưởng
龙骑世界=Thế giới Ryuki
龟山警部=Thanh tra Kameyama
龟种古朗基=Gurongi Rùa
苍雪狼=Thương Tuyết Lang
秘食传承=Di Sản Bí Ẩm
碧水浮萍=Bích Thủy Phù Bình
黄金勋章=Huy chương Vàng
晨星勋章=Huy chương Sao Mai
黄金任务=Nhiệm vụ Vàng
郑大渊=Trịnh Đại Uyên
徐大渊=Từ Đại Uyên
百花锻神酒=Bách Hoa Đoán Thần Tửu
冥土教派=Minh Thổ Giáo Phái
冥火追猎=Minh Hỏa Truy Liệp
冥狱炎狼=Minh Ngục Viêm Lang
食骸犬王=Thực Hài Khuyển Vương
控骸=Khống Hài
黄泉生态秘境=Hoàng Tuyền Sinh Thái Bí Cảnh
黄泉秘境=Bí cảnh Hoàng Tuyền
黄泉龙蝶=Hoàng Tuyền Long Điệp
黄泉送葬=Hoàng Tuyền Tống Táng
告死鸟教派=Giáo phái Cáo Tử Điểu
即死射线=Tức Tử Xạ Tuyến
黑狼鸟=Hắc Lang Điểu
冰鳞蛇=Băng Lân Xà
织梦=Chức Mộng
虚空蠕虫=Hư Không Nhu Động
噬空螳螂母皇=Phệ Không Đường Lang Mẫu Hoàng
闪烁螳螂=Thiểm Thước Đường Lang
白银教会=Bạch Ngân Giáo Hội
黑石堡=Hắc Thạch Bảo
永恒冥界=Vĩnh Hằng Minh Giới
幽魂之树的树苗=Cây non U Hồn Thụ
天之修女遮眼纱布=Khăn che mắt Tu Nữ Thiên Thượng
虚空蠕虫的心脏=Trái tim sâu hư không
噬空螳螂母巢=Tổ Bọ ngựa nuốt không
幻梦蛛卵=Nhộng Nhện Huyễn Mộng
星光湖=Tinh Quang Hồ
寒霜冻土=Hàn Sương Đống Thổ
金刚吼=Kim Cương Hống
烈风雀=Liệt Phong Tước
桃花鼓蛙=Đào Hoa Cổ Oa
大黑天剑舞壹式=Đại Hắc Thiên Kiếm Vũ Nhất Thức
逐光=Trục Quang
调查员之书=Điều Tra Viên Chi Thư
昨日之花=Nhật Tạc Chi Hoa
真理之环=Chân Lý Chi Hoàn
高维污染=Ô Nhiễm Cao Duy
气息扩散=Khí Tức Khuếch Tán
杨绛=Dương Giáng
老六门卫=Lão Lục Môn Vệ
发必达=Phát Tất Đạt
走地坤=Tẩu Địa Khôn
喷水坤=Phun Thủy Khôn
鬼脸咒蛙的咒傀器官=Quỷ Diện Chú Oa Đích Chú Khôi Khí Quan
迷雾市=Mê Vụ Thị
灵界蜘蛛之血=Linh Giới Tri Chu Chi Huyết
灵傀之线布丁=Linh Khôi Chi Tuyến Bố Đinh
雾鸦之羽=Vụ Nha Chi Vũ
沙丘蛇=Sa Khâu Xà
凌小东=Lăng Tiểu Đông
大黑天剑=Đại Hắc Thiên Kiếm
风灵猫=Phong Linh Miêu
砂岩蛇=Sa Nham Xà
陈记早餐=Trần Ký Bữa Sáng
暗月湾=Ám Nguyệt Loan
耐力甲虫=Nại Lực Giáp Trùng
莉莉丝·爱丽……斯妲=Lilith Ailis Dát
眼魔大君=Nhãn Ma Đại Quân
眼魔法师=Nhãn Ma Pháp Sư
督军之眼=Đốc Quân Chi Nhãn
巢母之眼=Sào Mẫu Chi Nhãn
三眼乌鸦=Tam Nhãn Ô Nha
负能量力场=Phụ Năng Lượng Lực Tràng
冥界幽魂皇树=Minh Giới U Hồn Hoàng Thụ
御兽师协会=Ngự Thú Sư Hiệp Hội
御兽之家=Ngự Thú Chi Gia
暗竹林=Ám Trúc Lâm
白鹿区=Bạch Lộc Khu
联盟第三医院=Liên Minh Đệ Tam Bệnh Viện
新叶村=Tân Diệp Thôn
渊海镇=Uyên Hải Trấn
阴影之触=Xúc Tu Bóng Tối
灰烬小队=Đội Tro Tàn
天地乖离·鼠鼠御魂剑=Thiên Địa Quai Li·Thử Thử Ngự Hồn Kiếm
大黑天剑舞叁式——阴影天幕=Đại Hắc Thiên Kiếm Vũ Tam Thức - Âm Ảnh Thiên Mạc
大黑天剑舞伍式——沉世之月=Đại Hắc Thiên Kiếm Vũ Ngũ Thức - Trầm Thế Chi Nguyệt
百兽塔=Bách Thú Tháp
虚空圣女果=Hư Không Thánh Nữ Quả
尘世黑雾=Trần Thế Hắc Vụ
艾瑞斯曼=Ngải Thụy Tư Mạn
无尽欢宴之主=Vô Tận Hoan Yến Chi Chủ
大欲神=Đại Dục Thần
翡翠小区=Phỉ Thúy tiểu khu
血雷城=Huyết Lôi Thành
气象谷=Khí Tượng Cốc
石铠蝼蛄=Thạch Khải Lâu Cô
冰咒鱼=Băng Chú Ngư
睡眠魔蛛=Thụy Miên Ma Chu
吸血鬼沼泽=Đầm Lầy Ma Cà Rồng
太古树森林=Rừng Cây Cổ Đại
沙漠火蚁=Sa Mạc Hỏa Kiến
力环=Lực Hoàn
帝都研究所=Đế Đô Nghiên Cứu Sở
虚空神力蛛=Hư Không Thần Lực Chu
嗅灵犬=Khứu Linh Khuyển
番茄味=Hương vị cà chua
焦糖布丁=Bánh Pudding Caramel
红眼铁皮怪=Quái Vật Thiết Bì Mắt Đỏ
雷音虎=Lôi Âm Hổ
灵傀之线=Linh Khôi Chi Tuyến
摄魂魔云羊=Nhiếp Hồn Ma Vân Dương
雷音锻体=Lôi Âm Đoán Thể
初级自愈=Sơ Cấp Tự Dũ
剪影鼠=Tiễn Ảnh Thử
阴影拟态=Âm Ảnh Nghĩ Thái
灵火之目=Linh Hỏa Chi Mục
幽魂灯笼灵=U Hồn Đăng Lung Linh
鬼灯小队=Quỷ Đăng Tiểu Đội
焚暗者=Phần Ám Giả
霜雪亚龙=Sương Tuyết Á Long
鬼面蛇=Quỷ Diện Xà
傲慢堕天使壶=Bình Kiêu Ngạo Đọa Thiên Sứ
熔岩地龙=Địa Long Dung Nham
黑月商会=Thương Hội Hắc Nguyệt
土砂鳄=Thổ Sa Ngạc
克丝丝=Khắc Ti Tư
死棘天王城=Thành Trói Chết Thiên Vương
肖兵=Tiêu Binh
江航=Giang Hàng
黑暗沼泽=Đầm Lầy Hắc Ám
血肉之翼魔盗团=Huyết Nhục Chi Dực Ma Đạo Đoàn
鼠天尊=Thử Thiên Tôn
元素之弓=Nguyên Tố Chi Cung
目剑咒灵=Mục Kiếm Chú Linh
怪力臂=Quái Lực Tí
铜噬=Đồng Phệ
银噬=Ngân Phệ
金噬=Kim Phệ
厚脂岩羊=Hậu Chi Nham Dương
斗士克星=Đấu Sĩ Khắc Tinh
特殊科=Đặc Thù Khoa
鼠爪接肢魔=Chuột Trảo Chi Ghép Quỷ
岚龙拳=Quyền Lam Long
冰狮学派=Băng Sư Học Phái
雷电印记黑豹=Báo đen Ấn ký Lôi điện
火蛇学派=Hỏa Xà Học Phái
血肉之翼=Đôi Cánh Thịt Máu
千面魔胎=Thiên Diện Ma Thai
蟹钳接肢魔=Giải Kiềm Tiếp Chi Ma
深红秽血降=Thâm Hồng Uế Huyết Giáng
朱雀七号炎爆手榴弹=Lựu đạn viêm bạo Chu Tước số 7
暴风巨妖=Bạo Phong Cự Yêu
黑光电豹=Hắc Quang Điện Báo
烈焰蛇=Liệt Diễm Xà
八臂泰坦蛇人=Bát Tí Thái Thản Xà Nhân
小座天使=Tiểu Tọa Thiên Sứ
雾鸦=Vụ Nha
千面荒力蚁=Thiên Diện Hoang Lực Kiến
冰魔白狮=Băng Ma Bạch Sư
白明义=Bạch Minh Nghĩa
陈玉霄=Trần Ngọc Tiêu
彭锷=Bành Ngạc
三瓣眼面具=Tam Biện Nhãn Diện Cụ
痛苦荆棘会=Thống Khổ Kinh Cức Hội
狂欢剧团=Cuồng Hoan Kịch Đoàn
荒蚁冢秘境=Bí Cảnh Gò Kiến Hoang
潮汐密林=Mật Lâm Triều Tịch
沼泽三足鱼=Ngư Ba Chân Đầm Lầy
沙耳狐=Hồ Tai Cát
拳击仙人掌=Xương Rồng Đấm Bốc
苍白岩林=Nham Lâm Bạc
沙漠石笋=Măng Đá Sa Mạc
血色戈壁=Gobi Huyết Sắc
黑麟三型=Hắc Lân Tam Hình
蚁塔平原=Bình Nguyên Tháp Kiến
千面大魔的心核=Thiên Diện Đại Ma Đích Tâm Hạch
摄魂魔云的触臂=Nhiếp Hồn Ma Vân Đích Xúc Tí
千面树形布丁=Bánh Pudding Hình Cây Ngàn Mặt
千面大魔心核=Trái Tim Đại Ma Ngàn Mặt
掘地鲨鱼王=Quật Địa Sa Ngư Vương
鼠天神=Thử Thiên Thần
奥丁鼠=Áo Đinh Thử
千面之荒力蚁=Thiên Diện Chi Hoang Lực Nghĩ
掘地鲨鱼=Quật Địa Sa Ngư
大地之母教团=Đại Địa Chi Mẫu Giáo Đoàn
魂之分身=Hồn Chi Phân Thân
梦魇之印=Mộng Yểm Chi Ấn
千面之鼠=Thiên Diện Chi Thử
鼠鼠一号=Thử Thử Nhất Hào
鼠鼠二号=Thử Thử Nhị Hào
电纹=Điện Văn
大黑天剑气=Đại Hắc Thiên Kiếm Khí
血蚀剑气=Huyết Thực Kiếm Khí
深渊垂钓者=Thâm Uyên Thùy Điếu Giả
黄金级秘仪=Hoàng Kim Cấp Bí Nghi
色欲大罪之祷告=Sắc Dục Đại Tội Chi Đảo Cáo
幽海潜行=U Hải Tiềm Hành
蝎尾牛=Hạt Vĩ Ngưu
蝎牛王=Hạt Ngưu Vương
青梧=Thanh Ngô
浮梦水母=Phù Mộng Thủy Mẫu
连心鸟=Liên Tâm Điểu
幻魇之丝=Huyễn Yểm Chi Ti
噩梦之丝=Ác Mộng Chi Ti
银焰梦狱=Ngân Diễm Mộng Ngục
陨星市第一高中=Trường Trung học Số 1 Vẫn Tinh Thị
铜甲狒狒=Đồng Giáp Phí Phí
桃花斑点蛙=Ếch Đốm Đào Hoa
猛火雕=Mãnh Hỏa Điêu
碧水蓝狼=Bích Thủy Lam Lang
灵性蜕变接肢魔首领=Linh Tính Thoái Biến Tiếp Chi Ma Thủ Lĩnh
操纵蚁潮的红火蚁后=Thao Túng Nghĩ Triều Đích Hồng Hỏa Nghĩ Hậu
星云妖=Tinh Vân Yêu
陨星巨人=Vẫn Tinh Cự Nhân
永恒的星灵=Vĩnh Hằng Đích Tinh Linh
朱斐=Chu Phỉ
苏斌=Tô Bân
王兴剑=Vương Hưng Kiếm
黄金龙狮=Hoàng Kim Long Sư
灵傀咒线=Linh Khôi Chú Tuyến
宝库妖=Bảo Khố Yêu
赤璃果=Xích Li quả
星光雾妖=Tinh Quang Vụ Yêu
雪鬼盾蟹=Tuyết Quỷ Thuẫn Giải
煌黑赤蚁=Huỳnh Hắc Xích Nghị
烁油降神计划=Chúc Duáng Thần Kế Hoạch
星光城=Tinh Quang Thành
苏彬=Tô Bân
许青叶=Hứa Thanh Diệp
龙面鲤=Long Diện Lí
大渊市高中=Đại Uyên Thị Cao Trung
嗜血龙树=Thị Huyết Long Thụ
屋蜗牛=Ốc Sên Nhà
黄昏神祇=Hoàng Hôn Thần Kỳ
深红三眼龙鹰=Thâm Hồng Tam Nhãn Long Ưng
鼠鼠御魂剑·蚁王碎星=Thử Thử Ngự Hồn Kiếm - Nghĩ Vương Toái Tinh
深红之海=Thâm Hồng Chi Hải
鼠符咒=Thử Phù Chú
大黑天剑术=Đại Hắc Thiên Kiếm Thuật
黑月斩=Hắc Nguyệt Trảm
灵傀线技=Linh Khôi Tuyến Kỹ
傀儡网=Khôi Lỗi Võng
虚空龙枪=Hư Không Long Thương
铁房蜗牛=Thiết Phòng Ốc Sên
深红湮灭炮=Thâm Hồng Yêm Diệt Pháo
红水晶心脏=Hồng Thủy Tinh Tâm Tạng
万物奇迹=Vạn Vật Kỳ Tích
秘食之力=Bí Thực Chi Lực
生命之红王=Sinh Mệnh Chi Hồng Vương
噬空螳螂=Phệ Không Đường Lang
生命锻造术=Sinh Mệnh Đoán Tạo Thuật
黄昏之母教团=Giáo Đoàn Hoàng Hôn Chi Mẫu
付锋=Phó Phong
应平=Ứng Bình
少女鼠=Thiếu Nữ Thử
鼠妈妈=Thử Mẫu Mụ
陨星高中=Vẫn Tinh Cao Trung
马岩=Mã Nham
赤蛟蛇=Xích Giao Xà
冥火狼犬=Minh Hỏa Lang Khuyển
龙血虫=Long Huyết Trùng
黄泉之土=Hoàng Tuyền Chi Thổ
煌黑荒力蚁=Hoàng Hắc Hoang Lực Kiến
地狱火魔=Địa Ngục Hỏa Ma
桃花香牌香烟=Đào Hoa Hương Bài Hương Yên
食梦教团教主=Thực Mộng Giáo Đoàn Giáo Chủ
永恒梦乡=Vĩnh Hằng Mộng Hương
桃花牌香烟=Thuốc lá Đào Hoa Bài
齐康=Tề Khang
太古异种荒力蚁=Thái Cổ Dị Chủng Hoang Lực Kiến
痛苦荆棘教会=Giáo Hội Khổ Đau Gai Góc
苦痛之母=Khổ Đau Chi Mẫu
冥土教团=Minh Thổ Giáo Đoàn
黄昏三头龙=Hoàng Hôn Tam Đầu Long
冥土祭司=Minh Thổ tế tư
白瓷面具女=Bạch Từ diện cụ nữ
尸骸龙神=Thi Hài Long Thần
煌黑赤龙蚁后=Hoàng Hắc Xích Long Nghĩ Hậu
黄泉龙=Hoàng Tuyền Long
安息教会=An Tức Giáo Hội
血狼面具=Huyết Lang Diện Cụ
鲛魔=Giao Ma
狂暴山鬼=Cuồng Bạo Sơn Quỷ
风暴巨妖=Phong Bạo Cự Yêu
蓝铁巨魔=Lam Thiết Cự Ma
流水漩涡=Lưu Thủy Tuyền Qua
脑垫波=Não Điệm Ba
原始灵海=Nguyên Thủy Linh Hải
杨岩=Dương Nham
荆棘痛苦教会=Giáo hội Gai Góc Đau Khổ
黑光战团=Chiến đoàn Hắc Quang
桃花乡=Đào Hoa Hương
卢诞=Lư Đản
魇海魔鲸=Yểm Hải Ma Kình
司徒空会长=Hội trưởng Tư Đồ Không
关门，放鼠鼠！=Đóng cửa, thả Thử Thử!
小小鼠=Tiểu Tiểu Thử
灵蚀状态——幻影侵世者=Linh Thực Trạng Thái - Huyễn Ảnh Xâm Thế Giả
唐白虎=Đường Bạch Hổ
鬼脸咒蛙=Quỷ Diện Chú Oa
混沌蛛巢=Hỗn Độn Chu Sào
藏骸帝之书=Tàng Hài Đế Chi Thư
生命泡泡=Sinh Mệnh Bào Bào
亡骸登圣术=Vong Hài Đăng Thánh Thuật
初始之藏骸帝=Sơ Thủy Chi Tàng Hài Đế
织星=Chức Tinh
魔云老哥=Ma Vân Lão Ca
狂血鬣狗=Cuồng Huyết Liệp Cẩu
狮面鹿=Sư Diện Lộc
铁血域=Thiết Huyết Vực
铁血剑犬=Thiết Huyết Kiếm Khuyển
铁血狱獒=Thiết Huyết Ngục Ngao
医王域=Y Vương Vực
月蚀教团=Nguyệt Thực Giáo Đoàn
众生平等砖=Chúng Sinh Bình Đẳng Chuyên
地中海老头=Ông lão Địa Trung Hải
阳光咩羊=Dương Quang Miệt Dương
原初时代=Thời Đại Nguyên Sơ
碎星大远征=Toái Tinh Đại Viễn Chinh
晨曦时代=Thời Đại Thần Hi
三重逆生骸天使仪式=Tam Trùng Nghịch Sinh Hài Thiên Sứ Nghi Thức
齿轮人偶=Xỉ Luân Nhân Ngẫu
骸骨国度=Hài Cốt Quốc Độ
机械之神正教=Cơ Giới Chi Thần Chính Giáo
蒸汽之神=Hơi Nước Chi Thần
烁油派=Thước Du Phái
黄泉幽鱼=Hoàng Tuyền U Ngư
黄泉幽角鲨=Hoàng Tuyền U Giác акула
群星时代=Quần Tinh Thời Đại
骸天使之骨=Xương Thiên Sứ Hài Cốt
骸骨掌控=Khống Chế Hài Cốt
圣遗物黑剑=Thánh Di Vật Hắc Kiếm
陨星市=Vẫn Tinh Thị
雷角蛇=Lôi Giác Xà
大渊市新星竟然是个怪物！=Tân Tinh Đại Uyên Thị Lại Là Quái Vật!
暗月花妖=Ám Nguyệt Hoa Yêu
育种蜻蜓=Dục Chủng Tinh Đình
甘霖蛙=Cam Lâm Oa
月玫=Nguyệt Môi
暗月玫瑰=Ám Nguyệt Môi Khôi
梦狱=Yểm Mộng Ngục
凝神灵茶=Ngưng Thần Linh Trà
庚金灵米=Canh Kim Linh Mễ
磐石小麦=Bàn Thạch Tiểu Mạch
食腐教团=Thực Hủ Giáo Đoàn
雷鸟蛛=Lôi Điểu Chu
周小黄=Chu Tiểu Hoàng
千面大魔=Thiên Diện Đại Ma
白银黍=Bạch Ngân Kê
黄金圣光黍=Hoàng Kim Thánh Quang Kê
大欲巷=Đại Dục Hạng
杨鸣岐=Dương Minh Kỳ
欢愉修道会=Hoan Du Tu Đạo Hội
虎头兽人=Hổ Đầu Thú Nhân
混沌魔蛛=Hỗn Độn Ma Chu
极乐圣女=Cực Lạc Thánh Nữ
欢愉之子=Đứa con của Hoan Hỉ
欢乐修道会=Tu đạo hội Hoan Lạc
天赋门之主=Thiên Phú Môn Chi Chủ
喰欲巨人=Thực Dục Cự Nhân
碎玉吼=Toái Ngọc Hống
五兽=Ngũ Thú
青铜鉴妖=Thanh Đồng Giám Yêu
侦查之眼=Trinh Tra Chi Nhãn
原始升灵树=Nguyên Thủy Thăng Linh Thụ
风暴歌剧院=Nhà hát Opera Bão Táp
海螺交易会=Hội chợ Thương mại Ốc Biển
罪孽金币=Tội Nghiệt Kim Tệ
灵性蜕变=Linh Tính Thoái Biến
残月森林=Rừng Trăng Tàn
月灵麋鹿=Nai Sừng Tấm Ánh Trăng
超能月轮=Siêu Năng Nguyệt Luân
欢愉女妖=Nữ Yêu Hoan Lạc
心灵之盾=Khiên Tâm Linh
庇护之参=Sâm Che Chở
膨胀猿猴=Vượn Bành Trướng
煌黑荒龙蚁=Hoàng Hắc Hoang Long Kiến
深海连击=Liên Kích Biển Sâu
门之使徒=Sứ Đồ Cánh Cửa
辟途者=Tịch Đồ Giả
逐光骑士=Trục Quang Kỵ Sĩ
冥帝鼠=Minh Đế Thử
千面鼠神=Thiên Diện Thử Thần
欢喜佛鼠=Hoan Hỉ Phật Thử
暴食鼠神=Bạo Thực Thử Thần
怠惰鼠神=Đãi Nọa Thử Thần
腥风蜈蚣=Tinh Phong Ngô Công
升灵果=Thăng Linh Quả
地母莲子=Địa Mẫu Liên Tử
异想物·梦幻泡影=Dị Tưởng Vật - Mộng Huyễn Bào Ảnh
终末黄昏=Chung Mạt Hoàng Hôn
极冰猛犸=Cực Băng Mãnh Mã
霜妖精=Sương Yêu Tinh
黑暗魔人=Hắc Ám Ma Nhân
黑暗之盾=Hắc Ám Chi Thuẫn
腐败与纷争之龙=Hủ Bại Dữ Phân Tranh Chi Long
自然繁茂之绿龙=Lục Long Tự Nhiên Phồn Mậu
生命腐败=Sinh Mệnh Hủ Bại
翠玉龙斩=Thúy Ngọc Long Trảm
腐败龙息=Hủ Bại Long Tức
腐败龙息·千丝=Hủ Bại Long Tức · Thiên Ti
祁长海=Kỳ Trường Hải
地灵之握=Địa Linh Chi Ác
繁绿之盾=Phồn Lục Chi Thuẫn
虚空放牧者=Hư Không Phóng Mục Giả
冥蛛剑气=Minh Chu Kiếm Khí
秘境黄毛陆羽=Bí Cảnh Hoàng Mao Lục Vũ
翠绿之宫=Thúy Lục Chi Cung
空鬼面具=Không Quỷ Diện Cụ
真理慈父=Chân Lý Từ Phụ
腐败秘境=Hủ Bại Bí Cảnh
沙王座=Sa Vương Tọa
原始升灵果=Nguyên Thủy Thăng Linh Quả
腐败蜂巢=Hủ Bại Phong Sào
藏骸帝神力=Tàng Hài Đế Thần Lực
黄昏之力=Hoàng Hôn Chi Lực
太古巨树=Thái Cổ Cự Thụ
太古王树=Thái Cổ Vương Thụ
梁奎=Lương Khuê
御兽空间=Ngự Thú Không Gian
原始灵能=Nguyên Thủy Linh Năng
虚空龙蚁号=Hư Không Long Nghĩ Hào
深红百目龙首=Thâm Hồng Bách Mục Long Thủ
灵性拼图=Linh Tính Phổ Đồ
小魂灯=Tiểu Hồn Đăng
虚空引擎=Hư Không Dẫn Động
蟹老板=Giải Lão Bản
深红龙首=Thâm Hồng Long Thủ
暗星泰坦号=Ám Tinh Thái Thản Hào
深海镇=Thâm Hải Trấn
潮汐使者=Triều Tịch Sứ Giả
大地咒棺=Đại Địa Chú Quan
灾兽咒神将=Tai Thú Chú Thần Tướng
求空之路=Cầu Không Chi Lộ
尘世之锁=Trần Thế Chi Tỏa
李憬=Lý Cảnh
涅槃大魔=Nirvana Đại Ma
虚空蛞蝓=Hư Không Sên
虚空力场=Hư Không Lực Trường
宋玥=Tống Nguyệt
爆裂火牛=Bạo Liệt Hỏa Ngưu
烈火烹油灵性拼图=Liệt Hỏa Phanh Du Linh Tính Phanh Đồ
色欲之鼠=Chuột sắc dục
怠惰之鼠=Chuột lười biếng
暴食之鼠=Chuột tham ăn
温泉山庄=Ôn Tuyền Sơn Trang
地震之兽=Địa Chấn Chi Thú
陈池=Trần Trì
雷翼蛇=Lôi Dực Xà
熔山者=Dung Sơn Giả
冥鬼之面=Minh Quỷ Chi Diện
千面牧场=Thiên Diện Mục Trường
深渊堕落幽魂树=Thâm Uyên Đọa Lạc U Hồn Thụ
幽冥·千炮=U Minh · Thiên Pháo
线技——空天之巢=Tuyệt Kỹ Tơ Nhện - Không Thiên Chi Sào
红莲女武神=Hồng Liên Nữ Vũ Thần
度魂之种=Độ Hồn Chi Chủng
边境新星=Biên Cảnh Tân Tinh
绞杀之网=Giảo Sát Chi Võng
赤灵鬼=Xích Linh Quỷ
奥义——灼世红莲枪=Áo Nghĩa - Chước Thế Hồng Liên Thương
剥面者=Bóc Diện Giả
炎缚蛇首明王=Viêm Phược Xà Thủ Minh Vương
古凰巢=Cổ Hoàng Sào
黄昏教会=Giáo Hội Hoàng Hôn
癫血鬣狗=Điên Huyết Liệp Cẩu
疯狂高原=Cao Nguyên Điên Cuồng
温泉小镇=Ôn Tuyền Tiểu Trấn
万世贪婪圣杯=Vạn Thế Tham Lam Thánh Bôi
枯虫灵木=Khô Trùng Linh Mộc
空晶珊瑚=Không Tinh San Hô
珊瑚王虫=San Hô Vương Trùng
虚空之子=Hư Không Chi Tử
虚空皮肤=Hư Không Bì Phu
幽鬼碎星炮=U Quỷ Toái Tinh Pháo
虚空隙斩=Hư Không Khích Trảm
蛛丝送葬=Tru Chu Ti Tống Táng
千丝牢=Thiên Ti Lao
隐匿之镜=Ẩn Nặc Chi Kính
虚空鱼霸主=Hư Không Ngư Bá Chủ
次元乱空斩=Thứ Nguyên Loạn Không Trảm
虚鸣百目之蝉=Hư Minh Bách Mục Chi Thiền
虚鸣乐章=Hư Minh Nhạc Chương
赐福珊瑚=Tứ Phúc San Hô
禁忌秘食=Cấm Kỵ Bí Thực
虚空监牢=Hư Không Giam Lao
虚鸣真言=Hư Minh Chân Ngôn
虚空鱼=Hư Không Ngư
星辰叶=Tinh Thần Diệp
恩赐珊瑚=Ân Tứ San Hô
黑暗兽人王国=Hắc Ám Thú Nhân Vương Quốc
厄运蒙蔽=Ách Vận Mông Tế
魇海潜行=Yểm Hải Tiềm Hành
虚空蛛后=Hư Không Chu Hậu
虚空牦牛=Hư Không Hao Ngưu
月光蛾=Nguyệt Quang Nga
无面鼠神计划=Kế hoạch Thần Chuột Vô Diện
虚鸣百目蝉=Hư Minh Bách Mục Thiền
雪花飘飘=Tuyết Hoa Phiêu Phiêu
欢宴者=Hoan Yến Giả
龙之秘境=Long Chi Bí Cảnh
夜月生态=Dạ Nguyệt Sinh Thái
无生骨冢=Vô Sinh Cốt Trủng
梦之熔炉=Mộng Chi Dung Lô
狩狼战团=Thú Lang Chiến Đoàn
张荔=Trương Lệ
赤龙秘境=Xích Long Bí Cảnh
辛羸=Tân Doanh
琉璃苏家=Lưu Ly Tô gia
苏礼=Tô Lễ
天青琉璃鸟=Thiên Thanh Lưu Li Điểu
魇梦之城=Yểm Mộng Chi Thành
夜月菇=Dạ Nguyệt Cô
月萤虫=Nguyệt Huỳnh Trùng
食人月桂=Thực Nhân Nguyệt Quế
紫翼雷蝠=Tử Dực Lôi Bức
无生骨=Vô Sinh Cốt
幽火骨龙=U Hỏa Cốt Long
熔岩柱=Dung Nham Trụ
熔岩驮兽=Dung Nham Đà Thú
狂雷亚龙=Cuồng Lôi Á Long
雷暴秘境=Lôi Bạo Bí Cảnh
腐梦大蛇=Hủ Mộng Đại Xà
夜月秘境=Bí cảnh Dạ Nguyệt
轮回之龙=Luân Hồi Chi Long
不朽饥渴之龙=Bất Hủ Cơ Khát Chi Long
幽魂骨龙=U Hồn Cốt Long
薄暮小镇=Tiểu trấn Bạc Mộ
夜月镇=Trấn Dạ Nguyệt
黄昏邪龙=Tà Long Hoàng Hôn
苍白之握=Cú Vồ Xám Trắng
百骨帝=Bách Cốt Đế
农场领主=Lãnh Chúa Nông Trại
秘境黄毛=Bí Cảnh Hoàng Mao
昏光天使战甲=Hôn Quang Thiên Sứ Chiến Giáp
黑山羊之盾=Thuẫn Dê Đen
升月湖=Hồ Thăng Nguyệt
暮色草场=Mộ Sắc Thảo Trường
腐宴=Hủ Yến
秽血大炮=Uế Huyết Đại Pháo
贪婪者的血肉=Thịt của kẻ tham lam
薄暮农场=Bạc Mộ Nông Trại
终产者之手=Chung Sản Giả Chi Thủ
繁育女士=Phồn Dục Nữ Sĩ
彭麟=Bành Lân
白虎忍者=Bạch Hổ Nhẫn Giả
蝴蝶忍=Hồ Điệp Nhẫn
骆驼忍者=Lạc Đà Nhẫn Giả
锈剑豹=Tú Kiếm Báo
压缩猿猴=Áp Súc Viên Hầu
骸食=Hài Thực
魂食=Hồn Thực
云海之露=Vân Hải Chi Lộ
千里镜妖=Thiên Lý Kính Yêu
黄金髓液=Hoàng Kim Tủy Dịch
废弃城区=Phế Khí Thành Khu
冥河原液=Minh Hà Nguyên Dịch
腐宴秘境=Hủ Yến Bí Cảnh
白骨号角=Bạch Cốt Hào Giác
生机之梦=Sinh Cơ Chi Mộng
梦境屏障术=Mộng Cảnh Bình Chướng Thuật
锈血诅咒=Tú Huyết Nguyền Rủa
千面之盾=Thiên Diện Chi Thuẫn
群星信使=Quần Tinh Tín Sứ
牧场之兽=Quái thú trang trại
黄昏畸变体=Dị thể Hoàng Hôn
联盟群星百兽塔=Liên minh Quần Tinh Bách Thú Tháp
暮色倒影=Mộ Sắc Đảo Ảnh
食影巨蚯=Thực Ảnh Cự Giun
天之修女=Thiên Chi Tu Nữ
黄昏主教=Giáo chủ Hoàng Hôn
燃灯女=Nhiên Đăng Nữ
繁绿女士=Phồn Lục Nữ Sĩ
第十指=Thập Chỉ
黄昏国度=Hoàng Hôn Quốc Độ
暗影三头蛇=Ám Ảnh Tam Đầu Xà
阴影天幕=Âm Ảnh Thiên Mạc
魔云之枪=Ma Vân Chi Thương
诸星唯光！喰日黄昏！=Chư Tinh Duy Quang! Thực Nhật Hoàng Hôn!
日暮之轮=Nhật Mộ Chi Luân
摄魂场域=Nhiếp Hồn Tràng Vực
骸骨王座=Hài Cốt Vương Tọa
黄昏燃灯女=Hoàng Hôn Nhiên Đăng Nữ
黄衣大主教=Hoàng Y Đại Giáo Chủ
圣骸王=Thánh Hài Vương
徐小桃=Từ Tiểu Đào
小亟=Tiểu Cức
神殿废墟=Thần Điện Phế Khư
蚁王碎星剑=Nghĩ Vương Toái Tinh Kiếm
冥土之印=Minh Thổ Chi Ấn
喰雷虫将军=Xúc Lôi Trùng Tướng Quân
喰雷虫鼓手=Xúc Lôi Trùng Cổ Thủ
回复之雷音=Hồi Phục Chi Lôi Âm
喰雷虫谋士=Xúc Lôi Trùng Mưu Sĩ
黄昏污染=Hoàng Hôn Ô Nhiễm
接肢魔种族=Tiếp Chi Ma Chủng Tộc
八臂明王咒术=Bát Tí Minh Vương Chú Thuật
八面忿怒明王=Bát Diện Phẫn Nộ Minh Vương
衰老天秤=Suy Lão Thiên Bình
三重逆升骸天使之阵=Tam Trùng Nghịch Thăng Hài Thiên Sứ Chi Trận
食骸鬼=Thực Hài Quỷ
黄昏尘埃=Hoàng Hôn Trần Ai
屏障腐蚀液=Bình Chướng Hủ Thực Dịch
星光屏障=Tinh Quang Bình Chướng
影界召唤门=Ảnh Giới Triệu Hoán Môn
闫丽川=Diêm Lệ Xuyên
潘均=Phan Quân
覃京燕=Đàm Kinh Yến
舒祝林=Thư Chúc Lâm
日轮金羊=Nhật Luân Kim Dương
幽魂灯笼=U Hồn Đăng Lung
阴影虫后=Âm Ảnh Trùng Hậu
暴刃虎=Bạo Nhận Hổ
铁血獒=Thiết Huyết Ngao
乙木亚龙=Ất Mộc Á Long
历战王体系=Lịch Chiến Vương Hệ Thống
暗月冒险团=Ám Nguyệt Mạo Hiểm Đoàn
金甲狒狒宠兽培育基地=Kim Giáp Phí Phí Sủng Thú Bồi Dưỡng Căn Cứ
荡空古钟=Đãng Không Cổ Chung
古剑之灵=Cổ Kiếm Chi Linh
荡魔之钟=Đãng Ma Chi Chung
繁绿之龙=Phồn Lục Chi Long
喰雷之虫=Xực Lôi Chi Trùng
亡骸之眼=Vong Hài Chi Nhãn
黑渊裂隙=Hắc Uyên Liệt Khích
骷王枪=Khô Vương Thương
千面之树=Thiên Diện Chi Thụ
安宁墓界=An Ninh Mộ Giới
破碎黄昏天=Phá Toái Hoàng Hôn Thiên
林漫=Lâm Mạn
王树东=Vương Thụ Đông
影镰螳螂=Ảnh Liêm Đường Lang
吕高峰=Lữ Cao Phong
黄召清=Hoàng Triệu Thanh
张茘=Trương Lệ
三重逆生骸天使之阵=Tam Trọng Nghịch Sinh Hài Thiên Sứ Chi Trận
小黄昏天=Tiểu Hoàng Hôn Thiên
铁道镇=Thiết Đạo Trấn
辛茜=Tân Sẩn
第十妖孽=Đệ Thập Yêu Nghiệt
原始角斗场=Nguyên Thủy Giác Đấu Tràng
毒月蚰蜒=Độc Nguyệt Du Diên
嗜血星狼=Thị Huyết Tinh Lang
星光夜鹄=Tinh Quang Dạ Hộc
繁育之月的主母=Chủ mẫu Phồn Dục Chi Nguyệt
喰月=Thực Nguyệt
繁育主母的月之宫=Nguyệt Cung của Mẫu Thể Sinh Sản
喰月泰坦=Thực Nguyệt Thái Thản
星光枸杞=Tinh Quang Câu Kỷ
星光龙眼=Tinh Quang Long Nhãn
星光黄精=Tinh Quang Hoàng Tinh
周天倒星仪轨=Chu Thiên Đảo Tinh Nghi Quỹ
泰坦之臂=Titan Chi Tí
关相平=Quan Tương Bình
永光云海=Vĩnh Quang Vân Hải
雾之都=Vụ Chi Đô
星野猎犬=Tinh Dã Liệp Khuyển
黑光秘境=Hắc Quang Bí Cảnh
噬光河灵=Phệ Quang Hà Linh
黄昏触手剑=Hoàng Hôn Xúc Thủ Kiếm
阴影之剑=Âm Ảnh Chi Kiếm
暗影九头大蛇=Ám Ảnh Cửu Đầu Đại Xà
林家庄园=Trang viên Lâm gia
脊骨之矛=Tích Cốt Chi Mâu
吞星湾流=Thôn Tinh Loan Lưu
黄昏龙拳=Hoàng Hôn Long Quyền
食光河灵=Thực Quang Hà Linh
千面鼠国=Thiên Diện Thử Quốc
日暮教会=Nhật Mộ Giáo Hội
林长帆=Lâm Trường Phàm
喰月泰坦之臂=Thực Nguyệt Thái Thản Chi Tí
岁星草=Tuế Tinh Thảo
星峰巨鹿=Tinh Phong Cự Lộc
八面狱王拳=Bát Diện Ngục Vương Quyền
星风蝶之翼=Tinh Phong Điệp Chi Dực
星光独角虫=Tinh Quang Độc Giác Trùng
星辰罡风=Tinh Thần Cương Phong
聚星灯鬼=Tụ Tinh Đăng Quỷ
星光钻石鹰=Tinh Quang Kim Cương Ưng
星钻之盔=Tinh Toản Chi Khôi
暗河之灵=Ám Hà Chi Linh
星辰翼龙=Tinh Thần Dực Long
碎星虎=Toái Tinh Hổ
跃星魔蛛=Dược Tinh Ma Chu
异星虫之卵=Dị Tinh Trùng Chi Noãn
黑光蛇星草=Hắc Quang Xà Tinh Thảo
食光星域=Thực Quang Tinh Vực
君主真言=Quân Chủ Chân Ngôn
万星市=Vạn Tinh Thị
终焉教会=Chung Yên Giáo Hội
星湾市=Tinh Loan Thị
砾光沙漠=Lịch Quang Sa Mạc
万金之林=Vạn Kim Chi Lâm
石油巨沼=Thạch Du Cự Chiểu
铜镍山=Đồng Nhiếp Sơn
韩古=Hàn Cổ
弹簧麻雀=Đạn Hoàng Ma Tước
金属弹簧生态=Kim Loại Đạn Hoàng Sinh Thái
弹簧裂变=Đạn Hoàng Liệt Biến
弹簧猛禽=Đạn Hoàng Mãnh Cầm
灵性蜕变级=Cấp Độ Linh Tính Lột Xác
蒸汽之盾=Khiên Hơi Nước
蒸汽大摆锤=Búa Lớn Hơi Nước
叶绿虫=Diệp Lục Trùng
活力树海=Sinh Lực Thụ Hải
木之屏障=Mộc Chi Bình Chướng
深红龙王=Thâm Hồng Long Vương
不夜城区=Bất Dạ Khu Thành
完美圣械油=Hoàn Mỹ Thánh Giới Du
老吴机械修理店=Lão Ngô Cơ Giới Tu Lý Điếm
吴技师=Kỹ sư Ngô
老吴修理=Lão Ngô Tu Lý
掘地金鼠=Quật Địa Kim Thử
麟焰铁=Lân Diễm Thiết
深渊魔眼=Thâm Uyên Ma Nhãn
深渊蛇人=Thâm Uyên Xà Nhân
万蛇之祖=Vạn Xà Chi Tổ
生命之红龙=Sinh Mệnh Chi Hồng Long
深渊眼魔=Thâm Uyên Nhãn Ma
幽影魔=U Ảnh Ma
雷纹天牛虫=Lôi Văn Thiên Ngưu Trùng
气象市=Khí Tượng Thị
雷暴天=Lôi Bạo Thiên
碧水蛇=Bích Thủy Xà
冻土龙息=Đống Thổ Long Tức
重水之拳=Trọng Thủy Chi Quyền
水雾幻影=Thủy Vụ Huyễn Ảnh
蚁王子弹拳=Nghĩ Vương Tử Đạn Quyền
剑术——尘世之月=Kiếm Thuật - Trần Thế Chi Nguyệt
冰霜国度=Băng Sương Quốc Độ
寒息蛟龙=Hàn Tức Giao Long
重水之灵=Trọng Thủy Chi Linh
弱水蜘蛛=Nhược Thủy Tri Chu
自然亲和=Tự Nhiên Thân Hòa
黑日教会=Hắc Nhật Giáo Hội
五骨丰登=Ngũ Cốt Phong Đăng
暮鸦=Mộ Nha
永夜之女=Vĩnh Dạ Chi Nữ
黄昏神性残肢=Hoàng Hôn Thần Tính Tàn Chi
万棘之路=Vạn Cức Chi Lộ
棘果小妖=Cức Quả Tiểu Yêu
棘果炮台树=Cức Quả Pháo Đài Thụ
毒棘巨人=Độc Cức Cự Nhân
毒棘龙=Độc Cức Long
万世荆棘乐园=Vạn Thế Kinh Cức Lạc Viên
诸星王家=Chư Tinh Vương Gia
诸星之墓=Chư Tinh chi Mộ
万械养蛊场=Vạn Giới Dưỡng Cổ Tràng
千面号角=Thiên Diện Hào Giác
赤帝喰空焰轮=Xích Đế Thực Không Diễm Luân
烁油二型动力炉=Lò động cơ Nhũ Du Nhị Hình
银甲狒狒=Ngân Giáp Vượn
金甲狒狒=Kim Giáp Vượn
苍山负雪=Thương Sơn Phụ Tuyết
吞渊大蛇=Thôn Uyên Đại Xà
幻梦蛛=Huyễn Mộng Chu
冥河之灵=Minh Hà Chi Linh
群鸦阶梯=Quần Nha Giai Thê
幽魂系=U Hồn Hệ
袭魂蜈蚣=Tập Hồn Ngô Công
黄泉虫龙=Hoàng Tuyền Trùng Long
烛照龙蜈=Chúc Chiếu Long Ngô
冥玉龙=Minh Ngọc Long
噬魂龙蜈=Phệ Hồn Long Ngô
死冥龙蜈=Tử Minh Long Ngô
冥河圣杯=Minh Hà Thánh Bôi
冥河佳酿=Minh Hà Giai Nương
边墓村=Biên Mộ Thôn
千面之力=Thiên Diện Chi Lực
勾魂蜈蚣=Câu Hồn Ngô Công
墓之神=Thần Mộ
冥府看守者=Người canh giữ Minh Phủ
安息牧师=Mục Sư An Tức
祓灵修女=Tu Nữ Bạt Linh
诸星家族=Gia tộc Chư Tinh
岳瑞霞=Nhạc Thụy Hà
紫蛇冒险团=Tử Xà Mạo Hiểm Đoàn
赤兔号=Xích Thố Hiệu
密武界=Mật Vũ Giới
灵蛇许磐=Linh Xà Hứa Bàn
仙鹤门=Tiên Hạc Môn
血羽流派=Huyết Vũ Lưu Phái
地魔蝎流派=Địa Ma Hạt Lưu Phái
帝企鹅流派=Đế Xí Nga Lưu Phái
雷牛流派=Lôi Ngưu Lưu Phái
藏剑密武流派=Tàng Kiếm Mật Vũ Lưu Phái
商余光=Thương Dư Quang
大蟾宫=Đại Sàm Cung
吞世邪龙甲=Thôn Thế Tà Long Giáp
仇玉=Cừu Ngọc
大蟾气法门=Đại Thiềm Khí Pháp Môn
古鹿=Cổ Lộc
暗蝠=Ám Bức
线技——沉默心网！=Tuyệt Kỹ Tuyến - Trầm Mặc Tâm Võng!
撕裂魔眼=Té Rách Ma Nhãn
冰天葬刃=Băng Thiên Táng Nhận
积羽沉舟=Tích Vũ Trầm Chu
真实蟾祖降魔仪祭飞升咒印=Chân Thực Thiềm Tổ Hàng Ma Nghi Tế Phi Thăng Chú Ấn
真魔飞升台=Chân Ma Phi Thăng Đài
崔啸=Thôi Khiếu
三十六臂龙魔古树=Tam Thập Lục Tý Long Ma Cổ Thụ
浊世羽衣=Trọc Thế Vũ Y
血羽密武=Huyết Vũ Mật Vũ
浊狱之舞=Trọc Ngục Chi Vũ
大靇气=Đại Lũng Khí
湮灭之息=Yên Diệt Chi Tức
雷古=Lôi Cổ
北无疆=Bắc Vô Cương
大黑天剑舞=Đại Hắc Thiên Kiếm Vũ
沉世之月=Trầm Thế Chi Nguyệt
日暮氦闪=Nhật Mộ Hê Thiểm
诸生无我=Chư Sinh Vô Ngã
许磐=Hứa Bàn
碧落奈何龙=Bích Lạc Nại Hà Long
黄泉龙狼=Hoàng Tuyền Long Lang
澹台玉=Đạm Đài Ngọc
至暗之门=Chí Ám Chi Môn
深红牧场=Thâm Hồng Mục Tràng
深红结界=Thâm Hồng Kết Giới
深红审判=Thâm Hồng Thẩm Phán
冻土之眼=Đống Thổ Chi Nhãn
阐玉儿=Xiển Ngọc Nhi
九械魔蝎=Cửu Giới Ma Hạt
星墓公牛=Tinh Mộ Công Ngưu
勾魂龙蜈=Câu Hồn Long Ngô
大蟾市=Đại Thiềm Thị
吴心月=Ngô Tâm Nguyệt
百吞虫后=Bách Thôn Trùng Hậu
亿万光辉者=Ức Vạn Quang Huy Giả
帝都联盟=Đế Đô Liên Minh
徐枢=Từ Xu
天梭鹰=Thiên Thoa Ưng
碧水牛=Bích Thủy Ngưu
狂风枪蟹=Cuồng Phong Thương Giải
幽光海蜇=U Quang Hải Triết
黑暗尾猪=Hắc Ám Vĩ Trư
大赤猿王之颅=Đầu Đại Xích Viên Vương
百吞虫后果冻=Bách Thôn Trùng Hậu Quả Đống
蚀空兽的虚空之腹=Hư Không Chi Phúc của Thực Không Thú
盛剑=Thịnh Kiếm
诸生剑匣=Chư Sinh Kiếm Hạp
虚空宝箱=Hư Không Bảo Rương
虚空诸生剑冢=Hư Không Chư Sinh Kiếm Trủng
龙王之颅=Long Vương Chi Lư
秘仪系=Hệ Bí Nghi
药王域=Dược Vương Vực
朽毒王=Hủ Độc Vương
狩猎药王=Săn Bắn Dược Vương
百棱架构秘仪法=Bách Lăng Giá Cấu Bí Nghi Pháp
秘仪魔笔妖=Bí Nghi Ma Bút Yêu
木须马=Mộc Tu Mã
木瘿症=Mộc Anh Chứng
吮木虫=Xuyến Mộc Trùng
金翼啄木鸟=Kim Dực Trác Mộc Điểu
冰肌女妖=Băng Cơ Nữ Yêu
玉骨龙=Ngọc Cốt Long
风行符鬼=Phong Hành Phù Quỷ
黑死铡刀腿=Hắc Tử Sát Đao Thối
穹天九御仪轨=Khung Thiên Cửu Ngự Nghi Quỹ
陨石仔=Vẫn Thạch Tử
星陨石人=Tinh Vẫn Thạch Nhân
星脉狐=Tinh Mạch Hồ
陨石蟾蜍=Vẫn Thạch Thiềm Thừ
磁场飞鹰=Từ Trường Phi Ưng
东山72号矿场=Mỏ số 72 Đông Sơn
堕龙密武=Đọa Long Mật Vũ
藏剑密武=Tàng Kiếm Mật Vũ
击坠群星=Kích trụy quần tinh
星光箭雨=Tinh Quang Tiễn Vũ
坠星之盾=Truy Tinh Chi Thuẫn
多重坠星咒印=Đa Trọng Truy Tinh Chú Ấn
迭加击坠群星仪轨=Điệt Gia Kích Trụy Quần Tinh Nghi Quỹ
秘食=Bí Thực
异想物——梦幻泡影=Dị Tưởng Vật - Mộng Huyễn Bào Ảnh
幻境掌控=Huyễn Cảnh Chưởng Khống
十二坠星=Thập Nhị Truy Tinh
原始星空肉田=Nguyên Thủy Tinh Không Nhục Điền
永恒星界之门=Vĩnh Hằng Tinh Giới Chi Môn
光头祭司=Quang Đầu Tế Tự
流星熔炉=Lưu Tinh Dung Lô
囚月星链=Tù Nguyệt Tinh Liên
永恒星界=Vĩnh Hằng Tinh Giới
真言——碎星=Chân Ngôn - Toái Tinh
诸星龙王剑匣=Chư Tinh Long Vương Kiếm Hạp
大赤猿王=Đại Xích Viên Vương
门之主晋升晨星仪式=Môn Chi Chủ Tấn Thăng Thần Tinh Nghi Thức
密武投影=Mật Vũ Đầu Ảnh
四十二臂神圣龙树投影=Tứ Thập Nhị Tí Thần Thánh Long Thụ Đầu Ảnh
食光湾流=Thực Quang Loan Lưu
灰烬锻造屋=Tro Tẫn Đoán Tạo Ốc
原始之铜=Nguyên Thủy Chi Đồng
星之血=Tinh Chi Huyết
虚空之眼=Hư Không Chi Nhãn
虚空之冕=Hư Không Chi Miện
碎星真言=Toái Tinh Chân Ngôn
千面镇魂鼓=Thiên Diện Trấn Hồn Cổ
深红世界=Thâm Hồng Thế Giới
穿死星=Xuyên Tử Tinh
星灾=Tinh Tai
穿死星之枪=Xuyên Tử Tinh Chi Thương
群星王族=Quần Tinh Vương Tộc
郭志青=Quách Chí Thanh
天星莲妖=Thiên Tinh Liên Yêu
东山矿工协会=Hiệp hội Thợ mỏ Đông Sơn
星神将=Tinh Thần Tướng
星辰雷击木=Tinh Thần Lôi Kích Mộc
星海之砂=Tinh Hải Chi Sa
影星巨鲸=Ảnh Tinh Cự Kình
星影跃迁=Tinh Ảnh Dược Thiên
星寿花=Tinh Thọ Hoa
星霜果=Tinh Sương Quả
星火兽=Tinh Hỏa Thú
暗星域人民=Nhân Dân Ám Tinh Vực
星黎=Tinh Lê
群星兄弟会=Quần Tinh Huynh Đệ Hội
工人鼠=Công Nhân Thử
咒鸦=Chú Nha
寒冰巨象=Hàn Băng Cự Tượng
火山巨蛇=Hỏa Sơn Cự Xà
律法种子=Luật Pháp Chủng Tử
太古星域=Thái Cổ Tinh Vực
纸艺=Chỉ Nghệ
极暗纸枪=Cực Ám Chỉ Thương
诸世切割=Chư Thế Thiết Cát
暗纸爆破=Ám Chỉ Bạo Phá
燃纸维新=Nhiên Chỉ Duy Tân
藏骸帝神殿=Tàng Hài Đế Thần Điện
骸天使安海=Hài Thiên Sứ An Hải
万纸之国的所有生命=Vạn Chỉ Chi Quốc Đích Sở Hữu Sinh Mệnh
翡翠之梦=Phỉ Thúy Chi Mộng
万纸国度=Vạn Chỉ Quốc Độ
灰烬小屋=Tro Tàn Tiểu Ốc
天厄星灾龙=Thiên Ách Tinh Tai Long
群星眷族=Quần Tinh Quyến Tộc
诸星熔炼法=Chư Tinh Dung Luyện Pháp
星灾熔炉=Tinh Tai Dung Lô
诸星秘宝=Chư Tinh Bí Bảo
击坠群星兄弟会=Kích Trụy Quần Tinh Huynh Đệ Hội
暗星域联盟分部=Ám Tinh Vực Liên Minh Phân Bộ
星鲸战团=Tinh Kình Chiến Đoàn
肖菱=Tiếu Lăng
岳豪=Nhạc Hào
郝达=Hách Đạt
帝都邵家=Đế Đô Thiệu Gia
重力群山=Trọng Lực Quần Sơn
重力犬=Trọng Lực Khuyển
重力环=Trọng Lực Hoàn
重力石=Trọng Lực Thạch
重山狼=Trọng Sơn Lang
多重重力环=Đa Trọng Trọng Lực Hoàn
重力狱狼=Ngục Lang Trọng Lực
李曙=Lý Thử
邵明川=Thiệu Minh Xuyên
蚀日之渊=Thực Nhật Chi Uyên
纸界=Chỉ Giới
戴玄=Đái Huyền
密神恩赐=Mật Thần Ân Tứ
玩偶双子云=Oản Ngẫu Song Tử Vân
森之荆棘主宰=Sâm Chi Gai Cức Chủ Tể
孽王=Nghiệt Vương
荆棘主宰=Gai Cức Chủ Tể
丰饶女神庆典=Lễ hội Nữ thần Phong nhiêu
万千生长者=Đấng Vạn Thiên Sinh Trưởng
世界哺育者=Đấng Thế Giới Bú Mớm
永恒丰收女神=Nữ Thần Vĩnh Hằng Phong Thu
五谷丰登鸟=Ngũ Cốc Phong Đăng Điểu
青铜黍=Thanh Đồng Thử
丰饶之主=Chúa Tể Phong Nhiêu
圣月大母神=Thánh Nguyệt Đại Mẫu Thần
大地之母教会=Đại Địa Chi Mẫu Giáo Hội
林维昌=Lâm Duy Xương
万物丰穰仪祭=Vạn Vật Phong Nhương Nghi Tế
金线螟虫=Kim Tuyến Manh Trùng
丰饶女神=Phong Nhiêu Nữ Thần
五色穗酒=Ngũ Sắc Tuệ Tửu
青铜黍枭=Thanh Đồng Thử Kiêu
黄金树鸦=Hoàng Kim Thụ Nha
负田巨鹰=Phụ Điền Cự Ưng
大地蚯蚓=Đại Địa Khâu Dẫn
丰饶螳螂=Phong Nhiêu Đường Lang
稻荷青蛙=Đạo Hà Thanh Oa
金穗瓢虫=Kim Tuệ Biêu Trùng
草羚=Thảo Linh
狩猎蝽=Thú Liệp Xuân
大地步甲=Đại Địa Bộ Giáp
食蚜蜻蜓=Thực Nha Tinh Đình
青苗狐=Thanh Miêu Hồ
稻荷锤=Đạo Hà Chùy
丰饶祭司=Tế tự Phong Nhiêu
丰饶教会=Giáo hội Phong Nhiêu
丰饶教会教宗=Giáo tông Giáo hội Phong Nhiêu
神农百草灵妖=Thần Nông Bách Thảo Linh Yêu
百目之龙=Bách Mục Chi Long
稻荷青鸾=Đạo Hà Thanh Loan
赤地螟蛉=Xích Địa Minh Linh
神农百草灵妖盔甲=Thần Nông Bách Thảo Linh Yêu Khôi Giáp
褐飞虱=Hạt Phi Sắt
黄昏之光=Twilight Light
黄昏虫宴——日暮送葬！=Twilight Bug Banquet - Sunset Funeral!
丰饶平原=Abundant Plain
腐蛇壁龙求生术=Corrupted Snake Wall Dragon Survival Technique
朽世百头蛇=Rotten World Hundred-Headed Serpent
丰饶之壁=Abundant Wall
麦浪狐=Wheat Wave Fox
龙穗鸦=Dragon Spike Crow
五色圣穗=Five-Colored Holy Spike
灵蚀形态——幻影侵蚀者=Spirit Erosion Form - Phantom Intruder
腐败之神=God of Corruption
丰饶之神=God of Abundance
恒世创伤=Eternal World Wounds
食谷鸟=Grain Eating Bird
稷鸟=Ji Bird
丰饶圣子=Abundant Holy Son
腐世淤泥=Rotten World Sludge
永恒之兽=Beast of Eternity
黑暗丰穰祸种=Darkness Abundant Calamity Seed
混乱卵=Chaos Egg
黑暗丰穰母巢=Hắc Ám Phong Nhưỡng Mẫu Sào
丰穰平原=Phong Nhưỡng Bình Nguyên
大丰收术=Đại Phong Thuật
丰穰大祭司=Phong Nhưỡng Đại Tế Tư
神之祸种=Thần Chi Họa Chủng
旱魃牛=Hạn Bạt Ngưu
四十八臂神圣龙树=Tứ Thập Bát Tí Thần Thánh Long Thụ
日蚀之渊=Nhật Thực Chi Uyên
天厄之渊=Thiên Ách Chi Uyên
灾眼=Tai Nhãn
超·虚空龙枪=Siêu · Hư Không Long Thương
永暗骑枪=Vĩnh Ám Kỵ Thương
千面武装——龙王之颅=Thiên Diện Vũ Trang - Long Vương Chi Lô
蛛网地狱=Chu Võng Địa Ngục
暗影掌控=Ám Ảnh Chưởng Khống
天命玄鸟=Thiên Mệnh Huyền Điểu
蛋蛋龙=Đản Đản Long
古穗鲎虫=Cổ Tuệ Hậu Trùng
符索=Phù Tác
巢炳炎=Sào Bỉnh Viêm
封枭=Phong Kiêu
血蚀虫群=Bầy Sâu Huyết Thực
桃猪项目=Dự Án Đào Trư
腐蜜=Hủ Mật
紫金甲狒狒=Vượn Đầu Chó Giáp Tím
邵明轩=Thiệu Minh Hiên
结晶女武神=Kết Tinh Nữ Võ Thần
极北军方熊家=Cực Bắc Quân Phương Hùng Gia
白须老头=Bạch Tu Lão Đầu
祖国人=Tổ Quốc Nhân
天界呼吸——目击术=Thiên Giới Hô Hấp - Mục Kích Thuật
咒骑兵军团=Chú Kỵ Binh Quân Đoàn
负王会=Phụ Vương Hội
结晶诅咒=Kết Tinh Nguyền Rủa
千面之鼓=Thiên Diện Chi Cổ
血咒之灵=Huyết Chú Chi Linh
白骨咒灵=Bạch Cốt Chú Linh
替死果实=Thế Tử Quả Thực
原始星空灵能=Nguyên Thủy Tinh Không Linh Năng
言灵王=Ngôn Linh Vương
咒王城=Chú Vương Thành
灾兽=Tai Thú
灰烬城=Hôi Tẫn Thành
灵之虫蛹=Linh Chi Trùng Dũng
阿鼻王=A Tỳ Vương
阿鼻诅咒=A Tỳ Nguyền Rủa
万须王=Vạn Tu Vương
万须诅咒=Vạn Tu Nguyền Rủa
咒耳王=Chú Nhĩ Vương
咒耳诅咒=Chú Nhĩ Nguyền Rủa
熔肤王=Dung Phu Vương
蚀齿王=Thực Xỉ Vương
真言王=Chân Ngôn Vương
纸心=Chỉ Tâm
颠倒真理之眼=Điên Đảo Chân Lý Chi Nhãn
人之律——缪论律法=Nhân Chi Luật - Mậu Luận Luật Pháp
咒之黑月=Chú Chi Hắc Nguyệt
亿万咒兽之母=Ức Vạn Chú Thú Chi Mẫu
万目王=Vạn Mục Vương
七尊咒之王=Thất Tôn Chú Chi Vương
黄金乡=Hoàng Kim Hương
脑神=Não Thần
发神=Phát Thần
皮肤神=Bì Phu Thần
目神=Mục Thần
项髓神=Hạng Tủy Thần
脊神=Tích Thần
鼻神=Tị Thần
舌神=Thiệt Thần
耳神=Nhĩ Thần
齿神=Xỉ Thần
白正=Bạch Chính
咒命之口=Chú Mệnh Chi Khẩu
八景神=Bát Cảnh Thần
五骨丰登鸟=Ngũ Cốt Phong Đăng Điểu
大道界河=Đại Đạo Giới Hà
灵之虫=Linh Chi Trùng
灵之蝶=Linh Chi Điệp
虚空蚀梦蛛=Hư Không Thực Mộng Tri Chu
灵王咒线=Linh Vương Chú Tuyến
虚空圣印=Hư Không Thánh Ấn
奥义·虚剑=Áo Nghĩa · Hư Kiếm
五行咒线=Ngũ Hành Chú Tuyến
面部七神咒线=Diện Bộ Thất Thần Chú Tuyến
咒月之线=Chú Nguyệt Chi Tuyến
天人五衰相咒=Thiên Nhân Ngũ Suy Tướng Chú
咒神将=Chú Thần Tướng
熊运章=Hùng Vận Chương
白色正教=Bạch Sắc Chính Giáo
蛛魔神=Nhện Ma Thần
韩昌=Hàn Xương
门先生=Môn tiên sinh
咒之王=Chú Chi Vương
韩劫=Hàn Kiếp
第三任教皇=Đệ Tam Nhậm Giáo Hoàng
门之教=Môn Chi Giáo
食心豹=Báo Ăn Tim
食人树鹰=Diều Hâu Ăn Thịt Người
荆棘之环=Vòng Gai
商玉光=Thương Ngọc Quang
荆棘之母=Mẹ Gai
天穹九御仪轨=Nghi quỹ Cửu Ngự Thiên Khung
龙血长江生态秘境=Bí cảnh sinh thái Trường Giang Long Huyết
青苔龟=Rùa Rêu
长江龙鱼=Cá Rồng Trường Giang
覆海鳌=Phúc Hải Ngao
黄昏大祭司=Hoàng Hôn Đại Tế Tư
摄魂魔云=Nhiếp Hồn Ma Vân
日暮教派=Nhật Mộ Giáo Phái
棘杀炮台=Gai Sát Pháo Đài
原初之嗣=Hậu duệ Nguyên Thủy
欲月之兽=Dục Nguyệt Chi Thú
月球战车=Chiến xa Mặt Trăng
丰穰祸种=Phong Nhưỡng Họa Chủng
昼日之火=Trú Nhật Chi Hỏa
无尽焦土=Vô Tận Tiêu Thổ
祸之羽=Họa Chi Vũ
旱灾神光=Hạn Tai Thần Quang
四灾孔雀=Tứ Tai Khổng Tước
叶荞=Diệp Kiều
圣月孕兽术=Thánh Nguyệt Dựng Thú Thuật
欲月之虫=Dục Nguyệt Chi Trùng
月鼠=Nguyệt Thử
天界爆裂枪=Thiên Giới Bạo Liệt Thương
银月吐息=Ngân Nguyệt Thổ Tức
繁衍树海秘境=Phồn Diễn Thụ Hải Bí Cảnh
王血月兽=Vương Huyết Nguyệt Thú
孕月=Dựng Nguyệt
毁灭月车禁域=Hủy Diệt Nguyệt Xa Cấm Vực
黄昏光翼=Hoàng Hôn Quang Dực
五感剥夺咒线=Ngũ Cảm Bóc Đoạt Chú Tuyến
傀儡天国=Khôi Lỗi Thiên Quốc
深红践踏=Thâm Hồng Tiễn Đạp
赤色旱灾神光=Xích Sắc Hạn Tai Thần Quang
鼠鼠化身的三灾孔雀=Thử Thử Hóa Thân Tam Tai Khổng Tước
万欲黑蛇山羊=Vạn Dục Hắc Xà Sơn Dương
日暮圣袍=Nhật Mộ Thánh Bào
长眠蟾酥=Trường Miên Thiềm Tô
金风雨露=Kim Phong Vũ Lộ
繁育主母=Phồn Dục Chủ Mẫu
喑月之眼=Ấm Nguyệt Chi Nhãn
永夜骑枪=Vĩnh Dạ Kỵ Thương
繁衍树海=Rừng Cây Sinh Sản
天狗月兽=Thiên Cẩu Nguyệt Thú
蟾祖蝉衣=Thiềm Tổ Thiền Y
月鼠君主=Nguyệt Thử Quân Chủ
陆黄毛=Lục Hoàng Mao
荆棘战斧=Chiến phủ Kinh Cức
奥义——苦海棘世斩=Áo nghĩa - Khổ Hải Gai Thế Trảm
戴薇=Đới Vi
师萍=Sư Bình
翻江龙鳌=Phiên Giang Long Ngao
奥义——月喰波纹=Áo nghĩa - Nguyệt Thực Ba Văn
缪论律法=Mâu Luận Luật Pháp
月之祭坛=Tế Đàn Mặt Trăng
圣女候选=Ứng Viên Thánh Nữ
幽玥=U Việt
陆是人非=Lục Thị Nhân Phi
赫连屠=Hách Liên Đồ
纸树=Chỉ Thụ
繁育大母=Phồn Dục Đại Mẫu
月吼之眼=Nguyệt Hống Chi Nhãn
藏骸帝神国=Tàng Hài Đế Thần Quốc
月之风笛=Nguyệt Chi Phong Địch
虚咒月神蛛=Hư Chú Nguyệt Thần Chu
原始之月教团=Nguyên Thủy Chi Nguyệt Giáo Đoàn
祭月狼人=Tế Nguyệt Lang Nhân
始祖嗥狼=Thủy Tổ Hào Lang
寒月兔人=Hàn Nguyệt Thố Nhân
郑漪=Trịnh Y
姜滇=Giang Điền
日暮农场=Nhật Mộ Nông Tràng
荆棘修女=Kinh C棘 Tu Nữ
圣女庆典=Thánh Nữ Khánh Điển
金灌木=Kim Quán Mộc
颜瑜=Nhan Du
棘果酒=Cức Quả Tửu
黑暗真王=Hắc Ám Chân Vương
荆棘教宗=Giáo Tông Gai
黄昏神话=Hoàng Hôn Thần Thoại
江滇=Giang Điền
太古荆棘巨人=Thái Cổ Cức Tức Cự Nhân
荆棘大祭司=Đại Tế Tư Gai
天灾祸羽=Thiên Tai Họa Vũ
秩序之城=Trật Tự Chi Thành
蜜金花=Mật Kim Hoa
繁育之月教会=Phồn Dục Chi Nguyệt Giáo Hội
静械之粉=Tĩnh Giới Chi Phấn
烈阳海岛=Liệt Dương Hải Đảo
万目圣天使=Vạn Mục Thánh Thiên Sứ
天使之国=Thiên Sứ Chi Quốc
大木柜子=Đại Mộc Quỹ Tử
精灵影视=Tinh Linh Ảnh Thị
茅贵娴=Mao Quý Nhàn
沈鸿=Thẩm Hồng
风暴教会=Phong Bạo Giáo Hội
冥土教会=Minh Thổ Giáo Hội
万须之神教会=Vạn Tu Chi Thần Giáo Hội
誓言之珠=Thệ Ngôn Chi Châu
万须教会=Vạn Tu Giáo Hội
星之后裔=Tinh Chi Hậu Duệ
圣树长枪=Thánh Thụ Trường Thương
叶连青=Diệp Liên Thanh
九叶青莲=Cửu Diệp Thanh Liên
天星青莲妖=Thiên Tinh Thanh Liên Yêu
星吼虎=Tinh Hống Hổ
星光妖精=Tinh Quang Yêu Tinh
星空树灵=Tinh Không Thụ Linh
月吼大魔=Nguyệt Hống Đại Ma
叶光庭=Diệp Quang Đình
叶光野=Diệp Quang Dã
叶芜=Diệp Vu
天青陨星叶=Thiên Thanh Vẫn Tinh Diệp
天青星海=Thiên Thanh Tinh Hải
喰时之虫=Xúc Thời Chi Trùng
天星青莲妖君=Thiên Tinh Thanh Liên Yêu Quân
天星青莲妖君主=Thiên Tinh Thanh Liên Yêu Quân Chủ
星之王朝=Tinh Chi Vương Triều
青莲之躯=Thanh Liên Chi Khu
星之眷族=Tinh Chi Quyến Tộc
叶会海=Diệp Hội Hải
冥土大祭司=Minh Thổ Đại Tế Tư
冥土之心=Minh Thổ Chi Tâm
风暴大祭司=Phong Bạo Đại Tế Tư
风暴教团=Phong Bạo Giáo Đoàn
雷桀=Lôi Kiệt
雷电平原=Lôi Điện Bình Nguyên
真言——雷骨=Chân Ngôn - Lôi Cốt
雷霆暴君=Lôi Đình Bạo Quân
雷眼泰坦=Lôi Nhãn Thái Thản
万须大祭司=Vạn Tu Đại Tế Tư
野兽之主=Dã Thú Chi Chủ
万魔之母=Vạn Ma Chi Mẫu
须神界=Tu Thần Giới
叶胤=Diệp Dận
赤焰麟兽=Xích Diễm Lân Thú
地狱豹=Địa Ngục Báo
吞雷狼犬=Thôn Lôi Lang Khuyển
地煌生态=Địa Hoàng Sinh Thái
十械之枪=Thập Giới Chi Thương
阎罗隼型战舰=Diêm La Chuẩn Hình Chiến Hạm
黄铜邪神教团=Giáo đoàn Tà Thần Đồng Thau
旧械区=Cựu Giới Khu
金械蜂王=Kim Giới Phong Vương
秩序高塔=Trật Tự Cao Tháp
秩序主城=Trật Tự Chủ Thành
地煌神铁=Địa Hoàng Thần Thiết
永恒烈阳阶=Vĩnh Hằng Liệt Dương Giai
机械派系=Cơ Giới Phái Hệ
镇山虎=Trấn Sơn Hổ
秩序主城区=Trật Tự Chủ Thành Khu
丰饶庆典=Phong Nhiêu Khánh Điển
边境长城=Trường Thành Biên Giới
腐败大祭司=Hủ Bại Đại Tế Tư
机械麒麟=Cơ Giới Kỳ Lân
万须教团=Vạn Tu Giáo Đoàn
生命之须=Sinh Mệnh Chi Tu
纸之眷属=Chỉ Chi Quyến Thuộc
地煌动力炉=Địa Hoàng Động Lực Lò
天界树枪=Thiên Giới Thụ Thương
龙魔臂=Long Ma Tý
神圣龙树=Thần Thánh Long Thụ
千面武装——幽鬼碎星臂=Thiên Diện Vũ Trang - U Quỷ Toái Tinh Tý
线技——傀儡·世界！=Tuyệt Kỹ Dây - Khôi Lỗi Thế Giới!
械王域的未来=Tương lai của Giới Vương Cơ
黑麟三型摩托车=Xe mô tô Hắc Lân Tam Hình
蒸汽派系=Phái Hệ Hơi Nước
吴欣悦的三头械兽=Tam Đầu Cơ Thú của Ngô Hân Duyệt
缄默天隼=Hải Đông Im Lặng
地煌炮=Địa Hoàng Pháo
机械蛊教=Giáo hội Cổ Máy
穷天蒸汽巨神兵=Cùng Thiên Hơi nước Cự Thần Binh
穷天=Cùng Thiên
鼠城=Thành Chuột
天界牧场=Trang trại Thiên giới
伟大之械=Vĩ Đại Chi Giới
圣械禁狱=Thánh Giới Cấm Ngục
纸神污染=Chỉ Thần Ô Nhiễm
黄昏龙极闪=Hoàng Hôn Long Cực Thiểm
谬论之舌=Mâu Luận Chi Thiệt
脑域读取=Não Vực Đọc
方荻=Phương Địch
铬铜树林=Crôm Đồng Thụ Lâm
核心卜算=Hạch Tâm Bốc Toán
断魂千射=Đoạn Hồn Thiên Xạ
线技=Tuyệt Kỹ Dây
蛛丝结盾=Tri Chu Ti Kết Thuẫn
诸生天罗=Chư Sinh Thiên La
大龙气=Đại Long Khí
蒸汽械界=Giới Cơ Giới Hơi Nước
蒸汽天柱=Trụ Thiên Hơi Nước
蒸汽城区=Khu Thành Thị Hơi Nước
电离子风暴模块=Mô-đun Bão Ion Điện
电磁形体=Điện Từ Hình Thể
缆线之眼=Mắt Cáp
铬铜树=Crom Đồng Thụ
械天=Cơ Thiên
万卜寺=Vạn Bốc Tự
神罗义体改造所=Thần La Nghĩa Thể Cải Tạo Sở
卜算子金融公司=Bốc Toán Tử Công Ty Tài Chính
异种族恋爱GalGame=Dị Chủng Tộc Luyến Ái GalGame
百臂精灵公主=Bách Tí Tinh Linh Công Chúa
九头风暴鲛姬=Cửu Đầu Phong Bạo Giao Cơ
梵空战甲=Phạn Không Chiến Giáp
周荐=Chu Tiến
迟辛=Trì Tân
机械核心——原始齿轮=Cơ Giới Hạch Tâm - Xích Luân Nguyên Thủy
天命齿轮=Thiên Mệnh Xích Luân
肖千=Tiêu Thiên
杨圣=Dương Thánh
机械核心——飞升三叉戟=Cơ Giới Hạch Tâm - Phi Thăng Tam Xoa Kích
电磁派系=Phái Điện Từ
血械派系=Phái Huyết Giới
齿轮派系=Phái Xích Luân
气象域=Khí Tượng Vực
荒王域=Hoang Vương Vực
九重械界=Cửu Trọng Cơ Giới
蒸汽天=Hơi Nước Thiên
太阳古王=Thái Dương Cổ Vương
蛊械天=Cổ Cơ Thiên
圣甲天=Thánh Giáp Thiên
磁暴天=Từ Bạo Thiên
齿轮天=Bánh Răng Thiên
进化天=Tiến Hóa Thiên
湮械法令=Pháp Lệnh Diệt Máy
吴寿大师=Đại sư Ngô Thọ
旧械天=Cựu Giới Thiên
齐盛=Tề Thịnh
机械百兽=Cơ Giới Bách Thú
老吴修理店=Lão Ngô Tu Lý Điếm
机械师xp=Máy móc sư xp
大圣树枪=Đại Thánh Thụ Thương
破碎百头射杀=Phá Toái Bách Đầu Xạ Sát
抹除律法=Mạt Trừ Luật Pháp
湮灭律法=Yên Diệt Luật Pháp
暴械之犼=Bạo Giới Chi Hống
深红之锤=Thâm Hồng Chi Chùy
圣械十首龙=Thánh Giới Thập Thủ Long
圣械=Thánh Giới
十诫之光=Thập Giới Chi Quang
圣光之力=Thánh Quang Chi Lực
太阳古王血脉=Thái Dương Cổ Vương Huyết Mạch
圣械·十诫=Thánh Giới·Thập Giới
银袍人=Ngân Bào Nhân
邪神教团=Tà Thần Giáo Đoàn
地煌之力=Địa Hoàng Chi Lực
械王之冠=Giới Vương Chi Quan
放牧者=Kẻ Chăn Dắt
幽鬼碎星臂=Cánh Tay U Quỷ Nghiền Nát Sao
原始磁暴力场=Trường Bạo Lực Từ Tính Nguyên Thủy
纸国盔甲=Giáp Giấy Quốc
骑士美德=Đức Hạnh Kỵ Sĩ
燃日骑魂=Kỵ Hồn Đốt Ngày
圣械飞升=Thăng Hoa Thánh Giới
黄铜世界=Thế Giới Hoàng Đồng
械界之门=Giới Giới Chi Môn
械国=Giới Quốc
圣械白虎=Thánh Giới Bạch Hổ
蛊械教会=Cổ Giới Giáo Hội
王榕生=Vương Dung Sinh
人之律=Nhân Chi Luật
卜算派系=Bốc Toán Phái Hệ
战甲派系=Chiến Giáp Phái Hệ
颜伦=Nhan Luân
圣金域=Thánh Kim Vực
四圣械兽=Tứ Thánh Giới Thú
戈界虎啸=Qua Giới Hổ Khiếu
浊世齿轮=Trọc Thế Xỉ Luân
天械神=Thiên Giới Thần
旧日之船=Cựu Nhật Chi Thuyền
八臂蝎首泰坦=Bát Tí Hạt Thủ Titan
黑帝·否天=Hắc Đế · Phủ Thiên
旧械会=Cựu Giới Hội
血械=Huyết Giới
灵能蛊场=Linh Năng Cổ Tràng
千机困神铰链=Thiên Cơ Khốn Thần Giảo Liễn
蒸汽巨神兵=Chưng Khí Cự Thần Binh
繁育月足=Phồn Dục Nguyệt Túc
机械世界树=Cơ Giới Thế Giới Thụ
八个机械核心=Tám Hạt Nhân Cơ Giới
真王议会=Chân Vương Nghị Hội
机械构造体=Cấu Tạo Cơ Giới
金械蜂群=Kim Giới Phong Quần
机械构造体的发丝·世界树之灵=Sợi Tóc Của Cấu Tạo Cơ Giới · Tinh Linh Của Thế Giới Thụ
世界树人=Thế Giới Thụ Nhân
机魂=Cơ Hồn
机械主宰=Chúa Tể Cơ Giới
禁忌太阳污染=Ô Nhiễm Thái Dương Cấm Kỵ
众械议会=Chúng Giới Nghị Hội
孙陵=Tôn Lăng
秩序天=Trật Tự Thiên
沉寂之月=Trầm Tịch Chi Nguyệt
界笙=Giới Sanh
械星=Tinh Cơ Giới
小灵姬=Tiểu Linh Cơ
细柳女妖=Tế Liễu Nữ Yêu
械之环=Vòng Cỗ Máy
机械八卦=Bát Quái Cơ Khí
圣械十头龙=Thánh Cỗ Máy Thập Đầu Long
黎无限之子黎永炼=Lê Vô Hạn Chi Tử Lê Vĩnh Luyện
晨星极限=Thần Tinh Cực Hạn
腐败教会=Hủ Bại Giáo Hội
宝儿姐=Bảo Nhi Tỷ
太阳美德=Thái Dương Mỹ Đức
无尽暴怒=Vô Tận Bạo Nộ
众械之门=Chúng Giới Chi Môn
吴欣悦=Ngô Hân Duyệt
烁油鼠群=Thước Du Thử Quần
蒸汽泰坦巨蟹=Chưng Khí Thái Thản Cự Giải
世界树残骸=Thế Giới Thụ Tàn Hài
世界树人一族=Thế Giới Thụ Nhân Nhất Tộc
帝都擂台赛=Đế Đô Lôi Đài Tái
钉杀吴寿圣械十头龙=Đinh Sát Ngô Thọ Thánh Giới Thập Đầu Long
太卜天=Thái Bốc Thiên
筱秀玲=Tiêu Tú Linh
边境战场=Biên Cảnh Chiến Trường
九尊顶级妖孽=Cửu Tôn Đỉnh Cấp Yêu Nghiệt
边境遗迹召集令=Biên Cảnh Di Tích Triệu Tập Lệnh
万族天骄争霸赛=Vạn Tộc Thiên Kiêu Tranh Bá Tái
群星大远征=Quần Tinh Đại Viễn Chinh
虚剑奥义=Hư Kiếm Áo Nghĩa
原初世界树=Nguyên Sơ Thế Giới Thụ
幽魂之树=U Hồn Chi Thụ
械神之手=Giới Thần Chi Thủ
青铜怀表=Thanh Đồng Hoài Biểu
伟大之械教团=Vĩ Đại Chi Giới Giáo Đoàn
念化千丝=Niệm Hóa Thiên Ti
朽王冠=Hủ Vương Quan
食尸鬼之靴=Thực Thi Quỷ Chi Ngoa
异想体=Dị Tưởng Thể
灵械之国=Linh Giới Chi Quốc
械国齿轮=Giới Quốc Xỉ Luân
圣械油=Thánh Giới Du
电子银网=Điện Tử Ngân Võng
械天使之骨=Giới Thiên Sứ Chi Cốt
灵械之翼=Linh Giới Chi Dực
引力之核=Dẫn Lực Chi Hạch
原始齿轮=Nguyên Thủy Xỉ Luân
飞升三叉戟=Phi Thăng Tam Xoa Kích
械天使之魂=Giới Thiên Sứ Chi Hồn
械判官=Giới Phán Quan
械兽=Giới Thú
械煌生态=Giới Hoàng Sinh Thái
至高齿轮=Chí Cao Xỉ Luân
荒蚁冢=Hoang Nghĩ Trủng
琉璃之路=Lưu Li Chi Lộ
红火蚁=Hồng Hỏa Nghĩ
红火蚁后=Hồng Hỏa Nghĩ Hậu
星月泰坦=Tinh Nguyệt Titan
蝗牯=Hoàng Cổ
陆大黄毛=Lục Đại Hoàng Mao
大渊王族=Đại Uyên Vương Tộc
孙桀=Tôn Kiệt
月光兔人=Nguyệt Quang Thỏ Nhân
幻影猫人=Huyễn Ảnh Miêu Nhân
渊眼魔人=Uyên Nhãn Ma Nhân
暗月海渊=Ám Nguyệt Hải Uyên
桃猪=Đào Trư
龙首头盔=Long Thủ Đầu Khôi
万族争霸赛=Vạn Tộc Tranh Bá Tái
奴心锁链=Nô Tâm Tỏa Liên
小丑魂面=Tiểu Sửu Hồn Diện
狂欢之城=Cuồng Hoan Chi Thành
黑暗马戏团=Đoàn Xiếc Tối Tăm
龙首雷隼=Long Thủ Lôi Chuẩn
瘟疫巨魔族=Ôn Dịch Cự Ma Tộc
太古魂林=Thái Cổ Hồn Lâm
尸傀古树=Thi Côi Cổ Thụ
星矿龙=Tinh Khoáng Long
尸傀魂种=Thi Côi Hồn Chủng
大圣树螺旋枪=Đại Thánh Thụ Loa Toàn Thương
圣树托天=Thánh Thụ Thác Thiên
圣树印=Thánh Thụ Ấn
禁忌位格=Cấm Kỵ Vị Cách
苍天奥义=Thương Thiên Áo Nghĩa
牧场降临=Mục Tràng Giáng Lâm
终焉之墓=Chung Yên Chi Mộ
真言—虚鬼=Chân Ngôn - Hư Quỷ
虚灾=Hư Tai
天魔吕布=Thiên Ma Lữ Bố
金晶蛛=Kim Tinh Chu
大桃猪王=Đại Đào Trư Vương
疫鸠=Dịch Cưu
碧陵=Bích Lăng
胡皓=Hồ Hạo
蝗轱=Hoàng Cô
天魔吕鼠=Thiên Ma Lữ Thử
地皇真印=Địa Hoàng Chân Ấn
苍岭巨人=Thương Lĩnh Cự Nhân
苍苔=Thương Đài
苍岭呼唤=Thương Lĩnh Hô Hoán
苍岭石人=Thương Lĩnh Thạch Nhân
杨衡=Dương Hành
沼泽之主=Chiểu Trạch Chi Chủ
邪魔沼泽=Đầm lầy Ma tà
无光城=Vô Quang thành
黑暗河=Hắc Ám hà
元素森林=Rừng Nguyên tố
汲血蒲公英=Cấp Huyết Bồ Công Anh
光辉力场=Quang Huy Lực Trường
丰饶圣子苗峰=Phong Nhiêu Thánh Tử Miêu Phong
日冕之眼=Nhật Miện Chi Nhãn
星树赵家=Tinh Thụ Triệu Gia
赵景=Triệu Cảnh
星矿叶家=Tinh Quáng Diệp Gia
星树市=Tinh Thụ Thị
星矿市=Tinh Quáng Thị
古星树妖=Cổ Tinh Thụ Yêu
星言之树=Tinh Ngôn Chi Thụ
接肢魔首领=Tiếp Chi Ma Thủ Lĩnh
四季树灵族=Tứ Quý Thụ Linh Tộc
金角翼人=Kim Giác Dực Nhân
血海天豸=Huyết Hải Thiên Trãi
雷暴独眼巨人=Lôi Bạo Độc Nhãn Cự Nhân
大地羯人族=Đại Địa Yết Nhân Tộc
羯阳=Yết Dương
控尸傀儡族=Khống Thi Khôi Lỗi Tộc
金穗之光=Kim Tú Chi Quang
金灵之光=Kim Linh Chi Quang
厄运太岁殿下=Ách Vận Thái Tuế điện hạ
九尾裂空豹=Cửu Vĩ Liệt Không Báo
裂空生态=Liệt Không sinh thái
黑光涡虫族=Hắc Quang Qua Trùng tộc
天青木人族=Thiên Thanh Mộc Nhân tộc
灵能妖术师=Linh Năng Yêu Thuật Sư
渡厄殿下=Độ Ách Điện Hạ
天极光河=Thiên Cực Quang Hà
准巨头四季树人=Chuẩn Cự Đầu Tứ Quý Thụ Nhân
句芒之盾=Cú Mang Chi Thuẫn
万木之龙=Vạn Mộc Chi Long
地皇之印=Địa Hoàng Chi Ấn
祸王之炉=Họa Vương Chi Lò
智械银王=Trí Giới Ngân Vương
圣王化=Thánh Vương Hóa
麒麟践踏=Kỳ Lân Tiễn Đạp
四季奥义=Tứ Quý Áo Nghĩa
诸生枯荣=Chư Sinh Khô Vinh
百目吞世龙=Bách Mục Thôn Thế Long
终焉龙拳=Chung Yên Long Quyền
梁继文=Lương Kế Văn
噤声三代封印秘仪=Cấm Thanh Tam Đại Phong Ấn Bí Nghi
四季盆地=Tứ Quý Bồn Địa
岁厄国度=Tuế Ách Quốc Độ
句芒之刃=Câu Mang Chi Nhận
灼灼烈日=Chước Chước Liệt Nhật
诸生萧瑟=Chư Sinh Tiêu Sắt
冰封万里=Băng Phong Vạn Lý
树身缚苍龙=Thụ Thân Phược Thương Long
枯荣绝灭之光=Khô Vinh Tuyệt Diệt Chi Quang
背负轮回的百目吞世之龙=Bối Phụ Luân Hồi Đích Bách Mục Thôn Thế Chi Long
不朽饥渴=Bất Hủ Cơ Khát
古禅圣陀舍族=Cổ Thiền Thánh Đà Xá Tộc
陀舍古族=Đà Xá Cổ Tộc
三灾神光=Tam Tai Thần Quang
昼日骑枪=Trú Nhật Kỵ Thương
震世尊=Chấn Thế Tôn
地藏尊=Địa Tạng Tôn
烁油之潮=Thước Du Chi Triều
药师尊=Dược Sư Tôn
育生诸子=Dục Sinh Chư Tử
三千陀舍=Tam Thiên Đà Xá
陀舍婴=Đà Xá Anh
药师尊陀舍婴=Dược Sư Tôn Đà Xá Anh
燃灯陀舍婴=Nhiên Đăng Đà Xá Anh
虚空藏陀舍婴=Hư Không Tàng Đà Xá Anh
除盖障陀舍婴=Trừ Cái Chướng Đà Xá Anh
文殊尊=Văn Thù Tôn
群星百兽塔=Quần Tinh Bách Thú Tháp
死冥镰刀=Tử Minh Liêm Đao
圣陀舍族=Thánh Đà Xá Tộc
陀兽=Đà Thú
文殊尊陀舍婴=Văn Thù Tôn Đà Xá Anh
恒禅=Hằng Thiền
无量智慧之主=Vô Lượng Trí Tuệ Chi Chủ
世界树人族=Thế Giới Thụ Nhân Tộc
古禅域=Cổ Thiền Vực
无光之夜=Vô Quang Chi Dạ
厄运太岁王族=Ách Vận Thái Tuế Vương Tộc
碧海蛇人族=Bích Hải Xà Nhân Tộc
哀嚎女妖=Ai Hào Nữ Yêu
双首恶鬼=Song Thủ Ác Quỷ
血海天豸族=Huyết Hải Thiên Trãi Tộc
闇之河=Ám Chi Hà
永暗潮汐=Vĩnh Ám Tri Triều
黄昏龙甲=Hoàng Hôn Long Giáp
黄昏牧场=Hoàng Hôn Mục Tràng
王族殿下=Vương Tộc Điện Hạ
荆棘大教堂=Kinh Cức Đại Giáo Đường
大黑天咒印·归暗天使=Đại Hắc Thiên Chú Ấn · Quy Ám Thiên Sứ
永暗风暴=Vĩnh Ám Phong Bạo
诸暗之羽=Chư Ám Chi Vũ
万目天使少女=Vạn Mục Thiên Sứ Thiếu Nữ
奎扎尔考赤=Quieza'er Khảo Xích
岁厄生态国=Tuế Ách Sinh Thái Quốc
永暗蛇神=Vĩnh Ám Xà Thần
极光天河=Cực Quang Thiên Hà
痴愚乐者=Si Ngu Nhạc Giả
长眠蟾油=Trường Miên Thiềm Du
天象域=Thiên Tượng Vực
蜃景市=Thận Cảnh Thị
云之蜃龙=Vân Chi Thận Long
云雾蜃虫=Vân Vụ Thận Trùng
蜃楼蛟=Thận Lâu Giao
云海蜃龙=Vân Hải Thận Long
雾海看守者=Vụ Hải Khán Thủ Giả
无垠蜃楼=Vô Ngân Thận Lâu
迷雾之宫=Mê Vụ Chi Cung
双首恶鬼族=Song Thủ Ác Quỷ Tộc
浊雾军团=Trọc Vụ Quân Đoàn
连山女妖=Liên Sơn Nữ Yêu
潘青萍=Phan Thanh Bình
万木之城=Vạn Mộc Chi Thành
神木古蛇=Thần Mộc Cổ Xà
地王域=Địa Vương Vực
符易本=Phù Dịch Bản
大地之女=Đại Địa Chi Nữ
无尽骨地=Vô Tận Cốt Địa
冥界巫妖=Minh Giới Vu Yêu
冥界白骨高原=Minh Giới Bạch Cốt Cao Nguyên
姜世钰=Khương Thế Ngọc
焚幻之火=Phần Huyễn Chi Hỏa
流星火海=Lưu Tinh Hỏa Hải
伏行命运之棺=Phục Hành Mệnh Vận Chi Quan
不败青松=Bất Bại Thanh Tùng
帝都洛家=Đế Đô Lạc Gia
神圣太阳之门=Thần Thánh Thái Dương Chi Môn
日之冕=Nhật Chi Miện
太古异种=Thái Cổ Dị Chủng
裂心山谷=Liệt Tâm Sơn Cốc
移形魔=Di Hình Ma
蝶翩翩=Điệp Phiên Phiên
陀天=Đà Thiên
万族碑=Vạn Tộc Bia
奎扎尔=Khuê Trát Nhĩ
战争宫殿=Chiến Tranh Cung Điện
羽金圣=Vũ Kim Thánh
鬼十七=Quỷ Thập Thất
黑暗天幕=Màn Đêm Hắc Ám
兽之律——虚织天=Thú Chi Luật - Hư Chức Thiên
寂灭之月=Tịch Diệt Chi Nguyệt
恒定仙鹤之羽=Hằng Định Tiên Hạc Chi Vũ
永暗羽蛇始祖的心之血=Vĩnh Ám Vũ Xà Thủy Tổ Đích Tâm Chi Huyết
原始魔典的目录=Nguyên Thủy Ma Điển Đích Mục Lục
书写众生=Thư Tả Chúng Sinh
昼日骑士=Trú Nhật Kỵ Sĩ
永暗女妖=Vĩnh Ám Nữ Yêu
终末蔷薇蛋糕=Chung Mạt Tường Vi Đản Cao
蚀日骑士=Thực Nhật Kỵ Sĩ
天启泰坦骑士=Thiên Khải Thái Thản Kỵ Sĩ
终末骑士=Chung Mạt Kỵ Sĩ
光暗原核=Quang Ám Nguyên Hạch
终末救赎生态=Chung Mạt Cứu Thục Sinh Thái
须神教=Tu Thần Giáo
救赎魔典=Cứu Thục Ma Điển
终末帝·救赎蔷薇花园=Chung Mạt Đế · Cứu Thục Tường Vi Hoa Viên
阴阳圣印=Âm Dương Thánh Ấn
天启美德=Thiên Khải Mỹ Đức
四季树人巨头=Tứ Quý Thụ Nhân Cự Đầu
黑暗女巫族=Hắc Ám Nữ Vu Tộc
黑暗巫神=Hắc Ám Vu Thần
真言·童谣=Chân Ngôn · Đồng Dao
人之律——童话乡=Nhân Chi Luật - Đồng Thoại Hương
四季树灵=Tứ Quý Thụ Linh
厄运王族=Ách Vận Vương Tộc
蚀日纸骑士=Thực Nhật Chỉ Kỵ Sĩ
终末救赎骑士=Chung Mạt Cứu Thục Kỵ Sĩ
厄世兽触=Ách Thế Thú Xúc
六壬十二兽=Lục Nhâm Thập Nhị Thú
惊祸腾蛇=Kinh Họa Đằng Xà
灾心魔种=Tai Tâm Ma Chủng
岁厄奥义=Tuế Ách Áo Nghĩa
束法之棺=Thúc Pháp Chi Quan
大光明龙骑=Đại Quang Minh Long Kỵ
地煌冕=Địa Hoàng Miện
秩序王冕下=Trật Tự Vương Miện Hạ
蝗晟=Hoàng Thịnh
金光翼人巨头=Cự đầu Kim Quang Dực Nhân
高有华=Cao Hữu Hoa
郑昕=Trịnh Hân
白银太阳宝珠=Bảo Châu Thái Dương Bạc
镇狱魔虎=Trấn Ngục Ma Hổ
夺心蝗虫族长=Tộc Trưởng Châu Chấu Đoạt Tâm
天之修女遮眼布=Thiên Chi Tu Nữ Che Mắt Bố
岁厄苍龙族=Tuế Ách Thương Long Tộc
龙苍云=Long Thương Vân
血肉掌控=Huyết Nhục Chưởng Khống
岁厄冕下=Tuế Ách Miện Hạ
九重日之冕=Cửu Trọng Nhật Chi Miện
威猛小子=Uy Mãnh Tiểu Tử
万族战争=Vạn Tộc Chiến Tranh
斗龙之臂=Đấu Long Chi Tí
阴阳两仪大磨=Âm Dương Lưỡng Nghi Đại Ma
诸形照我镜=Chư Hình Chiếu Ngã Kính
联盟巨头=Liên Minh Cự Đầu
掠夺存在=Lược Đoạt Tồn Tại
小蜘蛛银行贷=Tiểu Tri Chu Ngân Hàng Đái
放牧者号=Phóng Mục Giả Hào
大光明龙骑甲=Đại Quang Minh Long Kỵ Giáp
渊子哥=Uyên Tử Ca
怨圣青鸟族=Oán Thánh Thanh Điểu Tộc
秽愿王族殿下=Uế Nguyện Vương Tộc Điện Hạ
谬论之眼=Mâu Luận Chi Nhãn
绝望神灯=Tuyệt Vọng Thần Đăng
天人五衰咒线=Thiên Nhân Ngũ Suy Chú Tuyến
不乐本座=Bất Lạc Bản Tọa
衣服垢秽=Y Phục Cấu Uế
涩仓鼠=Sáp Thương Thử
不死愿望=Bất tử nguyện vọng
希望规则=Hy vọng quy tắc
秽芜=Uế Vu
黑暗许愿机·秽愿神灯=Hắc Ám Hứa Nguyện Cơ · Uế Nguyện Thần Đăng
诸世之愿=Chư Thế Chi Nguyện
秽愿言灵=Uế Nguyện Ngôn Linh
秽愿之剑=Uế Nguyện Chi Kiếm
纸国=Chỉ Quốc
武邵=Võ Thiệu
败世青羽=Bại Thế Thanh Vũ
暗日之主=Ám Nhật Chi Chủ
毁败青鸟=Hủy Bại Thanh Điểu
秽愿王族=Uế Nguyện Vương Tộc
真言——轮转=Chân Ngôn - Luân Chuyển
秽芜殿下=Uế Vu Điện Hạ
旧日的幻想国——迟缓的时钟天使=Cựu Nhật Ảo Tưởng Quốc - Trì Hoãn Thời Chung Thiên Sứ
迟缓天钟王族=Trì Hoãn Thiên Chung Vương Tộc
秽愿=Uế Nguyện
渡厄王族=Độ Ách Vương Tộc
蚀时王国=Thực Thời Vương Quốc
夺时虫潮=Đoạt Thời Trùng Triều
古代学者蝶=Cổ Đại Học Giả Điệp
救赎蔷薇骑王枪=Cứu Thục Tường Vi Kỵ Vương Thương
转空蛇之眼=Chuyển Không Xà Chi Nhãn
影河畸变体=Ảnh Hà Kì Biến Thể
王司=Vương Tư
佛纸骑士=Phật Chỉ Kỵ Sĩ
旧时天使之钟=Cựu Thời Thiên Sứ Chi Chung
滞世赐福=Trệ Thế Tứ Phúc
蚀时之虫=Thực Thời Chi Trùng
秽愿护卫队=Uế Nguyện Hộ Vệ Đội
荡海枭=Đãng Hải Kiêu
闪烁蜘蛛=Thiểm Thước Tri Chu
浊日之火=Trọc Nhật Chi Hỏa
赤狱魔像=Xích Ngục Ma Tượng
圣暗之触=Thánh Ám Chi Xúc
暗日之矛=Ám Nhật Chi Mâu
太阳使徒=Thái Dương Sứ Đồ
太阳之兽=Thái Dương Chi Thú
太阳马车=Thái Dương Mã Xa
虚鬼大药=Hư Quỷ Đại Dược
大鬼皇药=Đại Quỷ Hoàng Dược
空涡之药=Không Qua Chi Dược
圣城之门=Thánh Thành Chi Môn
迟缓结界=Trì Hoãn Kết Giới
太阳圣地=Thái Dương Thánh Địa
顶级神祇=Đỉnh Cấp Thần Kỳ
迟缓天使=Trì Hoãn Thiên Sứ
心之渊=Tâm Chi Uyên
术意马=Thuật Ý Mã
伥心虎=Trành Tâm Hổ
古铜钟魔人族=Cổ Đồng Chung Ma Nhân Tộc
岁厄苍龙=Tuế Ách Thương Long
真王级=Chân vương cấp
太阳白马=Thái Dương Bạch Mã
灾心魔身=Tai Tâm Ma Thân
大日太岁=Đại Nhật Thái Tuế
童话乡=Đồng Thoại Hương
黑灯=Hắc Đăng
微笑尸山=Vi Tiếu Thi Sơn
虚鬼面具=Hư Quỷ Diện Cụ
赤狗=Xích Cẩu
卡母河=Tạp Mẫu Hà
食日王庭猎犬=Thực Nhật Vương Đình Liệp Khuyển
神之指=Thần Chi Chỉ
遥远的欢宴者=Dao Viễn Đích Hoan Yến Giả
缢王悲歌=Ách Vương Bi Ca
天昼之光=Thiên Trú Chi Quang
牧场审判者=Mục Tràng Thẩm Phán Giả
不灭光辉加护=Bất Diệt Quang Huy Gia Hộ
太阳加护=Thái Dương Gia Hộ
白银之环=Bạch Ngân Chi Hoàn
王庭猎犬=Vương Đình Liệp Khuyển
光辉践踏=Quang Huy Tiễn Đạp
极光之刃=Cực Quang Chi Nhận
天昼王庭之兽=Thiên Trú Vương Đình Chi Thú
饥饿大日=Mặt Trời Đói Khát
腐化绿日=Mặt Trời Xanh Hủ Hóa
衰老古阳=Mặt Trời Cổ Suy Tàn
鲁容海=Lỗ Dung Hải
天河渡鸦=Thiên Hà Độ Nha
天水生态秘境=Bí Cảnh Sinh Thái Thiên Thủy
重水鸦=Trọng Thủy Nha
天河重水=Thiên Hà Trọng Thủy
天水角虫=Thiên Thủy Giác Trùng
喰雷特异体=Thực Lôi Dị Thể
渊鱼=Uyên Ngư
接肢魔=Ma Ghép Chi
晨星阶=Thần Tinh Giai
辉月君主=Huy Nguyệt Quân Chủ
联盟会长=Hội Trưởng Liên Minh
大占卜师=Đại Chiêm Bốc Sư
收藏家事件=Sự Kiện Nhà Sưu Tập
暴食坩埚=Vạc Bạo Thực
灵食学派=Linh Thực Học Phái
太古之影=Thái Cổ Chi Ảnh
至高母河=Chí Cao Mẫu Hà
古王律法=Cổ Vương Luật Pháp
圣狱真王=Thánh Ngục Chân Vương
天咒之国=Thiên Chú Chi Quốc
咒钰=Chú Ngọc
迟缓王国=Trì Hoãn Vương Quốc
湮界王国=Yên Giới Vương Quốc
岁厄之国=Tuế Ách Chi Quốc
秽愿王国=Uế Nguyện Vương Quốc
夺心蝗虫=Đoạt Tâm Hoàng Trùng
天盾龙=Thiên Thuẫn Long
绿龙繁绿=Lục Long Phồn Lục
绿龙族=Lục Long Tộc
暗日监视者=Ám Nhật Giam Thị Giả
暗日之眼=Ám Nhật Chi Nhãn
暗日半神=Ám Nhật Bán Thần
暗日监视者号=Ám Nhật Giám Thị Giả
尘世太阳王=Trần Thế Thái Dương Vương
黑灯异想体=Hắc Đăng Dị Tưởng Thể
世界树文明=Văn Minh Thế Giới Thụ
溶解之光=Dung Giải Chi Quang
奥义——撼世星凰=Áo Nghĩa - Hám Thế Tinh Hoàng
奥义——屠灵之剑=Áo Nghĩa - Đồ Linh Chi Kiếm
奥义——诸法之眼=Áo Nghĩa - Chư Pháp Chi Nhãn
神国——黄昏天=Thần Quốc - Hoàng Hôn Thiên
魂之千面=Hồn Chi Thiên Diện
九重日冕之花=Cửu Trọng Nhật Miện Chi Hoa
械界天=Giới Cơ Giới
岁厄王宫=Tuế Ách Vương Cung
星凰=Tinh Hoàng
溶空翼龙=Dung Không Dực Long
天昼之眼=Thiên Trú Chi Nhãn
天昼奥义——灼世烈阳=Thiên Trú Áo Nghĩa – Chước Thế Liệt Dương
天昼奥义——大光明天舟=Thiên Trú Áo Nghĩa – Đại Quang Minh Thiên Chu
天昼畸变奥义——太阳影河之枪=Thiên Trú Kì Biến Áo Nghĩa – Thái Dương Ảnh Hà Chi Thương
月之宫=Nguyệt Chi Cung
繁育之月教团=Phồn Dục Chi Nguyệt Giáo Đoàn
光辉穹顶=Quang Huy Khung Đỉnh
旧日岁月=Cựu Nhật Tuế Nguyệt
太阳邪神=Thái Dương Tà Thần
千面武装=Thiên Diện Vũ Trang
幻影侵世者=Huyễn Ảnh Xâm Thế Giả
灰烬之王=Tro Tẫn Chi Vương
天昼王庭=Thiên Trú Vương Đình
黄昏脐带=Hoàng Hôn Tề Đới
黄昏权柄=Hoàng Hôn Quyền Bính
祭祀秘食=Tế Tự Bí Thực
邪神胚胎=Tà Thần Phôi Thai
食骸鬼之靴=Thực Hài Quỷ Chi Ngoa
赤月梦红=Xích Nguyệt Mộng Hồng
陈煨=Trần Ủi
灰烬王=Tro Tàn Vương
童话熊=Đồng Thoại Hùng
白银宝珠=Bạch Ngân Bảo Châu
深红龙王之矛=Thương của Thâm Hồng Long Vương
千眼太阳王武装=Thiên Nhãn Thái Dương Vương Vũ Trang
辉月极限=Huy Nguyệt Cực Hạn
灰烬之心=Tro Tàn Chi Tâm
秽愿真王=Uế Nguyện Chân Vương
崔涵=Thôi Hàm
繁绿=Phồn Lục
艾律=Ngải Luật
魂云=Hồn Vân
瑶池青羽=Dao Trì Thanh Vũ
夜吼者之触=Dạ Hống Giả Chi Xúc
苦界面具=Khổ Giới Diện Cụ
雷电心脏=Lôi Điện Tâm Tạng
深海翼膜=Thâm Hải Dực Mô
黑暗女巫=Hắc Ám Nữ Vu
青怨=Thanh Oán
食日天狗=Thực Nhật Thiên Cẩu
光辉之眼=Quang Huy Chi Nhãn
轮回之国=Luân Hồi Chi Quốc
轮回天界=Luân Hồi Thiên Giới
黄昏之虫=Hoàng Hôn Chi Trùng
始祖黄昏虫之卵=Thủy Tổ Hoàng Hôn Trùng Chi Noãn
天暮光环=Thiên Mộ Quang Hoàn
命昏虫=Mệnh Hôn Trùng
天暮虫=Thiên Mộ Trùng
黄昏虫宴=Hoàng Hôn Trùng Yến
吞世百目之龙=Thôn Thế Bách Mục Chi Long
破碎的黄昏天=Phá Toái Đích Hoàng Hôn Thiên
黄昏之宫=Hoàng Hôn Chi Cung
生命之红=Sinh Mệnh Chi Hồng
终焉之锁=Chung Yên Chi Tỏa
日暮大主教=Nhật Mộ Đại Chủ Giáo
神之双子=Thần chi Song Tử
深红之矛=Thâm Hồng Chi Mâu
黄昏始祖虫=Hoàng Hôn Thủy Tổ Trùng
终焉双子古蛇=Chung Yên Song Tử Cổ Xà
光之猎犬=Quang Chi Liệp Khuyển
太阳圣甲虫=Thái Dương Thánh Giáp Trùng
无限熔炉=Vô Hạn Dung Lô
最初万灵百相=Tối Sơ Vạn Linh Bách Tướng
无限面具=Vô Hạn Diện Cụ
千眼太阳王=Thiên Nhãn Thái Dương Vương
第九指=Ngón tay thứ chín
第四指=Ngón tay thứ tư
终末帝的花园=Chung Mạt Đế Đích Hoa Viên
天相·虚空面=Thiên Tướng · Hư Không Diện
深红树枪=Thâm Hồng Thụ Thương
三相结界=Tam Tướng Kết Giới
剥面术奥义——三相逆恶身=Bóc Diện Thuật Áo Nghĩa - Tam Tướng Nghịch Ác Thân
人相·斩恶尸=Nhân Tướng · Trảm Ác Thi
虚织天=Hư Chức Thiên
黑暗蛛影=Hắc Ám Chu Ảnh
灰烬之马=Tro Tẫn Chi Mã
灵蚀状态·尘世骸龙甲=Linh Xích Trạng Thái · Trần Thế Hài Long Giáp
藏骸帝圣城=Tàng Hài Đế Thánh Thành
微笑的尸山=Vi Tiếu Đích Thi Sơn
剥面术=Bóc Diện Thuật
人相·互为因果=Nhân Tương · Hỗ Vi Nhân Quả
食日王庭=Thực Nhật Vương Đình
尘世骸龙=Trần Thế Hài Long
人之律法=Nhân Chi Luật Pháp
终焉锁链=Chung Yên Tỏa Liên
奥义——超·虚剑=Áo Nghĩa - Siêu · Hư Kiếm
奥义——救赎骑王枪=Áo Nghĩa - Cứu Thục Kỵ Vương Thương
奥义——幽鬼碎星臂=Áo Nghĩa - U Quỷ Toái Tinh Tí
奥义——三灾神光=Áo Nghĩa - Tam Tai Thần Quang
奥义——祸王动力炉剑=Áo Nghĩa - Họa Vương Động Lực Lô Kiếm
未来鼠=Vị Lai Thử
御兽界=Ngự Thú Giới
千手工作台=Thiên Thủ Công Tác Đài
恒世之光=Hằng Thế Chi Quang
万物原初之火=Vạn Vật Nguyên Sơ Chi Hỏa
第九指的夜吼者之触=Xúc tu Dạ Hống Giả của Ngón Tay Thứ Chín
第四指的苦痛面具=Mặt Nạ Khổ Đau của Ngón Tay Thứ Tư
因果之卵=Trứng Nhân Quả
绝望神灯·黑暗许愿机=Đèn Thần Tuyệt Vọng - Máy Ước Nguyện Bóng Tối
他化自在太岁印=Ấn Thái Tuế Tha Hóa Tự Tại
第三指的三相尸=Tam Tướng Thi của Ngón Tay Thứ Ba
遥远欢宴者=Người Dự Tiệc Xa Xôi
荆棘之主苦海神庭=Khổ Hải Thần Đình của Chúa Tể Gai Góc
遗迹之灵=Linh Di Tích
命运庇护=Che Chở Mệnh Vận
蚀界恶神布丁=Bánh Pudding Tà Thần Thực Giới
千面魂鼠=Chuột hồn ngàn mặt
蚀界恶神=Ác thần ăn mòn thế giới
三世不死身=Thân bất tử tam thế
千面魂树=Cây hồn ngàn mặt
深红之果=Quả thẫm đỏ
深红之树=Cây thẫm đỏ
深红之冠=Vương miện thẫm đỏ
深红蚀界王冠=Vương miện ăn mòn thế giới thẫm đỏ
深红之眼=Mắt thẫm đỏ
劫王之眼=Mắt kiếp vương
他化自在天魔种=Hóa tha tự tại thiên ma chủng
深红天魔种=Thiên ma chủng thẫm đỏ
深红使徒=Sứ đồ thẫm đỏ
无量苦海=Vô lượng khổ hải
大宏愿术=Đại hồng nguyện thuật
千面熔炉=Lò luyện ngàn mặt
赤王魔种=Ma chủng xích vương
赤王之子=Con của xích vương
旅行青蛙=Ếch du lịch
黑金色三灾孔雀=Hắc Kim Sắc Tam Tai Khổng Tước
千面之触=Thiên Diện Chi Xúc
虚空母巢=Hư Không Mẫu Sào
折纸战士=Chiết Chỉ Chiến Sĩ
电子机械=Điện Tử Cơ Giới
联盟探索者=Liên Minh Tham Sách Giả
造母恩赐=Tạo Mẫu Ân Tứ
天磁暴君力场=Thiên Từ Bạo Quân Lực Tràng
智械之眼=Trí Giới Chi Nhãn
初代蒸汽机=Sơ Đại Chưng Khí Cơ
神文——巨灵=Thần Văn - Cự Linh
知识的重量=Tri Thức Đích Trọng Lượng
轮回圣城=Luân Hồi Thánh Thành
轮回之虫=Luân Hồi Chi Trùng
奥义——坠世树枪=Áo Nghĩa - Trụy Thế Thụ Thương
日暮闪光=Nhật Mộ Thiểm Quang
他化自在天魔赤王=Tha Hóa Tự Tại Thiên Ma Xích Vương
骑士王之心=Kỵ Sĩ Vương Chi Tâm
虚织天律法=Hư Chức Thiên Luật Pháp
诸生剑冢=Chư Sinh Kiếm Trủng
禹峯狩=Vũ Phong Thủ
元世圣=Nguyên Thế Thánh
苍岭巨人战团=Thương Lĩnh Cự Nhân Chiến Đoàn
邵垚=Thiệu Nghiêu
吴寿=Ngô Thọ
缄默天鹰战斗群=Giam Mặc Thiên Ưng Chiến Đấu Quần
镇海鲸=Trấn Hải Kình
电子光龙=Điện Tử Quang Long
机械翼龙=Cơ Giới Dực Long
日暮决斗场=Nhật Mộ Quyết Đấu Tràng
日冕之花=Nhật Miện Chi Hoa
太阳影河=Thái Dương Ảnh Hà
兽之壳=Thú Chi Xác
天昼之兽=Thiên Trú Chi Thú
天昼圣城=Thiên Trú Thánh Thành
繁绿者=Phồn Lục Giả
农场婴天使=Nông Tràng Anh Thiên Sứ
第八指=Đệ Bát Chỉ
白银太阳文明=Bạch Ngân Thái Dương Văn Minh
禁忌咒印=Cấm Kỵ Chú Ấn
至高母神赐福=Chí Cao Mẫu Thần Tứ Phúc
落日之门=Lạc Nhật Chi Môn
朝阳之门=Triêu Dương Chi Môn
灰烬人影=Tro Tàn Nhân Ảnh
上帝之死=Thượng Đế Chi Tử
大灯泡校长=Hiệu trưởng Đầu bóng đèn lớn
吉祥天香炉兽=Cát Tường Thiên Hương Lô Thú
吉祥岁香=Cát Tường Tuế Hương
天昼文明=Thiên Trú Văn Minh
宋沄=Tống Vận
云海虎=Vân Hải Hổ
云海狮虎兽=Vân Hải Sư Hổ Thú
缄默天鹰=Giam Mặc Thiên Ưng
械球=Giới Cầu
六十八臂天界龙树=Lục Thập Bát Tý Thiên Giới Long Thụ
天理教会=Thiên Lý Giáo Hội
缄默天鹰战机群=Chiến cơ Thiên Ưng Câm Lặng
幽暗之参=U Ám Chi Sâm
无光之藤=Vô Quang Chi Đằng
天月枝=Thiên Nguyệt Chi
银海神木=Ngân Hải Thần Mộc
夺心蝗虫族=Đoạt Tâm Hoàng Trùng Tộc
岁厄少主=Tuế Ách Thiếu Chủ
粒子兔=Lạp Tử Thỏ
不死兔=Bất Tử Thỏ
机械师联盟=Cơ Giới Sư Liên Minh
黎永炼=Lê Vĩnh Luyện
黎无限=Lê Vô Hạn
羽之大陆=Vũ Chi Đại Lục
鹿蜗秘药=Lộc Ốc Bí Dược
古蜗城=Cổ Ốc Thành
蜗粟=Ốc Túc
涡流城=Qua Luu Thành
鹿角城=Lộc Giác Thành
灰烬领主=Tro Tẫn Lĩnh Chủ
骑士之心=Kỵ Sĩ Chi Tâm
恒世仙光=Hằng Thế Tiên Quang
大黑天之契=Đại Hắc Thiên Chi Khế
万纸之国=Vạn Chỉ Chi Quốc
蜗瘴城=Ốc Chương Thành
蜗虞=Ốc Ngu
鹿灵之愈=Lộc Linh Chi Dũ
风暴大泽=Phong Bạo Đại Trạch
岚之风袋=Lam Chi Phong Đại
柴甲=Sài Giáp
山岭巨人军团=Sơn Lĩnh Cự Nhân Quân Đoàn
六十八臂天界龙树法相=Lục Thập Bát Tí Thiên Giới Long Thụ Pháp Tướng
蜗珑=Ốc Lũng
天界龙树=Thiên Giới Long Thụ
蜗泽=Ốc Trạch
赤王魔典=Xích Vương Ma Điển
天水之角=Thiên Thủy Chi Giác
鹿蜗祖灵之躯=Lộc Ốc Tổ Linh Chi Khu
岚王龙的风袋=Lam Vương Long Đích Phong Đại
深渊龙蜗族=Thâm Uyên Long Ốc Tộc
鹿蜗族=Lộc Ốc Tộc
陈沄=Trần Vân
缄默天鹰军团=Giam Mặc Thiên Ưng Quân Đoàn
万法之花=Vạn Pháp Chi Hoa
天理规则=Thiên Lý Quy Tắc
识法之眼=Thức Pháp Chi Nhãn
噬法=Phệ Pháp
灭国基金=Diệt Quốc Quỹ Kim
他化自在天魔·赤王=Tha Hóa Tự Tại Thiên Ma · Xích Vương
鹿蜗=Lộc Ốc
圣月结晶=Thánh Nguyệt Kết Tinh
边墓镇=Biên Mộ Trấn
天理之瞳=Thiên Lý Chi Đồng
穷极之门=Cùng Cực Chi Môn
深红之国=Thâm Hồng Chi Quốc
虚王之剑=Hư Vương Chi Kiếm
他化自在天魔王=Tha Hóa Tự Tại Thiên Ma Vương
轮回之柱=Luân Hồi Chi Trụ
祸世械鞘=Họa Thế Giới Sao
救赎之笔=Cứu Thục Chi Bút
陀舍一族=Đà Xá Nhất Tộc
古天帝=Cổ Thiên Đế
造母=Tạo Mẫu
世尊劫鼠=Thế Tôn Kiếp Thử
伏凰山=Phục Hoàng Sơn
冥食炁法=Minh Thực Khí Pháp
盗机观=Đạo Cơ Quan
小荃子=Tiểu Thuyên Tử
扶桑法脉=Phù Tang Pháp Mạch
阴阳双子蚀刻封魔大阵=Âm Dương Song Tử Thực Khắc Phong Ma Đại Trận
武明月=Võ Minh Nguyệt
关陇道=Quan Lũng Đạo
天之夔牛=Thiên Chi Quỳ Ngưu
通天符法脉=Thông Thiên Phù Pháp Mạch
神都洛阳=Thần Đô Lạc Dương
古蜀山=Cổ Thục Sơn
通天符箓法脉=Thông Thiên Phù Lục pháp mạch
盗机一脉=Đạo Cơ nhất mạch
上官昭容=Thượng Quan Chiêu Dung
梅花内卫=Mai Hoa Nội Vệ
先天道姥天尊=Tiên Thiên Đạo Mỗ Thiên Tôn
勾陈上宫东皇大帝=Câu Trần Thượng Cung Đông Hoàng Đại Đế
中天紫薇北极大帝=Trung Thiên Tử Vi Bắc Cực Đại Đế
九皇之母=Cửu Hoàng Chi Mẫu
无极大天尊=Vô Cực Đại Thiên Tôn
太乙元君=Thái Ất Nguyên Quân
三位菩萨=Tam Vị Bồ Tát
戎胥氏=Nhung Tư Thị
姜寨遗址=Khương Trại Di Chỉ
蜈蚣精国师=Ngô Công Tinh Quốc Sư
清风老祖=Thanh Phong Lão Tổ
明月老祖=Minh Nguyệt Lão Tổ
盗机法脉=Đạo Cơ Pháp Mạch
骊山福地=Ly Sơn Phúc Địa
骊山法脉=Ly Sơn Pháp Mạch
赤羽大鹏鸟=Xích Vũ Đại Bằng Điểu
李荃=Lý Thuyên
张夔=Trương Quỳ
天理子=Thiên Lý Tử
香积寺之战=Hương Tích Tự chi chiến
凌荣=Lăng Vinh
四大法脉=Tứ Đại Pháp Mạch
火宅寺=Hỏa Trạch Tự
神之月车=Xe Thần Chi Nguyệt
月之宫殿=Cung Điện Mặt Trăng
太阴仙宫=Thái Âm Tiên Cung
农场夫人=Nông Trường Phu Nhân
婴天使=Anh Thiên Sứ
月主会=Nguyệt Chủ Hội
无限海=Vô Hạn Hải
律法王庭=Luật Pháp Vương Đình
虚月之冠=Hư Nguyệt Chi Quan
大欲王=Đại Dục Vương
欢愉母树=Hoan Du Mẫu Thụ
欢乐街=Hoan Lạc Nhai
魅魔族=Mị Ma Tộc
先天月桂树=Tiên Thiên Nguyệt Quế Thụ
黄金月桂树=Hoàng Kim Nguyệt Quế Thụ
牧场主号=Mục Tràng Chủ Hào
银光城=Ngân Quang Thành
地沼巨鲲=Địa Chiểu Cự Côn
千里江山鲲鹏=Thiên Lí Giang Sơn Côn Bằng
四季树人=Tứ Quý Thụ Nhân
厄运太岁族=Ách Vận Thái Tuế Tộc
金羽圣=Kim Vũ Thánh
金羽帝=Kim Vũ Đế
季灵=Quý Linh
岁厄长河=Tuế Ách Trường Hà
千手魔神=Thiên Thủ Ma Thần
道姥=Đạo Mỗ
不休饥渴=Bất Hưu Cơ Khát
因果之爪=Nhân Quả Chi Trảo
终焉骑枪=Chung Yên Kỵ Thương
安墨=An Mặc
神国夜乡=Thần Quốc Dạ Hương
六道轮回龙=Lục Đạo Luân Hồi Long
桃花牌=Đào Hoa Bài
太岁生态主=Thái Tuế sinh thái chủ
天劫之光=Thiên Kiếp Chi Quang
密神教=Mật Thần Giáo
戴煌=Đới Hoàng
密神=Mật Thần
虚空天晶犼=Hư Không Thiên Tinh Hống
光辉世界=Quang Huy Thế Giới
朱华炬=Chu Hoa Cự
银羽鹰人国=Ngân Vũ Ưng Nhân Quốc
隋曙=Tùy Thử
地沼鲲鹏=Địa Chiểu Côn Bằng
银羽鹰人=Ngân Vũ Ưng Nhân
赤王魔身=Xích Vương Ma Thân
赤王印记=Xích Vương Ấn Ký
魔种鼠13号=Ma Chủng Thử Số 13
魔种鼠17号=Ma Chủng Thử Số 17
魔种鼠27号=Ma Chủng Thử Số 27
三相赤王魔身=Tam Tướng Xích Vương Ma Thân
魔种鼠44号=Ma Chủng Thử Số 44
司冥龙=Tư Minh Long
天创龙之脊=Thiên Sáng Long Chi Tích
薪火时代=Thời đại Xin Huo
大木柜子魅魔莉莉丝=Đại Mộc Quỹ Tử Mị Ma Lili
虚空女皇=Hư Không Nữ Hoàng
十三号魔种鼠=Ma Chủng Thử Số 13
边境联盟=Biên Cảnh Liên Minh
缄默天鹰战机=Giàm Mặc Thiên Ưng Chiến Cơ
云狮军团=Vân Sư Quân Đoàn
铁血剑獒=Thiết Huyết Kiếm Ngao
诡狱妖花=Quỷ Ngục Yêu Hoa
渊眼魔人族=Uyên Nhãn Ma Nhân Tộc
渡厄太岁=Độ Ách Thái Tuế
荆棘神国=Gai Thần Quốc
天鬼树=Thiên Quỷ Thụ
北极光之筋=Bắc Cực Quang Chi Cân
原始光辉心脏=Nguyên Thủy Quang Huy Tâm Tạng
地界魔眼之渊=Địa Giới Ma Nhãn Chi Uyên
熔岩魔人族=Dung Nham Ma Nhân Tộc
最初凰庭=Sơ Thủy Hoàng Đình
地心之门=Địa Tâm Chi Môn
苍天百臂魔神=Thương Thiên Bách Tí Ma Thần
真言——门=Chân Ngôn - Môn
传说灵基——穷极之门=Truyền Thuyết Linh Cơ - Cùng Cực Chi Môn
天界奥义——光辉之狱=Thiên Giới Áo Nghĩa - Quang Huy Chi Ngục
陀舍智慧树=Đà Xá Trí Tuệ Thụ
尸山面具=Thi Sơn Diện Cụ
转生之土=Chuyển Sinh Chi Thổ
黑扶桑林=Hắc Phù Tang Lâm
不死凰律=Bất Tử Hoàng Luật
涅凰祭=Niết Hoàng Tế
纸国军团=Chỉ Quốc Quân Đoàn
虚灾之门=Hư Tai Chi Môn
血蚀虫=Huyết Thực Trùng
虚灾真言=Hư Tai Chân Ngôn
月光蛛=Nguyệt Quang Chu
闪烁蛛=Thiểm Thước Chu
兽王体系=Thú Vương Hệ Thống
烁油=Thước Du
道士型折纸军团=Đạo Sĩ Hình Chiết Chỉ Quân Đoàn
凰羽剑=Hoàng Vũ Kiếm
黑扶桑树王=Hắc Phù Tang Thụ Vương
海凰蛇王=Hải Hoàng Xà Vương
凰兽尸妖王=Hoàng Thú Thi Yêu Vương
生死阶梯=Sinh Tử Giai Thê
皇树=Hoàng Thụ
冥界十神=Minh Giới Thập Thần
天骸·应龙=Thiên Hài Ứng Long
地狱凰血雀=Địa Ngục Hoàng Huyết Tước
黑扶桑树海=Hắc Phù Tang Thụ Hải
不朽河=Bất Hủ Hà
天凰律法=Thiên Hoàng Luật Pháp
冥界神祇=Thần minh Minh giới
涅凰之舞=Nhiệt Hoàng Chi Vũ
冥凰=Minh Hoàng
天启泰坦=Khải Thiên Thái Thản
兽之律=Thú Chi Luật
审判之星=Thẩm Phán Chi Tinh
传说灵基·巨灵之脊=Truyền Thuyết Linh Cơ · Cự Linh Chi Tích
千面武装——赤帝之手=Thiên Diện Vũ Trang - Xích Đế Chi Thủ
赤帝·否天=Xích Đế · Phủ Thiên
虚空百目蛛龙之甲=Hư Không Bách Mục Chu Long Chi Giáp
凰庭=Phượng Đình
转生皇树=Chuyển Sinh Hoàng Thụ
终末帝=Chung Mạt Đế
轮回之河=Luân Hồi Chi Hà
凰主之女=Hoàng Chủ Chi Nữ
伟大存在=Vĩ Đại Tồn Tại
天凰精血=Thiên Hoàng Tinh Huyết
至高母神之血=Chí Cao Mẫu Thần Chi Huyết
至高母神孕灵禁仪=Chí Cao Mẫu Thần Dựng Linh Cấm Nghi
凰主=Hoàng Chủ
天王枪=Thiên Vương Thương
天凰奥义=Thiên Hoàng 奥义
尘世劫火=Trần Thế Kiếp Hỏa
天凰之宫=Thiên Hoàng Chi Cung
母神之宫=Mẫu Thần Chi Cung
天凰尸骸=Thiên Hoàng Thi Hài
天凰之舞=Thiên Hoàng Chi Vũ
病界道姥天尊=Bệnh Giới Đạo Lão Thiên Tôn
禁忌真理=Cấm Kỵ Chân Lý
真理之子=Chân Lý Chi Tử
终末帝花园=Chung Mạt Đế Hoa Viên
夜乡=Dạ Hương
圣诞岛红蟹=Cua đỏ đảo Christmas
凰芸=Hoàng Vân
蛛姐=Chu Tỷ
凰羽=Hoàng Vũ
古凰族长=Cổ Hoàng Tộc Trưởng
荆棘圣女=Kinh C棘 Thánh Nữ
深渊不死天凰=Thâm Uyên Bất Tử Thiên Hoàng
亡眼暴君=Vong Nhãn Bạo Quân
深渊幽魂皇树=Thâm Uyên U Hồn Hoàng Thụ
狩猎之日=Ngày Săn Bắn
深渊七罪天=Thất Tội Thiên Vực Thẳm
黄甜甜=Hoàng Điềm Điềm
血月蛛妃=Huyết Nguyệt Chu Phi
深渊999层=Tầng 999 vực sâu
地狱火山位面=Mặt phẳng núi lửa địa ngục
熔山恶魔族=Dung Sơn Ác Ma tộc
地狱火鬼=Địa Ngục Hỏa Quỷ
蚀火巨人=Thực Hỏa Cự Nhân
地狱火妖族=Địa Ngục Hỏa Yêu tộc
赤狱律法=Xích Ngục Luật Pháp
赤狱魔王国=Xích Ngục Ma Vương Quốc
深渊魔王=Thâm Uyên Ma Vương
深渊大君=Thâm Uyên Đại Quân
械界之神=Giới Thần Máy Móc
天熔之眼=Thiên Dung Chi Nhãn
深渊升魔之门=Thâm Uyên Thăng Ma Chi Môn
古老蛛魔=Cổ Lão Chu Ma
古老战魔=Cổ Lão Chiến Ma
古老龙首魔=Cổ Lão Long Thủ Ma
古老魔鸟=Cổ Lão Ma Điểu
熔山恶魔=Ác Ma Dung Sơn
地狱火妖巨头=Địa Ngục Hỏa Yêu Cự Đầu
七印=Thất Ấn
七兽=Thất Thú
七原罪=Thất Nguyên Tội
血海皇树=Huyết Hải Hoàng Thụ
化生皇树=Hóa Sinh Hoàng Thụ
纯血龙=Thuần Huyết Long
镇灵皇树=Trấn Linh Hoàng Thụ
冥渡皇树=Minh Độ Hoàng Thụ
赤王投影=Xích Vương Đầu Ảnh
赤王化身=Xích Vương Hóa Thân
业障劫王盘=Nghiệp Chướng Kiếp Vương Bàn
深渊幽魂树=Thâm Uyên U Hồn Thụ
冥狱皇树=Minh Ngục Hoàng Thụ
深渊冥狱树=Thâm Uyên Minh Ngục Thụ
深渊冥渡皇树=Thâm Uyên Minh Độ Hoàng Thụ
天械王=Thiên Giới Vương
秩序刑王之剑=Trật Tự Hình Vương Chi Kiếm
古魔之渊=Cổ Ma Chi Uyên
千眼古魔=Thiên Nhãn Cổ Ma
天骸古魔=Thiên Hài Cổ Ma
永暗古魔=Vĩnh Ám Cổ Ma
蚀命古魔=Thực Mệnh Cổ Ma
不死古魔=Bất Tử Cổ Ma
黄昏古魔=Hoàng Hôn Cổ Ma
戏命古魔=Hí Mệnh Cổ Ma
赤狱魔国=Xích Ngục Ma Quốc
灼狱王庭=Chước Ngục Vương Đình
暗月精灵位面=Ám Nguyệt Tinh Linh Vị Diện
天熔山=Thiên Dung Sơn
安宁之主=Chúa tể An Ninh
死亡神树=Thần Thụ Tử Vong
幽魂皇树=U Hồn Hoàng Thụ
七大皇树=Thất Đại Hoàng Thụ
暗月精灵族=Ám Nguyệt Tinh Linh Tộc
暗月精灵女王=Ám Nguyệt Tinh Linh Nữ Vương
魅魔王室=Mị Ma Vương Thất
赤狱王=Xích Ngục Vương
暗月王=Ám Nguyệt Vương
阿忒弥=A Thể Di
黄昏之女=Hoàng Hôn Chi Nữ
轮回之界=Luân Hồi Chi Giới
始祖羽蛇=Thủy Tổ Vũ Xà
不死天凰=Bất Tử Thiên Hoàng
蟾祖神殿=Thiềm Tổ Thần Điện
蟾祖之子=Thiềm Tổ Chi Tử
蟾衣=Thiềm Y
密武文明=Mật Vũ Văn Minh
大赤猿王密武=Đại Xích Viên Vương Mật Vũ
以身藏剑=Dĩ Thân Tàng Kiếm
崩解血肉=Băng Giải Huyết Nhục
天蟾气=Thiên Thiềm Khí
蟾祖呼吸=Thiềm Tổ Hô Hấp
蟾祖蟾衣之膏=Thiềm Tổ Thiềm Y Chi Cao
神圣懒惰=Thần Thánh Lười Biếng
食光羽衣=Thực Quang Vũ Y
百臂苍天魔神=Bách Tí Thương Thiên Ma Thần
终结之鞘=Chung Kết Chi Sao
圣光系半神=Thánh Quang Hệ Bán Thần
永暗羽蛇族=Vĩnh Ám Vũ Xà Tộc
光之神=Quang Chi Thần
创造之心=Sáng Tạo Chi Tâm
原始天界魔神=Nguyên Thủy Thiên Giới Ma Thần
魅魔王国=Mị Ma Vương Quốc
第903层位面=Vị Diện Tầng 903
狩猎之阳=Thú Liệp Chi Dương
暗月商会=Ám Nguyệt Thương Hội
暗月真王=Ám Nguyệt Chân Vương
天凰巢=Thiên Hoàng Sào
九重械天=Cửu Trọng Giới Thiên
械王=Giới Vương
天凰之女=Thiên Hoàng Chi Nữ
深渊赤雀=Thâm Uyên Xích Tước
十二臂鬼人族=Thập Nhị Tí Quỷ Nhân Tộc
金光翼人生态主=Kim Quang Dực Nhân Sinh Thái Chủ
无量光暗祸世械龙=Vô Lượng Quang Ám Họa Thế Giới Long
雾鸣=Vụ Minh
真理之钥=Chân Lý Chi Khóa
无量光龙拳=Vô Lượng Quang Long Quyền
雾海锁界=Vụ Hải Tỏa Giới
赤狱魔王=Xích Ngục Ma Vương
咒兽界=Chú Thú Giới
门之主=Môn Chi Chủ
强肾魔药=Cường Thận Ma Dược
暴食之宴=Bạo Thực Chi Yến
宇宙蜂族=Vũ Trụ Phong Tộc
寿蜂之巢=Thọ Phong Chi Sào
盛岗=Thịnh Cương
金光翼人=Kim Quang Dực Nhân
纯白高塔=Tháp Trắng Tinh Khiết
帝都大学=Đế Đô Đại Học
十万树海关=Thập Vạn Thụ Hải Quan
精灵真王=Tinh Linh Chân Vương
昼日力士=Trú Nhật Lực Sĩ
智械天=Trí Giới Thiên
千臂精灵圣女帝=Thiên Tí Tinh Linh Thánh Nữ Đế
九头龙鲛姬=Cửu Đầu Long Giao Cơ
天堂百目天使=Thiên Đường Bách Mục Thiên Sứ
赤月家=Xích Nguyệt gia
魅魔之巢=Mị Ma Chi Sào
自然天心流=Tự Nhiên Thiên Tâm Lưu
自然天心神风拳=Tự Nhiên Thiên Tâm Thần Phong Quyền
九头鲛姬=Cửu Đầu Giao Cơ
陆师=Lục Sư
穹顶殿=Khung Đỉnh Điện
天体派=Thiên Thể Phái
大自然意识=Đại Tự Nhiên Ý Thức
宝石花丛=Bảo Thạch Hoa Tùng
灵孽审判庭=Linh Nghiệt Thẩm Phán Đình
深红百目龙王之矛=Thâm Hồng Bách Mục Long Vương Chi Mâu
夜吼者=Dạ Hống Giả
尘世天顶=Trần Thế Thiên Đỉnh
天树真王=Thiên Thụ Chân Vương
旧日之书=Cựu Nhật Chi Thư
百目天使长=Bách Mục Thiên Sứ Trưởng
虚空千足剑圣=Hư Không Thiên Túc Kiếm Thánh
风暴九头龙鲛姬=Phong Bạo Cửu Đầu Long Giao Cơ
天理之眼=Thiên Lý Chi Nhãn
寿之蜂=Thọ Chi Phong
百目天使少女=Bách Mục Thiên Sứ Thiếu Nữ
终末救赎之枪=Chung Mạt Cứu Thục Chi Thương
纸道士=Chỉ Đạo Sĩ
精灵女帝=Tinh Linh Nữ Đế
千臂树皇=Thiên Tí Thụ Hoàng
QQ农场=QQ Nông Tràng
夜吼者之颅=Dạ Hống Giả Chi Lô
无限赤王=Vô Hạn Xích Vương
深红律法=Luật Thâm Hồng
黑夜权柄=Quyền Bính Hắc Dạ
原初熔炉=Lò Nung Nguyên Sơ
轮回·应龙=Luân Hồi Ứng Long
虚空魔眼=Ma Nhãn Hư Không
大千足虚圣剑=Đại Thiên Túc Hư Thánh Kiếm
心眼御魂剑=Tâm Nhãn Ngự Hồn Kiếm
炽·圣天使=Sí Thánh Thiên Sứ
终末之盘=Chung Mạt Chi Bàn
鼠天帝=Chuột Thiên Đế
古书虫=Cổ Thư Trùng
历史学者蝶=Lịch Sử Học Giả Điệp
藏骸帝都=Tàng Hài Đế Đô
骸天使=Hài Thiên Sứ
千臂精灵公主=Thiên Tí Tinh Linh Công Chúa
风暴鲛姬=Phong Bạo Giao Cơ
千足剑姬=Thiên Túc Kiếm Cơ
原始魔典=Nguyên Thủy Ma Điển
旧世枷锁=Cựu Thế Gia Khóa
大光明深红使徒=Đại Quang Minh Thâm Hồng Sứ Đồ
欲望百相=Dục Vọng Bách Tướng
孽神千击=Nghiệt Thần Thiên Kích
静之领域=Tĩnh Chi Lĩnh Vực
快慢奥义=Khoái Mạn Áo Nghĩa
须臾时枪=Tu Du Thì Thương
牺牲之刺=Hi Sinh Chi Thứ
寿蜂=Thọ Phong
树海关=Thụ Hải Quan
天顶之城=Thiên Đỉnh Chi Thành
腐朽之握=Hủ Hủ Chi Ác
天穹树=Thiên Khung Thụ
天穹树律法=Thiên Khung Thụ Luật Pháp
天穹之手=Thiên Khung Chi Thủ
赫里丝塔夏=Helys Tháp Hạ
尘月之王=Trần Nguyệt Chi Vương
萨法塔伊德=Tát Pháp Tháp Y Đức
爱尔芙海姆=Ái Nhĩ Phu Hải Mỗ
旧日神国=Cựu Nhật Thần Quốc
王庭——天穹之路=Vương Đình - Thiên Khung Chi Lộ
灰烬天舟=Tro Tàn Thiên Chu
天昼王=Thiên Trú Vương
千臂精灵女帝=Thiên Tí Tinh Linh Nữ Đế
虚空千足剑姬=Hư Không Thiên Túc Kiếm Cơ
百目天使=Bách Mục Thiên Sứ
风暴九头龙=Phong Bạo Cửu Đầu Long
四十四号魔种鼠=Ma Chủng Thử Số 44
旧日时代=Cựu Nhật Thời Đại
灵械主宰=Linh giới chủ tể
纯血精灵=Thuần huyết tinh linh
混沌灵神孽=Hỗn độn linh thần nghiệt
尘月真王=Trần Nguyệt Chân Vương
赫里斯塔夏=Herista Hạ
深红蚀王树=Thâm hồng thực vương thụ
真理殿堂=Chân Lý Điện Đường
天之王=Thiên Chi Vương
恃强凌弱学派=Thị Cường Lăng Nhược Học Phái
千面灵孽=Thiên Diện Linh Nghiệt
鼠分身=Thử Phân Thân
律娲=Luật Oa
命印魔典=Mệnh Ấn Ma Điển
破碎齿轮=Phá Toái Xích Luân
黄昏双子=Hoàng Hôn Song Tử
长眠蟾蜍=Trường Miên Thiềm Thừ
日暮之袍=Nhật Mộ Chi Bào
万触=Vạn Xúc
基因牛奶=Gien Nãi Nãi
轮回虫宴=Luân Hồi Trùng Yến
轮回之城=Luân Hồi Chi Thành
械之钥=Giới Chi Khóa
黄昏之泪=Hoàng Hôn Chi Lệ
永暗之纱=Vĩnh Ám Chi Sa
古老者=Cổ Lão Giả
至高母神之宫=Chí Cao Mẫu Thần Chi Cung
地母神=Địa Mẫu Thần
地母莲=Địa Mẫu Liên
地母教团=Địa Mẫu Giáo Đoàn
黄昏天=Hoàng Hôn Thiên
咒月=Chú Nguyệt
第四月神——小蜘蛛=Tứ Nguyệt Thần - Tiểu Tri Chu
虚月幻神蛛=Hư Nguyệt Huyễn Thần Chu
亘古之月=Tuyên Cổ Chi Nguyệt
繁育之月=Phồn Dục Chi Nguyệt
原始之月=Nguyên Thủy Chi Nguyệt
天昼伪王=Thiên Trú Ngụy Vương
日之母=Nhật Chi Mẫu
天穹树国=Thiên Khung Thụ Quốc
永恒烈阳=Vĩnh Hằng Liệt Dương
永暗之女=Vĩnh Ám Chi Nữ
天穹树王=Thiên Khung Thụ Vương
石鬼山脉=Thạch Quỷ Sơn Mạch
倪锋=Nghê Phong
阴血龙=Âm Huyết Long
辉月阶=Huy Nguyệt Giai
阴龙军团长=Âm Long Quân Đoàn Trưởng
天风雕人巨头=Thiên Phong Điêu Nhân Cự Đầu
雷暴之须=Lôi Bạo Chi Tu
风暴之羽=Phong Bạo Chi Vũ
荆棘虎=Kinh C棘 Hổ
荆棘教会=Kinh C棘 Giáo Hội
寰宇象王族=Hoàn Vũ Tượng Vương Tộc
象王族生态主=Tượng Vương Tộc Sinh Thái Chủ
岁厄王族=Tuế Ách Vương Tộc
寰宇象王国度=Hoàn Vũ Tượng Vương Quốc Độ
寰宇象王之子=Hoàn Vũ Tượng Vương Chi Tử
孽王之眼=Nghiệt Vương Chi Nhãn
象王子=Tượng Vương Tử
天风雕人族=Thiên Phong Điêu Nhân Tộc
生态主=Sinh Thái Chủ
光之王族=Quang Chi Vương Tộc
虚空幻隙鲨=Hư Không Huyễn Khích Sa
无限之光=Vô Hạn Chi Quang
虚幻之鳍=Hư Huyễn Chi Kỳ
诸世倒转=Chư Thế Đảo Chuyển
万物退散=Vạn Vật Thối Tán
寰宇巨象=Hoàn Vũ Cự Tượng
苍天践踏=Thương Thiên Tiễn Đạp
纸神残骸=Chỉ Thần Tàn Hài
救赎圣经=Cứu Thục Thánh Kinh
梦界跃迁=Mộng Giới Dược Thiên
狱天使=Ngục Thiên Sứ
天风雕人=Thiên Phong Điêu Nhân
痴愚者之座=Si Ngu Giả Chi Tọa
地煌之剑=Địa Hoàng Chi Kiếm
象主之子=Tượng Chủ chi tử
光之王子=Quang Chi vương tử
金光翼人族=Kim Quang Dực Nhân tộc
四季树人族=Tứ Quý Thụ Nhân tộc
岁厄王国=Tuế Ách vương quốc
天昼一族=Thiên Trú nhất tộc
象神之子=Tượng Thần chi tử
寰宇象族=Hoàn Vũ Tượng tộc
噩梦之神=Ác Mộng Chi Thần
圆光镜妖=Viên Quang Kính Yêu
段履青=Đoạn Lý Thanh
天昼血脉=Thiên Trú Huyết Mạch
厄运真王=Ách Vận Chân Vương
时校长=Thời Hiệu Trưởng
古龙梦域=Cổ Long Mộng Vực
银焰天国=Ngân Diễm Thiên Quốc
梦魇之海=Mộng Yểm Chi Hải
梦魇鱼=Mộng Yểm Ngư
噩梦蛙=Ác Mộng Oa
不死梦蛇=Bất Tử Mộng Xà
永魇咒女=Vĩnh Ám Chú Nữ
古魇龙=Cổ Ám Long
魇眼巨人=Ám Nhãn Cự Nhân
天魇鬼=Thiên Ám Quỷ
天理路径=Thiên Lý Lộ Kính
天理图书馆=Thiên Lý Đồ Thư Quán
鹿蜗国=Lộc Ốc Quốc
真理权柄=Quyền Bính Chân Lý
天创龙=Thiên Sáng Long
边境城=Biên Cảnh Thành
无面兄弟=Vô Diện Huynh Đệ
魇梦狱=Ác Mộng Ngục
赤王龙甲=Xích Vương Long Giáp
寿蜂之刺=Thọ Phong Chi Thứ
天界奥义=Thiên Giới Áo Nghĩa
诸天圣击=Chư Thiên Thánh Kích
迟缓王族=Trì Hoãn Vương Tộc
食梦教团=Thực Mộng Giáo Đoàn
岚王龙=Lam Vương Long
无面兄弟会=Vô Diện Huynh Đệ Hội
迟冢=Trì Trủng
食梦教皇=Thực Mộng Giáo Hoàng
赤龙部落=Xích Long Bộ Lạc
天昼城=Thiên Trú Thành
百目吞世之龙=Bách Mục Thôn Thế Chi Long
终宴权柄=Chung Yến Quyền Bính
终焉路径=Chung Yên Lộ Kính
盛宴路径=Thịnh Yến Lộ Kính
诸界末日=Chư Giới Mạt Nhật
终焉之宴=Chung Yên Chi Yến
末日上帝=Mạt Nhật Thượng Đế
荒力蚁=Hoang Lực Kiến
癫火之冠=Điên Hỏa Chi Quan
最古崇高之龙=Tối Cổ Sùng Cao Chi Long
梦魇之王=Mộng Yểm Chi Vương
梦乡天使=Mộng Hương Thiên Sứ
禁忌太阳=Cấm Kỵ Thái Dương
地都=Địa Đô
无面歌剧院=Vô Diện Ca Kịch Viện
无面之神=Vô Diện Chi Thần
旧日之枪=Cựu Nhật Chi Thương
深红百目龙王=Thâm Hồng Bách Mục Long Vương
林芮=Lâm Nhuế
黄昏大主教=Hoàng Hôn Đại Chủ Giáo
日暮大祭司=Nhật Mộ Đại Tế Tư
星凰一族=Tinh Hoàng nhất tộc
太阳家族=Thái Dương gia tộc
月亮家族=Nguyệt Lượng gia tộc
星凰纪家=Tinh Hoàng Kỷ gia
星龙许家=Tinh Long Hứa gia
星树孙家=Tinh Thụ Tôn gia
星河沈家=Tinh Hà Thẩm gia
星蟹赵家=Tinh Giải Triệu gia
星愈易家=Tinh Dũ Dịch gia
星骨李家=Tinh Cốt Lý gia
穿星号=Xuyên Tinh Hào
姚日生=Diêu Nhật Sinh
灵树蝶=Linh Thụ Điệp
星火严家=Tinh Hỏa Nghiêm Gia
星火元素灵=Tinh Hỏa Nguyên Tố Linh
群星叶家=Quần Tinh Diệp Gia
万星古凰=Vạn Tinh Cổ Hoàng
星凰之血=Tinh Hoàng Chi Huyết
星凰灭世=Tinh Hoàng Diệt Thế
救赎之拳=Cứu Thục Chi Quyền
天鬼虫=Thiên Quỷ Trùng
地煌剑林=Địa Hoàng Kiếm Lâm
地煌麒麟=Địa Hoàng Kỳ Lân
林钧舟=Lâm Quân Chu
齐勇锋=Tề Dũng Phong
白狐大佬=Đại lão Bạch Hồ
林星河=Lâm Tinh Hà
星时白家=Tinh Thời Bạch Gia
星时狐=Tinh Thời Hồ
星之拼图=Tinh Chi Bính Đồ
群星王朝=Quần Tinh Vương Triều
生命之塔=Sinh Mệnh Chi Tháp
黄昏教团=Hoàng Hôn Giáo Đoàn
万欲蛇母树=Vạn Dục Xà Mẫu Thụ
暗星域=Ám Tinh Vực
诸星之泪=Chư Tinh Chi Lệ
牧场主=Mục Trường Chủ
月之公牛=Nguyệt Chi Công Ngưu
长眠巨蟾=Trường Miên Cự Thiềm
时之狐=Thời Chi Hồ
旧日之印=Cựu Nhật Chi Ấn
原始天狐(技能)=Nguyên Thủy Thiên Hồ
万族诸王=Vạn Tộc Chư Vương
人族诸王=Nhân Tộc Chư Vương
原始星空之门=Nguyên Thủy Tinh Không Chi Môn
深红国度=Thâm Hồng Quốc Độ
古龙之争=Cổ Long chi tranh
王之律法=Vương Chi Luật Pháp
谬论律法=Mậu Luận Luật Pháp
混沌卵=Hỗn Độn Noãn
真理之殿=Chân Lý Chi Điện
昼日骑士兽=Trú Nhật Kỵ Sĩ Thú
暗蚀女妖=Ám Thực Nữ Yêu
群星熔炼=Quần Tinh Dung Luyện
星之贵族=Tinh Chi Quý Tộc
星凰始祖=Tinh Hoàng Thủy Tổ
白时一=Bạch Thời Nhất
星海玉家=Tinh Hải Ngọc Gia
星湾林家=Tinh Loan Lâm Gia
林蕊=Lâm Nhụy
星叶叶家=Tinh Diệp Diệp Gia
蚀神树=Thực Thần Thụ
原始天狐=Nguyên Thủy Thiên Hồ
群星域=Quần Tinh Vực
三灾孔雀=Tam Tai Khổng Tước
安宁教会=An Ninh Giáo Hội
烁油之海=Thước Du Chi Hải
深红蚀神树=Thâm Hồng Thực Thần Thụ
踏尘者之杖=Quyền trượng Đạp Trần Giả
修人=Tu Nhân
终极腐朽之主=Chúa Tể Hủ Hại Tối Thượng
终极腐朽=Hủ Hại Tối Thượng
衰老神子=Suy Lão Thần Tử
终宴=Chung Yến
深渊真王=Chân Vương Thâm Uyên
真理位格=Chân Lý Vị Cách
藏骸帝=Tàng Hài Đế
永恒夜乡之主=Chúa Tể Dạ Hương Vĩnh Hằng
天厄星灾枪=Thiên Ách Tinh Tai Thương
诸星熔炉=Chư Tinh Dung Lô
原始星空=Tinh Không Nguyên Thủy
群星家族=Gia Tộc Quần Tinh
月神脐带=Rốn Nguyệt Thần
星界意志=Ý Chí Tinh Giới
神亟=Thần Cức
暗亟=Ám Cức
旧天高原=Cao Nguyên Cựu Thiên
苍天魔神=Thương Thiên Ma Thần
褚青鸾=Chử Thanh Loan
岁厄太子=Tuế Ách Thái Tử
星墓王家=Tinh Mộ Vương gia
武乱云=Vũ Loạn Vân
沐暮=Mộc Mộ
械王域=Giới Vương Giới
顾坚=Cố Kiên
龙江海=Long Giang Hải
斗王域=Đấu Vương Vực
冥王域=Minh Vương Vực
洛千秋=Lạc Thiên Thu
太阳遗迹=Di tích Thái Dương
眼魔一族=Nhãn Ma Nhất Tộc
三百三十三臂苍天魔神=Tam Bách Tam Thập Tam Tí Thương Thiên Ma Thần
旧天之枪=Cựu Thiên Chi Thương
真理之眼=Chân Lý Chi Nhãn
始祖之蛇=Thủy Tổ Chi Xà
天界呼吸=Thiên Giới Hô Hấp
纸国骑士王=Chí Quốc Kỵ Sĩ Vương
纯白天界=Thuần Bạch Thiên Giới
至高议会=Chí Cao Nghị Hội
座天使奥菲尼=Tọa Thiên Sứ Áo Phỉ Ni
命运记录者=Mệnh Vận Ký Lục Giả
癫神=Điên Thần
古老天使王=Cổ Lão Thiên Sứ Vương
光辉之地=Quang Huy Chi Địa
深渊第007号位面=Vị Diện Số 007 của Thâm Uyên
母亲的神国=Thần Quốc của Mẫu Thân
永暗之海=Vĩnh Ám Chi Hải
永暗蛇人族=Vĩnh Ám Xà Nhân Tộc
大黑天意志=Đại Hắc Thiên Ý Chí
天界烈阳=Mặt Trời Rực Lửa của Thiên Giới
炽爱天使律法=Luật Pháp của Thiên sứ Tình Yêu Rực Lửa
天界之眼=Con Mắt của Thiên Giới
王座天使律法=Luật Pháp của Thiên Sứ Vương Tọa
美德天使律法=Luật Pháp của Thiên Sứ Đức Hạnh
王国天使律法=Luật Pháp của Thiên Sứ Vương Quốc
永惰蟾界=Vĩnh Đọa Thiềm Giới
时蟾之环=Thời Thiềm Chi Hoàn
永恒天之剑=Kiếm Trời Vĩnh Hằng
永暗始祖之蛇=Xà Tổ Thủy Vĩnh Ám
他化自在天·赤王=Tha Hóa Tự Tại Thiên - Xích Vương
蚀界恶神鼠=Thần Chuột Tà Ác Ăn Mòn Thế Giới
尘世古龙=Cổ Long Trần Thế
王焱=Vương Diễm
恒定仙鹤=Hằng Định Tiên Hạc
虚神剑=Hư Thần Kiếm
血月蛛后=Huyết Nguyệt Chu Hậu
轮回天=Luân Hồi Thiên
奉遗天使=Phụng Di Thiên Sứ
终焉龙神=Chung Yên Long Thần
痴愚乐手=Si Ngu Nhạc Thủ
折纸昼日力士=Chiết Chỉ Trú Nhật Lực Sĩ
轮回虫群=Luân Hồi Trùng Quần
终末之神=Chung Mạt Chi Thần
美德天使拉斐尔=Mỹ Đức Thiên Sứ Rafiel
力量天使加百列=Lực Lượng Thiên Sứ Gabriel
天武界=Thiên Vũ Giới
王国米迦勒=Vương Quốc Mikael
普智天使=Phổ Trí Thiên Sứ
厄运长河=Ách Vận Trường Hà
械天使=Giới Thiên Sứ
械母=Giới Mẫu
世界女士=Thế Giới Nữ Sĩ
普智天使基路伯=Phổ Trí Thiên Sứ Cơ Lộ Bá
永暗羽蛇=Vĩnh Ám Vũ Xà
蟾祖长子=Thiềm Tổ Trưởng Tử
残光之刃=Tàn Quang Chi Nhận
统治天使乌里叶=Thống Trị Thiên Sứ Ô Lí Diệp
六百六十六臂魔神=Lục Bách Lục Thập Lục Tí Ma Thần
原始天界呼吸=Nguyên Thủy Thiên Giới Hô Hấp
鼠鼠赤王=Thử Thử Xích Vương
炽天使长=Sí Thiên Sứ Trưởng
奉遗天使撒索斯=Phụng Di Thiên Sứ Tát Tác Tư
终末之鞘=Chung Mạt Chi Vỏ
蟾祖=Thiềm Tổ
纯白上帝=Thuần Bạch Thượng Đế
炽爱天使=Xí Ái Thiên Sứ
斗世金光=Đấu Thế Kim Quang
冥理之神=Minh Lý Chi Thần
永暗羽蛇人=Vĩnh Ám Vũ Xà Nhân
秩序王=Trật Tự Vương
刑王之剑=Hình Vương Chi Kiếm
须之神=Tu Chi Thần
苍白暴君=Thương Bạch Bạo Quân
病界=Bệnh Giới
道姥天尊=Đạo Mỗ Thiên Tôn
厄运太岁=Ách Vận Thái Tuế
东方渊=Đông Phương Uyên
万印武=Vạn Ấn Võ
洛子松=Lạc Tử Tùng
赤月红莲=Xích Nguyệt Hồng Liên
赤月曦=Xích Nguyệt Hi
岁厄真王=Tuế Ách Chân Vương
永恒梦乡之主=Vĩnh Hằng Mộng Hương Chi Chủ
魇之母=Yểm Chi Mẫu
冥土之神=Minh Thổ Chi Thần
械界=Giới Giới
天理教派=Thiên Lý Giáo Phái
天理之主=Thiên Lý Chi Chủ
知识蒙宠会=Tri Thức Mông Sủng Hội
雾海魔人族=Vụ Hải Ma Nhân Tộc
恒娥=Hằng Nga
时维均=Thời Duy Quân
极乐王=Cực Lạc Vương
暗月魔王=Ám Nguyệt Ma Vương
姜棘=Khương C棘
金色太阳=Kim Sắc Thái Dương
纸神=Chỉ Thần
祁威=Kỳ Uy
陆圣=Lục Thánh
周成=Chu Thành
洛清月=Lạc Thanh Nguyệt
至高母神=Chí Cao Mẫu Thần
荆棘之主=Kinh C棘 Chi Chủ
黄昏之母=Hoàng Hôn Chi Mẫu
至高太阳=Chí Cao Thái Dương
大渊市=Đại Uyên Thị
煌黑赤龙蚁=Hoàng Hắc Xích Long Kiến
千面灵神孽=Thiên Diện Linh Thần Nghiệt
五灾孔雀=Ngũ Tai Khổng Tước
鼠鼠=Thử Thử
纸骑士=Chỉ Kỵ Sĩ
陆娲=Lục Oa
陆溟=Lục Minh
欢享家=Hoan Hưởng Gia
广东收买佬=Quảng Đông Thu Mãi Lão
黑毛鸟=Hắc Mao Điểu
虞夕颜=Ngu Tịch Nhan
赤月梦=Xích Nguyệt Mộng
