2V2=2V2
Avenger=Avenger
Emmm=Emmm
GOD=GOD
KPI=KPI
P9=P9
PPT=PPT
PY=PY
T1=T1
T2=T2
T3=T3
giegie=giegie
ntr=NTR
一些天才=một vài thiên tài
一千个人类=một ngàn nhân loại
一口吃喝=một ngụm ăn uống
一口闷气=một hơi ngột ngạt
一掌门=một chưởng môn
一本道藏=một bảng Đạo Tàng
一条龙影=một cái long ảnh
一针一线=một mũi kim một sợ chỉ
丁勉=Đinh Miễn
万物母气根=Vạn Vật Mẫu Khí Căn
万里乾坤符=Vạn Dặm Càn Khôn Phù
三使=tam sứ
三千六百郡=3600 quận
上武者=thượng võ giả
不得自在=không được tự tại
世纪伟才=thế kỉ vĩ tài
两个妹子=hai cái muội tử
两个家丁=hai tên gia đinh
两个小姑娘=hai tiểu cô nương
两个道童=hai cái Đạo đồng
两个道童模样=hai cái đạo đồng bộ dáng
两人修为=hai người tu vi
两人内力=hai người nội lực
两人血战=hai người huyết chiến
两人还是=hai người vẫn là
两天帝=hai Thiên Đế
两禁=hai cấm
个道童模样=đạo đồng bộ dáng
中土蛮子=Trung Thổ Man Tử
中岳图=Trung Nhạc Đồ
丽城=Lệ Thành
举头三尺有神明=ngẩn đầu ba thước có thần minh
之字形=hình chữ z
乐的=vui
九妙=Cửu Diệu
九生九灭=cửu sinh cửu diệt
九重的=cửu trọng
九龙拉棺=Cửu Long Kéo Quan
二人的脑海中=hai người trong óc
五岳印=Ngũ Nhạc Ấn
五岳真形图=Ngũ Nhạc Chân Hình Đồ
亦有此能=cũng có này năng lực
人元果=Nhân Nguyên Quả
人的精神=người tinh thần
人的脑海中=trong đầu người
人的身躯=người thân thể
人血战=người huyết chiến
人间巅峰=Nhân Gian Đỉnh Phong
从武者=từ võ giả
任一掌门= bất kỳ một chưởng môn
任桑=Nhậm tang
伞盖山=Tán Cái Sơn
伟岸存在=vĩ ngạn tồn tại
传说中神魔=trong truyền thuyết thần ma
传送到=truyền tống đến
体会飞行=trải nghiệm phi hành
余深=Dư Thâm
余老狗=Dư lão cẩu
佛系=Phật hệ
佩珀=Rhodes
便当=cơm hộp/liền đem/tiện lợi/tiện lợi/thuận tiện/đơn giản/dễ dàng/bento
俊朗的年轻人=tuấn lãng thanh niên
俞总兵=Du tổng binh
做件事情=làm một sự tình
元妙先生=Nguyên Diệu tiên sinh
全新的壳=mới tinh vỏ bọc
八荒六合唯我独尊功=Bát Hoang Lục Hợp Duy Ngã Độc Tôn Công
公明哥哥=Công Minh ca ca
其性命=kỳ tính mệnh
再弱鸡=yếu gà hơn nữa
冤种=ngu ngốc
冰水双属性=băng thủy song thuộc tính
冲和道人=Xung Hòa đạo nhân
冲虚=Xung Hư/xung hư
冲虚道长=Xung Hư đạo trưởng
分享的=chia sẻ
刘高=Lưu Cao
十字坡=Thập Tự sườn núi
千手一族=Senju Nhất Tộc
半桶子=nửa thùng
华山上下=Hoa Sơn trên dưới
厚厚的冰霜=thật dày băng sương
原位面=nguyên vị diện
去成长=để trưởng thành
口火炉=khẩu hỏa lô
古老王朝=Cổ Lão Vương Triều
古色古香的书籍=cổ kính thư tịch
可以对标=có thể đối tiêu
可能才=khả năng mới
史夫人声音=Sử phu nhân thanh âm
史莱克学院=Sử Lai Khắc Học Viện
右手=tay phải/bên phải
吃瓜=ăn dưa
同袍手足=đồng bào thủ túc
吐出一口闷气=thở phào một hơi
吕良=Lữ Lương
吴都=Ngô Đô
周明云=Chu Minh Vân
呼出一口闷气=thở phào một cái
命也=mệnh cũng
哪都通=Na Đô Thông
唯美若=duy mỹ như
唳鸣=lệ minh
回的= về
在景阳=tại Cảnh Dương
在观战席=tại quan chiến vị trí
坟墓的事情=phần mộ sự tình
墨绿色血液=dòng máu màu xanh sẫm
壮壮胆气=tăng chút dũng khí
夏禾=Hạ Hòa
外门长老=ngoại môn trưởng lão
夜帝=Dạ Đế
大圣女=Đại Thánh Nữ
大工不巧=đại công bất xảo
大汉气势=đại hán khí thế
大消息=đại tin tức
大道五十=Đại Đạo 50
天下大势=thiên hạ đại thế
天剑绝=Thiên Kiếm Tuyệt
天子命格=Thiên Tử mệnh cách
天星下凡=Thiên Tinh hạ phàm
天衍四十九= Thiên Diễn 49
天鹅颈=thiên nga cổ
天鹏博龙术=Thiên Bằng Bác Long Thuật
天鹏屠圣术=Thiên Bằng Đồ Thánh Thuật
太岳先生=Thái Nhạc tiên sinh
太极为=Thái Cực vì
太阳的光辉=mặt trời quang huy
夫人面前=phu nhân trước mặt
奔龙=bôn long
女子声音=nữ tử thanh âm
她哥哥=nàng ca ca
如龙象=như long tượng
妙风使=Diệu Phong Sứ
嫁衣真气=Giá Y Chân Khí
孕先天=dựng Tiên Thiên
孟婆汤了=canh Mạnh Bà
安远伯=An Viễn Bá
家人是谁=người nhà là ai
宿老=túc lão
对方的手指=đối phương ngón tay
对身体的控制=đối với thân thể khống chế
小吃货=tiểu ăn hàng
小囡囡=Tiểu Niếp Niếp
小开不算开=mở nhỏ không được tính mở
小日子=tháng ngày/cuộc sống tạm bợ/cuộc sống gia đình tạm ổn
小昭=Tiểu Chiêu
小棉袄=áo bông nhỏ
小豆丁=tiểu đậu đinh
小阴阳炼宝法=Tiểu Âm Dương Luyện Bảo Pháp
小阴阳照神镜=Tiểu Âm Dương Chiếu Thần Kính
小阴阳真法=Tiểu Âm Dương Chân Pháp
小阴阳镜=Tiểu Âm Dương Kính
小鹏王=Tiểu Bằng Vương
少年手=thiếu niên tay
少年手里=thiếu niên trong tay
少年还是=thiếu niên vẫn là
少年面容=thiếu niên mặt mũi
就更冷静=thì càng lãnh tĩnh
就跟他拼=liền liều mạng với hắn
就跟他拼了=liền liều mạng với hắn
屠四方=Đồ Tứ Phương
山君=Sơn Quân
山贼老大=sơn tặc lão đại
巍巍颤颤=run run rẩy rẩy
左道的=Tả Đạo
左道的巅峰=Tả Đạo đỉnh phong
已经出手=đã ra tay
希冀=chờ mong/mong được/mong có/ước ao/khao khát/hy kí/mong mỏi/hi ký
希望=hi vọng/mong muốn/ước ao/mong/ý muốn/ước muốn/nguyện vọng/niềm hi vọng/mong ngóng/hy vọng
帝使=Đế Sứ
庄旗使=Trang kì sứ
延续断路=kéo dài đoạn lộ
张之维=Trương Chi Duy
张九阴=Trương Cửu Âm
张予德=Trương Dư Đức
张罗浮=Trương La Phù
张锡林=Trương Tích Lâm
强迫症=OCD/chứng cưỡng bách/ocd
彦祖=Ngạn Tổ
很多世界=rất nhiều thế giới
很开门=rất cởi mở
很河狸=rất hải ly
很行=rất tốt
徐鹏飞=Từ Bằng Phi
心底轻语=đáy lòng nhẹ nói
心有所感悟=lòng có cảm ngộ
怎么还=làm sao còn
思路=mạch suy nghĩ/ý nghĩ của/dòng suy nghĩ/ý nghĩ/con đường riêng
悠悠=ung dung/lo lắng/lâu dài/xa tắp/xa vời/dài dằng dặc/nhiều/đông đúc/thong thả/khoan thai/hoang đường/khoa trương/du du/dằng dặc/xa xôi
憨气=ngớ ngẩn
懦软=hèn nhát
我的女帝妹妹=ta Nữ Đế muội muội
战狼一样=chiến lang giống như
所有人愤怒=tất cả mọi người tức giận
拙峰=Chuyết Phong/chuyết phong
挺帅气=thật soái khí
探索=thăm dò/tìm tòi/tìm kiếm
援军令=viện quân lệnh
文人眼=văn nhân mắt
斥风符=xích phong phù
斩玄铁=trảm huyền thiết
方夜=Phương Dạ
方远大师=Phương Viễn đại sư
无三=vô tam
无上存在=vô thượng tồn tại
无人区=khu không người
旧书铺=sách cũ phô
时不我待=thời gian không đợi ta
时也=thời cũng
时间线=thời gian tuyến
明教中=Minh Giáo bên trong
明面身份=bên ngoài thân phận
易经伐髓=dịch kinh phạt tủy
是宁儿= là Ninh nhi
是神=
是神仙=là thần tiên
是神魔=là Thần Ma
是神魔位面=là Thần Ma Vị Diện
是越国=là Việt Quốc
智慧王=Trí Tuệ Vương
暗自嘀咕=lẩm bẩm với chính mình
更加速成=càng thêm tốc thành
最后了断=cuối cùng chấm dứt
有点迟疑=có chút do dự
有这种=có cái loại này
有这种事情=có loại này sự tình
有限额=có giới hạn
服部千军=Hattori Senjun
朱门酒肉臭=cửa son lộ thịt ôi
机缘流=cơ duyên lưu
杀了我=giết ta
杨龙象=Dương Long Tượng
柳妍妍=Liễu Nghiên Nghiên
梅林=rừng mai
欢快起来=trở nên vui sướng
正道上=chính đạo trên
武大哥=Võ đại ca
武松的=Võ Tòng
武植=Võ Thực
死无葬身之地=chết không có chỗ chôn
残片里面的=tàn phiến bên trong
比蒙鱼=so Mông Ngư
比较弱鸡=yếu như gà
气之云=khí chi vân
求返其真=cầu phản kì chân/Cầu Phản Kỳ Chân
汪洋=uông dương
汪洋的=uông dương
没什么事业心=không có gì sự nghiệp tâm
没开辟=không có mở ra
流云使=Lưu Vân Sứ
涟漪=gợn sóng/rung động/sóng lăn tăn/sóng gợn/gợn sóng
混着=lẫn vào
渡闻=Độ Văn
游神行气法=Du Thần Hành Khí Pháp
漏了气的=lọt khí
潜世=ẩn thế
灭你的门=diệt ngươi môn
灭绝=Diệt Tuyệt
灭霸=Thanos
灵世界=linh thế giới
点血=điểm huyết/chút máu/chút huyết
炽盛光辉=hừng hực quang huy
猎人的精神=thợ săn tinh thần
猴子=hầu tử/con khỉ/khỉ
猿飞日月=Sarutobi Nichigetsu
玄徽=Huyền Huy
玄金甲=Huyền Kim Giáp
瓷像=tượng sứ
生死面前=sinh tử trước mặt
田晋中=Điền Tấn Trung
男人心情=nam nhân tâm tình
留下来了=lưu lại
留传说=lưu truyền thuyết
疾火=tật hỏa
白沙坞=Bạch Sa Ổ
白额侯=Bạch Ngạch Hầu
百丈=trăm trượng
的想象=tưởng tượng
的脑子里=trong đầu
皆不凡=đều bất phàm
皇后区=khu Queens
真人的意思=chân nhân ý tứ
眼珠=con mắt/con ngươi
知寨=tri trại
矮子=thằng lùn/người lùn/chú lùn/người nhỏ bé/người tầm thường/người nhỏ nhen
破碎=phá toái
破碎了=phá toái
破碎飞升=Phá Toái Phi Thăng
神击之术=Thần Kích Chi Thuật
神榕树=Thần Dung thụ
神秘瑞兽=thần bí thụy thú
种牛逼=loại ngưu bức
秦华麟=Tần Hoa Lân
秦华龙=Tần Hoa Long
秦江=Tần Giang
秦镇渊=Tần Trấn Uyên
稀罕么=hiếm a
空地上=đất trống bên trên
空相大师=Không Tướng Đại Sư
穿梭者=người xuyên việt
粱上客=Lương Thượng Khách
粱飞=Lương Phi
精神破碎=Tinh Thần Phá Toái
糊弄一个=lừa bịp một cái
紫耀剑=Tử Diệu Kiếm
红叶师伯=Hồng Diệp sư bá
纵横无敌手=tung hoành vô địch thủ
纸鹞断线一般=con diều cắt đứt dây đồng dạng
给上面=cho phía trên
绝灵世界=tuyệt linh thế giới
继国岩胜=Tsugikuni Michikatsu
继国缘壹=Tsugikuni Yoriichi
罗仪=La Nghi
罗刹女=La Sát Nữ
罗澄=La Trừng
翟云峰=Địch Vân Phong
翟大爹=Địch Đại Đa
翟谦=Địch Khiêm
老人的视线=lão nhân tầm mắt
老人的话音=lão nhân âm thanh
老阴比=lão âm bỉ
而生死=mà sinh tử
胜观峰=Thắng Quan Phong
自己很行=mình rất giỏi
至大的=rất lớn
至阳至大=chí dương chí đại
良才美玉=lương tài mỹ ngọc
花知寨=Hoa tri trại
花霜=Hoa Sương
苏家子弟=Tô gia tử đệ
苏心悦=Tô Tâm Duyệt
苦无良策=khổ không thượng sách
英雄无敌=anh hùng vô địch
草长莺飞=cỏ mọc én bay/thảo trường oanh phi
莫得=không có
落寞的感觉=cô đơn cảm giác
蒋降龙=Tưởng Giáng Long
蓝天凤=Lam Thiên Phượng
蔡老狗=Thái lão cẩu
血继忍者=huyết kế ninja
裸游=bơi khỏa thân
见到你很高兴=Rất vui được gặp ngươi
让人人=để cho người người
诸圣子=chư Thánh Tử
诸天的意思=chư thiên ý tứ
谁吗=ai
谜语人=câu đố người
谢大当家=Tạ đại đương gia
贼老大=tặc lão đại
赖蛤蟆=Lại Cáp Mô
赤红色光辉的=xích hồng quang huy
赵晓棠=Triệu Hiểu Đường
路有冻死骨=ngoài đường đầy xác chết
辉月使=Huy Nguyệt Sứ
近百万里之遥=xa gần trăm vạn dặm
这么厉害=lợi hại như thế
这样子=như vậy
这辈子=đời này
远桥=Viễn Kiều
连载版=đăng nhiều kỳ bản
迟迟=chậm chạp/trì trệ/chậm trễ/lần lữa/kề cà
遁去其一=Độn Đi 1
道的巅峰=đạo đỉnh phong
道长出手=đạo trưởng xuất thủ
遮天法=Già Thiên pháp
邀月大侠=Yêu Nguyệt đại hiệp
邀月姑娘=Yêu Nguyệt cô nương
邀月施主=Yêu Nguyệt thí chủ
邀月盟主=Yêu Nguyệt minh chủ
释户=Thích Hộ
重剑无锋=trọng kiếm vô phong
野云渡=Dã Vân Độ
金刚破碎=Kim Cương Phá Toái
锦毛虎=Cẩm Mao Hổ
长生不死神=Trường Sinh Bất Tử Thần
长蛇百寻=trường xà bách tầm
门房乙=người gác cổng Ất
闪躲机会=trốn tránh cơ hội
阅览室=phòng đọc sách
阮小七=Nguyễn Tiểu Thất
阮小二=Nguyễn Tiểu Nhị
阮小五=Nguyễn Tiểu Ngũ
陆娴=Lục Nhàn
陆恒=Lục Hằng
陆谪仙=Lục Trích Tiên
陈专员=Trần chuyên viên
降龙掌=Giáng Long chưởng
雎华仙人=Sư Hoa Tiên Nhân
霍然=bỗng nhiên/đột nhiên/khỏi bệnh ngay/thuyên giảm nhanh chóng/hoắc nhiên
青年男子=thanh niên nam tử/chàng thanh niên/nam tử thanh niên
非常饿=rất đói
靠不靠=có thể dựa vào không
风云月三使=Phong Vân Nguyệt tam sứ
马知州=Mã Tri Châu
马虎=qua loa/đại khái/tàm tạm/mã hổ
高一=cao nhất/cấp một/cao nhất/lớp 10/cao một/năm nhất THPT/năm nhất cao trung
鸟位=điểu vị
黄师=Hoàng sư
黑暗动乱=Hắc Ám Náo Động
黑暗年代=hắc ám niên đại
鼎湖派=Đỉnh Hồ Phái
齐长生=Tề Trường Sinh
龙场=long tràn
ＢＵＦＦ=BUFF
丁巳月=Đinh Tị nguyệt
丙子日=Bính Tý nhật
天玑殿=Thiên Cơ Điện
丁酉=Đinh Dậu
丁巳=Đinh Tỵ
浑元功=Hỗn Nguyên Công
大周姬氏=Đại Chu Cơ thị
姜仲元=Khương Trọng Nguyên
观星望气=Quan Tinh Vọng Khí
水晶之肚=Thủy Tinh Chi Đổ
江百川=Giang Bách Xuyên
丁震=Đinh Chấn
蔡志英=Thái Chí Anh
易扬=Dịch Dương
纵横道=Tung Hoành Đạo
惊鸿七度=Kinh Hồng Thất Độ
赤岚烟罗=Xích Lam Yên La
女先生白洁=Nữ tiên sinh Bạch Khiết
天河神沙=Thiên Hà Thần Sa
祖师九天尚父五方都总管北极左垣上将都统大元帅天蓬真君=Tổ Sư Cửu Thiên Thượng Phụ Ngũ Phương Đô Tổng Quản Bắc Cực Tả Viên Thượng Tướng Đô Thống Đại Nguyên Soái Thiên Bồng Chân Quân
北斗破军星=Bắc Đẩu Phá Quân Tinh
七殿之主=Thất Điện Chi Chủ
阴符七术·实意法螣蛇=Âm phù thất thuật - Thực ý pháp Đằng Xà
赤霞烟岚=Xích Hà Yên Lam
大荒北经=Đại Hoang Bắc Kinh
庚申月=Canh Thân nguyệt
辛丑日=Tân Sửu nhật
惊雷师兄=Kinh Lôi sư huynh
秋水师姐=Thu Thủy sư tỷ
万叶飞花掌=Vạn Diệp Phi Hoa Chưởng
萧师道=Tiêu Sư Đạo
叶雨迟=Diệp Vũ Trì
地风升=Địa Phong Thăng
九黎刀章=Cửu Lê Đao Chương
桥县=Kiều Huyện
碧水镇=Bích Thủy Trấn
龙泉镇=Long Tuyền Trấn
少侠阿宾=Thiếu Hiệp A Bin
常山郡=Thường Sơn Quận
巨鹿郡=Cự Lộc Quận
神都云县=Thần Đô Vân Huyện
六品道器=Lục Phẩm Đạo Khí
谯明之山=Tiều Minh Chi Sơn
山巅天枢殿=Sơn Điên Thiên Xu Điện
紫袍中年天玑长老=Tử Bào Trung Niên Thiên Cơ trưởng lão
暗世玄流=Ám Thế Huyền Lưu
玄门三皇派=Huyền Môn Tam Hoàng Phái
姬氏皇族=Cơ Thị Hoàng Tộc
张振阳=Trương Chấn Dương
世本=Thế Bản
李重岳=Lý Trọng Nhạc
天兵神威=Thiên Binh Thần Uy
奉天讨逆=Phụng Thiên Thảo Nghịch
黄铜浑天仪=Hoàng Đồng Hỗn Thiên Nghi
命门关=Mệnh Môn Quan
鼎湖北面=Đỉnh Hồ bắc diện
北玄=Bắc Huyền
丘怀安=Khâu Hoài An
天玑师兄=Thiên Cơ sư huynh
天玑禄存=Thiên Cơ Lộc Tồn
玉衡廉贞=Ngọc Hành Liêm Trinh
紫山根=Tử Sơn Căn
金戈草=Kim Qua Thảo
《百草经》=《Bách Thảo Kinh》
奎木星官=Khuê Mộc Tinh Quan
骠骑将军·冠军侯=Phiêu Kỵ Tướng Quân - Quán Quân Hầu
西方昆虚仙宫=Tây Phương Côn Khư Tiên Cung
真定姜家=Chân Định Khương Gia
阴山鬼王=Âm Sơn Quỷ Vương
真定郡=Chân Định Quận
应龙之鳞=Ứng Long Chi Lân
天目符=Thiên Mục Phù
五力士符=Ngũ Lực Sĩ Phù
绝处逢生，华而不败=Tuyệt xứ phùng sinh, hoa nhi bất bại
搬山力士=Bàn Sơn Lực Sĩ
斩妖吞孽咒=Trảm Yêu Thôn Nghiệt Chú
姜冲=Khương Xung
凰君=Hoàng Quân
南飞云=Nam Phi Vân
巫觋=Vu Hịch
向枢使=Hướng Khu Sứ
连天璇=Liên Thiên Toàn
神行太保枢使向云天=Thần Hành Thái Bảo Xu Sứ Hướng Vân Thiên
景云县=Cảnh Vân huyện
江怀民=Giang Hoài Dân
易数玄学=Dịch số huyền học
祝融相=Chúc Dung Tướng
狐岐=Hồ Kỳ
九灲（xiāo）离经=Cửu Tiêu Ly Kinh
岐山姜=Kỳ Sơn Khương
姜家大爷=Khương gia đại gia
指南剑法=Chỉ Nam Kiếm Pháp
岐山县城=Kỳ Sơn Huyện Thành
七叶断肠草=Thất Diệp Đoạn Trường Thảo
无生花=Vô Sinh Hoa
紫棘叶=Tử Gai Diệp
眠狂草=Miên Cuồng Thảo
炎阳刀=Viêm Dương Đao
九泉心诀=Cửu Tuyền Tâm Quyết
右弼=Hữu Bật
阴阳双流掌=Âm Dương Song Lưu Chưởng
飞云姜家=Phi Vân Khương Gia
姜元奇=Khương Nguyên Kỳ
飞云镇=Phi Vân Trấn
姜无咎=Khương Vô Cữu
心窍绛宫=Tâm Khiếu Giáng Cung
腹下黄庭=Phúc Hạ Hoàng Đình
神都飞云姜家=Thần Đô Phi Vân Khương Gia
任子和=Nhậm Tử Hòa
岐山姜氏=Kỳ Sơn Khương Thị
扶风郡守=Phù Phong Quận Thủ
野狐岭=Dã Hồ Lĩnh
姜无野=Khương Vô Dã
姜昭义=Khương Chiêu Nghĩa
剪云峰=Tiễn Vân Phong
天山遁=Thiên Sơn Độn
姜昭仁=Khương Chiêu Nhân
福神道器玉如意=Phúc Thần Đạo Khí Ngọc Như Ý
司晨啼晓=Tư Thần Đề Hiểu
扶风郡城=Phù Phong quận thành
并州高阳=Tịnh Châu Cao Dương
那伽=Na Già
元帅横天乱地咒=Nguyên Soái Hoành Thiên Loạn Địa Chú
神都皇宫=Thần Đô Hoàng Cung
小雷仙·杨殛=Tiểu Lôi Tiên · Dương Cực
天慧堂=Thiên Tuệ Đường
临山=Lâm Sơn
回春符=Hồi Xuân Phù
养气符=Dưỡng Khí Phù
孟元支=Mạnh Nguyên Chi
雨师祭坛=Vũ Sư Tế Đàn
雨师道果=Vũ Sư Đạo Quả
傩面=Na Diện
姜敬元=Khương Kính Nguyên
六合符阵=Lục Hợp Phù Trận
阴符七术·养志法灵龟=Âm Phù Thất Thuật · Dưỡng Chí Pháp Linh Quy
青阳符剑=Thanh Dương Phù Kiếm
一气大擒拿=Nhất Khí Đại Cầm Nã
明真道人=Minh Chân Đạo Nhân
鱼奉先=Ngư Phụng Tiên
董相国=Đổng Tướng Quốc
提婆族=Đề Bà Tộc
大衍五十=Đại Diễn Ngũ Thập
明光符=Minh Quang Phù
碧焰阴雷刀=Bích Diễm Âm Lôi Đao
格物刀=Cách Vật Đao
纪云流=Kỷ Vân Lưu
捷疾可畏=Tiệp Tật Khả Úy
神通力=Thần Thông Lực
暴恶鬼面=Bạo Ác Quỷ Diện
雷部正神三五火车雷公=Lôi Bộ Chính Thần Tam Ngũ Hỏa Xa Lôi Công
姜道山=Khương Đạo Sơn
天符号雷=Thiên Phù Hào Lôi
雷边捷鬼=Lôi Biên Tiệp Quỷ
七星河=Thất Tinh hà
八神主=Bát Thần Chủ
淮河水神=Hoài Hà Thủy Thần
守静心诀=Thủ Tĩnh Tâm Quyết
幽灵牛车=U Linh Ngưu Xa
太白经天=Thái Bạch Kinh Thiên
马面罗刹=Mã Diện La Sát
天蓬咒=Thiên Bồng Chú
九天雷霆=Cửu Thiên Lôi Đình
临山镇=Lâm Sơn trấn
凤泉河=Phượng Tuyền hà
阎罗道果=Diêm La đạo quả
福神玉如意=Phúc Thần Ngọc Như Ý
西凉山=Tây Lương Sơn
神农像=Tượng Thần Nông
六丁六甲护身符=Lục Đinh Lục Giáp hộ thân phù
鲁王世子姬承业=Lỗ Vương thế tử Cơ Thừa Nghiệp
御士=Ngự Sĩ
天鼋=Thiên Nguyên
轩辕剑典=Hiên Viên Kiếm Điển
萧九娘=Tiêu Cửu Nương
火宅佛狱之主=Hỏa Trạch Phật Ngục Chi Chủ
九元煞童=Cửu Nguyên Sát Đồng
阴阳本根=Âm Dương Bản Căn
高周波=Cao Chu Ba
六道轮回浮屠禁典=Lục Đạo Luân Hồi Phù Đồ Cấm Điển
降魔印=Hàng Ma Ấn
活神露=Hoạt Thần Lộ
担山超海=Đảm Sơn Siêu Hải
千秋永存=Thiên Thu Vĩnh Tồn
真龙血裔=Chân Long Huyết Duệ
碑镇山河=Bi Trấn Sơn Hà
长寿吉祥=Trường Thọ Cát Tường
风乎舞雩=Phong Hồ Vũ Vu
鲁王姬野=Lỗ Vương Cơ Dã
长驸马风满楼=Trưởng Phò Mã Phong Mãn Lâu
华阳长公主=Hoa Dương Trưởng công chúa
中指峰=Trung Chỉ Phong
大周朝廷=Đại Chu Triều Đình
苦一苦=Khổ Nhất Khổ
雍州刺史洪好古=Thứ sử Ung Châu Hồng Hảo Cổ
天水郡守王奇=Thái thú Thiên Thủy quận Vương Kỳ
安定郡守杨淼=Thái thú An Định quận Dương Miểu
扶风郡守姜之焕=Thái thú Phù Phong quận Khương Chi Hoán
增福神=Tăng Phúc Thần
炎武阁=Viêm Võ Các
陵光姑姑=Lăng Quang cô cô
姬野=Cơ Dã
少教主杨殛=Thiếu giáo chủ Dương Cực
赤翎殿=Xích Linh Điện
天赐神兵=Thiên Tứ Thần Binh
奉天征讨=Phụng Thiên Chinh Thảo
巡值四方=Tuần Trị Tứ Phương
功曹道果=Công Tào Đạo Quả
墨武刀=Mặc Võ Đao
李真君=Lý Chân Quân
楚昭元=Sở Chiêu Nguyên
辛酉月=Tân Dậu nguyệt
戊子日=Mậu Tý nhật
天权星=Thiên Quyền Tinh
雷地豫=Lôi Địa Dự
太玄金刀=Thái Huyền Kim Đao
瑶池仙舟=Dao Trì Tiên Chu
金童·牛郎=Kim Đồng・Ngưu Lang
摇光师弟=Dao Quang sư đệ
少阳天箓=Thiếu Dương Thiên Lục
武曲坪=Vũ Khúc Bình
麟德历=Lân Đức Lịch
后土相=Hậu Thổ Tướng
纠罚=Củ Phạt
八部天龙广力普萨之相=Bát Bộ Thiên Long Quảng Lực Phổ Tát Chi Tướng
广明道长=Quảng Minh đạo trưởng
玄明道士=Huyền Minh đạo sĩ
太阳金羽=Thái Dương Kim Vũ
柔云精粹=Nhu Vân Tinh Túy
神珍铁=Thần Trân Thiết
玉虚观剑法·太乙分光剑=Ngọc Hư Quan Kiếm Pháp · Thái Ất Phân Quang Kiếm
先天木炁=Tiên Thiên Mộc Khí
紫雷金铜=Tử Lôi Kim Đồng
天志战剑=Thiên Chí Chiến Kiếm
看胸识人=Khán Hung Thức Nhân
巽剑道=Tốn Kiếm Đạo
超电磁剑诀=Siêu Điện Từ Kiếm Quyết
罗刹鬼王=La Sát Quỷ Vương
乾剑道=Càn Kiếm Đạo
龙岳大匠师=Long Nhạc đại tượng sư
福留肾穴=Phúc Lưu Thận Huyệt
天沉铁=Thiên Trầm Thiết
金乌羽=Kim Ô Vũ
柔云之精=Nhu Vân Chi Tinh
紫电金铜=Tử Điện Kim Đồng
如意玄铁=Như Ý Huyền Thiết
木炁=Mộc Khí
金炁=Kim Khí
复古派=Phái Phục Cổ
华岳神女=Hoa Nhạc Thần Nữ
灵曲河=Linh Khúc Hà
造化神刀=Tạo Hóa Thần Đao
云莱岛=Vân Lai Đảo
明玉真=Minh Ngọc Chân
净坤体=Tịnh Khôn Thể
九幽素阴元女道体=Cửu U Tố Âm Nguyên Nữ Đạo Thể
青龙孟家=Thanh Long Mạnh Gia
孟晚舟=Mạnh Vãn Chu
接仙台=Tiếp Tiên Đài
璇玑殿=Toàn Cơ Điện
幻灵慑心阵=Huyễn Linh Nhiếp Tâm Trận
纯阳真人吕洞宾=Thuần Dương chân nhân Lã Động Tân
三清神像=Tượng Tam Thanh
提挈天地=Đề Huề Thiên Địa
通明堂=Thông Minh Đường
飞剑斩黄龙=Phi Kiếm Trảm Hoàng Long
鬼影鞭=Quỷ Ảnh Tiên
四季花=Tứ Quý Hoa
抱朴堂=Bão Phác Đường
云县姜氏=Vân Huyện Khương Thị
他化自在天主——大自在天子波旬=Tha Hóa Tự Tại Thiên Chủ - Đại Tự Tại Thiên Tử Ba Tuần
神都云县姜氏=Thần Đô Vân Huyện Khương Thị
褚江=Chử Giang
飞云使者=Phi Vân Sứ Giả
封云杰=Phong Vân Kiệt
神都王家=Thần Đô Vương gia
杜少保=Đỗ Thiếu Bảo
袇房=Nhiễm Phòng
姬成稷=Cơ Thành Tắc
高侃=Cao Khản
沈可法=Thẩm Khả Pháp
王千峰=Vương Thiên Phong
壬戌月=Tháng Nhâm Tuất
丙午日=Ngày Bính Ngọ
射龙台=Xạ Long Đài
文虚真人=Văn Hư chân nhân
姜氏族人=Khương thị tộc nhân
千钧臂=Thiên Quân Tí
幽天玄金体=U Thiên Huyền Kim Thể
西华妙道真经=Tây Hoa Diệu Đạo Chân Kinh
左枢使=Tả Khu Sứ
先天真身法=Tiên Thiên Chân Thân Pháp
南天司枢使·左招=Nam Thiên Tư Xu Mật Sử · Tả Chiêu
太白真君李玄=Thái Bạch Chân Quân Lý Huyền
噙血荡元=Hàm huyết đãng nguyên
明珠在椟，含光忍辱=Minh châu tại độc, hàm quang nhẫn nhục
宗明=Tông Minh
姬承源=Cơ Thừa Nguyên
六识颠倒=Lục thức điên đảo
气浊血滞=Khí trọc huyết trệ
魂离魄散=Hồn ly phách tán
形销骨立=Hình tiêu cốt lập
四皇子姬承源=Tứ hoàng tử Cơ Thừa Nguyên
瘟癀大帝=Ôn Hoằng Đại Đế
神都城=Thần Đô Thành
文虚=Văn Hư
昭华炉=Chiêu Hoa Lô
云县姜家=Vân Huyện Khương Gia
沐凌衣=Mộc Lăng Y
太学大祭酒=Thái Học Đại Tế Tửu
冯正=Phùng Chính
承源=Thừa Nguyên
明德坊=Minh Đức Phường
许邈=Hứa Miểu
文昌殿=Văn Xương Điện
崔向忠=Thôi Hướng Trung
通元子=Thông Nguyên Tử
万辅座=Vạn Phụ Tọa
万卿=Vạn Khanh
姬常洛=Cơ Thường Lạc
曹元龙=Tào Nguyên Long
大公公曹林=Đại công công Tào Lâm
云明阁=Vân Minh Các
京兆府左内史=Kinh Triệu Phủ Tả Nội Sử
一阳初生=Nhất Dương Sơ Sinh
长乐门=Trường Lạc Môn
开元门=Khai Nguyên Môn
红云散花针=Hồng Vân Tán Hoa Châm
红云散花=Hồng Vân Tán Hoa
纤云弄巧=Tiêm Vân Lộng Xảo
七杀破军，羊铃为虐=Thất Sát Phá Quân, Dương Linh Vi Ngược
北山经=Bắc Sơn Kinh
狱法之山=Ngục Pháp Chi Sơn
代王=Đại Vương
司录参军=Tư Lục Tham Quân
司法参军=Tư Pháp Tham Quân
司兵参军=Tư Binh Tham Quân
云县=Vân Huyện
九天聚仙=Cửu Thiên Tụ Tiên
小红狗=Tiểu Hồng Cẩu
师宝男=Sư Bảo Nam
青玥郡主=Thanh Nguyệt Quận Chúa
我妈=Mẹ tôi
姬承稷=Cơ Thừa Tắc
宗海=Tông Hải
红狗=Hồng Cẩu
天青化龙诀=Thiên Thanh Hóa Long Quyết
沈源=Thẩm Nguyên
步玉笙=Bộ Ngọc Sanh
孟修吾=Mạnh Tu Ngô
黄龙街=Hoàng Long Nhai
王守立=Vương Thủ Lập
华阳公主=Hoa Dương công chúa
黄帝土皇道=Hoàng Đế Thổ Hoàng Đạo
九地锁天罡=Cửu Địa Tỏa Thiên Cương
广寒月神=Quảng Hàn Nguyệt Thần
华阳公主府=Phủ Hoa Dương Công chúa
判官崔珏=Phán Quan Thôi Giác
玉华宫=Ngọc Hoa Cung
孟长林=Mạnh Trường Lâm
赵客=Triệu Khách
判官·钟馗=Phán Quan · Chung Quỳ
阳灵鬼武诀=Dương Linh Quỷ Võ Quyết
太清九天剑=Thái Thanh Cửu Thiên Kiếm
现象玩占=Hiện Tượng Ngoạn Chiêm
舆鬼五星=Dư Quỷ Ngũ Tinh
神剑御雷高周波真诀=Thần Kiếm Ngự Lôi Cao Chu Ba Chân Quyết
乾阳殿=Càn Dương Điện
姬氏宗正=Cơ Thị Tông Chính
纳魂布袋=Nạp Hồn Bố Đại
孟家主=Mạnh gia chủ
紫阳宗=Tử Dương Tông
神农九泉=Thần Nông Cửu Tuyền
超电磁真诀=Siêu Điện Từ Chân Quyết
赤霞山=Xích Hà Sơn
老五凌无觉=Lão Ngũ Lăng Vô Giác
郡城平昌=Quận thành Bình Xương
阿修罗道果=A Tu La Đạo Quả
九玄代身符=Cửu Huyền Đại Thân Phù
玄冥一气雷=Huyền Minh Nhất Khí Lôi
江阳县=Giang Dương huyện
魔罗波旬=Ma La Ba Tuần
大雷音剑诀=Đại Lôi Âm Kiếm Quyết
庚金剑诀=Canh Kim Kiếm Quyết
八荒凶神=Bát Hoang Hung Thần
索命夜叉=Sách Mệnh Dạ Xoa
六阴鬼王=Lục Âm Quỷ Vương
天香阁=Thiên Hương Các
宙道=Trụ Đạo
江阳城=Giang Dương Thành
翻江蛟=Phiên Giang Giao
宇道阵法=Vũ Đạo Trận Pháp
真龙九击=Chân Long Cửu Kích
神蝗幡=Thần Hoàng Phiên
天龙探爪=Thiên Long Thám Trảo
曲灵言=Khúc Linh Ngôn
先天易剑=Tiên Thiên Dịch Kiếm
槐江之山=Hòe Giang Chi Sơn
坤阴真元=Khôn Âm Chân Nguyên
魔罗之境=Ma La Chi Cảnh
洛南郡=Lạc Nam Quận
拘夷那竭国=Câu Di Na Yết Quốc
大圆镜智=Đại Viên Kính Trí
大自在天主业如来=Đại Tự Tại Thiên Chủ Nghiệp Như Lai
齐阳河=Tề Dương Hà
西土佛国=Tây Thổ Phật Quốc
洛书阵法=Lạc Thư Trận Pháp
法外逍遥李清涟=Pháp Ngoại Tiêu Dao Lý Thanh Liên
江罗汉=Giang La Hán
文虚师兄=Văn Hư sư huynh
人王·禹=Nhân Vương · Vũ
李清涟师兄=Lý Thanh Liên sư huynh
地云黄霙=Địa Vân Hoàng Anh
黄天庙=Hoàng Thiên miếu
神州姜氏=Thần Châu Khương thị
赵穿=Triệu Xuyên
破军榜=Phá Quân bảng
北极四圣=Bắc Cực Tứ Thánh
青玉坛=Thanh Ngọc Đàn
蹈海力士=Đạp Hải Lực Sĩ
雷鼓力士=Lôi Cổ Lực Sĩ
撼山手=Hám Sơn Thủ
北斗七元=Bắc Đẩu Thất Nguyên
天罡大圣=Thiên Cương Đại Thánh
北斗七元符=Bắc Đẩu Thất Nguyên Phù
巨灵崩天捶=Cự Linh Băng Thiên Chuy
巨灵真罡经=Cự Linh Chân Cương Kinh
青元山人=Thanh Nguyên Sơn Nhân
朱裳=Chu Thường
褚延=Chử Diên
八岐大神=Bát Kỳ Đại Thần
蜀郡二圣庙=Thục Quận Nhị Thánh Miếu
云海天光镜=Vân Hải Thiên Quang Kính
雍州姜氏=Ung Châu Khương thị
炎帝神像=Viêm Đế thần tượng
寿华之野=Thọ Hoa Chi Dã
摇光师兄=Dao Quang sư huynh
育归流=Dục Quy Lưu
春秋剑=Xuân Thu Kiếm
天荡式=Thiên Đãng Thức
断崖之剑=Đoạn Nhai chi kiếm
归藏定位=Quy Tàng Định Vị
短狐=Đoản Hồ
育藏海=Dục Tàng Hải
风、火、兵三灾=Phong, Hỏa, Binh Tam Tai
天厉刃=Thiên Lệ Nhận
天之厉刃=Thiên Chi Lệ Nhận
众星化海=Chúng Tinh Hóa Hải
墨武战匣=Mặc Võ Chiến Hạp
左招=Tả Chiêu
水灵愈体符=Thủy Linh Dũ Thể Phù
何罗=Hà La
庄子三剑=Trang Tử Tam Kiếm
佛门六字大明咒=Phật Môn Lục Tự Đại Minh Chú
方叶生=Phương Diệp Sinh
天蓬师兄=Thiên Bồng sư huynh
神木战袍=Thần Mộc Chiến Bào
大圜=Đại Hoàn
二圣庙=Nhị Thánh Miếu
九天聚仙阵=Cửu Thiên Tụ Tiên Trận
八邪罗生=Bát Tà La Sinh
姜之焕=Khương Chi Hoán
癸卯年=Quý Mão Niên
乙丑月=Ất Sửu Nguyệt
壬申日=Nhâm Thân Nhật
酉时三刻=Dậu Thời Tam Khắc
许知林=Hứa Tri Lâm
云明郡=Vân Minh Quận
玉疏颜=Ngọc Sơ Nhan
蜀王妃=Thục Vương Phi
天木重劫=Thiên Mộc Trọng Kiếp
幽山君=U Sơn Quân
壬水神雷=Nhâm Thủy Thần Lôi
沧浪池=Thương Lãng Trì
赤血龙旗=Xích Huyết Long Kỳ
齐物论=Tề Vật Luận
燹骨成丘=Tiển Cốt Thành Khâu
太阴炼神法=Thái Âm Luyện Thần Pháp
净天地神咒=Tịnh Thiên Địa Thần Chú
作家助手=Trợ lý tác giả
赤铜元身=Xích Đồng Nguyên Thân
赤阳刀=Xích Dương Đao
伏羲血脉=Phục Hy Huyết Mạch
明德街=Minh Đức Nhai
辟水=Tích Thủy
沧水=Thương Thủy
左轻鸿=Tả Khinh Hồng
炳灵公=Bỉnh Linh Công
楼观剑法=Lâu Quan kiếm pháp
梧桐路=Ngô Đồng Lộ
李观明=Lý Quan Minh
易天绝剑=Dịch Thiên Tuyệt Kiếm
绝剑·水逝=Tuyệt Kiếm · Thủy Thệ
绝剑·天诛=Tuyệt Kiếm · Thiên Tru
禹王的道果=Vũ Vương Đạo Quả
蛟太子=Giao Thái Tử
天龙吟=Thiên Long Ngâm
太古妖兽夔牛=Thái Cổ Yêu Thú Quỳ Ngưu
镇海眼神通=Trấn Hải Nhãn Thần Thông
辟水口=Tích Thủy Khẩu
天河关=Thiên Hà Quan
骑虎道人=Kỵ Hổ đạo nhân
星河横天=Tinh Hà Hoành Thiên
唐合=Đường Hợp
任海=Nhậm Hải
还珠楼=Hoàn Châu Lâu
赤霞丹=Xích Hà Đan
神农炎帝=Thần Nông Viêm Đế
平成郡=Bình Thành Quận
通文长老=Thông Văn Trưởng Lão
摧花道人=Tồi Hoa đạo nhân
獬豸玉像=Giải Trãi Ngọc Tượng
墨武剑=Mặc Vũ Kiếm
分秋剑=Phân Thu Kiếm
大圜劍=Đại Hoàn Kiếm
元浮散人=Nguyên Phù Tán Nhân
太乙乾元诀=Thái Ất Càn Nguyên Quyết
淮水龙宫=Hoài Thủy Long Cung
水猴子=Thủy Hầu Tử
巫山妖神教=Vu Sơn Yêu Thần Giáo
廉贞殿=Liêm Trinh Điện
山海经·大荒西经=Sơn Hải Kinh - Đại Hoang Tây Kinh
丰沮=Phong Trở
灵山十巫=Linh Sơn Thập Vu
巫即=Vu Tức
巫朌=Vu Phán
巫彭=Vu Bành
巫姑=Vu Cô
巫礼=Vu Lễ
巫谢=Vu Tạ
巫罗=Vu La
六欲天女=Lục Dục Thiên Nữ
善乐天女=Thiện Lạc Thiên Nữ
毕方真神=Tất Phương Chân Thần
淮水真神=Hoài Thủy Chân Thần
星孛=Tinh Bội
风氏族人=Phong Thị Tộc Nhân
法外逍遥=Pháp Ngoại Tiêu Dao
灵山会=Linh Sơn Hội
天遁剑意=Thiên Độn Kiếm Ý
金丹妙道=Kim Đan Diệu Đạo
莲纹甲=Liên Văn Giáp
天将·顺风耳=Thiên Tướng - Thuận Phong Nhĩ
天罡亢龙=Thiên Cương Kang Long
裂云手=Liệt Vân Thủ
儒门绝箭·射天狼=Nho Môn Tuyệt Tiễn · Xạ Thiên Lang
日诛恶=Nhật Tru Ác
九虫诀·噙血荡元=Cửu Trùng Quyết · Hàm Huyết Đãng Nguyên
万鼎天=Vạn Đỉnh Thiên
岳陵郡=Nhạc Lăng quận
蜀王府=Thục Vương phủ
向怀义=Hướng Hoài Nghĩa
五经博士=Ngũ Kinh bác sĩ
夔鼓雷音=Quỳ Cổ Lôi Âm
夔牛变=Quỳ Ngưu Biến
华而不败=Hoa Nhi Bất Bại
大圜剑光=Đại Hoàn Kiếm Quang
犴嗷=Hãn Ngao
黄帝内传=Hoàng Đế Nội Truyện
大周律=Đại Chu Luật
姜氏子=Khương thị tử
关玉山=Quan Ngọc Sơn
宗正姬博古=Tông Chính Cơ Bác Cổ
夔牛道果=Quỳ Ngưu đạo quả
太上洞玄灵宝救苦妙经=Thái Thượng Động Huyền Linh Bảo Cứu Khổ Diệu Kinh
玉衡殿=Ngọc Hành Điện
神农石像=Thần Nông Thạch Tượng
百草识别=Bách thảo nhận biết
药理之祖=Dược lý chi tổ
天玑师伯=Thiên Cơ sư bá
正一玄坛元帅·赵公明=Chính Nhất Huyền Đàn Nguyên Soái Triệu Công Minh
天元台=Thiên Nguyên Đài
天璇师姐=Thiên Toàn sư tỷ
太乘长老=Thái Thừa trưởng lão
铁柱观洞天=Thiết Trụ Quan động thiên
天蓬长老=Thiên Bồng trưởng lão
五丁都司=Ngũ Đinh Đô Tư
高刁北翁=Cao Điêu Bắc Ông
曹元升=Tào Nguyên Thăng
纯阳道心=Thuần Dương Đạo Tâm
钁天大斧=Quắc Thiên Đại Phủ
斩鬼五形=Trảm Quỷ Ngũ Hình
羊铃=Dương Linh
宇道=Vũ Đạo
直达天听=Trực Đạt Thiên Thính
公孙寿=Công Tôn Thọ
公孙太乘=Gongsun Taicheng
曹易玄=Cao Dịch Huyền
黄龙变=Hoàng Long Biến
太素剑=Thái Tố Kiếm
阴符七术=Âm Phù Thất Thuật
散势法鸷鸟=Tán Thế Pháp Trĩ Điểu
盛神法五龙=Thịnh Thần Pháp Ngũ Long
分威法伏熊=Phân Uy Pháp Phục Hùng
养志法灵龟=Dưỡng Chí Pháp Linh Quy
转圆法猛兽=Chuyển Viên Pháp Mãnh Thú
损兑法灵蓍=Tổn Đoái Pháp Linh Thi
希夷剑诀=Hy Di Kiếm Quyết
折花手=Chiết Hoa Thủ
乙巳占=Ất Tị Chiêm
金堤之战=Kim Đê Chi Chiến
天水峡=Thiên Thủy Hạp
烈山茶=Liệt Sơn trà
北辰星=Bắc Thần tinh
北辰辨=Bắc Thần Biện
三省吾身=Tam Tỉnh Ngô Thân
舞雩=Vũ Vu
格物天弓=Cách Vật Thiên Cung
文虚道人=Văn Hư Đạo Nhân
九幽之神=Cửu U Chi Thần
姬氏诸王=Cơ thị chư vương
阳锋=Dương Phong
于琴弦=Vu Cầm Huyền
太平之战=Thái Bình chi chiến
北小年=Bắc Tiểu Niên
姬博古=Cơ Bác Cổ
八景山=Bát Cảnh Sơn
娄云青=Lâu Vân Thanh
天暴星=Thiên Bạo Tinh
广阳郡=Quảng Dương Quận
天元洞天=Thiên Nguyên Động Thiên
太上长老公孙鞅=Thái Thượng Trưởng Lão Công Tôn Ưởng
应龙道器=Ứng Long Đạo Khí
风坟=Phong Phần
杀贼=Sát Tặc
心魔秘剑=Tâm Ma Bí Kiếm
正定印=Chính Định Ấn
近道宗师=Cận Đạo Tông Sư
天地人神四盘=Thiên Địa Nhân Thần Tứ Bàn
南方天帝=Nam Phương Thiên Đế
白莲菩萨=Bạch Liên Bồ Tát
蓬安郡=Bồng An quận
五浊之剑=Ngũ Trược Chi Kiếm
神火弩=Thần Hỏa Nỗ
蓬安全郡=Bồng An Toàn Quận
玉枢雷=Ngọc Xu Lôi
太昊镜=Thái Hạo Kính
天君·公孙弃=Thiên Quân - Công Tôn Khí
先天风炁=Tiên Thiên Phong Khí
先天火炁=Tiên Thiên Hỏa Khí
先天山炁=Tiên Thiên Sơn Khí
紫微天府=Tử Vi Thiên Phủ
先天八景功=Tiên Thiên Bát Cảnh Công
先天乾坤功=Tiên Thiên Càn Khôn Công
东林县=Đông Lâm Huyện
五莲之体=Ngũ Liên Chi Thể
龙须白虎=Long Tu Bạch Hổ
白莲圣母菩萨（八部天龙广力菩萨）=Bạch Liên Thánh Mẫu Bồ Tát
玄门三清派=Huyền Môn Tam Thanh Phái
西乡郡=Tây Hương Quận
卢川郡=Lô Xuyên Quận
岐山姜家=Kỳ Sơn Khương Gia
佛狱业印=Phật Ngục Nghiệp Ấn
神门峰=Thần Môn Phong
渊兮·用不盈=Uyên Hề · Dụng Bất Doanh
三十六柄天罡刀=Ba mươi sáu thanh Thiên Cương Đao
文殊一脉=Văn Thù Nhất Mạch
惠岸行者木吒=Huệ Ngạn Hành Giả Mộc Tra
浩浩长风=Hạo Hạo Trường Phong
瀚海沧溟=Hãn Hải Thương Minh
殷师叔祖=Ân sư thúc tổ
舍卫国=Xá Vệ quốc
祗树给孤独园=Kỳ Thụ Cấp Cô Độc Viên
天疏=Thiên Sơ
广元师弟=Quảng Nguyên sư đệ
云衣=Vân Y
云华天女=Vân Hoa Thiên Nữ
二郎神·杨戬=Nhị Lang Thần - Dương Tiễn
司法天神·杨戬=Tư Pháp Thiên Thần - Dương Tiễn
戮天吴=Lục Thiên Ngô
有穷=Hữu Cùng
军荼利明王菩萨=Quân Trà Lợi Minh Vương Bồ Tát
川主=Xuyên Chủ
赵二郎=Triệu Nhị Lang
玄甲墨扇=Huyền Giáp Mặc Phiến
蹴鞠神=Xúc Cúc Thần
龙城录=Long Thành Lục
九幽素女=Cửu U Tố Nữ
莲华印诀=Liên Hoa Ấn Quyết
黄龙法身=Hoàng Long Pháp Thân
西华妙真玄气=Tây Hoa Diệu Chân Huyền Khí
甘露太子=Cam Lộ Thái Tử
琉璃炽盛=Lưu Ly Sí Thịnh
三昧耶印=Tam Muội Da Ấn
龙蛇体=Long Xà Thể
六丁六甲符=Lục Đinh Lục Giáp Phù
五丁开山符=Ngũ Đinh Khai Sơn Phù
游神慑鬼符=Du Thần Nhiếp Quỷ Phù
天府云波符=Thiên Phủ Vân Ba Phù
姜姓申氏=Khương Tính Thân Thị
乱神咒=Loạn Thần Chú
西天大雷音寺=Tây Thiên Đại Lôi Âm Tự
天仙·白云子=Thiên Tiên · Bạch Vân Tử
惠岸行者·木吒=Huệ Ngạn Hành Giả · Mộc Tra
甘露太子·金吒=Cam Lộ Thái Tử · Kim Tra
赵玄坛=Triệu Huyền Đàn
广乘观主=Quảng Thừa Quan Chủ
六景=Lục Cảnh
天地二景=Thiên Địa Nhị Cảnh
阳形日=Dương Hình Nhật
屠龙师伯=Đồ Long Sư Bá
尚卡秋=Thượng Tạp Thu
日月二神=Nhật Nguyệt Nhị Thần
无相转轮=Vô Tướng Chuyển Luân
大乘魔掌=Đại Thừa Ma Chưởng
勾招法=Câu Chiêu Pháp
荡魔真气=Đãng Ma Chân Khí
罗睺障月=La Hầu Chướng Nguyệt
八邪秽世=Bát Tà Uế Thế
黑天之甲=Hắc Thiên Chi Giáp
奶奶的因果集=Nãi nãi đích nhân quả tập
三品·大自在天道果=Tam phẩm · Đại Tự Tại Thiên Đạo Quả
清虚道德天尊=Thanh Hư Đạo Đức Thiên Tôn
广陵道人=Quảng Lăng đạo nhân
玉虚关=Ngọc Hư Quan
都天大灵官=Đô Thiên Đại Linh Quan
王去恶=Vương Khứ Ác
玉枢火府天将=Ngọc Xu Hỏa Phủ Thiên Tướng
三五火车雷公=Tam Ngũ Hỏa Xa Lôi Công
玄门两大气刃=Huyền Môn Lưỡng Đại Khí Nhận
天罡刀=Thiên Cương Đao
元经会=Nguyên Kinh Hội
姬承业=Cơ Thừa Nghiệp
东林之战=Đông Lâm Chi Chiến
雍州之战=Ung Châu Chi Chiến
火云殿=Hỏa Vân Điện
先天金炁=Tiên Thiên Kim Khí
梁州西边=Lương Châu Tây biên
巨灵胡=Cự Linh Hồ
雷法枢机=Lôi Pháp Xu Cơ
燕寒清=Yến Hàn Thanh
雍梁=Ung Lương
瘟癀昊天大帝=Ôn Hoảng Hạo Thiên Đại Đế
天蓬神咒=Thiên Bồng Thần Chú
九天应元普化天尊=Cửu Thiên Ứng Nguyên Phổ Hóa Thiên Tôn
姜氏家主=Gia chủ Khương thị
太宰令=Thái Tể Lệnh
林奇然=Lâm Kỳ Nhiên
于安=Vu An
天下三剑=Thiên Hạ Tam Kiếm
太平教尊=Thái Bình Giáo Tôn
中黄太一=Trung Hoàng Thái Nhất
千里之地=Thiên Lí Chi Địa
潺亭=Sàn Đình
铁甲神雷=Thiết Giáp Thần Lôi
九天十地十九神魔=Cửu Thiên Thập Địa Thập Cửu Thần Ma
道兵巨灵神=Đạo Binh Cự Linh Thần
上清派掌门=Thượng Thanh Phái Chưởng Môn
道仙后=Đạo Tiên Hậu
潺亭县=Sàn Đình Huyện
宗经=Tông Kinh
东方忌=Đông Phương Kỵ
九虫诀=Cửu Trùng Quyết
纯阳祖师=Thuần Dương Tổ Sư
纯阳剑仙=Thuần Dương Kiếm Tiên
啸命风雷=Khiếu Mệnh Phong Lôi
元经=Nguyên Kinh
梁州大鼎=Lương Châu Đại Đỉnh
毕方妖神=Tất Phương Yêu Thần
雷神电母=Lôi Thần Điện Mẫu
三清派=Tam Thanh Phái
三皇派=Tam Hoàng Phái
上神都=Thượng Thần Đô
公羊学派=Công Dương Học Phái
于潺亭县=Vu Sằn Đình Huyện
潺亭城=Sầm Đình Thành
巨灵胡神通·【擘山分河】=Cự Linh Hồ Thần Thông · [Bách Sơn Phân Hà]
五岳之形=Ngũ Nhạc Chi Hình
震雷之相=Chấn Lôi Chi Tướng
禹步大统摄雷=Vũ Bộ Đại Thống Nhiếp Lôi
铁柱观=Thiết Trụ Quan
瘟癀阵=Ôn Hoằng Trận
五雷都司=Ngũ Lôi Đô Tư
天心正法=Thiên Tâm Chính Pháp
靖平=Tĩnh Bình
修凡=Tu Phàm
怀远侯=Hoài Viễn Hầu
姬明方=Cơ Minh Phương
西华妙真=Tây Hoa Diệu Chân
玄冥真道=Huyền Minh Chân Đạo
先天坎离水火=Tiên Thiên Khảm Ly Thủy Hỏa
天罡九节杖=Thiên Cương Cửu Tiết Trượng
黄天之目=Hoàng Thiên Chi Mục
罡斗神雷=Cương Đấu Thần Lôi
太乐令明少微=Thái Nhạc Lệnh Minh Thiếu Vi
东林城=Đông Lâm Thành
龙伯巨人=Long Bá Cự Nhân
魏元舒=Ngụy Nguyên Thư
姜家主=Khương Gia Chủ
岳陵城=Nhạc Lăng Thành
靖平军=Tĩnh Bình Quân
苍天化身=Thương Thiên Hóa Thân
燕国地图=Yến Quốc Địa Đồ
八十一郡=Bát Thập Nhất Quận
朱雀楼=Chu Tước Lâu
天君公孙弃=Thiên Quân Công Tôn Khí
九州八十一郡=Cửu Châu Bát Thập Nhất Quận
钟无期=Chung Vô Kỳ
孟云帆=Mạnh Vân Phàm
帝颛顼=Đế Chuyên Húc
吕忘机=Lữ Vong Cơ
姜无明=Khương Vô Minh
羽流=Vũ Lưu
大荒东经=Đại Hoang Đông Kinh
三相化生妙法=Tam Tương Hóa Sinh Diệu Pháp
首山赤铜=Thủ Sơn Xích Đồng
形坟·土形山=Hình Phần · Thổ Hình Sơn
气坟·山气止=Khí Phần · Sơn Khí Chỉ
山兮·鬼神惊=Sơn Hề · Quỷ Thần Kinh
蚩尤氏=Xi Vưu Thị
太平教四神=Thái Bình Giáo Tứ Thần
都天生煞=Đô Thiên Sinh Sát
杨殛=Dương Tắc
雨师符诏=Vũ Sư Phù Chiếu
伏羲大神=Phục Hy Đại Thần
关武阳=Quan Vũ Dương
三垣二十八宿=Tam Viên Nhị Thập Bát Tú
凤凰变=Phượng Hoàng Biến
五炁星君=Ngũ Khí Tinh Quân
凤凰印=Phượng Hoàng Ấn
先天真身=Tiên Thiên Chân Thân
金霞冠=Kim Hà Quan
担山赶日=Đảm Sơn Cản Nhật
寰宇昭空阵=Hoàn Vũ Chiêu Không Trận
烛龙道果=Chúc Long Đạo Quả
弥罗妙境=Di La Diệu Cảnh
朱雀华裳=Chu Tước Hoa Thường
跪火莲=Quỳ Hỏa Liên
乾形天=Càn Hình Thiên
水形川=Thủy Hình Xuyên
雨形云=Vũ Hình Vân
风形气=Phong Hình Khí
震天箭=Chấn Thiên Tiễn
射蛟台=Xạ Giao Đài
九天荡魔真气=Cửu Thiên Đãng Ma Chân Khí
姜氏族地=Khương thị tộc địa
衔雨=Hàm Vũ
天权殿=Thiên Quyền Điện
摇光殿=Dao Quang Điện
蚩尤相=Xi Vưu Tướng
地祇神域=Địa Kỳ Thần Vực
实意法螣蛇=Thực Ý Pháp Đằng Xà
姜洛=Khương Lạc
姜炀=Khương Dương
太微玄术=Thái Vi Huyền Thuật
北斗九皇=Bắc Đẩu Cửu Hoàng
护法天璇=Hộ Pháp Thiên Toàn
万星袍=Vạn Tinh Bào
星辰寰宇=Tinh Thần Hoàn Vũ
借形代果符=Tá Hình Đại Quả Phù
九如袈裟=Cửu Như Ca Sa
何罗神=Hà La Thần
广乘师兄=Quảng Thừa sư huynh
玄冥神通=Huyền Minh Thần Thông
器阁=Khí Các
天璇长老=Thiên Toàn Trưởng Lão
神农姜氏=Thần Nông Khương Thị
神农百草丹=Thần Nông Bách Thảo Đan
与愿印=Dữ Nguyện Ấn
昊天镜碎片=Hạo Thiên Kính Toái Phiến
天下第一搅屎棍=Thiên Hạ Đệ Nhất Giảo Thỉ Côn
无生佛=Vô Sinh Phật
金刚力士=Kim Cương Lực Sĩ
靖阳军=Tĩnh Dương Quân
孟修凡=Mạnh Tu Phàm
西昆虚=Tây Côn Khư
姜别鹤=Khương Biệt Hạc
青木小树=Tiểu Thụ Thanh Mộc
七杀星辰=Thất Sát Tinh Thần
水伯天吴=Thủy Bá Thiên Ngô
遁甲阵势=Độn Giáp Trận Thế
帝坐命库=Đế Tọa Mệnh Khố
金舆扶辇=Kim Dư Phù Liễn
素箭=Tố Tiễn
贯天恸日=Quán Thiên Thống Nhật
大宇轮转=Đại Vũ Luân Chuyển
众星法域=Chúng Tinh Pháp Vực
天星遁法=Thiên Tinh Độn Pháp
无为先生=Vô Vi tiên sinh
后天人种袋=Hậu Thiên Nhân Chủng Túi
姜逐云=Khương Trục Vân
万佛窟=Vạn Phật Quật
东胜大神洲=Đông Thắng Đại Thần Châu
灵台方寸祖=Linh Đài Phương Thốn Tổ
烈山袍=Liệt Sơn Bào
转轮菩萨=Chuyển Luân Bồ Tát
六耳神通=Lục Nhĩ Thần Thông
他化自在天主=Tha Hóa Tự Tại Thiên Chủ
应龙变=Ứng Long Biến
有穷后羿=Hữu Cùng Hậu Nghệ
炎帝烈血=Viêm Đế Liệt Huyết
姜其中=Khương Kỳ Trung
有穷夷羿=Hữu Cung Di Nghệ
天王神像=Thiên Vương Thần Tượng
长阿含经=Trường A Hàm Kinh
日月天子=Nhật Nguyệt Thiên Tử
佛狱第四王=Phật Ngục Đệ Tứ Vương
阿修罗王非天=A Tu La Vương Phi Thiên
阿修罗王罗睺=A Tu La Vương La Hầu
金刚手菩萨=Kim Cương Thủ Bồ Tát
天子魔=Thiên Tử Ma
夔鼓=Khuy Cổ
非天=Phi Thiên
灵感寺=Linh Cảm Tự
鼎湖天璇=Đỉnh Hồ Thiên Toàn
萧西涯=Tiêu Tây Nhai
巫抵=Vu Để
姜氏祖地=Khương Thị Tổ Địa
广元道长=Quảng Nguyên Đạo Trưởng
天之刃=Thiên Chi Nhận
天照道果=Thiên Chiếu Đạo Quả
阎浮檀紫摩金色=Diêm Phù Đàn Tử Ma Kim Sắc
八部天龙广力菩萨=Bát Bộ Thiên Long Quảng Lực Bồ Tát
菩提萨埵=Bồ Đề Tát Đỏa
天魅真身=Thiên Mị Chân Thân
三位大士=Tam Vị Đại Sĩ
王云蓝=Vương Vân Lam
乙巳年=Ất Tỵ Niên
庚辰月=Canh Thìn Nguyệt
辛未日=Tân Vị Nhật
江鸣=Giang Minh
岐山县=Kỳ Sơn Huyện
金刚藏=Kim Cương Tàng
大行山脉=Đại Hành Sơn Mạch
盗版猴=Khỉ nhái
洪好古=Hồng Hảo Cổ
姜流光=Khương Lưu Quang
水火锋=Thủy Hỏa Phong
八卦紫绶衣=Bát Quái Tử Thụ Y
光聚佛顶印=Quang Tụ Phật Đỉnh Ấn
般若剑=Bát Nhã Kiếm
天志剑=Thiên Chí Kiếm
金仙·赤精子=Kim Tiên - Xích Tinh Tử
太平教主=Thái Bình Giáo Chủ
无生佛友=Vô Sinh Phật Hữu
白毛猿猴=Bạch Mao Viên Hầu
大兴郡=Đại Hưng Quận
风兮·破地=Phong hề · Phá Địa
大日笼御=Đại Nhật Lung Ngự
无涯不及=Vô Nhai Bất Cập
火兮·焚野=Hỏa hề · Phần Dã
雷兮·天地碎=Lôi hề · Thiên Địa Toái
裂天之境=Liệt Thiên Chi Cảnh
断生矛=Đoạn Sinh Mâu
华山论键=Hoa Sơn luận kiếm
二品道果=Nhị Phẩm Đạo Quả
菩萨乘=Bồ Tát Thừa
阿逸多=A Dật Đa
南无大日如来毗卢遮那佛=Nam Mô Đại Nhật Như Lai Tỳ Lô Giá Na Phật
九黎寰空禁法=Cửu Lê Hoàn Không Cấm Pháp
白帝白招拒=Bạch Đế Bạch Chiêu Cự
火神·重黎=Hỏa Thần · Trọng Lê
帝高阳=Đế Cao Dương
五炁真君=Ngũ Khí Chân Quân
火府星=Hỏa Phủ Tinh
万木朝春=Vạn Mộc Triều Xuân
荧惑守心=Huỳnh Hoặc Thủ Tâm
大皇子姬承天=Đại Hoàng Tử Cơ Thừa Thiên
羽流姑姑=Vũ Lưu cô cô
老太尉=Lão Thái Úy
姜逐流=Khương Trục Lưu
先天八炁=Tiên Thiên Bát Khí
风后罗盘=Phong Hậu La Bàn
风后奇门=Phong Hậu Kỳ Môn
三奇六仪=Tam Kỳ Lục Nghi
首创种桑养蚕=Thủ Sáng Chủng Tang Dưỡng Tằm
先蚕神=Tiên Tằm Thần
三煞位=Tam Sát Vị
明少微=Minh Thiếu Vi
朱雀法坛=Chu Tước pháp đàn
七尊神将=Thất Tôn Thần Tướng
般若慧剑=Bát Nhã Huệ Kiếm
金乌遗骨=Kim Ô Di Cốt
姬承天=Cơ Thừa Thiên
太官令=Thái Quan Lệnh
封禅剑法=Phong Thiện Kiếm Pháp
以元经会=Dĩ Nguyên Kinh Hội
军神四兵=Quân Thần Tứ Binh
气坟·时乘六龙=Khí phần - Thời thừa Lục Long
形坟·阳形日=Hình phần - Dương hình Nhật
血荐轩辕=Huyết tiến Hiên Viên
至人之心=Chí Nhân Chi Tâm
姜离王=Khương Ly Vương
《气坟》=《Khí Phần》
朱翼=Chu Dực
太卜令姬远=Thái Bốc Lệnh Cơ Viễn
应龙法身=Ứng Long Pháp Thân
应龙真身=Ứng Long Chân Thân
天魅真神=Thiên Mị Chân Thần
大乘教=Đại Thừa Giáo
《梦中斩龙》=《Mộng Trung Trảm Long》
《阴符经》=《Âm Phù Kinh》
朝华阁=Triều Hoa Các
文帝钱=Văn Đế Tiền
羲和道果=Nghi Hòa đạo quả
寒浞道果=Hàn Trạc đạo quả
碎日天冰箭=Toái Nhật Thiên Băng tiễn
金乌道果=Kim Ô đạo quả
太微赋=Thái Vi Phú
太阳居午，日丽中天=Thái Dương Cư Ngọ, Nhật Lệ Trung Thiên
紫微天府，辅弼之功=Tử Vi Thiên Phủ, Phụ Bật Chi Công
龙王赘婿=Long Vương tế tế
朱雀道果=Chu Tước đạo quả
青龙道果=Thanh Long đạo quả
烈山殿=Liệt Sơn Điện
东华宝树=Đông Hoa Bảo Thụ
司空姜离=Tư Không Khương Ly
三相化生=Tam Tương Hóa Sinh
日母=Nhật Mẫu
羲和玉璧=Hi Hòa Ngọc Bích
老君观=Lão Quân Quan
魔波旬=Ma Ba Tuần
八正城=Bát Chính Thành
四大阿修罗王=Tứ Đại A Tu La Vương
赤衣僧人=Hồng y tăng nhân
无生老母大士=Vô Sinh Lão Mẫu Đại Sĩ
西华镜=Tây Hoa Kính
姜氏主家=Khương thị chủ gia
姜逐阳=Khương Trục Dương
齐天大圣孙悟空=Tề Thiên Đại Thánh Tôn Ngộ Không
四海朝元阵=Tứ Hải Triều Nguyên Trận
金毛猴子=Kim Mao Hầu Tử
三大劫法=Tam Đại Kiếp Pháp
七佛灭罪真言=Thất Phật Diệt Tội Chân Ngôn
未来星宿劫法=Vị Lai Tinh Tú Kiếp Pháp
五道轮回=Ngũ đạo luân hồi
九黎寰空=Cửu Lê Hoàn Không
裂天玄境=Liệt Thiên Huyền Cảnh
蚩尤三盘=Xi Vưu Tam Bàn
都天凝相=Đô Thiên Ngưng Tướng
幽冥之天=U Minh Chi Thiên
九索=Cửu Tác
五道将军姬玄通=Ngũ Đạo Tướng Quân Cơ Huyền Thông
五道将军=Ngũ Đạo Tướng Quân
幽都大罗掌=U Đô Đại La Chưởng
姬玄通=Cơ Huyền Thông
日御·羲和=Nhật Ngự · Hi Hòa
禄存星=Lộc Tồn Tinh
珈蓝宝树=Già Lam Bảo Thụ
僧邸佛钟=Tăng Để Phật Chung
舍祭城=Xá Tế Thành
申侯道长=Thân Hầu Đạo Trưởng
龙渊湖=Long Uyên Hồ
龙宫海神=Long Cung Hải Thần
天权长老=Trưởng lão Thiên Quyền
八峰山=Bát Phong Sơn
上清凌虚子=Thượng Thanh Lăng Hư Tử
五兵=Ngũ Binh
道莅天下，其鬼不神=Đạo Lệ Thiên Hạ, Kỳ Quỷ Bất Thần
天龙八峰=Thiên Long Bát Phong
第四王=Đệ Tứ Vương
广目城=Quảng Mục Thành
善乐城=Thiện Lạc Thành
云九夜=Vân Cửu Dạ
九华寺=Cửu Hoa Tự
白莲圣母菩萨=Bạch Liên Thánh Mẫu Bồ Tát
大菩萨·地藏=Đại Bồ Tát Địa Tạng
《佛说力士移山经》=《Phật Thuyết Lực Sĩ Di Sơn Kinh》
涅槃寂静=Niết Bàn Tịch Tĩnh
金刚藏菩萨=Kim Cương Tạng Bồ Tát
他化自在六天=Tha Hóa Tự Tại Lục Thiên
天兮·堕乾坤=Thiên Hề · Đọa Càn Khôn
九州版图=Cửu Châu Bản Đồ
佛土空间=Không gian Phật thổ
莲华圣耀=Liên Hoa Thánh Diệu
菩萨不灭体=Bồ Tát Bất Diệt Thể
三十三相·龙头观音=Tam Thập Tam Tướng · Long Đầu Quan Âm
金刚九会曼荼罗·三昧耶会=Kim Cương Cửu Hội Mạn Đà La · Tam Muội Da Hội
黄帝四相=Hoàng Đế Tứ Tướng
六仪八卦=Lục Nghi Bát Quái
一气化三千=Nhất Khí Hóa Tam Thiên
庄周道果=Trang Chu Đạo Quả
太素之剑=Thái Tố Chi Kiếm
无面天君=Vô Diện Thiên Quân
阴阳三才=Âm Dương Tam Tài
太上炼魔=Thái Thượng Luyện Ma
玄穹高上玉皇大帝=Huyền Khung Cao Thượng Ngọc Hoàng Đại Đế
长空万里，剑荡山河=Trường Không Vạn Lý, Kiếm Đãng Sơn Hà
万化生乎身=Vạn Hóa Sinh Hồ Thân
龙头观音=Long Đầu Quan Âm
琉璃观音=Lưu Ly Quan Âm
杨柳观音=Dương Liễu Quan Âm
鱼篮观音=Ngư Lam Quan Âm
一如观音=Nhất Như Quan Âm
不二观音=Bất Nhị Quan Âm
青木古树=Thanh Mộc Cổ Thụ
迷者=Mê Giả
广力=Quảng Lực
月净=Nguyệt Tịnh
高阳氏=Cao Dương Thị
大荒西经=Đại Hoang Tây Kinh
摇光长老=Dao Quang Trưởng Lão
开阳长老关武阳=Khai Dương trưởng lão Quan Vũ Dương
宝极洞天=Bảo Cực Động Thiên
楼双影=Lâu Song Ảnh
和业如来=Hòa Nghiệp Như Lai
波旬真灵=Ba Tuần Chân Linh
夏至日=Hạ Chí Nhật
素华宫=Tố Hoa Cung
晦庵先生=Hối Am tiên sinh
申侯道人=Thân Hầu đạo nhân
皇城轩辕台=Hoàng thành Hiên Viên Đài
中天北极紫微大帝=Trung Thiên Bắc Cực Tử Vi Đại Đế
昭元郡主=Chiêu Nguyên quận chúa
佛国灵台山=Phật Quốc Linh Đài Sơn
轩辕台洞天=Hiên Viên Đài Động Thiên
朱雀殿=Chu Tước Điện
神农之相=Thần Nông chi tướng
宗正姬长风=Tông Chính Cơ Trường Phong
太尉孟钧=Thái Úy Mạnh Quân
姜韬=Khương Thao
龙华树=Cây Long Hoa
圣莲卍化=Thánh Liên Vạn Hóa
弥勒道果=Di Lặc Đạo Quả
金光神咒=Kim Quang Thần Chú
穹荒青龙旗=Khung Hoang Thanh Long Kỳ
九宫乾天=Cửu Cung Càn Thiên
八极坤地=Bát Cực Khôn Địa
日御羲和=Nhật Ngự Hi Hòa
六龙之车=Lục Long chi xa
器阁长老=Khí Các trưởng lão
东平王=Đông Bình Vương
洪郡=Hồng Quận
开阳星君=Khai Dương Tinh Quân
厉罡天斩=Lệ Cương Thiên Trảm
水兮·滔天=Thủy Hề·Thao Thiên
玄武之御=Huyền Vũ chi Ngự
禹王道果=Vũ Vương Đạo Quả
太昊庖羲氏=Thái Hạo Bào Hy Thị
天之相=Thiên Chi Tướng
觉者会=Giác Giả Hội
玉帝老儿=Ngọc Đế Lão Nhi
宇空之法=Vũ Không Chi Pháp
修罗鬼面=Tu La Quỷ Diện
巫真=Vu Chân
阴象冬=Âm Tượng Đông
黄天之眼=Hoàng Thiên Chi Nhãn
崇山君=Sùng Sơn Quân
烈山民=Liệt Sơn Dân
潜山阴=Tiềm Sơn Âm
通闻符=Thông Văn Phù
勾陈上宫天皇大帝=Câu Trần Thượng Cung Thiên Hoàng Đại Đế
姜司空=Khương Tư Không
三清元神=Tam Thanh Nguyên Thần
太无=Thái Vô
玉虚开天剑=Ngọc Hư Khai Thiên Kiếm
矩子墨玄空=Củ Tử Mặc Huyền Không
金风玉露掌=Kim Phong Ngọc Lộ Chưởng
玉清道气=Ngọc Thanh Đạo Khí
天皇宝诰=Thiên Hoàng Bảo Cáo
紫微宸极=Tử Vi Thần Cực
九光宝苑=Cửu Quang Bảo Uyển
五炁玄都=Ngũ Khí Huyền Đô
至心皈命礼=Chí Tâm Quy Mệnh Lễ
潜渊缩地=Tiềm Uyên Súc Địa
勾陈真灵=Câu Trần Chân Linh
勾陈六星=Câu Trần Lục Tinh
太极之炁=Thái Cực Chi Khí
殁神戟=Một Thần Kích
灭元殳=Diệt Nguyên Thù
戮亡戈=Lục Vong Qua
灭生矛=Diệt Sinh Mâu
风雨雷电四神=Phong Vũ Lôi Điện Tứ Thần
众星法界=Chúng Tinh Pháp Giới
金仙·毗芦仙=Kim Tiên · Tỳ Lư Tiên
九黎寰空界法=Cửu Lê Hoàn Không Giới Pháp
刑囚夹印，刑杖惟司=Hình Tù Giáp Ấn, Hình Trượng Duy Tư
正是本宫=Chính Thị Bản Cung
七杀廉贞，路上埋尸=Thất Sát Liêm Trinh, Lộ Thượng Mai Thi
太阴居子，水澄桂萼=Thái Âm Cư Tử, Thủy Trừng Quế Ngạc
板角青牛=Bản Giác Thanh Ngưu
剑斩天机=Kiếm Trảm Thiên Cơ
三洞=Tam Động
三洞之元=Tam Động Chi Nguyên
庚金不灭剑体=Canh Kim Bất Diệt Kiếm Thể
勾陈道果=Câu Trần Đạo Quả
广明道人=Quảng Minh đạo nhân
文殊大士=Văn Thù đại sĩ
白虎道果=Bạch Hổ đạo quả
东平郡王=Đông Bình quận vương
梁州牧=Lương Châu Mục
雍州牧=Ung Châu Mục
十九神魔=Thập Cửu Thần Ma
三山之地=Tam Sơn chi địa
断天峡=Đoạn Thiên Hạp
地空=Địa Không
截空=Tiệt Không
旬空=Tuần Không
庚金剑芒=Canh Kim Kiếm Mang
龙甲神章=Long Giáp Thần Chương
旱神掌=Hạn Thần Chưởng
火焚穹霄=Hỏa Phần Khung Tiêu
红葫芦=Hồng Hồ Lô
谈无言=Đàm Vô Ngôn
开阳武曲=Khai Dương Vũ Khúc
道莅天下=Đạo Lệ Thiên Hạ
东华古树=Đông Hoa Cổ Thụ
如来不毁真身=Như Lai Bất Hủy Chân Thân
大常=Đại Thường
奢龙=Xa Long
大封=Đại Phong
大圜剑=Đại Hoàn Kiếm
太素之炁=Thái Tố Chi Khí
齐物与一=Tề Vật Dữ Nhất
通天灵剑=Thông Thiên Linh Kiếm
纯阳道祖=Thuần Dương Đạo Tổ
神阙天眼=Thần Khuyết Thiên Nhãn
黄帝六相=Hoàng Đế Lục Tướng
刑德=Hình Đức
黄天真身=Hoàng Thiên Chân Thân
一炁化三皇=Nhất Khí Hóa Tam Hoàng
鱼妇=Ngư Phụ
弥勒童子=Di Lặc Đồng Tử
姜蜀黍=Khương Thục Thúc
三尸咒·邪罗灭元=Tam Thi Chú - Tà La Diệt Nguyên
大日如来金刚印=Đại Nhật Như Lai Kim Cang Ấn
龙华宝树=Long Hoa Bảo Thụ
黄天法相=Hoàng Thiên Pháp Tướng
墨辩=Mặc Biện
姬温=Cơ Ôn
圣婴大王=Thánh Anh Đại Vương
太素之身=Thái Tố Chi Thân
广乘=Quảng Thừa
魔祖波旬=Ma Tổ Ba Tuần
姬素云=Cơ Tố Vân
黄眉大王=Hoàng Mi Đại Vương
西行路=Tây Hành Lộ
论剑海=Luận Kiếm Hải
东昆虚=Đông Côn Khư
商剑陵=Thương Kiếm Lăng
靖阳君=Tĩnh Dương Quân
《蚩尤三盘经》=《Xi Vưu Tam Bàn Kinh》
宙光逆转=Trụ Quang nghịch chuyển
天子道果=Thiên Tử Đạo Quả
应龙道果=Ứng Long Đạo Quả
公孙弃=Công Tôn Khí
刑遇贪狼=Hình Ngộ Tham Lang
辅弼夹帝=Phụ Bật Giáp Đế
青玥=Thanh Nguyệt
妘秋池=Vân Thu Trì
九黎刀经=Cửu Lê Đao Kinh
吕天蓬=Lữ Thiên Bồng
公孙羽流=Công Tôn Vũ Lưu
鲁王世子=Lỗ Vương Thế Tử
清河郡王=Thanh Hà Quận Vương
骠骑将军殷屠龙=Phiếu Kỵ Tướng Quân Ân Đồ Long
赤眉军=Xích Mi Quân
越王姬温=Việt Vương Cơ Ôn
圣德太子姬继稷=Thánh Đức Thái Tử Cơ Kế Tắc
萧秩=Tiêu Trật
圜丘台=Hoàn Khâu Đài
公孙家主=Công Tôn Gia Chủ
墨门矩子墨玄空=Mặc Môn Củ Tử Mặc Huyền Không
泰神殿=Thái Thần Điện
皇城太庙=Hoàng Thành Thái Miếu
神火九炼=Thần Hỏa Cửu Luyện
道空寰宇=Đạo Không Hoàn Vũ
造天法仪=Tạo Thiên Pháp Nghi
四姓家犬=Tứ Tính Gia Khuyển
姬继稷=Cơ Kế Tắc
张指玄=Trương Chỉ Huyền
旱神掌·如惔如焚=Hạn Thần Chưởng · Như Đàm Như Phần
少昊金天氏=Thiếu Hạo Kim Thiên Thị
军神五兵=Quân Thần Ngũ Binh
青华古树=Thanh Hoa Cổ Thụ
万仙大教=Vạn Tiên Đại Giáo
如来老儿=Như Lai Lão Nhi
玉清道统=Ngọc Thanh Đạo Thống
元始祖师=Nguyên Thủy Tổ Sư
太上老倌=Thái Thượng Lão Quán
灵山大雷音寺=Linh Sơn Đại Lôi Âm Tự
无障金刚=Vô Chướng Kim Cương
法轮印=Pháp Luân Ấn
金光佛轮=Kim Quang Phật Luân
丹虚子=Đan Hư Tử
无为洞天=Vô Vi Động Thiên
姜姓天子=Khương Tính Thiên Tử
水府星官=Thủy Phủ Tinh Quan
凌霄宝殿四大元帅=Lăng Tiêu Bảo Điện Tứ Đại Nguyên Soái
法身佛=Pháp Thân Phật
报身佛=Báo Thân Phật
应身佛=Ứng Thân Phật
中天紫微大帝=Trung Thiên Tử Vi Đại Đế
金轮炽盛光佛=Kim Luân Sí Thịnh Quang Phật
佛狱=Phật Ngục
琼宁苑=Quỳnh Ninh Uyển
姬长风=Cơ Trường Phong
姜伯维=Khương Bá Duy
随世感应仙姑=Tùy Thế Cảm Ứng Tiên Cô
雷部二十四正神=Lôi Bộ Nhị Thập Tứ Chính Thần
随世感应三仙姑=Tùy Thế Cảm Ứng Tam Tiên Cô
龙虎玄坛真君=Long Hổ Huyền Đàn Chân Quân
凌无觉=Lăng Vô Giác
乔山岛=Kiều Sơn Đảo
玉衡长老=Ngọc Hành trưởng lão
天璇殿=Thiên Tuyền Điện
开阳长老=Khai Dương trưởng lão
开阳殿=Khai Dương Điện
道法阁=Đạo Pháp Các
老万头=Lão Vạn Đầu
思返谷=Tư Phản Cốc
东阳长公主=Đông Dương Trưởng Công Chúa
姜氏天子=Khương Thị Thiên Tử
天女魃=Thiên Nữ Bạt
天枢殿=Thiên Xu Điện
上清洞天=Thượng Thanh Động Thiên
天玑长老=Thiên Cơ trưởng lão
荆扬之地=Kinh Dương Chi Địa
太史令萧秩=Thái Sử Lệnh Tiêu Trật
尚贤宫=Thượng Hiền Cung
东王公道果=Đông Vương Công Đạo Quả
天子玉玺=Thiên Tử Ngọc Tỉ
兵主蚩尤=Binh Chủ Xi Vưu
徐徐飞来的青木古树=Cổ Thụ Thanh Mộc từ từ bay đến
昆虚仙宫=Côn Khư Tiên Cung
阴律司=Âm Luật Tư
陶钧万物=Đào Quân Vạn Vật
五浊恶气=Ngũ Trọc Ác Khí
冬神=Đông Thần
九元岛=Cửu Nguyên Đảo
四宫主=Tứ Cung Chủ
东海分水将军=Đông Hải Phân Thủy Tướng Quân
皇城大明殿=Hoàng Thành Đại Minh Điện
暝晦视明·天地双沉=Minh Hối Thị Minh·Thiên Địa Song Trầm
黄帝四面=Hoàng Đế Tứ Diện
重阳全真开化真君=Trùng Dương Toàn Chân Khai Hóa Chân Quân
日母·羲和=Nhật Mẫu · Hi Hòa
虚日星官=Hư Nhật Tinh Quan
炎帝真灵=Viêm Đế Chân Linh
开化万天=Khai Hóa Vạn Thiên
朕即国家=Trẫm Tức Quốc Gia
姬道阳=Cơ Đạo Dương
药师袈裟=Dược Sư Ca Sa
东方药师琉璃光王如来=Đông Phương Dược Sư Lưu Ly Quang Vương Như Lai
玉皇道果=Ngọc Hoàng Đạo Quả
无佛寺=Vô Phật Tự
大明殿=Đại Minh Điện
冲虚真人·列子=Trùng Hư Chân Nhân · Liệt Tử
重阳全真开化真君·王重阳=Trùng Dương Toàn Chân Khai Hóa Chân Quân · Vương Trùng Dương
上仙·吕洞宾=Thượng Tiên · Lã Động Tân
纯阳帝君=Thuần Dương Đế Quân
蒙脱石散=Montmorillonit
牢姜=Lao Khương
曦贵妃=Hi Quý Phi
南明阁=Nam Minh Các
南天司=Nam Thiên Tư
太岁神=Thái Tuế Thần
龙渊阁=Long Uyên Các
燃灯如来=Nhiên Đăng Như Lai
转轮铳=Chuyển Luân Súng
万里荒漠=Vạn Lí Hoang Mạc
天魔波旬=Thiên Ma Ba Tuần
喷射战士=Splatoon
金刚界=Kim Cương Giới
不空光明遍照=Bất Không Quang Minh Biến Chiếu
十二药叉=Thập Nhị Dược Xoa
月宫永德=Nguyệt Cung Vĩnh Đức
连山阳=Liên Sơn Dương
藏山兵=Tàng Sơn Binh
迭山象=Điệt Sơn Tượng
暝晦视明=Minh Hối Thị Minh
兼山物=Kiêm Sơn Vật
物阳火=Vật Dương Hỏa
先天西华=Tiên Thiên Tây Hoa
西华妙气=Tây Hoa Diệu Khí
先天西华妙气=Tiên Thiên Tây Hoa Diệu Khí
后土皇地祗=Hậu Thổ Hoàng Địa Kỳ
三如来=Tam Như Lai
天人共尊=Thiên Nhân Cộng Tôn
三界亚君=Tam Giới Á Quân
星宿分野=Tinh Tú Phân Dã
太阳法相=Thái Dương Pháp Tướng
老妖精=Lão yêu tinh
朱晦庵=Chu Hối Am
昆虚雪峰=Côn Khư Tuyết Phong
天庭玉帝=Thiên Đình Ngọc Đế
昆虚山脉=Dãy núi Côn Khư
颠倒阴阳=Điên Đảo Âm Dương
广元道人=Quảng Nguyên Đạo Nhân
李伯阳=Lý Bá Dương
东方净琉璃世界=Thế giới Tịnh Lưu Ly phương Đông
金刚胎藏界=Kim Cang Thai Tạng Giới
灵台山=Linh Đài Sơn
太极天轮=Thái Cực Thiên Luân
燃灯佛=Nhiên Đăng Phật
谈无为=Đàm Vô Vi
两界十方=Lưỡng Giới Thập Phương
金刚胎藏=Kim Cương Thai Tạng
须弥化芥子=Tu Di Hóa Giới Tử
大日如来法印=Đại Nhật Như Lai Pháp Ấn
旃檀佛光=Chiên Đàn Phật Quang
金刚不坏佛=Kim Cương Bất Hoại Phật
宝光佛=Bảo Quang Phật
水天佛=Thủy Thiên Phật
红焰帝幢王佛=Hồng Diễm Đế Tràng Vương Phật
八十八佛=Tám mươi tám vị Phật
菩萨罗汉=Bồ tát La hán
太始之炁=Thái Thủy chi Khí
阴阳两极剑=Âm Dương Lưỡng Cực Kiếm
欢喜道主=Hoan Hỉ Đạo Chủ
欢喜佛法相=Hoan Hỉ Phật Pháp Tướng
欲界第六天=Dục Giới Đệ Lục Thiên
心外物化=Tâm Ngoại Vật Hóa
苦集灭道四圣谛=Khổ Tập Diệt Đạo Tứ Thánh Đế
白衣觉者=Bạch Y Giác Giả
金刚萨埵=Kim Cang Tát Đoả
佛说力士移山经=Phật Thuyết Lực Sĩ Di Sơn Kinh
阿弥陀佛法相=A Di Đà Phật Pháp Tướng
七佛灭罪=Thất Phật Diệt Tội
七邪荼黎=Thất Tà Đồ Lê
泽被万物=Trạch Bị Vạn Vật
真如居士=Chân Như Cư Sĩ
姜檀越=Khương Đàn Việt
天君姬继稷=Thiên Quân Cơ Kế Tắc
昆虚山=Côn Khư Sơn
雷泽龙神=Lôi Trạch Long Thần
神都皇城=Thần Đô Hoàng Thành
太阳神炎帝=Thái Dương Thần Viêm Đế
三州=Tam Châu
天埑=Thiên Triệt
天魅妖神=Thiên Mị Yêu Thần
百目金光=Bách Mục Kim Quang
玄暗之流=Huyền Ám Chi Lưu
玄灵七十变=Huyền Linh Thất Thập Biến
北极神数=Bắc Cực Thần Số
惑仙丹=Hoặc Tiên Đan
黑水玄流=Hắc Thủy Huyền Lưu
九州山河社稷之图=Cửu Châu Sơn Hà Xã Tắc Chi Đồ
六龙天车=Lục Long Thiên Xa
簪划天河=Trâm Hoa Thiên Hà
阴仪=Âm Nghi
恒沙诸佛=Hằng Sa Chư Phật
诸因之果=Chư Nhân Chi Quả
经天纬地图=Kinh Thiên Vĩ Địa Đồ
魔罗剑典=Ma La Kiếm Điển
天魔万化=Thiên Ma Vạn Hóa
九天荡魔真诀=Cửu Thiên Đãng Ma Chân Quyết
张道一=Trương Đạo Nhất
太白真君=Thái Bạch Chân Quân
李清涟=Lý Thanh Liêm
风氏始祖=Phong Thị Thủy Tổ
羲皇道果=Hy Hoàng Đạo Quả
风氏一族=Phong Thị Nhất Tộc
冲虚堪道=Xung Hư Kham Đạo
末法天尊=Mạt Pháp Thiên Tôn
因果集=Nhân Quả Tập
东海郡王=Đông Hải Quận Vương
长公主姬陵光=Trưởng công chúa Cơ Lăng Quang
公孙皇后=Công Tôn Hoàng Hậu
南离宫=Nam Ly Cung
姬陵光=Cơ Lăng Quang
颜回=Nhan Hồi
公孙元希=Công Tôn Nguyên Hi
九黎氏=Cửu Lê Thị
一念三千界=Nhất Niệm Tam Thiên Giới
三十六渠帅=Tam Thập Lục Cừ Soái
金堤=Kim Đê
墨夷陵=Mặc Di Lăng
地仙之祖·镇元子=Địa Tiên Chi Tổ · Trấn Nguyên Tử
天庭四御=Thiên Đình Tứ Ngự
玉虚广乘=Ngọc Hư Quảng Thừa
天权文曲=Thiên Quyền Văn Khúc
豫州鼎=Dự Châu Đỉnh
墨门矩子=Mặc Môn Củ Tử
墨玄空=Mặc Huyền Không
太昊殿=Điện Thái Hạo
风紫阳=Phong Tử Dương
昊天金阙至尊玉皇赦罪大天尊玄穹高上帝=Hạo Thiên Kim Khuyết Chí Tôn Ngọc Hoàng Xá Tội Đại Thiên Tôn Huyền Khung Cao Thượng Đế
风清瑶=Phong Thanh Dao
广乘道人=Quảng Thừa Đạo Nhân
太学祭酒=Thái Học Tế Tửu
鼎湖=Đỉnh Hồ
大宗正=Đại Tông Chính
十二药叉大将=Thập Nhị Dược Xoa Đại Tướng
伏羲真灵=Phục Hy Chân Linh
三百六十五个洞天=Ba Trăm Sáu Mươi Lăm Động Thiên
《山坟》=《Sơn Phần》
《形坟》=《Hình Phần》
昊天金阙玉皇大帝=Hạo Thiên Kim Khuyết Ngọc Hoàng Đại Đế
九仪天尊剑=Cửu Nghi Thiên Tôn Kiếm
天极圣光=Thiên Cực Thánh Quang
一尺之捶=Nhất Xích Chi Chùy
养生主=Dưỡng Sinh Chủ
青帝长生=Thanh Đế Trường Sinh
混元一气上清神符=Hỗn Nguyên Nhất Khí Thượng Thanh Thần Phù
娲皇道器=Oa Hoàng Đạo Khí
黄帝的轩辕剑=Hiên Viên Kiếm của Hoàng Đế
太初一指=Thái Sơ Nhất Chỉ
四极天柱=Tứ Cực Thiên Trụ
宙光神通=Trụ Quang Thần Thông
《皇极经世书》=《Hoàng Cực Kinh Thế Thư》
六轮太阳法相=Lục Luân Thái Dương Pháp Tướng
水晶殿=Thủy Tinh Điện
帝女魃=Đế Nữ Bạt
大鲲老人=Đại Côn Lão Nhân
玄武王=Huyền Vũ Vương
癸水神罩=Quý Thủy Thần Tráo
帝出乎震=Đế Xuất Hồ Chấn
紫微殿=Tử Vi Điện
妖神教=Yêu Thần Giáo
公孙青玥=Công Tôn Thanh Nguyệt
北极天柱=Bắc Cực Thiên Trụ
太学祭酒墨夷陵=Thái Học Tế Tửu Mặc Di Lăng
广乘道长=Quảng Thừa Đạo Trưởng
殷屠龙=Ân Đồ Long
业如来=Nghiệp Như Lai
伏山臣=Phục Sơn Thần
三清道果=Đạo quả Tam Thanh
伏羲道果=Đạo quả Phục Hy
青帝道果=Đạo quả Thanh Đế
炎帝道果=Đạo quả Viêm Đế
玉皇大天尊=Ngọc Hoàng Đại Thiên Tôn
遍照十方=Biến Chiếu Thập Phương
三清道器=Tam Thanh Đạo Khí
乾坤易=Càn Khôn Dịch
玄都道长=Huyền Đô Đạo Trưởng
姜天子=Khương Thiên Tử
天之厉=Thiên Chi Lệ
后土皇地祇=Hậu Thổ Hoàng Địa Kỳ
南极长生大帝=Nam Cực Trường Sinh Đại Đế
雨师元君=Vũ Sư Nguyên Quân
