buff=buff
一届不如一届=một giới không bằng một giới
不少女生=không thiếu nữ sinh
两星半=hai sao rưỡi
凡人生命=phàm nhân sinh mệnh
出世修道=xuất thế tu đạo
刹那=nháy mắt¦chớp mắt¦nháy mắt¦khoảnh khắc¦sát na
原本就因为=nguyên bản bởi vì
四级=bốn cấp¦cấp bốn¦tứ cấp
墨镜=kính râm¦kính đen¦kính mát¦kính mác
姜缘=Khương Duyên
它们天生=bọn chúng thiên sinh
将光辉=đem quang huy
广心=Quảng Tâm
微微亮堂=hơi hơi sáng sủa
我是如来=ta là Như Lai
戴着墨镜=đeo kính râm¦đeo kính mát¦đeo kính đen
戴老大=Đái Lão Đại¦Đới Lão Đại
法甲=pháp giáp
泡浮=trôi nổi¦Awatsuki
登神长阶=đăng thần trường giai
白银灵性=Bạch Ngân linh tính
社会人儿=nhân viên xã hội
祖师的洞府=tổ sư động phủ
秘食传承=Bí Thực Truyền Thừa
自我尸=Tự Ngã Thi
药力的=dược lực
虚空蠕虫的心脏=Hư Không Nhuyễn Trùng Tâm Tạng
融合进化=dung hợp tiến hoá¦Fusion Evolution
让人无限=làm cho người vô hạn
违背了=vi phạm với¦vi phạm
黄金徽章=Hoàng Kim Huy Chương