byd=byd
lv=lv
七十级=70 cấp
三品官身=tam phẩm quan thân
三哥身上=Tam ca trên thân
上三品=thượng tam phẩm
两个美女=hai cô gái đẹp
两抹=hai vệt
临来前=trước khi đến
五级=năm cấp
任发=Nhậm Phát
任天堂=Nhậm Thiên Đường
何浪=Hà Lãng
修仙界之人=người của Tu Tiên giới
修士的手段=tu sĩ thủ đoạn
元流=Nguyên Lưu
八瓣仙兰=Tám Cánh Tiên Lan
叶骨衣=Diệp Cốt Y
吴羡=Ngô Tiện
周漪=Chu Y
周雪峰=Chu Tuyết Phong
唐仁=Đường Nhân
四十级=40 cấp
墨绿色眼眸=màu xanh sẫm tròng mắt
墨绿色瞳孔=con ngươi màu xanh sẫm
天梦=Thiên Mộng
天竹=thiên trúc
奇异的力量波动=kỳ dị lực lượng ba động
她小姐=nàng tiểu thư
如日中天=như mặt trời ban trưa¦cực kì hưng thịnh
姨太太=vợ bé¦vợ lẽ¦Di thái thái
婀娜的=thướt tha
嫁接了=giá tiếp
嫁接了过来=ghép lại
小先天=tiểu tiên thiên
小范闲=Tiểu Phạm Nhàn
小说作家=tiểu thuyết tác giả
小说改编=tiểu thuyết cải biên
小震子=Tiểu Chấn Tử
尸体内的能量=thi thể bên trong năng lượng
彼此的手法=thủ pháp của nhau
念英=Niệm Anh
懂懂懂=hiểu hiểu hiểu
掌控的=chưởng khống
星光笼罩=tinh quang bao phủ
是他的手下=là hắn thủ hạ
是姓顾=là họ Cố
是谁家=là nhà ai
本体之上=bản thể phía dưới
极致之冰=cực hạn băng
极致之火=cực hạn hoả
林惠群=Lâm Huệ Quần
林慧群=Lâm Tuệ Quần
毒不死=Độc Bất Tử
泰坦雪魔=Thái Thản Tuyết Ma
海神的使者=Hải Thần sứ giả
淡红色的光芒=ánh sáng màu đỏ nhạt
清楚了=rõ ràng
火凤凰血脉=hỏa phượng hoàng huyết mạch
狂刀门=Cuồng Đao Môn
猩红色的光芒=tinh quang màu đỏ
白玉阶前=trước bậc thềm ngọc trắng
的事业=sự nghiệp
真师父=chân sư phụ
碧绿色光点=xanh biếc điểm sáng
碧绿色的光点=điểm sáng màu xanh biếc
神情一振=thần sắc chấn động
神级=Thần cấp¦thần cấp¦cấp thần
突兀=đột ngột¦cao ngất¦cao vút¦cao chót vót¦bỗng nhiên¦bất ngờ¦chót vót
紫色光晕=vầng sáng màu tím
红莲庇佑=Hồng Liên che chở
老夫人的面前=lão phu nhân trước mặt
苏小龙=Tô Tiểu Long
莫飞云=Mạc Phi Vân
血影道友=Huyết Ảnh đạo hữu
表忠心=bày tỏ lòng trung thành¦biểu lộ trung thành
见面之礼=quà gặp mặt
谭文杰=Đàm Văn Kiệt
赏宝会=thưởng bảo hội
赛木大会=Tái Mộc đại hội
赤凰=Xích Hoàng
赵寅卯=Triệu Dần Mão
超标的=vượt tiêu chuẩn
轮回祖师=Luân Hồi tổ sư
金光就是=kim quang liền là
金光罩=Kim Quang Tráo
金神怒=Kim Thần Nộ
金铛=chuông vàng
钱师傅=Tiền sư phụ
钱开=Tiền Khai
陈冬=Trần Đông
陨落=vẫn lạc¦ngã xuống¦rơi xuống¦bỏ mình¦chết đi
雪帝=Tuyết Đế
青年才俊=thanh niên tài tuấn¦thanh niên tuấn kiệt
面过圣=diện thánh rồi
飞=bay¦phi
马云长老=Mã Vân trưởng lão
黑色=đen