一乐老板=Ichiraku lão bản
一刀无血=Nhất Đao Vô Huyết
七星点杀剑术=Thất Tinh Điểm Sát Kiếm Thuật
万俟楼=Vạn Sĩ Lâu
三天金刹功=Tam Thiên Kim Sát Công
三江城=Tam Giang Thành
三花钩镰枪=Tam Hoa Câu Liêm Thương
三转炼体丹=Tam Chuyển Luyện Thể Đan
上古刀王=Thượng Cổ Đao Vương
上古剑王=Thượng Cổ Kiếm Vương
不可……能=không thể……nào
不等=không đợi/không giống nhau/không bằng/không bằng nhau/không giống/không đều/không chờ/không đều/bất đồng
东方深海=Đông Phương Thâm Hải
东方深海红眼黑龙一族=Đông Phương Thâm Hải Hồng Nhãn Hắc Long Nhất Tộc
东皇城=Đông Hoàng Thành
东皇铠=Đông Hoàng Khải
东魔=Đông Ma
东魔谢知秋=Đông Ma Tạ Tri Thu
临江城=Lâm Giang Thành
丹王大会=Đan Vương Đại Hội
丹王岛=Đan Vương Đảo
丹王广场=Đan Vương Quảng Trường
为天下第一流=là thiên hạ đệ nhất lưu
乌青铁枪=Ô Thanh Thiết Thương
九九归元大阵=Cửu Cửu Quy Nguyên Đại Trận
九九归元阵法=Cửu Cửu Quy Nguyên trận pháp
九尾焱狐=Cửu Vĩ Diễm Hồ
九幽搜魂=Cửu U Sưu Hồn
九幽魔王=Cửu U Ma Vương
九彩天花=Cửu Sắc Thiên Hoa
九曲逆灵丹=Cửu Khúc Nghịch Linh Đan
九曲逆灵树=Cửu Khúc Nghịch Linh Thụ
九曲黄河枪阵=Cửu Khúc Hoàng Hà Thương Trận
九转火灵功=Cửu Chuyển Hỏa Linh Công
九龙湖=Cửu Long Hồ
书友***9425=Thư Hữu***9425
乾坤无极功=Càn Khôn Vô Cực Công
于岳=Vu Nhạc
云隐剑=Vân Ẩn Kiếm
五品势力=Ngũ Phẩm Thế Lực
五岳神拳=Ngũ Nhạc Thần Quyền
五岳门=Ngũ Nhạc Môn
五怒狂雷=Ngũ Nộ Cuồng Lôi
五百年前=năm trăm năm trước/500 năm trước
亦非常人=cũng phi thường nhân
人魔乡=Nhân Ma Hương
人魔家族=Nhân Ma Gia Tộc
人魔王=Nhân Ma Vương
伏龙翔天=Phục Long Tường Thiên
休书=hưu thư
传说中的龙元=trong truyền thuyết long nguyên
位神秘=vị thần bí
傀儡城=Khôi Lỗi Thành
傅殷红=Phó Ân Hồng
傲无败=Ngạo Vô Bại
元虚功=Nguyên Hư Công
先天大裂劲=Tiên Thiên Đại Liệt Kính
八荒战天圣法=Bát Hoang Chiến Thiên Thánh Pháp
兰翠翠=Lan Thúy Thúy
关琴=Quan Cầm
冯天=Phùng Thiên
冰天百花葬=Băng Thiên Bách Hoa Táng
冰晶帝国=Băng Tinh Đế Quốc
冰枪王=Băng Thương Vương
冰灵指=Băng Linh Chỉ
冰点之剑=Băng Điểm Chi Kiếm
冰雪剑宗=Băng Tuyết Kiếm Tông
冰霜大人=Băng Sương đại nhân
冰霜魔帝=Băng Sương Ma Đế
冷月枪=Lãnh Nguyệt Thương
冷月枪许江=Lãnh Nguyệt Thương Hứa Giang
凝水=Ngưng Thủy
凤鸣山山脉=Phượng Minh Sơn Sơn Mạch
凤鸣山脉=Phượng Minh Sơn Mạch
刀叟=Đao Tẩu
刀道三大宗师=Đao Đạo Tam Đại Tông Sư
刘元老=Lưu Nguyên Lão
刹那辉煌=Sát Na Huy Hoàng
剑道独尊世界=Kiếm Đạo Độc Tôn Thế Giới
剑阵侯=Kiếm Trận Hầu
力之奥义=Lực Chi Áo Nghĩa
北冥家族=Bắc Minh Gia Tộc
北冥枪王=Bắc Minh Thương Vương
北斗七星台=Bắc Đẩu Thất Tinh Đài
北海空帝=Bắc Hải Không Đế
北雪快刀=Bắc Tuyết Khoái Đao
北雪快刀林奇=Bắc Tuyết Khoái Đao Lâm Kỳ
十剑=Thập Kiếm
千丝国=Thiên Ti Quốc
千川=Chikawa
千川拓=Chikawa Taku
千羽圣冥=Thiên Vũ Thánh Minh
卍解青丘=Vạn Giải Thanh Khâu
南卓=Nam Trác
南方浅海联盟=Nam Phương Thiển Hải Liên Minh
南罗山脉=Nam La Sơn Mạch
南陵城=Nam Lăng Thành
南陵酒楼=Nam Lăng Tửu Lâu
卫天辰=Vệ Thiên Thần
原横空=Nguyên Hoành Không
原横鹰=Nguyên Hoành Ưng
双头王蝠=Song Đầu Vương Bức
古家东王=Cổ Gia Đông Vương
古泉山=Cổ Tuyền Sơn
古道山脉=Cổ Đạo Sơn Mạch
叶家子弟=Diệp gia tử đệ
同代天骄=cùng thế hệ Thiên kiêu
听海吟游=Thính Hải Ngâm Du
吴万山=Ngô Vạn Sơn
吴小慧=Ngô Tiểu Tuệ
吴银山=Ngô Ngân Sơn
唐满楼=Đường Mãn Lâu
商船海兽号=Thương thuyền Hải Thú Hào
囚笼山=Tù Lung Sơn
四大核心弟子=Tứ đại hạch tâm đệ tử
四极大帝之墓=Tứ Cực Đại Đế Chi Mộ
四极大帝墓地=Tứ Cực Đại Đế Mộ Địa
四极大手印=Tứ Cực Đại Thủ Ấn
四极广场=Tứ Cực Quảng Trường
四极王座=Tứ Cực Vương Tọa
圣龙拳=Thánh Long Quyền
圣龙枪诀=Thánh Long Thương Quyết
地也空=đất cũng không
地星丹=Địa Tinh Đan
地魔淬体功=Địa Ma Thối Thể Công
坚甲王=Kiên Giáp Vương
墨狼=Mặc Lang
大凤凰斩=Đại Phượng Hoàng Trảm
大师兄翡翠公子=Đại sư huynh Phỉ Thúy công tử
天一圣水诀=Thiên Nhất Thánh Thủy Quyết
天下四大家族=Thiên Hạ Tứ Đại Gia Tộc
天书公子李霄云=Thiên Thư Công Tử Lý Tiêu Vân
天书院=Thiên Thư Viện
天和泰极天=Thiên Hòa Thái Cực Thiên
天堑峡=Thiên Khiệm Hạp
天妖妖宗=Thiên Yêu Yêu Tông
天妖火灵果=Thiên Yêu Hỏa Linh Quả
天星酒楼=Thiên Tinh Tửu Lâu
天梦古地=Thiên Mộng Cổ Địa
天梦战殿=Thiên Mộng Chiến Điện
天武阁留名照壁=Thiên Vũ Các Lưu Danh Chiếu Bích
天火一枪=Thiên Hỏa Nhất Thương
天火流星=Thiên Hỏa Lưu Tinh
天璇锤杀=Thiên Toàn Chuy Sát
天罗铠=Thiên La Khải
天罡元气=Thiên Cương Nguyên Khí
天罡地煞枪术=Thiên Cương Địa Sát Thương Thuật
天罡王=Thiên Cương Vương
天虎一族=Thiên Hổ Nhất Tộc
天虎妖宗=Thiên Hổ Yêu Tông
天虎王=Thiên Hổ Vương
天虚王=Thiên Hư Vương
天蛇一击=Thiên Xà Nhất Kích
天蛇国=Thiên Xà Quốc
天蝎冢=Thiên Yết Trủng
天蝎剑=Thiên Yết Kiếm
天蝎王=Thiên Hạt Vương
天蝎甲=Thiên Hạt Giáp
天象淬体功=Thiên Tượng Tôi Thể Công
天陨大法=Thiên Vẫn Đại Pháp
天风鹫=Thiên Phong Thứu
天魔花=Thiên Ma Hoa
天魔蟒=Thiên Ma Mãng
天鹰堡堡主=Thiên Ưng Bảo Bảo Chủ
太极重意而不重形=Thái Cực trọng ý mà không trọng hình
夺宝圣塔=Đoạt Bảo Thánh Tháp
如此了得=cao minh như thế
妖魔帝=Yêu Ma Đế
妖魔皇=Yêu Ma Hoàng
孙元老=Tôn Nguyên lão
孤峰十三剑=Cô Phong Thập Tam Kiếm
孤峰绝杀=Cô Phong Tuyệt Sát
宁头儿=Ninh đầu nhi
宇文浩=Vũ Văn Hạo
守护神龙=thủ hộ thần long
完美人魔血脉=Hoàn Mỹ Nhân Ma Huyết Mạch
宝华广场=Bảo Hoa Quảng Trường
寂灭魔宗=Tịch Diệt Ma Tông
寂灭魔帝=Tịch Diệt Ma Đế
寂静山脉=Tịch Tĩnh Sơn Mạch
寂静森林=Tịch Tĩnh Sâm Lâm
寒山公子=Hàn Sơn Công Tử
封帝王者=Phong Đế Vương Giả
封王殿=Phong Vương Điện
小十五有点累=Tiểu Thập Ngũ Hữu Điểm Luy
小子你愁啥=Tiểu Tử Nhĩ Sầu Sa
小神腿=Tiểu Thần Thối
小血魔解体大法=Tiểu Huyết Ma Giải Thể Đại Pháp
尖耳魔王=Tiêm Nhĩ Ma Vương
尸鬼山=Thi Quỷ Sơn
尹无情=Doãn Vô Tình
屠重山=Đồ Trọng Sơn
屠龙之力=Đồ Long chi lực
山中客=Sơn Trung khách
山水大法=Sơn Thủy Đại Pháp
山水阁=Sơn Thủy Các
崔世明=Thôi Thế Minh
崔副岛主=Thôi Phó Đảo Chủ
巨剑候=Cự Kiếm Hầu
帝之墓=Đế Chi Mộ
帝之墓·白羊座=Đế Chi Mộ · Bạch Dương Tọa
帝皇书=Đế Hoàng Thư
帝皇峡谷=Đế Hoàng Hạp Cốc
幽火剑客=U Hỏa Kiếm Khách
庄斐庆=Trang Phỉ Khánh
庄清河=Trang Thanh Hà
异族大劫=Dị tộc đại kiếp
弃天爪=Khí Thiên Trảo
张鼎天=Trương Đỉnh Thiên
御兽公子莫翔=Ngự Thú Công Tử Mạc Tường
御兽大殿=Ngự Thú Đại Điện
忘忧城=Vong Ưu Thành
快刀吴万山=Khoái Đao Ngô Vạn Sơn
怒龙穿心=Nộ Long Xuyên Tâm
惊雁功=Kinh Nhạn Công
惊雷枪法=Kinh Lôi Thương Pháp
感谢先生=cảm tạ tiên sinh
愤怒的龙吟=phẫn nộ long ngâm
慕容止水=Mộ Dung Chỉ Thủy
战王佩剑=Chiến Vương Bội Kiếm
战王宗=Chiến Vương Tông
战象拳=Chiến Tượng Quyền
扇舞梨花=Phiến Vũ Lê Hoa
扇舞镰刃=Phiến Vũ Liêm Nhận
拓跋苦=Thác Bạt Khổ
掌绝=Chưởng Tuyệt
掌绝柳无相=Chưởng Tuyệt Liễu Vô Tướng
断冰河=Đoạn Băng Hà
断冷崖=Đoạn Lãnh Nhai
无影鞭崔英豪=Vô Ảnh Tiên Thôi Anh Hào
无情剑客=Vô Tình Kiếm Khách
无情剑客李道轩=Vô Tình Kiếm Khách Lý Đạo Hiên
日曜行空=Nhật Diệu Hành Không
明月丫头=Minh Nguyệt Nha Đầu
明月山山脉=Minh Nguyệt Sơn Sơn Mạch
明月山脉=Minh Nguyệt Sơn Mạch
星游城=Tinh Du Thành
星痕剑=Tinh Ngân Kiếm
星皇指=Tinh Hoàng Chỉ
星陨大阵=Tinh Vẫn Đại Trận
昭成天皇=Chiêu Thành Thiên Hoàng
暗香剑朱梅=Ám Hương Kiếm Chu Mai
更加厚实=càng thêm bền chặt
月华门=Nguyệt Hoa Môn
月明山脉=Nguyệt Minh Sơn Mạch
望海域=Vọng Hải Vực
朝阳国=Triều Dương Quốc
木逢远=Mộc Phùng Viễn
本命万象圣塔=Bản Mệnh Vạn Tượng Thánh Tháp
朱烈阳=Chu Liệt Dương
杀手鹰=Sát Thủ Ưng
李崩=Lý Băng
极品灵植培养液=Cực Phẩm Linh Thực Bồi Dưỡng Dịch
林天明=Lâm Thiên Minh
林奇岳父=Lâm Kỳ nhạc phụ
林水寒=Lâm Thủy Hàn
林永河=Lâm Vĩnh Hà
林笑天=Lâm Tiếu Thiên
林船长=Thuyền trưởng Lâm
枪出如龙=Thương xuất như long
枪叟=Thương Tẩu
枪域=Thương Vực
梦狼王=Mộng Lang Vương
梦里见鲸=Mộng Lí Kiến Kình
楚天云=Sở Thiên Vân
横岭域=Vực Hoành Lĩnh
横鹰=Hoành Ưng
橘子四块五=Quất Tử Tứ Khối Ngũ
武先生=Võ tiên sinh
武城星=Võ Thành Tinh
武家=Võ gia
武楼=Võ Lâu
武氏=Võ thị/Võ Thị
武王峰=Võ Vương Phong
残月弯轮=Tàn Nguyệt Loan Luân
殒落星辰大阵=Vẫn Lạc Tinh Thần Đại Trận
殿灵=Điện Linh
毁灭乌光=Hủy Diệt Ô Quang
水火无常=Thủy Hỏa Vô Thường
沙之澜歌=Sa Chi Lan Ca
治理天下会=quản lý Thiên Hạ Hội
洪千钧=Hồng Thiên Quân
洪荒岭=Hồng Hoang Lĩnh
流云大殿=Lưu Vân Đại Điện
流星火山=Lưu Tinh Hỏa Sơn
浅梦U墨染=Thiển Mộng U Mặc Nhiễm
浅梦U墨溪=Thiển Mộng U Mặc Khê
浑身周围=toàn thân chu vi
浮光城=Phù Quang Thành
浮光帝国=Phù Quang Đế Quốc
浮光楼=Phù Quang Lâu
海宗海无涯=Hải Tông Hải Vô Nhai
深铜母绿=Thâm Đồng Mẫu Lục
清河峰=Thanh Hà Phong
潜龙古地=Tiềm Long Cổ Địa
潜龙古城=Tiềm Long Cổ Thành
潜龙武城=Tiềm Long Võ Thành
潜龙秘境=Tiềm Long Bí Cảnh
澹台天明=Đạm Đài Thiên Minh
澹台火=Đạm Đài Hỏa
火尖枪法=Hỏa Tiêm Thương Pháp
火沼域=Hỏa Chiểu Vực
火舞漫天=Hỏa Vũ Mạn Thiên
火舞耀阳=Hỏa Vũ Diệu Dương
火鸟王=Hỏa Điểu Vương
灭人心神=Diệt Nhân Tâm Thần
灭天王手=Diệt Thiên Vương Thủ
灵丹王=Linh Đan Vương
灵魂障壁=Linh Hồn Chướng Bích
炼心一剑=Luyện Tâm Nhất Kiếm
烈火散人=Liệt Hỏa Tán Nhân
特地=đặc biệt
狄红英=Địch Hồng Anh
独孤刀帝=Độc Cô Đao Đế
独孤家族长=Độc Cô Gia Tộc Trưởng
独眼魔王=Độc Nhãn Ma Vương
狱王会=Ngục Vương Hội
狱门狱祖=Ngục Môn Ngục Tổ
狱龙破=Ngục Long Phá
狼头山=Lang Đầu Sơn
猎杀堂=Liệp Sát Đường
玄后燕轻萱=Huyền Hậu Yến Khinh Huyên
玄妙掌=Huyền Diệu Chưởng
玄宗秘阁=Huyền Tông Bí Các
玄金蟒=Huyền Kim Mãng
玄青石=Huyền Thanh Thạch
王副岛主=Vương Phó đảo chủ
王太一=Vương Thái Nhất
生之奥义=Sinh Chi Áo Nghĩa
生死乐园=Sinh Tử Lạc Viên
生死园林=Sinh Tử Viên Lâm
生死境王者=Sinh Tử Cảnh Vương Giả
生死石碑=Sinh Tử Thạch Bi
田冲=Điền Xung
白云酒楼=Bạch Vân Tửu Lâu
白狼妖宗=Bạch Lang Yêu Tông
白玄国=Bạch Huyền Quốc
白羊王墓地=Mộ Bạch Dương Vương
白羊王幻阵=Bạch Dương Vương Huyễn Trận
白骨鬼将=Bạch Cốt Quỷ Tướng
百鸟朝凤枪=Bách Điểu Triều Phụng Thương
的天下会=Thiên Hạ Hội
皇极惊世拳=Hoàng Cực Kinh Thế Quyền
皇极霸世拳=Hoàng Cực Bá Thế Quyền
盘山岛=Bàn Sơn Đảo
盘龙一怒=Bàn Long Nhất Nộ
盘龙枪决=Bàn Long Thương Quyết
盘龙枪域=Bàn Long Thương Vực
盘龙枪诀=Bàn Long Thương Quyết
盘龙树=Bàn Long Thụ
盘龙真气=Bàn Long Chân Khí
真水十二塔=Chân Thủy Thập Nhị Tháp
真灵世界=Chân Linh Thế Giới
真龙一怒=Chân Long Nhất Nộ
短剑候=Đoản Kiếm Hầu
矮瘦老者=Lão giả gầy gò
石人石破天=Thạch Nhân Thạch Phá Thiên
破坏王=Phá Hoại Vương
破阵霸王枪=Phá Trận Bá Vương Thương
碧海三味升=Bích Hải Tam Vị Thăng
碧湖先生=Bích Hồ tiên sinh
神指宗=Thần Chỉ Tông
神指王=Thần Chỉ Vương
神材=thần tài
神父=thần phụ
神眼王=Thần Nhãn Vương
神话级数=thần thoại cấp số
神鲨公主鲨若晴=Thần Sa Công Chúa Sa Nhược Tình
神鲨女王=Thần Sa Nữ Vương
神龙的躯体=thần long thân thể
秋德玛得=Thu Đức Mã Đắc
秋水剑诀=Thu Thủy Kiếm Quyết
秦煊=Tần Huyên
秦雨莲=Tần Vũ Liên
程俊=Trình Tuấn
空帝=Không Đế
空灵大阵=Không Linh đại trận
空间枪意=Không Gian Thương Ý
紫晶铁=Tử Tinh Thiết
紫极功=Tử Cực Công
紫气铁=Tử Khí Thiết
紫霞奔雷掌=Tử Hà Bôn Lôi Chưởng
红月国=Hồng Nguyệt Quốc
红眼黑龙一族=Hồng Nhãn Hắc Long Nhất Tộc
缘来你=Duyên Lai Nhĩ
缥缈雪域=Phiêu Diễu Tuyết Vực
罗刹门门主=Môn chủ La Sát Môn
罡灵子楚中天=Cương Linh Tử Sở Trung Thiên
罡灵王=Cương Linh Vương
羊头山=Dương Đầu Sơn
羊头山峰=Dương Đầu Sơn Phong
翡翠城=Phỉ Thúy Thành
翡翠峰=Phỉ Thúy Phong
翡翠枪=Phỉ Thúy Thương
翡翠鸟=Phỉ Thúy Điểu
胭脂刀=Yên Chi Đao
能力大部分=năng lực đại bộ phận
自我倾诉=Tự Ngã Khuynh Tố
花粉女王=Hoa Phấn Nữ Vương
苍云甲=Thương Vân Giáp
苍狼平原=Thương Lang Bình Nguyên
苍玄国=Thương Huyền Quốc
苍龙破=Thương Long Phá
莫翔鲁=Mạc Tường Lỗ
莲花城=Liên Hoa Thành
莲花群岛=Liên Hoa Quần Đảo
莲花魔岛=Liên Hoa Ma Đảo
萧尘宇=Tiêu Trần Vũ
萧楚河=Tiêu Sở Hà
萧辰宇=Tiêu Thần Vũ
落辉城=Lạc Huy Thành
落雁江=Lạc Nhạn Giang
蓝山岛=Lam Sơn Đảo
蔡月瑶=Thái Nguyệt Dao
薛无刃=Tiết Vô Nhận
藤默=Đằng Mặc
虎魔一刀=Hổ Ma Nhất Đao
虎魔潜血诀=Hổ Ma Tiềm Huyết Quyết
虚皇空帝=Hư Hoàng Không Đế
蛇少=Xà Thiếu
蛮荒星=Man Hoang Tinh
蛮荒毒蚊=Man Hoang Độc Văn
蛮荒石=Man Hoang Thạch
蛮荒象王=Man Hoang Tượng Vương
蛮魔宗=Man Ma Tông
蛮龙皇=Man Long Hoàng
蝎尾魔狼=Thiết Vĩ Ma Lang
血刀王=Huyết Đao Vương
血影刀蒙冲=Huyết Ảnh Đao Mông Xung
血手唐杰=Huyết Thủ Đường Kiệt
血手王=Huyết Thủ Vương
血翼女子=Huyết Dực Nữ Tử
血虎王=Huyết Hổ Vương
血鲨家族=Huyết Sa Gia Tộc
血鲨王=Huyết Sa Vương
裂海刀王=Liệt Hải Đao Vương
裂空刀=Liệt Không Đao
裂空拳=Liệt Không Quyền
褐衣老者=Hạt Y Lão Giả
西北拍卖场=Tây Bắc Đấu Giá Trường
西来大酒楼=Tây Lai Đại Tửu Lâu
西海剑宗=Tây Hải Kiếm Tông
西海剑王=Tây Hải Kiếm Vương
解开血脉=giải khai huyết mạch
诛心一剑=Tru Tâm Nhất Kiếm
象天战皇=Tượng Thiên Chiến Hoàng
象山国=Tượng Sơn Quốc
象王咆哮=Tượng Vương Bào Hao
象王守护=Tượng Vương Thủ Hộ
象甲国=Tượng Giáp Quốc
豪放开口=hào phóng mở miệng
豪放开口道=hào phóng mà nói
豪龙破军=Hào Long Phá Quân
赛星峰=Tái Tinh Phong
赤古沙漠=Xích Cổ Sa Mạc
赤水老怪=Xích Thủy Lão Quái
赤金炎=Xích Kim Viêm
轮回枪诀=Luân Hồi Thương Quyết
轻煊=Khinh Huyên
轻萱=Khinh Huyên
追风拳=Truy Phong Quyền
通灵国=Thông Linh Quốc
道道轨迹=đạo đạo quỹ tích
邪魔洞=Tà Ma Động
邪魔锏=Tà Ma Giản
重岳门=Trọng Nhạc Môn
金光楼=Kim Quang Lâu
金刚爆裂拳=Kim Cương Bạo Liệt Quyền
金枪兄=Kim Thương huynh
金枪客=Kim Thương Khách
金枪散人=Kim Thương Tán Nhân
金煌道人=Kim Hoàng Đạo Nhân
金虹贯日=Kim Hồng Quán Nhật
金鳌老祖=Kim Ngao Lão Tổ
金鼎城=Kim Đỉnh Thành
铁狂尊=Thiết Cuồng Tôn
铁骨王=Thiết Cốt Vương
铲除自己的=diệt trừ bản thân
银豹家族=Ngân Báo Gia Tộc
银豹王=Ngân Báo Vương
长刀门=Trường Đao Môn
长天派=Trường Thiên Phái
闪灵门=Thiểm Linh Môn
闪耀星河=Thiểm Diệu Tinh Hà
问天枪决=Vấn Thiên Thương Quyết
闲云子=Nhàn Vân Tử
阖家欢乐=Hợp gia hoan lạc
阴蚀邪帝=Âm Thực Tà Đế
陀罗国=Đà La Quốc
陈太虚=Trần Thái Hư
雨侠=Vũ Hiệp
雪剑候=Tuyết Kiếm Hầu
雪剑皇=Tuyết Kiếm Hoàng
雪女剑王=Tuyết Nữ Kiếm Vương
雪雁=Tuyết Nhạn
雪雁姐=Tuyết Nhạn tỷ
雷之公主靖傲萱=Lôi Chi Công Chúa Tĩnh Ngạo Huyên
雷兽变=Lôi Thú Biến
雷域亭台=Lôi Vực Đình Đài
雷火四重天=Lôi Hỏa Tứ Trọng Thiên
雷灵王=Lôi Linh Vương
雷都=Lôi Đô
雷霆雄狮=Lôi Đình Hùng Sư
雷鸣千军破=Lôi Minh Thiên Quân Phá
雷龙变=Lôi Long Biến
震荡枪法=Chấn Đãng Thương Pháp
霍家庄=Hoắc gia trang
青煞罡气=Thanh Sát Cương Khí
青眼白狼傲=Thanh Nhãn Bạch Lang Ngạo
青石神功=Thanh Thạch Thần Công
青竹门=Thanh Trúc Môn
青铜甲=Thanh Đồng Giáp
青龙殿=Thanh Long Điện
音波鬼将=Âm Ba Quỷ Tướng
风之伤=Phong Chi Thương
风雷二宗=Phong Lôi Nhị Tông
飘渺雪域=Phiêu Miểu Tuyết Vực
飘雪殿殿主=Phiêu Tuyết Điện Điện Chủ
骆加成=Lạc Gia Thành
骆家成=Lạc Gia Thành
骆白霜=Lạc Bạch Sương
骷髅大人=Khô Lâu đại nhân
骷髅魔帝=Khô Lâu Ma Đế
鬼吼功=Quỷ Hống Công
鬼影阁=Quỷ Ảnh Các
鬼眼玉狮子=Quỷ Nhãn Ngọc Sư Tử
魏东蛇=Ngụy Đông Xà
魏嘤嘤=Ngụy Anh Anh
魏武峰=Ngụy Võ Phong
魏遗风=Ngụy Di Phong
魏龙涛=Ngụy Long Đào
魔刀女王=Ma Đao Nữ Vương
魔刀王=Ma Đao Vương
魔刀诀=Ma Đao Quyết
魔水湖=Ma Thủy Hồ
魔眼莫言=Ma Nhãn Mạc Ngôn
魔鬼大草原=Ma Quỷ Đại Thảo Nguyên
魔鹰显形拳=Ma Ưng Hiển Hình Quyền
鸠无血=Cưu Vô Huyết
鸠无邪=Cưu Vô Tà
黄石镇=Hoàng Thạch trấn
黄龙殿=Hoàng Long Điện
黑山王=Hắc Sơn Vương
黑水联盟=Hắc Thủy Liên Minh
黑白双魔=Hắc Bạch Song Ma
黑翼大人=Hắc Dực đại nhân
黑翼魔帝=Hắc Dực Ma Đế
黑衣老者=Hắc y lão giả
黑雷王=Hắc Lôi Vương
黑鲨皇=Hắc Sa Hoàng
黑鸦大法=Hắc Nha Đại Pháp
黑龙老祖=Hắc Long Lão Tổ
鼎王门=Đỉnh Vương Môn
齐少峰=Tề Thiếu Phong
龙不与蛇居=long không cùng xà cư
龙凤龟麟=Long Phượng Quy Lân
龙吟铁=Long Ngâm Thiết
龙回头=Long Hồi Đầu
龙威镖局=Long Uy Tiêu Cục
龙王玄后=Long Vương Huyền Hậu
龙皇果=Long Hoàng Quả
龙皇果树=Long Hoàng Quả Thụ
龙碧云=Long Bích Vân
龙虎爆元丹=Long Hổ Bạo Nguyên Đan
龙行大运=Long hành đại vận
龙象力拳=Long Tượng Lực Quyền
龙象淬体功=Long Tượng Thối Thể Công
龙象淬体诀=Long Tượng Thối Thể Quyết
龙象震狱劲=Long Tượng Chấn Ngục Kính
龙象齐吼=Long Tượng Tề Hống
一剑平南=Nhất Kiếm Bình Nam
七星长空剑法=Thất Tinh Trường Không Kiếm Pháp
三元商会=Tam Nguyên Thương Hội
三江帮=Tam Giang Bang
三青帮=Tam Thanh Bang
上官尚=Thượng Quan Thượng
上山虎杜阳=Thượng Sơn Hổ Đỗ Dương
下山豹林恒=Hạ Sơn Báo Lâm Hằng
不二山庄=Bất Nhị Sơn Trang
丘山剑场=Khâu Sơn Kiếm Trường
东城六扇门=Đông Thành Lục Phiến Môn
东山剑派=Đông Sơn Kiếm Phái
东山郡=Đông Sơn Quận
东岳剑派=Đông Nhạc Kiếm Phái
东岳山=Đông Nhạc Sơn
东平城=Đông Bình Thành
东平郡=Đông Bình Quận
东方商会=Đông Phương Thương Hội
东水郡=Đông Thủy Quận
东海蓬莱岛=Đông Hải Bồng Lai Đảo
东阳追风楼=Đông Dương Truy Phong Lâu
东阳镖局=Đông Dương Tiêu Cục
东陵陈家=Đông Lăng Trần Gia
丧门鬼=Tang Môn Quỷ
临江及时雨=Lâm Giang Cập Thời Vũ
临江捉刀人=Lâm Giang Tróc Đao Nhân
临江捉刀人顾瞎子=Lâm Giang Tróc Đao Nhân Cố Hạt Tử
临江郡=Lâm Giang Quận
九台山=Cửu Đài Sơn
九幽鬼母殷九娘=Cửu U Quỷ Mẫu Ân Cửu Nương
九江盟=Cửu Giang Minh
九江龙王=Cửu Giang Long Vương
九阳内力=Cửu Dương Nội Lực
云州刺史府=Vân Châu Thứ Sử Phủ
云州大侠=Vân Châu đại hiệp
云州天榜=Vân Châu Thiên Bảng
云州总部=Vân Châu Tổng Bộ
云州江湖=Vân Châu Giang Hồ
云州神拳派=Vân Châu Thần Quyền Phái
云袖=Vân Tụ
云郡=Vân Quận
云雾幻剑=Vân Vụ Huyễn Kiếm
五毒神火掌=Ngũ Độc Thần Hỏa Chưởng
仙都观=Tiên Đô Quan
任天琦=Nhậm Thiên Kỳ
何行空=Hà Hành Không
何长青=Hà Trường Thanh
何齐正=Hà Tề Chính
佟氏三兄弟=Đồng thị tam huynh đệ
信义盟=Tín Nghĩa Minh
信义行=Tín Nghĩa Hành
信义行追风楼=Tín Nghĩa Hành Truy Phong Lâu
傀儡丹=Khôi Lỗi Đan
元道人=Nguyên Đạo Nhân
光明寺=Quang Minh Tự
八郡七十三县=Bát Quận Thất Thập Tam Huyện
六合童子=Lục Hợp Đồng Tử
六脉剑阵=Lục Mạch Kiếm Trận
兵器世家林家=Binh Khí thế gia Lâm gia
兵圣铁烛=Binh Thánh Thiết Chúc
内关穴=Nội Quan Huyệt
冬寒萝卜=Đông Hàn Củ Cải
冰髓莲花=Băng Tủy Liên Hoa
冰魄功=Băng Phách Công
冰魄金身=Băng Phách Kim Thân
净空=Tịnh Không
净空法师=Tịnh Không Pháp Sư
凌云山庄=Lăng Vân Sơn Trang
凤鸣渡=Phượng Minh Độ
凤鸣渡口=Phượng Minh Độ Khẩu
刀皇叶惊澜=Đao Hoàng Diệp Kinh Lan
刘三元=Lưu Tam Nguyên
刘园=Lưu Viên
刘氏医馆=Lưu Thị Y Quán
刘飞扬=Lưu Phi Dương
刮骨刀=Quát Cốt Đao
剑痴吴六指=Kiếm Si Ngô Lục Chỉ
剑首李秋雨=Kiếm Thủ Lý Thu Vũ
劫心蛊=Kiếp Tâm Cổ
劫心蛊王=Kiếp Tâm Cổ Vương
劫心金蛊=Kiếp Tâm Kim Cổ
勾陈刀=Câu Trần Đao
勾陈妖刀=Câu Trần Yêu Đao
北斗郡=Bắc Đẩu Quận
北湖剑派=Bắc Hồ Kiếm Phái
北莽=Bắc Mãng
北郡=Bắc Quận
匠神世家=Thợ Rèn Thần Thế Gia
十大宗师=Thập Đại Tông Sư
十方剑客=Thập Phương Kiếm Khách
千手人屠司空笑=Thiên Thủ Nhân Đồ Tư Không Tiếu
千手多叶掌=Thiên Thủ Đa Diệp Chưởng
千手拈花=Thiên Thủ Niêm Hoa
千手掌印=Thiên Thủ Chưởng Ấn
千手金光=Thiên Thủ Kim Quang
千机匣=Thiên Cơ Hạp
千棺蜃气=Thiên Quan Thận Khí
千灯镇=Thiên Đăng Trấn
华拳帮=Hoa Quyền Bang
卓芳华=Trác Phương Hoa
卓青峰=Trác Thanh Phong
南亭山庄=Nam Đình Sơn Trang
南宫月汐=Nam Cung Nguyệt Tịch
南宫群=Nam Cung Quần
南山剑客=Nam Sơn Kiếm Khách
南海剑派=Nam Hải Kiếm Phái
双刀客=Song Đao Khách
双刀客杨威=Song Đao Khách Dương Uy
古画童=Cổ Họa Đồng
叶宗师=Diệp Tông Sư
叶惊澜=Diệp Kinh Lan
叶挽月=Diệp Vãn Nguyệt
叶灵素=Diệp Linh Tố
叶老宗师=Diệp Lão Tông Sư
司空笑=Tư Không Tiếu
吉安巷=Cát An Hạng
听松山庄=Thính Tùng Sơn Trang
听松岭=Thính Tùng Lĩnh
吴六指=Ngô Lục Chỉ
吴天放=Ngô Thiên Phóng
吴家剑痴=Ngô Gia Kiếm Si
吴常=Ngô Thường
吴郡吴家=Ngô Quận Ngô Gia
哭道人=Khốc Đạo Nhân
唐不疑=Đường Bất Nghi
唐天琪=Đường Thiên Kỳ
唐安县=Đường An Huyện
唐家庄园=Đường Gia Trang Viên
唐氏双雄=Đường Thị Song Hùng
商不语=Thương Bất Ngữ
商阳剑气=Thương Dương Kiếm Khí
四只眼=Tứ Chích Nhãn
四大剑派=Tứ Đại Kiếm Phái
四方剑派=Tứ Phương Kiếm Phái
四绝山君=Tứ Tuyệt Sơn Quân
四绝神功=Tứ Tuyệt Thần Công
城阳公主=Thành Dương công chúa
塑方大漠=Tố Phương Đại Mạc
壹等客栈=Nhất Đẳng Khách Sạn
夜老鼠=Dạ Lão Thử
大塘双龙传=Đại Đường Song Long Truyện
大巫山=Đại Vu Sơn
大无相劫功=Đại Vô Tướng Kiếp Công
大灯谷=Đại Đăng Cốc
大王庄=Đại Vương Trang
天刀令=Thiên Đao Lệnh
天刀八诀=Thiên Đao Bát Quyết
天寒剑=Thiên Hàn Kiếm
天星功=Thiên Tinh Công
天机书生=Thiên Cơ Thư Sinh
天机书生叶笑=Thiên Cơ Thư Sinh Diệp Tiếu
天机仙翁=Thiên Cơ Tiên Ông
天机剑法=Thiên Cơ Kiếm Pháp
天演大法=Thiên Diễn Đại Pháp
天蚕宝衣=Thiên Tàm Bảo Y
天问刀法=Thiên Vấn Đao Pháp
天问十三刀=Thiên Vấn Thập Tam Đao
天问十二刀=Thiên Vấn Thập Nhị Đao
天霜劲=Thiên Sương Kính
太安县=Thái An Huyện
妖刀勾陈=Yêu Đao Câu Trần
始南山=Thủy Nam Sơn
姑苏燕子坞=Cô Tô Yến Tử Ổ
姜若虚=Khương Nhược Hư
孙烈=Tôn Liệt
孙笑天=Tôn Tiếu Thiên
孟晴空=Mạnh Tình Không
安源巷=An Nguyên Hạng
宋丹阳=Tống Đan Dương
宋君喜=Tống Quân Hỉ
定禅法师=Định Thiền Pháp Sư
容山派=Dung Sơn Phái
寒冰真经=Hàn Băng Chân Kinh
寒江门=Hàn Giang Môn
寒鸦渡=Hàn Nha Độ
寒鸦渡镇=Hàn Nha Độ Trấn
尉迟奉=Úy Trì Phụng
小顾飞刀=Tiểu Cố Phi Đao
少商剑气=Thiếu Thương Kiếm Khí
尹天叶=Doãn Thiên Diệp
尺云斋=Xích Vân Trai
尺泽穴=Xích Trạch Huyệt
居延县=Huyện Cư Diên
岐山六怪=Kỳ Sơn Lục Quái
岭南府=Lĩnh Nam phủ
岭南沧山镇=Lĩnh Nam Thương Sơn Trấn
左右道人=Tả Hữu đạo nhân
左泽=Tả Trạch
左越=Tả Việt
常四=Thường Tứ
常四爷=Thường Tứ Gia
平壤县=Bình Nhưỡng Huyện
平泽县=Bình Trạch Huyện
平谷县=Bình Cốc huyện
幽冥昙花=U Minh Đàm Hoa
广阳侯=Quảng Dương Hầu
广阳侯府=Quảng Dương Hầu Phủ
广阳侯白朝仙=Quảng Dương Hầu Bạch Triều Tiên
广阳县=Quảng Dương Huyện
庞明山=Bàng Minh Sơn
张光宗=Trương Quang Tông
归常树=Quy Thường Thụ
彩云山庄=Thải Vân Sơn Trang
彩云庄园=Thải Vân Trang Viên
御赐金锏=Ngự Tứ Kim Giản
德照帝=Đức Chiếu Đế
怒潮帮=Nộ Triều Bang
惊神刀=Kinh Thần Đao
慧源=Tuệ Nguyên
房县县令=Huyện lệnh Phòng Huyện
拓拔虎=Thác Bạt Hổ
拓拔龙=Thác Bạt Long
拜月圣教=Bái Nguyệt Thánh Giáo
拜月教教主=Giáo Chủ Bái Nguyệt Giáo
拜月教教徒=Giáo đồ Bái Nguyệt Giáo
文永=Văn Vĩnh
方连山=Phương Liên Sơn
旋风拂柳剑=Tuyền Phong Phất Liễu Kiếm
无垢剑=Vô Cấu Kiếm
无常鬼叟=Vô Thường Quỷ Tẩu
无常鬼叟桑孤鸿=Vô Thường Quỷ Tẩu Tang Cô Hồng
无面鬼=Vô Diện Quỷ
旧雁巷=Cựu Nhạn Hạng
明玉屠众=Minh Ngọc Đồ Chúng
春神谷=Xuân Thần Cốc
曲叔=Khúc thúc
曲婶=Khúc thẩm
曲恒=Khúc Hằng
曲晓=Khúc Hiểu
曲李氏=Khúc Lý thị
木王后人=Mộc Vương Hậu Nhân
木王宝藏=Mộc Vương Bảo Tàng
木王府=Mộc Vương Phủ
木白风=Mộc Bạch Phong
杀手吴常=Sát Thủ Ngô Thường
李仲易=Lý Trọng Dịch
李仲青=Lý Trọng Thanh
李鲤=Lý Lí
杏林世家苏家=Hạnh Lâm thế gia Tô gia
杜总捕=Đỗ Tổng Bộ
杨唐=Dương Đường
杨廷云=Dương Đình Vân
杨放=Dương Phóng
杨桥=Dương Kiều
杨神通=Dương Thần Thông
杨青桐=Dương Thanh Đồng
林七娘=Lâm Thất Nương
林不起=Lâm Bất Khởi
林中居士=Lâm Trung Cư Sĩ
林中居士孟晴空=Lâm Trung Cư Sĩ Mạnh Tình Không
林向东=Lâm Hướng Đông
林向西=Lâm Hướng Tây
林振岳=Lâm Chấn Nhạc
林故=Lâm Cố
林栖霞=Lâm Tê Hà
林端云=Lâm Đoan Vân
枯心师太=Khô Tâm Sư Thái
柯问水=Kha Vấn Thủy
柳城县=Liễu Thành Huyện
柳城县尉=Liễu Thành Huyện Úy
柳总捕=Liễu Tổng Bộ
柳溪镇=Trấn Liễu Khê
柳若鸿=Liễu Nhược Hồng
桃花山庄=Đào Hoa Sơn Trang
桐山派=Đồng Sơn Phái
桑孤鸿=Tang Cô Hồng
梁金山=Lương Kim Sơn
梧桐派=Ngô Đồng Phái
楚云舟=Sở Vân Chu
楚天倾=Sở Thiên Khuynh
樊塘西=Phàn Đường Tây
武判官=Võ Phán Quan
武欢=Võ Hoan
段长梅=Đoạn Trường Mai
殷九娘=Ân Cửu Nương
永安县=Vĩnh An Huyện
江左天刀门=Giang Tả Thiên Đao Môn
江心岛=Giang Tâm Đảo
江晚照=Giang Vãn Chiếu
沈万刃=Thẩm Vạn Nhận
沈白=Thẩm Bạch
沙坨城=Sa Đà Thành
沙坨山=Sa Đà Sơn
沙晖=Sa Huy
沙陀寺=Sa Đà Tự
沙陀山=Sa Đà Sơn
沧山=Thương Sơn
沧山镇=Thương Sơn Trấn
沧州六扇门指挥使=Thương Châu Lục Phiến Môn Chỉ Huy Sứ
沧州大侠=Thương Châu Đại Hiệp
沧州天榜=Thương Châu Thiên Bảng
沧源城=Thương Nguyên Thành
沧源郡=Thương Nguyên quận
沧澜剑宗=Thương Lan Kiếm Tông
沧澜县地界=Địa giới Thương Lan Huyện
沧澜山=Thương Lan Sơn
沧澜山上=Thương Lan Sơn Thượng
河间县=Hà Gian Huyện
泥沙大法=Nê Sa Đại Pháp
淫魔上官尚=Dâm Ma Thượng Quan Thượng
深井屯=Thôn Thâm Tỉnh
清泉山庄=Thanh Tuyền Sơn Trang
溟江=Minh Giang
漠北魁首=Mạc Bắc Khôi Thủ
火鬼郭全=Hỏa Quỷ Quách Toàn
灭绝十字刀法=Diệt Tuyệt Thập Tự Đao Pháp
灵寂大师=Linh Tịch đại sư
灵渠散人=Linh Cừ Tán Nhân
灵犀剑=Linh Tê Kiếm
灵犀名剑=Linh Tê Danh Kiếm
灵素仙子=Linh Tố Tiên Tử
炎炎金身功=Viêm Viêm Kim Thân Công
炎玉重生=Viêm Ngọc Trùng Sinh
炎阳真气=Viêm Dương Chân Khí
焃墟=Hặc Khư
焃墟遗迹=Di tích Hách Khư
燕三娘=Yến Tam Nương
燕羡梅=Yến Tiện Mai
狂风乱拳=Cuồng Phong Loạn Quyền
独掌摩天=Độc Chưởng Ma Thiên
猫妖案=Miêu Yêu Án
玄城=Huyền Thành
玄天浮石=Huyền Thiên Phù Thạch
玄智=Huyền Trí
玄素功=Huyền Tố Công
玄虚内力=Huyền Hư Nội Lực
玄虚心法=Huyền Hư Tâm Pháp
玉无牙=Ngọc Vô Nha
玉虚祖师=Ngọc Hư Tổ Sư
王元宝=Vương Nguyên Bảo
王卫阳=Vương Vệ Dương
王威扬=Vương Uy Dương
王定涛=Vương Định Đào
王家庄园=Vương Gia Trang Viên
琼山派=Quỳnh Sơn Phái
留郡=Lưu quận
疾风刀萧烈=Tật Phong Đao Tiêu Liệt
疾风武馆=Tật Phong Võ Quán
疾风神捕=Tật Phong Thần Bộ
瘦道人=Sấu đạo nhân
白云剑沈白=Bạch Vân Kiếm Thẩm Bạch
白弃疗=Bạch Khí Liệu
白月使=Bạch Nguyệt Sứ
白月剑=Bạch Nguyệt Kiếm
白朝仙=Bạch Triều Tiên
白玉霜天=Bạch Ngọc Sương Thiên
白老掌门=Bạch lão chưởng môn
白虎分舵=Bạch Hổ Phân Đà
白虎舵=Bạch Hổ Đà
白鹤山庄=Bạch Hạc Sơn Trang
百胜神拳=Bách Thắng Thần Quyền
百花酒楼=Bách Hoa Tửu Lâu
百里震惊=Bách Lý Chấn Kinh
盘龙十三枪=Bàn Long Thập Tam Thương
石红叶=Thạch Hồng Diệp
碧灵涎=Bích Linh Tiên
祖观=Tổ Quán
神刀无敌=Thần Đao Vô Địch
神宗皇帝=Thần Tông Hoàng Đế
神猫观=Thần Miêu Quan
神风劲=Thần Phong Kính
福威追风楼=Phúc Uy Truy Phong Lâu
秋水名剑=Thu Thủy Danh Kiếm
秦铁=Tần Thiết
空明寺=Không Minh Tự
空明山=Không Minh sơn
窦若华=Đậu Nhược Hoa
童飞=Đồng Phi
竹山县=Trúc Sơn Huyện
竹山县唐家=Trúc Sơn Huyện Đường Gia
笑罗汉=Tiếu La Hán
素心庵=Tố Tâm Am
紫云楼=Tử Vân Lâu
红月使=Hồng Nguyệt Sứ
红玉残阳=Hồng Ngọc Tàn Dương
纯阳观=Thuần Dương Quan
细雨剑法=Tế Vũ Kiếm Pháp
绝云栈=Tuyệt Vân Sạn
绣坊云家=Tú Phường Vân gia
老哑巴=Lão Á Câm
老孙头=Lão Tôn Đầu
聂东流=Nhiếp Đông Lưu
肖子岩=Tiếu Tử Nham
肖家镇=Tiêu Gia Trấn
肖惊鸿=Tiêu Kinh Hồng
肖轩=Tiêu Hiên
胖瘦道人=Béo Gầy Đạo Nhân
胖道人=Bàn đạo nhân
腾腾镇=Đằng Đằng Trấn
至诚典当行=Chí Thành Điển Đương Hành
花间山=Hoa Gian Sơn
苏允姣=Tô Duẫn Giảo
苏千秋=Tô Thiên Thu
范一雄=Phạm Nhất Hùng
范玉云=Phạm Ngọc Vân
荣威镖局=Vinh Uy Tiêu Cục
荣郡=Vinh Quận
药圣齐妙玄=Dược Thánh Tề Diệu Huyền
莫清闲=Mạc Thanh Nhàn
莲花堂=Liên Hoa Đường
菊九阴=Cúc Cửu Âm
菊山阴=Cúc Sơn Âm
菩提偈=Bồ Đề Kệ
萧烈=Tiêu Liệt
萧破军=Tiêu Phá Quân
落英谷=Lạc Anh Cốc
藏锋谷=Tàng Phong Cốc
虚云劲=Hư Vân Kính
虫游县=Trùng Du Huyện
蜃砂谷=Thận Sa Cốc
血手婆婆=Huyết Thủ bà bà
血手范玉云=Huyết Thủ Phạm Ngọc Vân
血泪石蚌=Huyết Lệ Thạch Bạng
血煞神掌=Huyết Sát Thần Chưởng
血玉屠众=Huyết Ngọc Đồ Chúng
血鼎真经=Huyết Đỉnh Chân Kinh
袁家屯=Viên Gia Thôn
袁珠=Viên Châu
裴即玉=Bùi Tức Ngọc
裴破霄=Bùi Phá Tiêu
西川剑派=Tây Xuyên Kiếm Phái
觉尘=Giác Trần
谢怀州=Tạ Hoài Châu
谢总捕=Tạ Tổng Bộ
谢明忠=Tạ Minh Trung
谢流萤=Tạ Lưu Huỳnh
贵远县=Quý Viễn Huyện
赤炎老怪=Xích Diễm Lão Quái
赤面兽杨唐=Xích Diện Thú Dương Đường
赵丛岳=Triệu Tùng Nhạc
赵从武=Triệu Tòng Võ
跗骨书生=Phụ Cốt thư sinh
迷障谷=Mê Chướng Cốc
追风楼=Truy Phong Lâu
追魂太保=Truy Hồn Thái Bảo
追魂无常=Truy Hồn Vô Thường
追魂鞭樊塘西=Truy Hồn Tiên Phàn Đường Tây
通县=Thông Huyện
通江县=Thông Giang huyện
造化圣丹=Tạo Hóa Thánh Đan
邢太冲=Hình Thái Xung
野狼秦彻=Dã Lang Tần Triệt
金兰府=Kim Lan phủ
金刚铁布衫=Kim Cương Thiết Bố Sam
金掌帮=Kim Chưởng Bang
金杯书生=Kim Bôi thư sinh
金泉帮=Kim Tuyền Bang
金花鬼婆=Kim Hoa Quỷ Bà
钟连山=Chung Liên Sơn
钱二爷=Tiền Nhị Gia
钱岳=Tiền Nhạc
钱旭=Tiền Húc
钱益之=Tiền Ích Chi
钱蛮=Tiền Man
铁手判官=Thiết Thủ Phán Quan
铁掌谭冲=Thiết Chưởng Đàm Xung
铁摩勒=Thiết Ma Lặc
铁烛=Thiết Chúc
铁罗汉玄智=Thiết La Hán Huyền Trí
铁面阎罗=Thiết Diện Diêm La
铜台城=Đồng Đài Thành
铜牛派=Đồng Ngưu Phái
银狐案=Ngân Hồ Án
镇岳功=Trấn Nhạc Công
长岭县=Trường Lĩnh Huyện
长眉剑派=Trường Mi Kiếm Phái
长风镖局=Trường Phong tiêu cục
问剑崖=Vấn Kiếm Nhai
问道门=Vấn Đạo Môn
阎王愁=Diêm Vương Sầu
阎罗点卯=Diêm La Điểm Mão
阳山老叟=Dương Sơn Lão Tẩu
阿绿=A Lục
陆应川=Lục Ứng Xuyên
陆残阳=Lục Tàn Dương
陈云樵=Trần Vân Tiều
陈修远=Trần Tu Viễn
陈指挥使=Trần Chỉ Huy Sứ
陈通玄=Trần Thông Huyền
陨星诀=Vẫn Tinh Quyết
雪岭双仙=Tuyết Lĩnh Song Tiên
雪岭山庄=Tuyết Lĩnh Sơn Trang
零陵百里香=Linh Lăng Bách Lý Hương
雷老拳师=Lôi Lão Quyền Sư
霹雳神剑=Bích Lịch Thần Kiếm
青云老道=Thanh Vân Lão Đạo
青叶堂=Thanh Diệp Đường
青叶堂主=Thanh Diệp Đường chủ
青岩古驿=Thanh Nham Cổ Dịch
青州九义=Thanh Châu Cửu Nghĩa
青州兵圣=Thanh Châu Binh Thánh
青州城神兵山庄=Thanh Châu Thành Thần Binh Sơn Trang
青州武林=Thanh Châu Võ Lâm
青州武林盟=Thanh Châu Võ Lâm Minh
青州第一美女=Thanh Châu Đệ Nhất Mỹ Nữ
青平巷=Thanh Bình Hạng
青阳武林=Thanh Dương Võ Lâm
青阳郡=Thanh Dương Quận
青龙分舵=Thanh Long Phân Đà
静娴师太=Tĩnh Nhàn Sư Thái
静慈师太=Tĩnh Từ Sư Thái
韩希仁=Hàn Hy Nhân
顾初冬=Cố Sơ Đông
顾瞎子=Cố Mù
顾陌=Cố Mạch
风云一=Phong Vân 1
风云二=Phong Vân 2
飞云九天=Phi Vân Cửu Thiên
飞天山=Phi Thiên Sơn
飞马帮=Phi Mã Bang
马季常=Mã Quý Thường
马宅=Mã Trạch
马王屯=Mã Vương Truân
马青雄=Mã Thanh Hùng
驼铃镇=Trấn Đà Linh
驼铃镇僵尸事件=Sự kiện cương thi Trấn Đà Linh
鬼哭岭=Quỷ Khốc Lĩnh
鬼工先生=Quỷ Công tiên sinh
鬼面婆婆=Quỷ Diện Bà Bà
魏无为=Ngụy Vô Vi
鱼十九=Ngư Thập Cửu
鱼十二=Ngư Thập Nhị
鱼十八=Ngư Thập Bát
麒麟秘宝=Kỳ Lân Bí Bảo
黄英融=Hoàng Anh Dung
黑月使=Hắc Nguyệt Sứ
鼎鼎有名的杀手=Sát thủ nổi tiếng
齐天枢=Tề Thiên Xu
齐妙玄=Tề Diệu Huyền
齐玲玲=Tề Linh Lung
龙口县=Long Khẩu Huyện
龙虎双雄=Long Hổ Song Hùng
龙门派=Long Môn Phái
