****=****
145789=145789
198742=198742
2333=2333
2500=2500
2V2=2V2
Avenger=Avenger
Come=Come
Emmm=Emmm
GOD=GOD
KPI=KPI
NYPD=NYPD
OMG=OMG
P9=P9
PPT=PPT
PY=PY
SS=SS
SSS=SSS
T1=T1
T2=T2
T3=T3
What=What
YES=YES
fuc*=fuck
giegie=giegie
ntr=NTR
《佛说力士移山经》=《Phật Thuyết Lực Sĩ Di Sơn Kinh》
《山坟》=《Sơn Phần》
《形坟》=《Hình Phần》
《梦中斩龙》=《Mộng Trung Trảm Long》
《气坟》=《Khí Phần》
《百草经》=《Bách Thảo Kinh》
《皇极经世书》=《Hoàng Cực Kinh Thế Thư》
《蚩尤三盘经》=《Xi Vưu Tam Bàn Kinh》
《阴符经》=《Âm Phù Kinh》
一些天才=một vài thiên tài
一千个人类=một ngàn nhân loại
一口吃喝=một ngụm ăn uống
一口闷气=một hơi ngột ngạt
一如观音=Nhất Như Quan Âm
一尺之捶=Nhất Xích Chi Chùy
一念三千界=Nhất Niệm Tam Thiên Giới
一掌门=một chưởng môn
一本道藏=một bảng Đạo Tàng
一条龙影=một cái long ảnh
一气化三千=Nhất Khí Hóa Tam Thiên
一气大擒拿=Nhất Khí Đại Cầm Nã
一炁化三皇=Nhất Khí Hóa Tam Hoàng
一针一线=một mũi kim một sợ chỉ
一阳初生=Nhất Dương Sơ Sinh
丁勉=Đinh Miễn
丁巳=Đinh Tỵ
丁巳月=Đinh Tị nguyệt
丁酉=Đinh Dậu
丁震=Đinh Chấn
七佛灭罪=Thất Phật Diệt Tội
七佛灭罪真言=Thất Phật Diệt Tội Chân Ngôn
七叶断肠草=Thất Diệp Đoạn Trường Thảo
七尊神将=Thất Tôn Thần Tướng
七星河=Thất Tinh hà
七杀廉贞，路上埋尸=Thất Sát Liêm Trinh, Lộ Thượng Mai Thi
七杀星辰=Thất Sát Tinh Thần
七杀破军，羊铃为虐=Thất Sát Phá Quân, Dương Linh Vi Ngược
七殿之主=Thất Điện Chi Chủ
七邪荼黎=Thất Tà Đồ Lê
万仙大教=Vạn Tiên Đại Giáo
万佛窟=Vạn Phật Quật
万化生乎身=Vạn Hóa Sinh Hồ Thân
万卿=Vạn Khanh
万叶飞花掌=Vạn Diệp Phi Hoa Chưởng
万司主=Vạn ti chủ
万归龙=Vạn Quy Long
万星袍=Vạn Tinh Bào
万木朝春=Vạn Mộc Triều Xuân
万物母气根=Vạn Vật Mẫu Khí Căn
万辅座=Vạn Phụ Tọa
万里乾坤符=Vạn Dặm Càn Khôn Phù
万里荒漠=Vạn Lí Hoang Mạc
万鼎天=Vạn Đỉnh Thiên
三之大刀=tam chi đại đao
三五火车雷公=Tam Ngũ Hỏa Xa Lôi Công
三位大士=Tam Vị Đại Sĩ
三使=tam sứ
三十三相·龙头观音=Tam Thập Tam Tướng · Long Đầu Quan Âm
三十六柄天罡刀=Ba mươi sáu thanh Thiên Cương Đao
三十六渠帅=Tam Thập Lục Cừ Soái
三千六百郡=3600 quận
三品·大自在天道果=Tam phẩm · Đại Tự Tại Thiên Đạo Quả
三垣二十八宿=Tam Viên Nhị Thập Bát Tú
三大劫法=Tam Đại Kiếp Pháp
三奇六仪=Tam Kỳ Lục Nghi
三如来=Tam Như Lai
三尸咒·邪罗灭元=Tam Thi Chú - Tà La Diệt Nguyên
三山之地=Tam Sơn chi địa
三州=Tam Châu
三昧耶印=Tam Muội Da Ấn
三洞=Tam Động
三洞之元=Tam Động Chi Nguyên
三清元神=Tam Thanh Nguyên Thần
三清派=Tam Thanh Phái
三清神像=Tượng Tam Thanh
三清道器=Tam Thanh Đạo Khí
三清道果=Đạo quả Tam Thanh
三煞位=Tam Sát Vị
三界亚君=Tam Giới Á Quân
三百六十五个洞天=Ba Trăm Sáu Mươi Lăm Động Thiên
三皇派=Tam Hoàng Phái
三相化生=Tam Tương Hóa Sinh
三相化生妙法=Tam Tương Hóa Sinh Diệu Pháp
三省吾身=Tam Tỉnh Ngô Thân
三美元=ba đô la
上仙·吕洞宾=Thượng Tiên · Lã Động Tân
上武者=thượng võ giả
上清凌虚子=Thượng Thanh Lăng Hư Tử
上清洞天=Thượng Thanh Động Thiên
上清派掌门=Thượng Thanh Phái Chưởng Môn
上神都=Thượng Thần Đô
不二观音=Bất Nhị Quan Âm
不得自在=không được tự tại
不空光明遍照=Bất Không Quang Minh Biến Chiếu
与愿印=Dữ Nguyện Ấn
世本=Thế Bản
世纪伟才=thế kỉ vĩ tài
丘怀安=Khâu Hoài An
丙午日=Ngày Bính Ngọ
丙子日=Bính Tý nhật
业如来=Nghiệp Như Lai
东华古树=Đông Hoa Cổ Thụ
东华宝树=Đông Hoa Bảo Thụ
东平王=Đông Bình Vương
东平郡王=Đông Bình quận vương
东方净琉璃世界=Thế giới Tịnh Lưu Ly phương Đông
东方忌=Đông Phương Kỵ
东方药师琉璃光王如来=Đông Phương Dược Sư Lưu Ly Quang Vương Như Lai
东昆虚=Đông Côn Khư
东林之战=Đông Lâm Chi Chiến
东林县=Đông Lâm Huyện
东林城=Đông Lâm Thành
东海分水将军=Đông Hải Phân Thủy Tướng Quân
东海郡王=Đông Hải Quận Vương
东王公道果=Đông Vương Công Đạo Quả
东胜大神洲=Đông Thắng Đại Thần Châu
东阳长公主=Đông Dương Trưởng Công Chúa
两个妹子=hai cái muội tử
两个家丁=hai tên gia đinh
两个小姑娘=hai tiểu cô nương
两个道童=hai cái Đạo đồng
两个道童模样=hai cái đạo đồng bộ dáng
两人修为=hai người tu vi
两人内力=hai người nội lực
两人血战=hai người huyết chiến
两人还是=hai người vẫn là
两啥东西=hai vật gì
两天帝=hai Thiên Đế
两界十方=Lưỡng Giới Thập Phương
两禁=hai cấm
个道童模样=đạo đồng bộ dáng
中土蛮子=Trung Thổ Man Tử
中天北极紫微大帝=Trung Thiên Bắc Cực Tử Vi Đại Đế
中天紫微大帝=Trung Thiên Tử Vi Đại Đế
中岳图=Trung Nhạc Đồ
中指峰=Trung Chỉ Phong
中黄太一=Trung Hoàng Thái Nhất
丰沮=Phong Trở
临山=Lâm Sơn
临山镇=Lâm Sơn trấn
丹虚子=Đan Hư Tử
为什么穿着=tại sao nên mặc
丽城=Lệ Thành
举头三尺有神明=ngẩn đầu ba thước có thần minh
之字形=hình chữ z
乐的=vui
乔山岛=Kiều Sơn Đảo
乔纳=Jonah
乙丑月=Ất Sửu Nguyệt
乙巳占=Ất Tị Chiêm
乙巳年=Ất Tỵ Niên
九仪天尊剑=Cửu Nghi Thiên Tôn Kiếm
九元岛=Cửu Nguyên Đảo
九元煞童=Cửu Nguyên Sát Đồng
九光宝苑=Cửu Quang Bảo Uyển
九华寺=Cửu Hoa Tự
九地锁天罡=Cửu Địa Tỏa Thiên Cương
九天十地十九神魔=Cửu Thiên Thập Địa Thập Cửu Thần Ma
九天应元普化天尊=Cửu Thiên Ứng Nguyên Phổ Hóa Thiên Tôn
九天聚仙=Cửu Thiên Tụ Tiên
九天聚仙阵=Cửu Thiên Tụ Tiên Trận
九天荡魔真气=Cửu Thiên Đãng Ma Chân Khí
九天荡魔真诀=Cửu Thiên Đãng Ma Chân Quyết
九天雷霆=Cửu Thiên Lôi Đình
九如袈裟=Cửu Như Ca Sa
九妙=Cửu Diệu
九宫乾天=Cửu Cung Càn Thiên
九州八十一郡=Cửu Châu Bát Thập Nhất Quận
九州山河社稷之图=Cửu Châu Sơn Hà Xã Tắc Chi Đồ
九州版图=Cửu Châu Bản Đồ
九幽之神=Cửu U Chi Thần
九幽素女=Cửu U Tố Nữ
九幽素阴元女道体=Cửu U Tố Âm Nguyên Nữ Đạo Thể
九泉心诀=Cửu Tuyền Tâm Quyết
九灲（xiāo）离经=Cửu Tiêu Ly Kinh
九玄代身符=Cửu Huyền Đại Thân Phù
九生九灭=cửu sinh cửu diệt
九索=Cửu Tác
九虫诀=Cửu Trùng Quyết
九虫诀·噙血荡元=Cửu Trùng Quyết · Hàm Huyết Đãng Nguyên
九重的=cửu trọng
九黎刀章=Cửu Lê Đao Chương
九黎刀经=Cửu Lê Đao Kinh
九黎寰空=Cửu Lê Hoàn Không
九黎寰空界法=Cửu Lê Hoàn Không Giới Pháp
九黎寰空禁法=Cửu Lê Hoàn Không Cấm Pháp
九黎氏=Cửu Lê Thị
九龙拉棺=Cửu Long Kéo Quan
乱神咒=Loạn Thần Chú
乾剑道=Càn Kiếm Đạo
乾坤易=Càn Khôn Dịch
乾宁=Càn Ninh
乾形天=Càn Hình Thiên
乾阳殿=Càn Dương Điện
了一会=một hồi
二人的脑海中=hai người trong óc
二品道果=Nhị Phẩm Đạo Quả
二圣庙=Nhị Thánh Miếu
二柱子=nhị trụ tử
二郎神·杨戬=Nhị Lang Thần - Dương Tiễn
于安=Vu An
于潺亭县=Vu Sằn Đình Huyện
于琴弦=Vu Cầm Huyền
云九夜=Vân Cửu Dạ
云华天女=Vân Hoa Thiên Nữ
云县=Vân Huyện
云县姜家=Vân Huyện Khương Gia
云县姜氏=Vân Huyện Khương Thị
云明郡=Vân Minh Quận
云明阁=Vân Minh Các
云海天光镜=Vân Hải Thiên Quang Kính
云莱岛=Vân Lai Đảo
云衣=Vân Y
五丁开山符=Ngũ Đinh Khai Sơn Phù
五丁都司=Ngũ Đinh Đô Tư
五兵=Ngũ Binh
五力士符=Ngũ Lực Sĩ Phù
五岳之形=Ngũ Nhạc Chi Hình
五岳印=Ngũ Nhạc Ấn
五岳真形图=Ngũ Nhạc Chân Hình Đồ
五浊之剑=Ngũ Trược Chi Kiếm
五浊恶气=Ngũ Trọc Ác Khí
五炁星君=Ngũ Khí Tinh Quân
五炁玄都=Ngũ Khí Huyền Đô
五炁真君=Ngũ Khí Chân Quân
五经博士=Ngũ Kinh bác sĩ
五莲之体=Ngũ Liên Chi Thể
五道将军=Ngũ Đạo Tướng Quân
五道将军姬玄通=Ngũ Đạo Tướng Quân Cơ Huyền Thông
五道轮回=Ngũ đạo luân hồi
五雷都司=Ngũ Lôi Đô Tư
亦有此能=cũng có này năng lực
京兆府左内史=Kinh Triệu Phủ Tả Nội Sử
人元果=Nhân Nguyên Quả
人王·禹=Nhân Vương · Vũ
人的精神=người tinh thần
人的脑海中=trong đầu người
人的身躯=người thân thể
人类的=nhân loại
人类的力量=nhân loại lực lượng
人血战=người huyết chiến
人间巅峰=Nhân Gian Đỉnh Phong
从武者=từ võ giả
他化自在六天=Tha Hóa Tự Tại Lục Thiên
他化自在天主=Tha Hóa Tự Tại Thiên Chủ
他化自在天主——大自在天子波旬=Tha Hóa Tự Tại Thiên Chủ - Đại Tự Tại Thiên Tử Ba Tuần
代王=Đại Vương
以元经会=Dĩ Nguyên Kinh Hội
任一掌门= bất kỳ một chưởng môn
任子和=Nhậm Tử Hòa
任桑=Nhậm tang
任海=Nhậm Hải
伏山臣=Phục Sơn Thần
伏羲大神=Phục Hy Đại Thần
伏羲真灵=Phục Hy Chân Linh
伏羲血脉=Phục Hy Huyết Mạch
伏羲道果=Đạo quả Phục Hy
众星化海=Chúng Tinh Hóa Hải
众星法域=Chúng Tinh Pháp Vực
众星法界=Chúng Tinh Pháp Giới
伞盖山=Tán Cái Sơn
伟岸存在=vĩ ngạn tồn tại
传说中神魔=trong truyền thuyết thần ma
传送到=truyền tống đến
体会飞行=trải nghiệm phi hành
何罗=Hà La
何罗神=Hà La Thần
余深=Dư Thâm
余老狗=Dư lão cẩu
佛国灵台山=Phật Quốc Linh Đài Sơn
佛土空间=Không gian Phật thổ
佛狱=Phật Ngục
佛狱业印=Phật Ngục Nghiệp Ấn
佛狱第四王=Phật Ngục Đệ Tứ Vương
佛系=Phật hệ
佛说力士移山经=Phật Thuyết Lực Sĩ Di Sơn Kinh
佛门六字大明咒=Phật Môn Lục Tự Đại Minh Chú
作家助手=Trợ lý tác giả
你家的面=nhà ngươi mỳ
佩珀=Rhodes
便当=cơm hộp¦liền đem¦tiện lợi¦tiện lợi¦thuận tiện¦đơn giản¦dễ dàng¦bento
俊朗的年轻人=tuấn lãng thanh niên
俞总兵=Du tổng binh
修凡=Tu Phàm
修罗鬼面=Tu La Quỷ Diện
借形代果符=Tá Hình Đại Quả Phù
做件事情=làm một sự tình
傅昌鼎=Phó Xương Đỉnh
傩面=Na Diện
僧邸佛钟=Tăng Để Phật Chung
儒门绝箭·射天狼=Nho Môn Tuyệt Tiễn · Xạ Thiên Lang
元妙先生=Nguyên Diệu tiên sinh
元始祖师=Nguyên Thủy Tổ Sư
元帅横天乱地咒=Nguyên Soái Hoành Thiên Loạn Địa Chú
元浮散人=Nguyên Phù Tán Nhân
元经=Nguyên Kinh
元经会=Nguyên Kinh Hội
先天乾坤功=Tiên Thiên Càn Khôn Công
先天八景功=Tiên Thiên Bát Cảnh Công
先天八炁=Tiên Thiên Bát Khí
先天坎离水火=Tiên Thiên Khảm Ly Thủy Hỏa
先天山炁=Tiên Thiên Sơn Khí
先天易剑=Tiên Thiên Dịch Kiếm
先天木炁=Tiên Thiên Mộc Khí
先天火炁=Tiên Thiên Hỏa Khí
先天真身=Tiên Thiên Chân Thân
先天真身法=Tiên Thiên Chân Thân Pháp
先天西华=Tiên Thiên Tây Hoa
先天西华妙气=Tiên Thiên Tây Hoa Diệu Khí
先天金炁=Tiên Thiên Kim Khí
先天风炁=Tiên Thiên Phong Khí
先蚕神=Tiên Tằm Thần
光聚佛顶印=Quang Tụ Phật Đỉnh Ấn
全新的壳=mới tinh vỏ bọc
八十一郡=Bát Thập Nhất Quận
八十八佛=Tám mươi tám vị Phật
八卦紫绶衣=Bát Quái Tử Thụ Y
八岐大神=Bát Kỳ Đại Thần
八峰山=Bát Phong Sơn
八景山=Bát Cảnh Sơn
八极坤地=Bát Cực Khôn Địa
八正城=Bát Chính Thành
八神主=Bát Thần Chủ
八荒六合唯我独尊功=Bát Hoang Lục Hợp Duy Ngã Độc Tôn Công
八荒凶神=Bát Hoang Hung Thần
八邪秽世=Bát Tà Uế Thế
八邪罗生=Bát Tà La Sinh
八部天龙广力普萨之相=Bát Bộ Thiên Long Quảng Lực Phổ Tát Chi Tướng
八部天龙广力菩萨=Bát Bộ Thiên Long Quảng Lực Bồ Tát
公孙元希=Công Tôn Nguyên Hi
公孙太乘=Gongsun Taicheng
公孙家主=Công Tôn Gia Chủ
公孙寿=Công Tôn Thọ
公孙弃=Công Tôn Khí
公孙皇后=Công Tôn Hoàng Hậu
公孙羽流=Công Tôn Vũ Lưu
公孙青玥=Công Tôn Thanh Nguyệt
公明哥哥=Công Minh ca ca
公羊学派=Công Dương Học Phái
六丁六甲护身符=Lục Đinh Lục Giáp hộ thân phù
六丁六甲符=Lục Đinh Lục Giáp Phù
六仪八卦=Lục Nghi Bát Quái
六合符阵=Lục Hợp Phù Trận
六品道器=Lục Phẩm Đạo Khí
六景=Lục Cảnh
六欲天女=Lục Dục Thiên Nữ
六耳神通=Lục Nhĩ Thần Thông
六识颠倒=Lục thức điên đảo
六轮太阳法相=Lục Luân Thái Dương Pháp Tướng
六道轮回浮屠禁典=Lục Đạo Luân Hồi Phù Đồ Cấm Điển
六邪入体=lục tà nhập thể
六阴鬼王=Lục Âm Quỷ Vương
六龙之车=Lục Long chi xa
六龙天车=Lục Long Thiên Xa
关武阳=Quan Vũ Dương
关玉山=Quan Ngọc Sơn
兵主蚩尤=Binh Chủ Xi Vưu
其性命=kỳ tính mệnh
养志法灵龟=Dưỡng Chí Pháp Linh Quy
养气符=Dưỡng Khí Phù
养生主=Dưỡng Sinh Chủ
兼山物=Kiêm Sơn Vật
再弱鸡=yếu gà hơn nữa
军神五兵=Quân Thần Ngũ Binh
军神四兵=Quân Thần Tứ Binh
军荼利明王菩萨=Quân Trà Lợi Minh Vương Bồ Tát
冤种=ngu ngốc
冬神=Đông Thần
冯正=Phùng Chính
冰水双属性=băng thủy song thuộc tính
冲和道人=Xung Hòa đạo nhân
冲虚=Xung Hư¦xung hư
冲虚堪道=Xung Hư Kham Đạo
冲虚真人·列子=Trùng Hư Chân Nhân · Liệt Tử
冲虚道长=Xung Hư đạo trưởng
净坤体=Tịnh Khôn Thể
净天地神咒=Tịnh Thiên Địa Thần Chú
凌无觉=Lăng Vô Giác
凌霄宝殿四大元帅=Lăng Tiêu Bảo Điện Tứ Đại Nguyên Soái
凤凰印=Phượng Hoàng Ấn
凤凰变=Phượng Hoàng Biến
凤泉河=Phượng Tuyền hà
凰君=Hoàng Quân
分享的=chia sẻ
分威法伏熊=Phân Uy Pháp Phục Hùng
分秋剑=Phân Thu Kiếm
刑囚夹印，刑杖惟司=Hình Tù Giáp Ấn, Hình Trượng Duy Tư
刑德=Hình Đức
刑遇贪狼=Hình Ngộ Tham Lang
刘高=Lưu Cao
判官·钟馗=Phán Quan · Chung Quỳ
判官崔珏=Phán Quan Thôi Giác
剑斩天机=Kiếm Trảm Thiên Cơ
剪云峰=Tiễn Vân Phong
功曹道果=Công Tào Đạo Quả
勾招法=Câu Chiêu Pháp
勾陈上宫天皇大帝=Câu Trần Thượng Cung Thiên Hoàng Đại Đế
勾陈六星=Câu Trần Lục Tinh
勾陈真灵=Câu Trần Chân Linh
勾陈道果=Câu Trần Đạo Quả
北小年=Bắc Tiểu Niên
北山经=Bắc Sơn Kinh
北斗七元=Bắc Đẩu Thất Nguyên
北斗七元符=Bắc Đẩu Thất Nguyên Phù
北斗九皇=Bắc Đẩu Cửu Hoàng
北斗破军星=Bắc Đẩu Phá Quân Tinh
北极四圣=Bắc Cực Tứ Thánh
北极天柱=Bắc Cực Thiên Trụ
北极神数=Bắc Cực Thần Số
北玄=Bắc Huyền
北辰星=Bắc Thần tinh
北辰辨=Bắc Thần Biện
十九神魔=Thập Cửu Thần Ma
十二药叉=Thập Nhị Dược Xoa
十二药叉大将=Thập Nhị Dược Xoa Đại Tướng
十字坡=Thập Tự sườn núi
千手一族=Senju Nhất Tộc
千手纲手=Senju Tsunade
千秋永存=Thiên Thu Vĩnh Tồn
千里之地=Thiên Lí Chi Địa
千钧臂=Thiên Quân Tí
半桶子=nửa thùng
华山上下=Hoa Sơn trên dưới
华山论键=Hoa Sơn luận kiếm
华岳神女=Hoa Nhạc Thần Nữ
华而不败=Hoa Nhi Bất Bại
华阳公主=Hoa Dương công chúa
华阳公主府=Phủ Hoa Dương Công chúa
华阳长公主=Hoa Dương Trưởng công chúa
南天司=Nam Thiên Tư
南天司枢使·左招=Nam Thiên Tư Xu Mật Sử · Tả Chiêu
南方天帝=Nam Phương Thiên Đế
南无大日如来毗卢遮那佛=Nam Mô Đại Nhật Như Lai Tỳ Lô Giá Na Phật
南明阁=Nam Minh Các
南极长生大帝=Nam Cực Trường Sinh Đại Đế
南离宫=Nam Ly Cung
南飞云=Nam Phi Vân
卢川郡=Lô Xuyên Quận
厉罡天斩=Lệ Cương Thiên Trảm
厚厚的冰霜=thật dày băng sương
原位面=nguyên vị diện
去成长=để trưởng thành
口火炉=khẩu hỏa lô
古代世界观=cổ đại thế giới quan
古老王朝=Cổ Lão Vương Triều
古色古香的书籍=cổ kính thư tịch
可以对标=có thể đối tiêu
可能才=khả năng mới
史夫人声音=Sử phu nhân thanh âm
史莱克学院=Sử Lai Khắc Học Viện
史蒂芬·方=Stephen Fang
右弼=Hữu Bật
右手=tay phải¦bên phải
叶雨迟=Diệp Vũ Trì
司兵参军=Tư Binh Tham Quân
司录参军=Tư Lục Tham Quân
司晨啼晓=Tư Thần Đề Hiểu
司法参军=Tư Pháp Tham Quân
司法天神·杨戬=Tư Pháp Thiên Thần - Dương Tiễn
司空姜离=Tư Không Khương Ly
吃瓜=ăn dưa
同袍手足=đồng bào thủ túc
后土皇地祇=Hậu Thổ Hoàng Địa Kỳ
后土皇地祗=Hậu Thổ Hoàng Địa Kỳ
后土相=Hậu Thổ Tướng
后天人种袋=Hậu Thiên Nhân Chủng Túi
吐出一口闷气=thở phào một hơi
向怀义=Hướng Hoài Nghĩa
向枢使=Hướng Khu Sứ
吕天蓬=Lữ Thiên Bồng
吕忘机=Lữ Vong Cơ
吕良=Lữ Lương
启明星君=Khải Minh Tinh Quân
吴都=Ngô Đô
周明云=Chu Minh Vân
呼出一口闷气=thở phào một cái
命也=mệnh cũng
命门关=Mệnh Môn Quan
和业如来=Hòa Nghiệp Như Lai
哪都通=Na Đô Thông
唐合=Đường Hợp
唯美若=duy mỹ như
唳鸣=lệ minh
商剑陵=Thương Kiếm Lăng
啸命风雷=Khiếu Mệnh Phong Lôi
善乐城=Thiện Lạc Thành
善乐天女=Thiện Lạc Thiên Nữ
喷射战士=Splatoon
噙血荡元=Hàm huyết đãng nguyên
器阁=Khí Các
器阁长老=Khí Các trưởng lão
四大阿修罗王=Tứ Đại A Tu La Vương
四姓家犬=Tứ Tính Gia Khuyển
四季花=Tứ Quý Hoa
四宫主=Tứ Cung Chủ
四极天柱=Tứ Cực Thiên Trụ
四海朝元阵=Tứ Hải Triều Nguyên Trận
四皇子姬承源=Tứ hoàng tử Cơ Thừa Nguyên
回春符=Hồi Xuân Phù
回的= về
因果集=Nhân Quả Tập
团藏大人=Danzo đại nhân
圜丘台=Hoàn Khâu Đài
圣人眼=Thánh Nhân mắt
圣婴大王=Thánh Anh Đại Vương
圣德太子姬继稷=Thánh Đức Thái Tử Cơ Kế Tắc
圣莲卍化=Thánh Liên Vạn Hóa
在景阳=tại Cảnh Dương
在观战席=tại quan chiến vị trí
地云黄霙=Địa Vân Hoàng Anh
地仙之祖·镇元子=Địa Tiên Chi Tổ · Trấn Nguyên Tử
地祇神域=Địa Kỳ Thần Vực
地空=Địa Không
地走进=mà đi vào
地风升=Địa Phong Thăng
坟墓的事情=phần mộ sự tình
坤阴真元=Khôn Âm Chân Nguyên
增福神=Tăng Phúc Thần
墨夷陵=Mặc Di Lăng
墨武刀=Mặc Võ Đao
墨武剑=Mặc Vũ Kiếm
墨武战匣=Mặc Võ Chiến Hạp
墨玄空=Mặc Huyền Không
墨绿色血液=dòng máu màu xanh sẫm
墨辩=Mặc Biện
墨门矩子=Mặc Môn Củ Tử
墨门矩子墨玄空=Mặc Môn Củ Tử Mặc Huyền Không
墨雨蝶=Mặc Vũ Điệp
壬戌月=Tháng Nhâm Tuất
壬水神雷=Nhâm Thủy Thần Lôi
壬申日=Nhâm Thân Nhật
壮壮胆气=tăng chút dũng khí
复古派=Phái Phục Cổ
夏禾=Hạ Hòa
夏至日=Hạ Chí Nhật
夔牛变=Quỳ Ngưu Biến
夔牛道果=Quỳ Ngưu đạo quả
夔鼓=Khuy Cổ
夔鼓雷音=Quỳ Cổ Lôi Âm
外门长老=ngoại môn trưởng lão
多如果=nhiều nếu như
夜帝=Dạ Đế
大乘教=Đại Thừa Giáo
大乘魔掌=Đại Thừa Ma Chưởng
大乾王朝=Đại Càn Vương Triều
大公公曹林=Đại công công Tào Lâm
大兴郡=Đại Hưng Quận
大周姬氏=Đại Chu Cơ thị
大周律=Đại Chu Luật
大周朝廷=Đại Chu Triều Đình
大圆镜智=Đại Viên Kính Trí
大圜=Đại Hoàn
大圜剑=Đại Hoàn Kiếm
大圜剑光=Đại Hoàn Kiếm Quang
大圜劍=Đại Hoàn Kiếm
大圣女=Đại Thánh Nữ
大宇轮转=Đại Vũ Luân Chuyển
大宗正=Đại Tông Chính
大封=Đại Phong
大工不巧=đại công bất xảo
大常=Đại Thường
大日如来法印=Đại Nhật Như Lai Pháp Ấn
大日如来金刚印=Đại Nhật Như Lai Kim Cang Ấn
大日笼御=Đại Nhật Lung Ngự
大明殿=Đại Minh Điện
大汉气势=đại hán khí thế
大消息=đại tin tức
大皇子姬承天=Đại Hoàng Tử Cơ Thừa Thiên
大自在天主业如来=Đại Tự Tại Thiên Chủ Nghiệp Như Lai
大荒东经=Đại Hoang Đông Kinh
大荒北经=Đại Hoang Bắc Kinh
大荒西经=Đại Hoang Tây Kinh
大菩萨·地藏=Đại Bồ Tát Địa Tạng
大行山脉=Đại Hành Sơn Mạch
大衍五十=Đại Diễn Ngũ Thập
大道五十=Đại Đạo 50
大野木=Ōnoki
大雷音剑诀=Đại Lôi Âm Kiếm Quyết
大鲲老人=Đại Côn Lão Nhân
天下三剑=Thiên Hạ Tam Kiếm
天下大势=thiên hạ đại thế
天下第一搅屎棍=Thiên Hạ Đệ Nhất Giảo Thỉ Côn
天之刃=Thiên Chi Nhận
天之厉=Thiên Chi Lệ
天之厉刃=Thiên Chi Lệ Nhận
天之相=Thiên Chi Tướng
天人共尊=Thiên Nhân Cộng Tôn
天仙·白云子=Thiên Tiên · Bạch Vân Tử
天元台=Thiên Nguyên Đài
天元洞天=Thiên Nguyên Động Thiên
天兮·堕乾坤=Thiên Hề · Đọa Càn Khôn
天兵神威=Thiên Binh Thần Uy
天剑绝=Thiên Kiếm Tuyệt
天厉刃=Thiên Lệ Nhận
天君·公孙弃=Thiên Quân - Công Tôn Khí
天君公孙弃=Thiên Quân Công Tôn Khí
天君姬继稷=Thiên Quân Cơ Kế Tắc
天地二景=Thiên Địa Nhị Cảnh
天地人神四盘=Thiên Địa Nhân Thần Tứ Bàn
天埑=Thiên Triệt
天女魃=Thiên Nữ Bạt
天子命格=Thiên Tử mệnh cách
天子玉玺=Thiên Tử Ngọc Tỉ
天子道果=Thiên Tử Đạo Quả
天子魔=Thiên Tử Ma
天将·顺风耳=Thiên Tướng - Thuận Phong Nhĩ
天山遁=Thiên Sơn Độn
天府云波符=Thiên Phủ Vân Ba Phù
天庭四御=Thiên Đình Tứ Ngự
天庭玉帝=Thiên Đình Ngọc Đế
天心正法=Thiên Tâm Chính Pháp
天志剑=Thiên Chí Kiếm
天志战剑=Thiên Chí Chiến Kiếm
天慧堂=Thiên Tuệ Đường
天星下凡=Thiên Tinh hạ phàm
天星遁法=Thiên Tinh Độn Pháp
天暴星=Thiên Bạo Tinh
天木重劫=Thiên Mộc Trọng Kiếp
天权文曲=Thiên Quyền Văn Khúc
天权星=Thiên Quyền Tinh
天权殿=Thiên Quyền Điện
天权长老=Trưởng lão Thiên Quyền
天极圣光=Thiên Cực Thánh Quang
天枢殿=Thiên Xu Điện
天水峡=Thiên Thủy Hạp
天水郡守王奇=Thái thú Thiên Thủy quận Vương Kỳ
天沉铁=Thiên Trầm Thiết
天河关=Thiên Hà Quan
天河神沙=Thiên Hà Thần Sa
天照道果=Thiên Chiếu Đạo Quả
天王神像=Thiên Vương Thần Tượng
天玑师伯=Thiên Cơ sư bá
天玑师兄=Thiên Cơ sư huynh
天玑殿=Thiên Cơ Điện
天玑禄存=Thiên Cơ Lộc Tồn
天玑长老=Thiên Cơ trưởng lão
天璇师姐=Thiên Toàn sư tỷ
天璇殿=Thiên Tuyền Điện
天璇长老=Thiên Toàn Trưởng Lão
天疏=Thiên Sơ
天皇宝诰=Thiên Hoàng Bảo Cáo
天目符=Thiên Mục Phù
天符号雷=Thiên Phù Hào Lôi
天罡九节杖=Thiên Cương Cửu Tiết Trượng
天罡亢龙=Thiên Cương Kang Long
天罡刀=Thiên Cương Đao
天罡大圣=Thiên Cương Đại Thánh
天荡式=Thiên Đãng Thức
天蓬咒=Thiên Bồng Chú
天蓬师兄=Thiên Bồng sư huynh
天蓬神咒=Thiên Bồng Thần Chú
天蓬长老=Thiên Bồng trưởng lão
天衍四十九= Thiên Diễn 49
天赐神兵=Thiên Tứ Thần Binh
天遁剑意=Thiên Độn Kiếm Ý
天门城主=Thiên Môn Thành chủ
天青化龙诀=Thiên Thanh Hóa Long Quyết
天香阁=Thiên Hương Các
天魅妖神=Thiên Mị Yêu Thần
天魅真神=Thiên Mị Chân Thần
天魅真身=Thiên Mị Chân Thân
天魔万化=Thiên Ma Vạn Hóa
天魔乱舞神功=Thiên Ma Loạn Vũ Thần Công
天魔波旬=Thiên Ma Ba Tuần
天鹅颈=thiên nga cổ
天鹏博龙术=Thiên Bằng Bác Long Thuật
天鹏屠圣术=Thiên Bằng Đồ Thánh Thuật
天鼋=Thiên Nguyên
天龙八峰=Thiên Long Bát Phong
天龙吟=Thiên Long Ngâm
天龙探爪=Thiên Long Thám Trảo
太上洞玄灵宝救苦妙经=Thái Thượng Động Huyền Linh Bảo Cứu Khổ Diệu Kinh
太上炼魔=Thái Thượng Luyện Ma
太上老倌=Thái Thượng Lão Quán
太上长老公孙鞅=Thái Thượng Trưởng Lão Công Tôn Ưởng
太乐令明少微=Thái Nhạc Lệnh Minh Thiếu Vi
太乘长老=Thái Thừa trưởng lão
太乙乾元诀=Thái Ất Càn Nguyên Quyết
太初一指=Thái Sơ Nhất Chỉ
太卜令姬远=Thái Bốc Lệnh Cơ Viễn
太古妖兽夔牛=Thái Cổ Yêu Thú Quỳ Ngưu
太史令萧秩=Thái Sử Lệnh Tiêu Trật
太始之炁=Thái Thủy chi Khí
太学大祭酒=Thái Học Đại Tế Tửu
太学祭酒=Thái Học Tế Tửu
太学祭酒墨夷陵=Thái Học Tế Tửu Mặc Di Lăng
太官令=Thái Quan Lệnh
太宰令=Thái Tể Lệnh
太尉孟钧=Thái Úy Mạnh Quân
太岁神=Thái Tuế Thần
太岳先生=Thái Nhạc tiên sinh
太平之战=Thái Bình chi chiến
太平教主=Thái Bình Giáo Chủ
太平教四神=Thái Bình Giáo Tứ Thần
太平教尊=Thái Bình Giáo Tôn
太微玄术=Thái Vi Huyền Thuật
太微赋=Thái Vi Phú
太无=Thái Vô
太昊庖羲氏=Thái Hạo Bào Hy Thị
太昊殿=Điện Thái Hạo
太昊镜=Thái Hạo Kính
太极为=Thái Cực vì
太极之炁=Thái Cực Chi Khí
太极天轮=Thái Cực Thiên Luân
太清九天剑=Thái Thanh Cửu Thiên Kiếm
太玄金刀=Thái Huyền Kim Đao
太白真君=Thái Bạch Chân Quân
太白真君李玄=Thái Bạch Chân Quân Lý Huyền
太白经天=Thái Bạch Kinh Thiên
太素之剑=Thái Tố Chi Kiếm
太素之炁=Thái Tố Chi Khí
太素之身=Thái Tố Chi Thân
太素剑=Thái Tố Kiếm
太阳居午，日丽中天=Thái Dương Cư Ngọ, Nhật Lệ Trung Thiên
太阳法相=Thái Dương Pháp Tướng
太阳的光辉=mặt trời quang huy
太阳神炎帝=Thái Dương Thần Viêm Đế
太阳金羽=Thái Dương Kim Vũ
太阴居子，水澄桂萼=Thái Âm Cư Tử, Thủy Trừng Quế Ngạc
太阴炼神法=Thái Âm Luyện Thần Pháp
夫人面前=phu nhân trước mặt
奈爷何=Nại Gia Hà
奉天征讨=Phụng Thiên Chinh Thảo
奉天讨逆=Phụng Thiên Thảo Nghịch
奎木星官=Khuê Mộc Tinh Quan
奔龙=bôn long
奢龙=Xa Long
女先生白洁=Nữ tiên sinh Bạch Khiết
女子声音=nữ tử thanh âm
奶奶的因果集=Nãi nãi đích nhân quả tập
她哥哥=nàng ca ca
如意玄铁=Như Ý Huyền Thiết
如来不毁真身=Như Lai Bất Hủy Chân Thân
如来老儿=Như Lai Lão Nhi
如龙象=như long tượng
妖神教=Yêu Thần Giáo
妘秋池=Vân Thu Trì
妙风使=Diệu Phong Sứ
姜之焕=Khương Chi Hoán
姜仲元=Khương Trọng Nguyên
姜伯维=Khương Bá Duy
姜元奇=Khương Nguyên Kỳ
姜其中=Khương Kỳ Trung
姜冲=Khương Xung
姜别鹤=Khương Biệt Hạc
姜司空=Khương Tư Không
姜天子=Khương Thiên Tử
姜姓天子=Khương Tính Thiên Tử
姜姓申氏=Khương Tính Thân Thị
姜家主=Khương Gia Chủ
姜家大爷=Khương gia đại gia
姜敬元=Khương Kính Nguyên
姜无咎=Khương Vô Cữu
姜无明=Khương Vô Minh
姜无野=Khương Vô Dã
姜昭义=Khương Chiêu Nghĩa
姜昭仁=Khương Chiêu Nhân
姜檀越=Khương Đàn Việt
姜氏主家=Khương thị chủ gia
姜氏天子=Khương Thị Thiên Tử
姜氏子=Khương thị tử
姜氏家主=Gia chủ Khương thị
姜氏族人=Khương thị tộc nhân
姜氏族地=Khương thị tộc địa
姜氏祖地=Khương Thị Tổ Địa
姜洛=Khương Lạc
姜流光=Khương Lưu Quang
姜炀=Khương Dương
姜离王=Khương Ly Vương
姜蜀黍=Khương Thục Thúc
姜逐云=Khương Trục Vân
姜逐流=Khương Trục Lưu
姜逐阳=Khương Trục Dương
姜道山=Khương Đạo Sơn
姜韬=Khương Thao
姬博古=Cơ Bác Cổ
姬常洛=Cơ Thường Lạc
姬成稷=Cơ Thành Tắc
姬承业=Cơ Thừa Nghiệp
姬承天=Cơ Thừa Thiên
姬承源=Cơ Thừa Nguyên
姬承稷=Cơ Thừa Tắc
姬明方=Cơ Minh Phương
姬氏宗正=Cơ Thị Tông Chính
姬氏皇族=Cơ Thị Hoàng Tộc
姬氏诸王=Cơ thị chư vương
姬温=Cơ Ôn
姬玄通=Cơ Huyền Thông
姬素云=Cơ Tố Vân
姬继稷=Cơ Kế Tắc
姬道阳=Cơ Đạo Dương
姬野=Cơ Dã
姬长风=Cơ Trường Phong
姬陵光=Cơ Lăng Quang
娄云青=Lâu Vân Thanh
娲皇道器=Oa Hoàng Đạo Khí
嫁衣真气=Giá Y Chân Khí
孕先天=dựng Tiên Thiên
孟云帆=Mạnh Vân Phàm
孟修凡=Mạnh Tu Phàm
孟修吾=Mạnh Tu Ngô
孟元支=Mạnh Nguyên Chi
孟婆汤了=canh Mạnh Bà
孟家主=Mạnh gia chủ
孟晚舟=Mạnh Vãn Chu
孟长林=Mạnh Trường Lâm
宁采臣=Ninh Thải Thần
宇智波宇=Uchiha Yu
宇空之法=Vũ Không Chi Pháp
宇道=Vũ Đạo
宇道阵法=Vũ Đạo Trận Pháp
守静心诀=Thủ Tĩnh Tâm Quyết
安定郡守杨淼=Thái thú An Định quận Dương Miểu
安远伯=An Viễn Bá
宗明=Tông Minh
宗正姬博古=Tông Chính Cơ Bác Cổ
宗正姬长风=Tông Chính Cơ Trường Phong
宗海=Tông Hải
宗经=Tông Kinh
宙光神通=Trụ Quang Thần Thông
宙光逆转=Trụ Quang nghịch chuyển
宙道=Trụ Đạo
宝光佛=Bảo Quang Phật
宝可梦=Pokémon
宝极洞天=Bảo Cực Động Thiên
实意法螣蛇=Thực Ý Pháp Đằng Xà
家人是谁=người nhà là ai
宿老=túc lão
密林中=rừng rậm bên trong
寒浞道果=Hàn Trạc đạo quả
寰宇昭空阵=Hoàn Vũ Chiêu Không Trận
对方的手指=đối phương ngón tay
对身体的控制=đối với thân thể khống chế
寿华之野=Thọ Hoa Chi Dã
封云杰=Phong Vân Kiệt
封禅剑法=Phong Thiện Kiếm Pháp
射蛟台=Xạ Giao Đài
射龙台=Xạ Long Đài
小医馆=tiểu y quán
小吃货=tiểu ăn hàng
小囡囡=Tiểu Niếp Niếp
小开不算开=mở nhỏ không được tính mở
小日子=tháng ngày¦cuộc sống tạm bợ¦cuộc sống gia đình tạm ổn
小昭=Tiểu Chiêu
小棉袄=áo bông nhỏ
小红狗=Tiểu Hồng Cẩu
小豆丁=tiểu đậu đinh
小阴阳炼宝法=Tiểu Âm Dương Luyện Bảo Pháp
小阴阳照神镜=Tiểu Âm Dương Chiếu Thần Kính
小阴阳真法=Tiểu Âm Dương Chân Pháp
小阴阳镜=Tiểu Âm Dương Kính
小雷仙·杨殛=Tiểu Lôi Tiên · Dương Cực
小鹏王=Tiểu Bằng Vương
少侠阿宾=Thiếu Hiệp A Bin
少年手=thiếu niên tay
少年手里=thiếu niên trong tay
少年还是=thiếu niên vẫn là
少年面容=thiếu niên mặt mũi
少教主杨殛=Thiếu giáo chủ Dương Cực
少昊金天氏=Thiếu Hạo Kim Thiên Thị
少阳天箓=Thiếu Dương Thiên Lục
尚卡秋=Thượng Tạp Thu
尚贤宫=Thượng Hiền Cung
就更冷静=thì càng lãnh tĩnh
就跟他拼=liền liều mạng với hắn
就跟他拼了=liền liều mạng với hắn
屠四方=Đồ Tứ Phương
屠龙师伯=Đồ Long Sư Bá
山中风=Yamanaka Fuu
山兮·鬼神惊=Sơn Hề · Quỷ Thần Kinh
山君=Sơn Quân
山巅天枢殿=Sơn Điên Thiên Xu Điện
山海经·大荒西经=Sơn Hải Kinh - Đại Hoang Tây Kinh
山贼老大=sơn tặc lão đại
岐山县=Kỳ Sơn Huyện
岐山县城=Kỳ Sơn Huyện Thành
岐山姜=Kỳ Sơn Khương
岐山姜家=Kỳ Sơn Khương Gia
岐山姜氏=Kỳ Sơn Khương Thị
岳陵城=Nhạc Lăng Thành
岳陵郡=Nhạc Lăng quận
崇山君=Sùng Sơn Quân
崔向忠=Thôi Hướng Trung
巅峰了=đỉnh phong
巍巍颤颤=run run rẩy rẩy
川主=Xuyên Chủ
巡值四方=Tuần Trị Tứ Phương
左招=Tả Chiêu
左枢使=Tả Khu Sứ
左轻鸿=Tả Khinh Hồng
左道的=Tả Đạo
左道的巅峰=Tả Đạo đỉnh phong
巨灵崩天捶=Cự Linh Băng Thiên Chuy
巨灵真罡经=Cự Linh Chân Cương Kinh
巨灵胡=Cự Linh Hồ
巨灵胡神通·【擘山分河】=Cự Linh Hồ Thần Thông · [Bách Sơn Phân Hà]
巨鹿郡=Cự Lộc Quận
巫即=Vu Tức
巫姑=Vu Cô
巫山妖神教=Vu Sơn Yêu Thần Giáo
巫彭=Vu Bành
巫抵=Vu Để
巫朌=Vu Phán
巫真=Vu Chân
巫礼=Vu Lễ
巫罗=Vu La
巫觋=Vu Hịch
巫谢=Vu Tạ
已经出手=đã ra tay
巽剑道=Tốn Kiếm Đạo
师宝男=Sư Bảo Nam
希冀=chờ mong¦mong được¦mong có¦ước ao¦khao khát¦hy kí¦mong mỏi¦hi ký
希夷剑诀=Hy Di Kiếm Quyết
希拉米西=Hiramisi
希望=hi vọng¦mong muốn¦ước ao¦mong¦ý muốn¦ước muốn¦nguyện vọng¦niềm hi vọng¦mong ngóng¦hy vọng
帝使=Đế Sứ
帝出乎震=Đế Xuất Hồ Chấn
帝坐命库=Đế Tọa Mệnh Khố
帝女魃=Đế Nữ Bạt
帝颛顼=Đế Chuyên Húc
帝高阳=Đế Cao Dương
常山郡=Thường Sơn Quận
平成郡=Bình Thành Quận
并州高阳=Tịnh Châu Cao Dương
幻灵慑心阵=Huyễn Linh Nhiếp Tâm Trận
幽冥之天=U Minh Chi Thiên
幽天玄金体=U Thiên Huyền Kim Thể
幽山君=U Sơn Quân
幽灵牛车=U Linh Ngưu Xa
幽都大罗掌=U Đô Đại La Chưởng
广乘=Quảng Thừa
广乘师兄=Quảng Thừa sư huynh
广乘观主=Quảng Thừa Quan Chủ
广乘道人=Quảng Thừa Đạo Nhân
广乘道长=Quảng Thừa Đạo Trưởng
广元师弟=Quảng Nguyên sư đệ
广元道人=Quảng Nguyên Đạo Nhân
广元道长=Quảng Nguyên Đạo Trưởng
广力=Quảng Lực
广寒月神=Quảng Hàn Nguyệt Thần
广明道人=Quảng Minh đạo nhân
广明道长=Quảng Minh đạo trưởng
广目城=Quảng Mục Thành
广阳郡=Quảng Dương Quận
广陵道人=Quảng Lăng đạo nhân
庄周道果=Trang Chu Đạo Quả
庄子三剑=Trang Tử Tam Kiếm
庄旗使=Trang kì sứ
应身佛=Ứng Thân Phật
应龙之鳞=Ứng Long Chi Lân
应龙变=Ứng Long Biến
应龙法身=Ứng Long Pháp Thân
应龙真身=Ứng Long Chân Thân
应龙道器=Ứng Long Đạo Khí
应龙道果=Ứng Long Đạo Quả
庚申月=Canh Thân nguyệt
庚辰月=Canh Thìn Nguyệt
庚金不灭剑体=Canh Kim Bất Diệt Kiếm Thể
庚金剑芒=Canh Kim Kiếm Mang
庚金剑诀=Canh Kim Kiếm Quyết
廉贞殿=Liêm Trinh Điện
延续断路=kéo dài đoạn lộ
开元门=Khai Nguyên Môn
开化万天=Khai Hóa Vạn Thiên
开阳星君=Khai Dương Tinh Quân
开阳武曲=Khai Dương Vũ Khúc
开阳殿=Khai Dương Điện
开阳长老=Khai Dương trưởng lão
开阳长老关武阳=Khai Dương trưởng lão Quan Vũ Dương
张之维=Trương Chi Duy
张九阴=Trương Cửu Âm
张予德=Trương Dư Đức
张指玄=Trương Chỉ Huyền
张振阳=Trương Chấn Dương
张罗浮=Trương La Phù
张道一=Trương Đạo Nhất
张锡林=Trương Tích Lâm
弥勒童子=Di Lặc Đồng Tử
弥勒道果=Di Lặc Đạo Quả
弥罗妙境=Di La Diệu Cảnh
强迫症=OCD¦chứng cưỡng bách¦ocd
归藏定位=Quy Tàng Định Vị
形坟·土形山=Hình Phần · Thổ Hình Sơn
形坟·阳形日=Hình phần - Dương hình Nhật
形销骨立=Hình tiêu cốt lập
彦祖=Ngạn Tổ
很多世界=rất nhiều thế giới
很开门=rất cởi mở
很河狸=rất hải ly
很行=rất tốt
徐徐飞来的青木古树=Cổ Thụ Thanh Mộc từ từ bay đến
徐鹏飞=Từ Bằng Phi
御士=Ngự Sĩ
心外物化=Tâm Ngoại Vật Hóa
心底轻语=đáy lòng nhẹ nói
心有所感悟=lòng có cảm ngộ
心窍绛宫=Tâm Khiếu Giáng Cung
心魔秘剑=Tâm Ma Bí Kiếm
怀远侯=Hoài Viễn Hầu
怎么还=làm sao còn
思路=mạch suy nghĩ¦ý nghĩ của¦dòng suy nghĩ¦ý nghĩ¦con đường riêng
思返谷=Tư Phản Cốc
恒沙诸佛=Hằng Sa Chư Phật
悠悠=ung dung¦lo lắng¦lâu dài¦xa tắp¦xa vời¦dài dằng dặc¦nhiều¦đông đúc¦thong thả¦khoan thai¦hoang đường¦khoa trương¦du du¦dằng dặc¦xa xôi
悬的=treo
惊雷师兄=Kinh Lôi sư huynh
惊鸿七度=Kinh Hồng Thất Độ
惑仙丹=Hoặc Tiên Đan
惠岸行者·木吒=Huệ Ngạn Hành Giả · Mộc Tra
惠岸行者木吒=Huệ Ngạn Hành Giả Mộc Tra
憨气=ngớ ngẩn
懦软=hèn nhát
戊子日=Mậu Tý nhật
我妈=Mẹ tôi
我爱罗=Gaara
我的女帝妹妹=ta Nữ Đế muội muội
战狼一样=chiến lang giống như
截空=Tiệt Không
戮亡戈=Lục Vong Qua
戮天吴=Lục Thiên Ngô
所有人愤怒=tất cả mọi người tức giận
手腕上=cổ tay bên trên
扶风郡城=Phù Phong quận thành
扶风郡守=Phù Phong Quận Thủ
扶风郡守姜之焕=Thái thú Phù Phong quận Khương Chi Hoán
承源=Thừa Nguyên
折花手=Chiết Hoa Thủ
护法天璇=Hộ Pháp Thiên Toàn
报身佛=Báo Thân Phật
抱朴堂=Bão Phác Đường
担山赶日=Đảm Sơn Cản Nhật
担山超海=Đảm Sơn Siêu Hải
拘夷那竭国=Câu Di Na Yết Quốc
拙峰=Chuyết Phong¦chuyết phong
指南剑法=Chỉ Nam Kiếm Pháp
挺帅气=thật soái khí
损兑法灵蓍=Tổn Đoái Pháp Linh Thi
捷疾可畏=Tiệp Tật Khả Úy
探索=thăm dò¦tìm tòi¦tìm kiếm
接仙台=Tiếp Tiên Đài
提婆族=Đề Bà Tộc
提挈天地=Đề Huề Thiên Địa
援军令=viện quân lệnh
搬山力士=Bàn Sơn Lực Sĩ
摇光师兄=Dao Quang sư huynh
摇光师弟=Dao Quang sư đệ
摇光殿=Dao Quang Điện
摇光长老=Dao Quang Trưởng Lão
摧花道人=Tồi Hoa đạo nhân
撼山手=Hám Sơn Thủ
散势法鸷鸟=Tán Thế Pháp Trĩ Điểu
文人眼=văn nhân mắt
文帝钱=Văn Đế Tiền
文昌殿=Văn Xương Điện
文殊一脉=Văn Thù Nhất Mạch
文殊大士=Văn Thù đại sĩ
文虚=Văn Hư
文虚师兄=Văn Hư sư huynh
文虚真人=Văn Hư chân nhân
文虚道人=Văn Hư Đạo Nhân
斥风符=xích phong phù
斩妖吞孽咒=Trảm Yêu Thôn Nghiệt Chú
斩玄铁=trảm huyền thiết
斩鬼五形=Trảm Quỷ Ngũ Hình
断天峡=Đoạn Thiên Hạp
断崖之剑=Đoạn Nhai chi kiếm
断生矛=Đoạn Sinh Mâu
新井雅八=Masahachi Arai
方可使用=mới có thể sử dụng
方叶生=Phương Diệp Sinh
方夜=Phương Dạ
方平=Phương Bình
方远大师=Phương Viễn đại sư
旃檀佛光=Chiên Đàn Phật Quang
无三=vô tam
无上存在=vô thượng tồn tại
无为先生=Vô Vi tiên sinh
无为洞天=Vô Vi Động Thiên
无人区=khu không người
无佛寺=Vô Phật Tự
无涯不及=Vô Nhai Bất Cập
无生佛=Vô Sinh Phật
无生佛友=Vô Sinh Phật Hữu
无生老母大士=Vô Sinh Lão Mẫu Đại Sĩ
无生花=Vô Sinh Hoa
无相转轮=Vô Tướng Chuyển Luân
无障金刚=Vô Chướng Kim Cương
无面天君=Vô Diện Thiên Quân
日御·羲和=Nhật Ngự · Hi Hòa
日御羲和=Nhật Ngự Hi Hòa
日月二神=Nhật Nguyệt Nhị Thần
日月天子=Nhật Nguyệt Thiên Tử
日母=Nhật Mẫu
日母·羲和=Nhật Mẫu · Hi Hòa
日诛恶=Nhật Tru Ác
旧书铺=sách cũ phô
旬空=Tuần Không
旱神掌=Hạn Thần Chưởng
旱神掌·如惔如焚=Hạn Thần Chưởng · Như Đàm Như Phần
时不我待=thời gian không đợi ta
时也=thời cũng
时间线=thời gian tuyến
昆虚仙宫=Côn Khư Tiên Cung
昆虚山=Côn Khư Sơn
昆虚山脉=Dãy núi Côn Khư
昆虚雪峰=Côn Khư Tuyết Phong
昊天金阙玉皇大帝=Hạo Thiên Kim Khuyết Ngọc Hoàng Đại Đế
昊天金阙至尊玉皇赦罪大天尊玄穹高上帝=Hạo Thiên Kim Khuyết Chí Tôn Ngọc Hoàng Xá Tội Đại Thiên Tôn Huyền Khung Cao Thượng Đế
昊天镜碎片=Hạo Thiên Kính Toái Phiến
明光符=Minh Quang Phù
明少微=Minh Thiếu Vi
明德坊=Minh Đức Phường
明德街=Minh Đức Nhai
明教中=Minh Giáo bên trong
明玉真=Minh Ngọc Chân
明珠在椟，含光忍辱=Minh châu tại độc, hàm quang nhẫn nhục
明真道人=Minh Chân Đạo Nhân
明面身份=bên ngoài thân phận
易天绝剑=Dịch Thiên Tuyệt Kiếm
易扬=Dịch Dương
易数玄学=Dịch số huyền học
易经伐髓=dịch kinh phạt tủy
星孛=Tinh Bội
星宿分野=Tinh Tú Phân Dã
星河横天=Tinh Hà Hoành Thiên
星辰寰宇=Tinh Thần Hoàn Vũ
春秋剑=Xuân Thu Kiếm
昭元郡主=Chiêu Nguyên quận chúa
昭华炉=Chiêu Hoa Lô
是宁儿= là Ninh nhi
是来购买=là tới mua sắm
是神=
是神仙=là thần tiên
是神魔=là Thần Ma
是神魔位面=là Thần Ma Vị Diện
是越国=là Việt Quốc
晦庵先生=Hối Am tiên sinh
普渡法师=Phổ Độ pháp sư
景云县=Cảnh Vân huyện
智慧王=Trí Tuệ Vương
暗世玄流=Ám Thế Huyền Lưu
暗自嘀咕=lẩm bẩm với chính mình
暝晦视明=Minh Hối Thị Minh
暝晦视明·天地双沉=Minh Hối Thị Minh·Thiên Địa Song Trầm
暴恶鬼面=Bạo Ác Quỷ Diện
曦贵妃=Hi Quý Phi
曲灵言=Khúc Linh Ngôn
更加速成=càng thêm tốc thành
曹亚=Tào Á
曹元升=Tào Nguyên Thăng
曹元龙=Tào Nguyên Long
曹易玄=Cao Dịch Huyền
最后了断=cuối cùng chấm dứt
月净=Nguyệt Tịnh
月宫永德=Nguyệt Cung Vĩnh Đức
有点迟疑=có chút do dự
有穷=Hữu Cùng
有穷后羿=Hữu Cùng Hậu Nghệ
有穷夷羿=Hữu Cung Di Nghệ
有这种=có cái loại này
有这种事情=có loại này sự tình
有限额=có giới hạn
服部千军=Hattori Senjun
朕即国家=Trẫm Tức Quốc Gia
朝华阁=Triều Hoa Các
木炁=Mộc Khí
木然=đờ đẫn¦thẫn thờ¦ngây ra¦thật thà¦đờ đẩn
未来星宿劫法=Vị Lai Tinh Tú Kiếp Pháp
末法天尊=Mạt Pháp Thiên Tôn
朱晦庵=Chu Hối Am
朱翼=Chu Dực
朱裳=Chu Thường
朱门酒肉臭=cửa son lộ thịt ôi
朱雀华裳=Chu Tước Hoa Thường
朱雀楼=Chu Tước Lâu
朱雀殿=Chu Tước Điện
朱雀法坛=Chu Tước pháp đàn
朱雀道果=Chu Tước đạo quả
机缘流=cơ duyên lưu
杀了我=giết ta
杀贼=Sát Tặc
李伯阳=Lý Bá Dương
李清涟=Lý Thanh Liêm
李清涟师兄=Lý Thanh Liên sư huynh
李真君=Lý Chân Quân
李观明=Lý Quan Minh
李重岳=Lý Trọng Nhạc
杜少保=Đỗ Thiếu Bảo
杨柳观音=Dương Liễu Quan Âm
杨殛=Dương Tắc
杨间=Dương Gian
杨龙象=Dương Long Tượng
板角青牛=Bản Giác Thanh Ngưu
林奇然=Lâm Kỳ Nhiên
林广=Lâm Quảng
柔云之精=Nhu Vân Chi Tinh
柔云精粹=Nhu Vân Tinh Túy
柳妍妍=Liễu Nghiên Nghiên
格物刀=Cách Vật Đao
格物天弓=Cách Vật Thiên Cung
桥县=Kiều Huyện
梁州大鼎=Lương Châu Đại Đỉnh
梁州牧=Lương Châu Mục
梁州西边=Lương Châu Tây biên
梅林=rừng mai
梧桐路=Ngô Đồng Lộ
楚昭元=Sở Chiêu Nguyên
楼双影=Lâu Song Ảnh
楼观剑法=Lâu Quan kiếm pháp
槐江之山=Hòe Giang Chi Sơn
欢喜佛法相=Hoan Hỉ Phật Pháp Tướng
欢喜道主=Hoan Hỉ Đạo Chủ
欢快起来=trở nên vui sướng
欲界第六天=Dục Giới Đệ Lục Thiên
止水=Shisui¦chỉ thuỷ
正一玄坛元帅·赵公明=Chính Nhất Huyền Đàn Nguyên Soái Triệu Công Minh
正定印=Chính Định Ấn
正是本宫=Chính Thị Bản Cung
正道上=chính đạo trên
步玉笙=Bộ Ngọc Sanh
武大哥=Võ đại ca
武当叛徒=Võ Đang phản đồ
武曲坪=Vũ Khúc Bình
武松的=Võ Tòng
武植=Võ Thực
武癫疯=Võ Đỉnh Phong
死无葬身之地=chết không có chỗ chôn
殁神戟=Một Thần Kích
残片里面的=tàn phiến bên trong
殷屠龙=Ân Đồ Long
殷师叔祖=Ân sư thúc tổ
比我想象=so với ta tưởng tượng
比蒙鱼=so Mông Ngư
比较弱鸡=yếu như gà
毕方妖神=Tất Phương Yêu Thần
毕方真神=Tất Phương Chân Thần
气之云=khí chi vân
气坟·山气止=Khí Phần · Sơn Khí Chỉ
气坟·时乘六龙=Khí phần - Thời thừa Lục Long
气浊血滞=Khí trọc huyết trệ
水伯天吴=Thủy Bá Thiên Ngô
水兮·滔天=Thủy Hề·Thao Thiên
水天佛=Thủy Thiên Phật
水府星官=Thủy Phủ Tinh Quan
水形川=Thủy Hình Xuyên
水晶之肚=Thủy Tinh Chi Đổ
水晶殿=Thủy Tinh Điện
水火锋=Thủy Hỏa Phong
水灵愈体符=Thủy Linh Dũ Thể Phù
水猴子=Thủy Hầu Tử
求返其真=cầu phản kì chân¦Cầu Phản Kỳ Chân
江怀民=Giang Hoài Dân
江百川=Giang Bách Xuyên
江罗汉=Giang La Hán
江阳县=Giang Dương huyện
江阳城=Giang Dương Thành
江鸣=Giang Minh
汪洋=uông dương
汪洋的=uông dương
沈可法=Thẩm Khả Pháp
沈源=Thẩm Nguyên
沐凌衣=Mộc Lăng Y
没什么事业心=không có gì sự nghiệp tâm
没开辟=không có mở ra
没落=xuống dốc¦sa sút¦suy tàn¦suy vong¦không rơi
沧水=Thương Thủy
沧浪池=Thương Lãng Trì
油女取根=Aburame Torune
油滑的=láu cá
法外逍遥=Pháp Ngoại Tiêu Dao
法外逍遥李清涟=Pháp Ngoại Tiêu Dao Lý Thanh Liên
法身佛=Pháp Thân Phật
法轮印=Pháp Luân Ấn
波旬真灵=Ba Tuần Chân Linh
泰神殿=Thái Thần Điện
泽被万物=Trạch Bị Vạn Vật
洛书阵法=Lạc Thư Trận Pháp
洛南郡=Lạc Nam Quận
洪好古=Hồng Hảo Cổ
洪郡=Hồng Quận
活神露=Hoạt Thần Lộ
流云使=Lưu Vân Sứ
浑元功=Hỗn Nguyên Công
浩浩长风=Hạo Hạo Trường Phong
涅槃寂静=Niết Bàn Tịch Tĩnh
涟漪=gợn sóng¦rung động¦sóng lăn tăn¦sóng gợn¦gợn sóng
淮水真神=Hoài Thủy Chân Thần
淮水龙宫=Hoài Thủy Long Cung
淮河水神=Hoài Hà Thủy Thần
混元一气上清神符=Hỗn Nguyên Nhất Khí Thượng Thanh Thần Phù
混着=lẫn vào
清河郡王=Thanh Hà Quận Vương
清虚道德天尊=Thanh Hư Đạo Đức Thiên Tôn
渊兮·用不盈=Uyên Hề · Dụng Bất Doanh
渡闻=Độ Văn
游神慑鬼符=Du Thần Nhiếp Quỷ Phù
游神行气法=Du Thần Hành Khí Pháp
漏了气的=lọt khí
潜世=ẩn thế
潜山阴=Tiềm Sơn Âm
潜渊缩地=Tiềm Uyên Súc Địa
潺亭=Sàn Đình
潺亭县=Sàn Đình Huyện
潺亭城=Sầm Đình Thành
瀚海之中=Hãn Hãi bên trong
瀚海沧溟=Hãn Hải Thương Minh
火云殿=Hỏa Vân Điện
火兮·焚野=Hỏa hề · Phần Dã
火宅佛狱之主=Hỏa Trạch Phật Ngục Chi Chủ
火府星=Hỏa Phủ Tinh
火焚穹霄=Hỏa Phần Khung Tiêu
火神·重黎=Hỏa Thần · Trọng Lê
灭你的门=diệt ngươi môn
灭元殳=Diệt Nguyên Thù
灭生矛=Diệt Sinh Mâu
灭绝=Diệt Tuyệt
灭霸=Thanos
灵世界=linh thế giới
灵台山=Linh Đài Sơn
灵台方寸祖=Linh Đài Phương Thốn Tổ
灵山会=Linh Sơn Hội
灵山十巫=Linh Sơn Thập Vu
灵山大雷音寺=Linh Sơn Đại Lôi Âm Tự
灵感寺=Linh Cảm Tự
灵曲河=Linh Khúc Hà
灵蛇步=Linh Xà Bộ
炎帝烈血=Viêm Đế Liệt Huyết
炎帝真灵=Viêm Đế Chân Linh
炎帝神像=Viêm Đế thần tượng
炎帝道果=Đạo quả Viêm Đế
炎武阁=Viêm Võ Các
炎阳刀=Viêm Dương Đao
炳灵公=Bỉnh Linh Công
点血=điểm huyết¦chút máu¦chút huyết
炽盛光辉=hừng hực quang huy
烈山殿=Liệt Sơn Điện
烈山民=Liệt Sơn Dân
烈山茶=Liệt Sơn trà
烈山袍=Liệt Sơn Bào
烛龙道果=Chúc Long Đạo Quả
烟雨蒙=Yên Vũ Mông
燃灯佛=Nhiên Đăng Phật
燃灯如来=Nhiên Đăng Như Lai
燕国地图=Yến Quốc Địa Đồ
燕寒清=Yến Hàn Thanh
燹骨成丘=Tiển Cốt Thành Khâu
爷傲=Gia Ngạo
牛大河=Ngưu Đại Hà
牛旋风=Ngưu Toàn Phong
牢姜=Lao Khương
物阳火=Vật Dương Hỏa
犴嗷=Hãn Ngao
状若无意=giống như vô tình
狐岐=Hồ Kỳ
狱法之山=Ngục Pháp Chi Sơn
猎人的精神=thợ săn tinh thần
猪无戒=Trư Vô Giới
猴子=hầu tử¦con khỉ¦khỉ
猿飞日月=Sarutobi Nichigetsu
獬豸玉像=Giải Trãi Ngọc Tượng
玄冥一气雷=Huyền Minh Nhất Khí Lôi
玄冥真道=Huyền Minh Chân Đạo
玄冥神通=Huyền Minh Thần Thông
玄君七章=Huyền Quân Thất Chương
玄徽=Huyền Huy
玄戒=Huyền Giới
玄明道士=Huyền Minh đạo sĩ
玄暗之流=Huyền Ám Chi Lưu
玄武之御=Huyền Vũ chi Ngự
玄武王=Huyền Vũ Vương
玄灵七十变=Huyền Linh Thất Thập Biến
玄甲墨扇=Huyền Giáp Mặc Phiến
玄穹高上玉皇大帝=Huyền Khung Cao Thượng Ngọc Hoàng Đại Đế
玄都道长=Huyền Đô Đạo Trưởng
玄金甲=Huyền Kim Giáp
玄门三清派=Huyền Môn Tam Thanh Phái
玄门三皇派=Huyền Môn Tam Hoàng Phái
玄门两大气刃=Huyền Môn Lưỡng Đại Khí Nhận
玉华宫=Ngọc Hoa Cung
玉帝老儿=Ngọc Đế Lão Nhi
玉枢火府天将=Ngọc Xu Hỏa Phủ Thiên Tướng
玉枢雷=Ngọc Xu Lôi
玉清道气=Ngọc Thanh Đạo Khí
玉清道统=Ngọc Thanh Đạo Thống
玉疏颜=Ngọc Sơ Nhan
玉皇大天尊=Ngọc Hoàng Đại Thiên Tôn
玉皇道果=Ngọc Hoàng Đạo Quả
玉虚关=Ngọc Hư Quan
玉虚广乘=Ngọc Hư Quảng Thừa
玉虚开天剑=Ngọc Hư Khai Thiên Kiếm
玉虚观剑法·太乙分光剑=Ngọc Hư Quan Kiếm Pháp · Thái Ất Phân Quang Kiếm
玉衡廉贞=Ngọc Hành Liêm Trinh
玉衡殿=Ngọc Hành Điện
玉衡长老=Ngọc Hành trưởng lão
王云蓝=Vương Vân Lam
王千峰=Vương Thiên Phong
王去恶=Vương Khứ Ác
王守立=Vương Thủ Lập
现象玩占=Hiện Tượng Ngoạn Chiêm
珈蓝宝树=Già Lam Bảo Thụ
琉璃炽盛=Lưu Ly Sí Thịnh
琉璃观音=Lưu Ly Quan Âm
琼宁苑=Quỳnh Ninh Uyển
瑶池仙舟=Dao Trì Tiên Chu
璇玑殿=Toàn Cơ Điện
瓷像=tượng sứ
甘露太子=Cam Lộ Thái Tử
甘露太子·金吒=Cam Lộ Thái Tử · Kim Tra
生死面前=sinh tử trước mặt
田晋中=Điền Tấn Trung
申侯道人=Thân Hầu đạo nhân
申侯道长=Thân Hầu Đạo Trưởng
男人心情=nam nhân tâm tình
留下来了=lưu lại
留传说=lưu truyền thuyết
疾火=tật hỏa
瘟癀大帝=Ôn Hoằng Đại Đế
瘟癀昊天大帝=Ôn Hoảng Hạo Thiên Đại Đế
瘟癀阵=Ôn Hoằng Trận
癸卯年=Quý Mão Niên
癸水神罩=Quý Thủy Thần Tráo
白头秃鹫=Đầu Bạc Kên Kên
白帝白招拒=Bạch Đế Bạch Chiêu Cự
白毛猿猴=Bạch Mao Viên Hầu
白沙坞=Bạch Sa Ổ
白若溪=Bạch Nhược Khê
白莲圣母菩萨=Bạch Liên Thánh Mẫu Bồ Tát
白莲圣母菩萨（八部天龙广力菩萨）=Bạch Liên Thánh Mẫu Bồ Tát
白莲菩萨=Bạch Liên Bồ Tát
白虎道果=Bạch Hổ đạo quả
白衣觉者=Bạch Y Giác Giả
白额侯=Bạch Ngạch Hầu
百丈=trăm trượng
百目金光=Bách Mục Kim Quang
百草识别=Bách thảo nhận biết
的想象=tưởng tượng
的手笔=thủ bút
的根部=Root
的脑子里=trong đầu
皆不凡=đều bất phàm
皇后区=khu Queens
皇城大明殿=Hoàng Thành Đại Minh Điện
皇城太庙=Hoàng Thành Thái Miếu
皇城轩辕台=Hoàng thành Hiên Viên Đài
盗版猴=Khỉ nhái
盛神法五龙=Thịnh Thần Pháp Ngũ Long
直达天听=Trực Đạt Thiên Thính
看胸识人=Khán Hung Thức Nhân
真人的意思=chân nhân ý tứ
真如居士=Chân Như Cư Sĩ
真定姜家=Chân Định Khương Gia
真定郡=Chân Định Quận
真蛸缠身劲=Chân Sao Triền Thân Kình
真龙九击=Chân Long Cửu Kích
真龙血裔=Chân Long Huyết Duệ
眠狂草=Miên Cuồng Thảo
眼珠=con mắt¦con ngươi
矢崎廉司=Renji Yazaki
知寨=tri trại
矩子墨玄空=Củ Tử Mặc Huyền Không
短狐=Đoản Hồ
矮子=thằng lùn¦người lùn¦chú lùn¦người nhỏ bé¦người tầm thường¦người nhỏ nhen
破军榜=Phá Quân bảng
破碎=phá toái
破碎了=phá toái
破碎飞升=Phá Toái Phi Thăng
碎日天冰箭=Toái Nhật Thiên Băng tiễn
碑镇山河=Bi Trấn Sơn Hà
碧水镇=Bích Thủy Trấn
碧焰阴雷刀=Bích Diễm Âm Lôi Đao
祖师九天尚父五方都总管北极左垣上将都统大元帅天蓬真君=Tổ Sư Cửu Thiên Thượng Phụ Ngũ Phương Đô Tổng Quản Bắc Cực Tả Viên Thượng Tướng Đô Thống Đại Nguyên Soái Thiên Bồng Chân Quân
祗树给孤独园=Kỳ Thụ Cấp Cô Độc Viên
祝融相=Chúc Dung Tướng
神农之相=Thần Nông chi tướng
神农九泉=Thần Nông Cửu Tuyền
神农像=Tượng Thần Nông
神农姜氏=Thần Nông Khương Thị
神农炎帝=Thần Nông Viêm Đế
神农百草丹=Thần Nông Bách Thảo Đan
神农石像=Thần Nông Thạch Tượng
神击之术=Thần Kích Chi Thuật
神剑御雷高周波真诀=Thần Kiếm Ngự Lôi Cao Chu Ba Chân Quyết
神州姜氏=Thần Châu Khương thị
神木战袍=Thần Mộc Chiến Bào
神榕树=Thần Dung thụ
神火九炼=Thần Hỏa Cửu Luyện
神火弩=Thần Hỏa Nỗ
神珍铁=Thần Trân Thiết
神秘瑞兽=thần bí thụy thú
神蝗幡=Thần Hoàng Phiên
神行太保枢使向云天=Thần Hành Thái Bảo Xu Sứ Hướng Vân Thiên
神通力=Thần Thông Lực
神都云县=Thần Đô Vân Huyện
神都云县姜氏=Thần Đô Vân Huyện Khương Thị
神都城=Thần Đô Thành
神都王家=Thần Đô Vương gia
神都皇城=Thần Đô Hoàng Thành
神都皇宫=Thần Đô Hoàng Cung
神都飞云姜家=Thần Đô Phi Vân Khương Gia
神门峰=Thần Môn Phong
神阙天眼=Thần Khuyết Thiên Nhãn
禄存星=Lộc Tồn Tinh
福留肾穴=Phúc Lưu Thận Huyệt
福神玉如意=Phúc Thần Ngọc Như Ý
福神道器玉如意=Phúc Thần Đạo Khí Ngọc Như Ý
禹步大统摄雷=Vũ Bộ Đại Thống Nhiếp Lôi
禹王的道果=Vũ Vương Đạo Quả
禹王道果=Vũ Vương Đạo Quả
秋水师姐=Thu Thủy sư tỷ
种牛逼=loại ngưu bức
科布=Cobb¦Khoa Bố¦cobh¦khoa bố¦cobh¦khoa bố
秦华麟=Tần Hoa Lân
秦华龙=Tần Hoa Long
秦江=Tần Giang
秦镇渊=Tần Trấn Uyên
稀罕么=hiếm a
穹荒青龙旗=Khung Hoang Thanh Long Kỳ
空地上=đất trống bên trên
空相大师=Không Tướng Đại Sư
穿梭者=người xuyên việt
第三天梯=đệ tam thiên thê
第二天梯=đệ nhị thiên thê
第四王=Đệ Tứ Vương
簪划天河=Trâm Hoa Thiên Hà
粱上客=Lương Thượng Khách
粱飞=Lương Phi
精神破碎=Tinh Thần Phá Toái
糊弄一个=lừa bịp một cái
素华宫=Tố Hoa Cung
素箭=Tố Tiễn
索命夜叉=Sách Mệnh Dạ Xoa
紫山根=Tử Sơn Căn
紫微天府=Tử Vi Thiên Phủ
紫微天府，辅弼之功=Tử Vi Thiên Phủ, Phụ Bật Chi Công
紫微宸极=Tử Vi Thần Cực
紫微殿=Tử Vi Điện
紫棘叶=Tử Gai Diệp
紫电金铜=Tử Điện Kim Đồng
紫耀剑=Tử Diệu Kiếm
紫袍中年天玑长老=Tử Bào Trung Niên Thiên Cơ trưởng lão
紫阳宗=Tử Dương Tông
紫雷金铜=Tử Lôi Kim Đồng
纠罚=Củ Phạt
红云散花=Hồng Vân Tán Hoa
红云散花针=Hồng Vân Tán Hoa Châm
红叶师伯=Hồng Diệp sư bá
红焰帝幢王佛=Hồng Diễm Đế Tràng Vương Phật
红狗=Hồng Cẩu
红葫芦=Hồng Hồ Lô
纤云弄巧=Tiêm Vân Lộng Xảo
纪云流=Kỷ Vân Lưu
纯阳剑仙=Thuần Dương Kiếm Tiên
纯阳帝君=Thuần Dương Đế Quân
纯阳真人吕洞宾=Thuần Dương chân nhân Lã Động Tân
纯阳祖师=Thuần Dương Tổ Sư
纯阳道心=Thuần Dương Đạo Tâm
纯阳道祖=Thuần Dương Đạo Tổ
纳魂布袋=Nạp Hồn Bố Đại
纵横无敌手=tung hoành vô địch thủ
纵横道=Tung Hoành Đạo
纸鹞断线一般=con diều cắt đứt dây đồng dạng
经天纬地图=Kinh Thiên Vĩ Địa Đồ
给上面=cho phía trên
绝剑·天诛=Tuyệt Kiếm · Thiên Tru
绝剑·水逝=Tuyệt Kiếm · Thủy Thệ
绝处逢生，华而不败=Tuyệt xứ phùng sinh, hoa nhi bất bại
绝灵世界=tuyệt linh thế giới
继国岩胜=Tsugikuni Michikatsu
继国缘壹=Tsugikuni Yoriichi
罗仪=La Nghi
罗刹女=La Sát Nữ
罗刹鬼王=La Sát Quỷ Vương
罗澄=La Trừng
罗睺障月=La Hầu Chướng Nguyệt
罡斗神雷=Cương Đấu Thần Lôi
羊铃=Dương Linh
羲和玉璧=Hi Hòa Ngọc Bích
羲和道果=Nghi Hòa đạo quả
羲皇道果=Hy Hoàng Đạo Quả
羽流=Vũ Lưu
羽流姑姑=Vũ Lưu cô cô
翟云峰=Địch Vân Phong
翟大爹=Địch Đại Đa
翟谦=Địch Khiêm
翡翠宫=Phỉ Thúy Cung
翻江蛟=Phiên Giang Giao
老万头=Lão Vạn Đầu
老五凌无觉=Lão Ngũ Lăng Vô Giác
老人的视线=lão nhân tầm mắt
老人的话音=lão nhân âm thanh
老人肉身=lão nhân nhục thân
老君观=Lão Quân Quan
老太尉=Lão Thái Úy
老妖精=Lão yêu tinh
老阴比=lão âm bỉ
而生死=mà sinh tử
聚虚合道=Tụ Hư Hợp Đạo
育归流=Dục Quy Lưu
育藏海=Dục Tàng Hải
胜观峰=Thắng Quan Phong
腹下黄庭=Phúc Hạ Hoàng Đình
自己很行=mình rất giỏi
至人之心=Chí Nhân Chi Tâm
至大的=rất lớn
至心皈命礼=Chí Tâm Quy Mệnh Lễ
至阳至大=chí dương chí đại
舆鬼五星=Dư Quỷ Ngũ Tinh
舍卫国=Xá Vệ quốc
舍祭城=Xá Tế Thành
舞雩=Vũ Vu
般若剑=Bát Nhã Kiếm
般若慧剑=Bát Nhã Huệ Kiếm
良才美玉=lương tài mỹ ngọc
花知寨=Hoa tri trại
花霜=Hoa Sương
苍天化身=Thương Thiên Hóa Thân
苏家子弟=Tô gia tử đệ
苏心悦=Tô Tâm Duyệt
苏晨=Tô Thần
苏醒=Tỉnh lại¦thức tỉnh¦tỉnh lại¦đã tỉnh giấc¦đã tỉnh
苦一苦=Khổ Nhất Khổ
苦无良策=khổ không thượng sách
苦集灭道四圣谛=Khổ Tập Diệt Đạo Tứ Thánh Đế
英雄无敌=anh hùng vô địch
荆扬之地=Kinh Dương Chi Địa
草长莺飞=cỏ mọc én bay¦thảo trường oanh phi
荡魔真气=Đãng Ma Chân Khí
荧惑守心=Huỳnh Hoặc Thủ Tâm
药师袈裟=Dược Sư Ca Sa
药师野乃宇=Yakushi Nonou
药理之祖=Dược lý chi tổ
莫得=không có
莲华印诀=Liên Hoa Ấn Quyết
莲华圣耀=Liên Hoa Thánh Diệu
莲纹甲=Liên Văn Giáp
菩提萨埵=Bồ Đề Tát Đỏa
菩萨不灭体=Bồ Tát Bất Diệt Thể
菩萨乘=Bồ Tát Thừa
菩萨罗汉=Bồ tát La hán
萧九娘=Tiêu Cửu Nương
萧师道=Tiêu Sư Đạo
萧秩=Tiêu Trật
萧西涯=Tiêu Tây Nhai
落寞的感觉=cô đơn cảm giác
葛小伦=Cát Tiểu Luân
董相国=Đổng Tướng Quốc
蒋降龙=Tưởng Giáng Long
蒙脱石散=Montmorillonit
蓝天凤=Lam Thiên Phượng
蓬安全郡=Bồng An Toàn Quận
蓬安郡=Bồng An quận
蔡志英=Thái Chí Anh
蔡老狗=Thái lão cẩu
藏山兵=Tàng Sơn Binh
虎伥拳=Hổ Trành Quyền
虚日星官=Hư Nhật Tinh Quan
虹蓝世界=Hồng Lam thế giới
虹蓝的世界=Hồng Lam thế giới
蚩尤三盘=Xi Vưu Tam Bàn
蚩尤氏=Xi Vưu Thị
蚩尤相=Xi Vưu Tướng
蛟太子=Giao Thái Tử
蜀王妃=Thục Vương Phi
蜀王府=Thục Vương phủ
蜀郡二圣庙=Thục Quận Nhị Thánh Miếu
血继忍者=huyết kế ninja
血荐轩辕=Huyết tiến Hiên Viên
血蟒吞象功=Huyết Mãng Thôn Tượng Công
衔雨=Hàm Vũ
袇房=Nhiễm Phòng
裂云手=Liệt Vân Thủ
裂天之境=Liệt Thiên Chi Cảnh
裂天玄境=Liệt Thiên Huyền Cảnh
裸游=bơi khỏa thân
褚延=Chử Diên
褚江=Chử Giang
西乡郡=Tây Hương Quận
西凉山=Tây Lương Sơn
西华妙气=Tây Hoa Diệu Khí
西华妙真=Tây Hoa Diệu Chân
西华妙真玄气=Tây Hoa Diệu Chân Huyền Khí
西华妙道真经=Tây Hoa Diệu Đạo Chân Kinh
西华镜=Tây Hoa Kính
西土佛国=Tây Thổ Phật Quốc
西域一带=Tây Vực một vùng
西域一带的=Tây Vực một vùng
西天大雷音寺=Tây Thiên Đại Lôi Âm Tự
西方昆虚仙宫=Tây Phương Côn Khư Tiên Cung
西昆虚=Tây Côn Khư
西行路=Tây Hành Lộ
见到你很高兴=Rất vui được gặp ngươi
观星望气=Quan Tinh Vọng Khí
觉者会=Giác Giả Hội
詹姆森=Jameson
让人人=để cho người người
许知林=Hứa Tri Lâm
许邈=Hứa Miểu
论剑海=Luận Kiếm Hải
诸因之果=Chư Nhân Chi Quả
诸圣子=chư Thánh Tử
诸天的意思=chư thiên ý tứ
谁吗=ai
谈无为=Đàm Vô Vi
谈无言=Đàm Vô Ngôn
谜语人=câu đố người
谢大当家=Tạ đại đương gia
谯明之山=Tiều Minh Chi Sơn
豪火球之术=Hào Hỏa Cầu Chi Thuật
豫州鼎=Dự Châu Đỉnh
贯天恸日=Quán Thiên Thống Nhật
贼老大=tặc lão đại
赖蛤蟆=Lại Cáp Mô
赤岚烟罗=Xích Lam Yên La
赤眉军=Xích Mi Quân
赤红色光辉的=xích hồng quang huy
赤翎殿=Xích Linh Điện
赤血龙旗=Xích Huyết Long Kỳ
赤衣僧人=Hồng y tăng nhân
赤铜元身=Xích Đồng Nguyên Thân
赤阳刀=Xích Dương Đao
赤霞丹=Xích Hà Đan
赤霞山=Xích Hà Sơn
赤霞烟岚=Xích Hà Yên Lam
赵二郎=Triệu Nhị Lang
赵客=Triệu Khách
赵晓棠=Triệu Hiểu Đường
赵玄坛=Triệu Huyền Đàn
赵穿=Triệu Xuyên
超电磁剑诀=Siêu Điện Từ Kiếm Quyết
超电磁真诀=Siêu Điện Từ Chân Quyết
越王姬温=Việt Vương Cơ Ôn
跪火莲=Quỳ Hỏa Liên
路有冻死骨=ngoài đường đầy xác chết
蹈海力士=Đạp Hải Lực Sĩ
蹴鞠神=Xúc Cúc Thần
轩辕剑典=Hiên Viên Kiếm Điển
轩辕台洞天=Hiên Viên Đài Động Thiên
转圆法猛兽=Chuyển Viên Pháp Mãnh Thú
转轮菩萨=Chuyển Luân Bồ Tát
转轮铳=Chuyển Luân Súng
轻快地道=nhẹ nhàng nói
辅弼夹帝=Phụ Bật Giáp Đế
辉月使=Huy Nguyệt Sứ
辛丑日=Tân Sửu nhật
辛未日=Tân Vị Nhật
辛酉月=Tân Dậu nguyệt
辟水=Tích Thủy
辟水口=Tích Thủy Khẩu
近百万里之遥=xa gần trăm vạn dặm
近道宗师=Cận Đạo Tông Sư
还珠楼=Hoàn Châu Lâu
这么厉害=lợi hại như thế
这样子=như vậy
这辈子=đời này
远桥=Viễn Kiều
连天璇=Liên Thiên Toàn
连山阳=Liên Sơn Dương
连载版=đăng nhiều kỳ bản
迟迟=chậm chạp¦trì trệ¦chậm trễ¦lần lữa¦kề cà
迭山象=Điệt Sơn Tượng
迷者=Mê Giả
通元子=Thông Nguyên Tử
通天灵剑=Thông Thiên Linh Kiếm
通文长老=Thông Văn Trưởng Lão
通明堂=Thông Minh Đường
通闻符=Thông Văn Phù
造化神刀=Tạo Hóa Thần Đao
造天法仪=Tạo Thiên Pháp Nghi
遁去其一=Độn Đi 1
遁甲阵势=Độn Giáp Trận Thế
遍照十方=Biến Chiếu Thập Phương
道仙后=Đạo Tiên Hậu
道兵巨灵神=Đạo Binh Cự Linh Thần
道法阁=Đạo Pháp Các
道的巅峰=đạo đỉnh phong
道空寰宇=Đạo Không Hoàn Vũ
道莅天下=Đạo Lệ Thiên Hạ
道莅天下，其鬼不神=Đạo Lệ Thiên Hạ, Kỳ Quỷ Bất Thần
道长出手=đạo trưởng xuất thủ
遮天法=Già Thiên pháp
邀月大侠=Yêu Nguyệt đại hiệp
邀月姑娘=Yêu Nguyệt cô nương
邀月施主=Yêu Nguyệt thí chủ
邀月盟主=Yêu Nguyệt minh chủ
那伽=Na Già
郡城平昌=Quận thành Bình Xương
都天凝相=Đô Thiên Ngưng Tướng
都天大灵官=Đô Thiên Đại Linh Quan
都天生煞=Đô Thiên Sinh Sát
酉时三刻=Dậu Thời Tam Khắc
释户=Thích Hộ
重剑无锋=trọng kiếm vô phong
重阳全真开化真君=Trùng Dương Toàn Chân Khai Hóa Chân Quân
重阳全真开化真君·王重阳=Trùng Dương Toàn Chân Khai Hóa Chân Quân · Vương Trùng Dương
野云渡=Dã Vân Độ
野狐岭=Dã Hồ Lĩnh
金丹妙道=Kim Đan Diệu Đạo
金乌羽=Kim Ô Vũ
金乌道果=Kim Ô đạo quả
金乌遗骨=Kim Ô Di Cốt
金仙·毗芦仙=Kim Tiên · Tỳ Lư Tiên
金仙·赤精子=Kim Tiên - Xích Tinh Tử
金光佛轮=Kim Quang Phật Luân
金光神咒=Kim Quang Thần Chú
金刚不坏佛=Kim Cương Bất Hoại Phật
金刚九会曼荼罗·三昧耶会=Kim Cương Cửu Hội Mạn Đà La · Tam Muội Da Hội
金刚力士=Kim Cương Lực Sĩ
金刚手菩萨=Kim Cương Thủ Bồ Tát
金刚界=Kim Cương Giới
金刚破碎=Kim Cương Phá Toái
金刚胎藏=Kim Cương Thai Tạng
金刚胎藏界=Kim Cang Thai Tạng Giới
金刚萨埵=Kim Cang Tát Đoả
金刚藏=Kim Cương Tàng
金刚藏菩萨=Kim Cương Tạng Bồ Tát
金堤=Kim Đê
金堤之战=Kim Đê Chi Chiến
金戈草=Kim Qua Thảo
金毛猴子=Kim Mao Hầu Tử
金炁=Kim Khí
金童·牛郎=Kim Đồng・Ngưu Lang
金舆扶辇=Kim Dư Phù Liễn
金轮炽盛光佛=Kim Luân Sí Thịnh Quang Phật
金霞冠=Kim Hà Quan
金风玉露掌=Kim Phong Ngọc Lộ Chưởng
钁天大斧=Quắc Thiên Đại Phủ
钟无期=Chung Vô Kỳ
铁柱观=Thiết Trụ Quan
铁柱观洞天=Thiết Trụ Quan động thiên
铁甲神雷=Thiết Giáp Thần Lôi
锦毛虎=Cẩm Mao Hổ
镇海眼神通=Trấn Hải Nhãn Thần Thông
长乐门=Trường Lạc Môn
长公主姬陵光=Trưởng công chúa Cơ Lăng Quang
长寿吉祥=Trường Thọ Cát Tường
长生不死神=Trường Sinh Bất Tử Thần
长空万里，剑荡山河=Trường Không Vạn Lý, Kiếm Đãng Sơn Hà
长蛇百寻=trường xà bách tầm
长阿含经=Trường A Hàm Kinh
长驸马风满楼=Trưởng Phò Mã Phong Mãn Lâu
门房乙=người gác cổng Ất
闪躲机会=trốn tránh cơ hội
阅览室=phòng đọc sách
阎浮檀紫摩金色=Diêm Phù Đàn Tử Ma Kim Sắc
阎罗道果=Diêm La đạo quả
阮小七=Nguyễn Tiểu Thất
阮小二=Nguyễn Tiểu Nhị
阮小五=Nguyễn Tiểu Ngũ
阳形日=Dương Hình Nhật
阳灵鬼武诀=Dương Linh Quỷ Võ Quyết
阳锋=Dương Phong
阴仪=Âm Nghi
阴山鬼王=Âm Sơn Quỷ Vương
阴律司=Âm Luật Tư
阴符七术=Âm Phù Thất Thuật
阴符七术·养志法灵龟=Âm Phù Thất Thuật · Dưỡng Chí Pháp Linh Quy
阴符七术·实意法螣蛇=Âm phù thất thuật - Thực ý pháp Đằng Xà
阴象冬=Âm Tượng Đông
阴阳三才=Âm Dương Tam Tài
阴阳两极剑=Âm Dương Lưỡng Cực Kiếm
阴阳双流掌=Âm Dương Song Lưu Chưởng
阴阳本根=Âm Dương Bản Căn
阴鹫爪=Âm Độc Trảo
阿修罗王罗睺=A Tu La Vương La Hầu
阿修罗王非天=A Tu La Vương Phi Thiên
阿修罗道果=A Tu La Đạo Quả
阿嘛特拉斯=Amaterasu
阿弥陀佛法相=A Di Đà Phật Pháp Tướng
阿逸多=A Dật Đa
陆娴=Lục Nhàn
陆恒=Lục Hằng
陆文武=Lục Văn Võ
陆谪仙=Lục Trích Tiên
陈专员=Trần chuyên viên
陈行知=Trần Hành Tri
降魔印=Hàng Ma Ấn
降龙掌=Giáng Long chưởng
陵光姑姑=Lăng Quang cô cô
陶钧万物=Đào Quân Vạn Vật
随世感应三仙姑=Tùy Thế Cảm Ứng Tam Tiên Cô
随世感应仙姑=Tùy Thế Cảm Ứng Tiên Cô
雍州之战=Ung Châu Chi Chiến
雍州刺史洪好古=Thứ sử Ung Châu Hồng Hảo Cổ
雍州姜氏=Ung Châu Khương thị
雍州牧=Ung Châu Mục
雍梁=Ung Lương
雎华仙人=Sư Hoa Tiên Nhân
雨师元君=Vũ Sư Nguyên Quân
雨师祭坛=Vũ Sư Tế Đàn
雨师符诏=Vũ Sư Phù Chiếu
雨师道果=Vũ Sư Đạo Quả
雨形云=Vũ Hình Vân
雷兮·天地碎=Lôi hề · Thiên Địa Toái
雷地豫=Lôi Địa Dự
雷法枢机=Lôi Pháp Xu Cơ
雷泽龙神=Lôi Trạch Long Thần
雷神电母=Lôi Thần Điện Mẫu
雷边捷鬼=Lôi Biên Tiệp Quỷ
雷部二十四正神=Lôi Bộ Nhị Thập Tứ Chính Thần
雷部正神三五火车雷公=Lôi Bộ Chính Thần Tam Ngũ Hỏa Xa Lôi Công
雷鼓力士=Lôi Cổ Lực Sĩ
震天箭=Chấn Thiên Tiễn
震雷之相=Chấn Lôi Chi Tướng
霍然=bỗng nhiên¦đột nhiên¦khỏi bệnh ngay¦thuyên giảm nhanh chóng¦hoắc nhiên
青元山人=Thanh Nguyên Sơn Nhân
青华古树=Thanh Hoa Cổ Thụ
青帝道果=Đạo quả Thanh Đế
青帝长生=Thanh Đế Trường Sinh
青年男子=thanh niên nam tử¦chàng thanh niên¦nam tử thanh niên
青年道士=thanh niên đạo sĩ
青木古树=Thanh Mộc Cổ Thụ
青木小树=Tiểu Thụ Thanh Mộc
青玉坛=Thanh Ngọc Đàn
青玥=Thanh Nguyệt
青玥郡主=Thanh Nguyệt Quận Chúa
青阳符剑=Thanh Dương Phù Kiếm
青龙孟家=Thanh Long Mạnh Gia
青龙道果=Thanh Long đạo quả
靖平=Tĩnh Bình
靖平军=Tĩnh Bình Quân
靖阳军=Tĩnh Dương Quân
靖阳君=Tĩnh Dương Quân
非天=Phi Thiên
非常饿=rất đói
靠不靠=có thể dựa vào không
须弥化芥子=Tu Di Hóa Giới Tử
颜回=Nhan Hồi
颠倒阴阳=Điên Đảo Âm Dương
风、火、兵三灾=Phong, Hỏa, Binh Tam Tai
风乎舞雩=Phong Hồ Vũ Vu
风云月三使=Phong Vân Nguyệt tam sứ
风兮·破地=Phong hề · Phá Địa
风后奇门=Phong Hậu Kỳ Môn
风后罗盘=Phong Hậu La Bàn
风坟=Phong Phần
风形气=Phong Hình Khí
风氏一族=Phong Thị Nhất Tộc
风氏始祖=Phong Thị Thủy Tổ
风氏族人=Phong Thị Tộc Nhân
风清瑶=Phong Thanh Dao
风紫阳=Phong Tử Dương
风雨雷电四神=Phong Vũ Lôi Điện Tứ Thần
飞云使者=Phi Vân Sứ Giả
飞云姜家=Phi Vân Khương Gia
飞云镇=Phi Vân Trấn
飞剑斩黄龙=Phi Kiếm Trảm Hoàng Long
首创种桑养蚕=Thủ Sáng Chủng Tang Dưỡng Tằm
首山赤铜=Thủ Sơn Xích Đồng
马知州=Mã Tri Châu
马虎=qua loa¦đại khái¦tàm tạm¦mã hổ
马面罗刹=Mã Diện La Sát
骑虎道人=Kỵ Hổ đạo nhân
骠骑将军·冠军侯=Phiêu Kỵ Tướng Quân - Quán Quân Hầu
骠骑将军殷屠龙=Phiếu Kỵ Tướng Quân Ân Đồ Long
高一=cao nhất¦cấp một¦cao nhất¦lớp 10¦cao một¦năm nhất THPT¦năm nhất cao trung
高侃=Cao Khản
高刁北翁=Cao Điêu Bắc Ông
高周波=Cao Chu Ba
高阳氏=Cao Dương Thị
鬼影鞭=Quỷ Ảnh Tiên
魂离魄散=Hồn ly phách tán
魏元舒=Ngụy Nguyên Thư
魔波旬=Ma Ba Tuần
魔祖波旬=Ma Tổ Ba Tuần
魔罗之境=Ma La Chi Cảnh
魔罗剑典=Ma La Kiếm Điển
魔罗波旬=Ma La Ba Tuần
鱼奉先=Ngư Phụng Tiên
鱼妇=Ngư Phụ
鱼篮观音=Ngư Lam Quan Âm
鲁王世子=Lỗ Vương Thế Tử
鲁王世子姬承业=Lỗ Vương thế tử Cơ Thừa Nghiệp
鲁王姬野=Lỗ Vương Cơ Dã
鸟位=điểu vị
麟德历=Lân Đức Lịch
黄天之目=Hoàng Thiên Chi Mục
黄天之眼=Hoàng Thiên Chi Nhãn
黄天庙=Hoàng Thiên miếu
黄天法相=Hoàng Thiên Pháp Tướng
黄天真身=Hoàng Thiên Chân Thân
黄师=Hoàng sư
黄帝六相=Hoàng Đế Lục Tướng
黄帝内传=Hoàng Đế Nội Truyện
黄帝四相=Hoàng Đế Tứ Tướng
黄帝四面=Hoàng Đế Tứ Diện
黄帝土皇道=Hoàng Đế Thổ Hoàng Đạo
黄帝的轩辕剑=Hiên Viên Kiếm của Hoàng Đế
黄眉大王=Hoàng Mi Đại Vương
黄铜浑天仪=Hoàng Đồng Hỗn Thiên Nghi
黄龙变=Hoàng Long Biến
黄龙法身=Hoàng Long Pháp Thân
黄龙街=Hoàng Long Nhai
黑天之甲=Hắc Thiên Chi Giáp
黑心煞掌=Hắc Tâm Sát Chưởng
黑心虎=Hắc Tâm Hổ
黑暗动乱=Hắc Ám Náo Động
黑暗年代=hắc ám niên đại
黑水玄流=Hắc Thủy Huyền Lưu
鼎湖=Đỉnh Hồ
鼎湖北面=Đỉnh Hồ bắc diện
鼎湖天璇=Đỉnh Hồ Thiên Toàn
鼎湖派=Đỉnh Hồ Phái
鼬=Itachi¦chồn sóc
齐天大圣孙悟空=Tề Thiên Đại Thánh Tôn Ngộ Không
齐物与一=Tề Vật Dữ Nhất
齐物论=Tề Vật Luận
齐长生=Tề Trường Sinh
齐阳河=Tề Dương Hà
龙伯巨人=Long Bá Cự Nhân
龙华宝树=Long Hoa Bảo Thụ
龙华树=Cây Long Hoa
龙场=long tràn
龙城录=Long Thành Lục
龙头观音=Long Đầu Quan Âm
龙宫海神=Long Cung Hải Thần
龙岳大匠师=Long Nhạc đại tượng sư
龙泉镇=Long Tuyền Trấn
龙渊湖=Long Uyên Hồ
龙渊阁=Long Uyên Các
龙王赘婿=Long Vương tế tế
龙甲神章=Long Giáp Thần Chương
龙虎玄坛真君=Long Hổ Huyền Đàn Chân Quân
龙蛇体=Long Xà Thể
龙须白虎=Long Tu Bạch Hổ
ＢＵＦＦ=BUFF