45号(水牛古朗基)=Số 45
Agito=Agito
Agit欧米茄=Agit Omega
AgtiΩ=AgtiΩ
ArcleApple=Arcle Apple
Arcle盖亚记忆体=Arcle Gaia Memory
Arcle记忆体=Arcle Memory
Armored Rider=Armored Rider
AttackRide=AttackRide
B1=B1
B1号=Số B1
BIG MACHINE=Cỗ máy Lớn
BOARD=BOARD
BOARD研究所=Viện nghiên cứu BOARD
Bad Apple=Bad Apple
BadApple=BadApple
Baron巴隆=Baron/Ba-ron
Batta=Batta
Beast=Beast
BlackApple=Black Apple
Blade=Blade
Blay=Blay
Blue Spader(绀蓝黑桃)=Blue Spader
Build=Build
Chalice=Chalice
ClayDoll=ClayDoll
ClayDoll（泥娃娃）=ClayDoll
Clock Up=Clock Up
Core Switch=Core Switch
Cyclone=Cyclone
DCD事务=Công việc DCD
DCD事务所=Văn phòng DCD
DJ相良=DJ Sagara
Dark Kiva=Dark Kiva
De-De-De-Decade=De-De-De-Decade
Decade=Decade
Decade时空=Không gian Decade
Decade驱动器=Decade Driver
Decade驾驭表头=Decade Ridewatch
Diend=Diend
Dragon Arms！=Dragon Arms!
Dragon——Lock On！=Dragon——Lock On!
Drive驾驭表头=Drive Gia Ngự Biểu Đầu
Dummy=Dummy
Elek=Elek
Faiz=Faiz
Fang=Fang
Fang(獠牙)=Fang
Fangire=Fangire
Final AttackRide=Final AttackRide
Fourze=Fourze
Fourze世界=Thế giới Fourze
Fourze驱动器=Fourze Driver
G1=G1
G1装甲=Áo giáp G1
G3=G3
G3-X=G3-X
G3-X系统=Hệ thống G3-X
G3-X装甲=Giáp G3-X
G3小组=Tổ G3
G3小队=Đội G3
G3挂车移动指挥室=Phòng chỉ huy di động xe moóc G3
G3系统=Hệ thống G3
G3装甲=Áo giáp G3
G3训练室=Phòng Huấn luyện G3
G4=G4
G4装甲=Áo giáp G4
G4计划=Kế hoạch G4
GS-03=GS-03
GX-05=GX-05
GX机枪=Súng Máy GX
Gaim铠武=Gaim/Kaimu
Garren=Garren
Garren觉醒器(醒枪)=Garren Awakener
Geiz=Geiz
Gigant=Gigant
Gills=Gills
Gills劫掠者=Gills Raider
Go集团=Tập đoàn Go
Gridon=Gridon
G挂车=Xe kéo G
G系列=Dòng G
G系统=Hệ thống G
Heat=Heat
Henshin～=Henshin～
Ichigo Arms！=Ichigo Arms!
Ichigo——Lock On！=Ichigo - Lock On!
JACK=JACK
JOKER=JOKER
Joker=Joker
Joker(王牌)=Joker
Kamen Rider=Kamen Rider
KamenRide=KamenRide
King=Vua
KingForm=KingForm
Kiva=Kiva
Kiva-la=Kivala
Kivat=Kivat
Kivat三世=Kivat III
Leangle=Leangle
Lisa姐=Lisa tỷ
Lock On=Lock On
Lock On！=Lock On!
Luna=Luna
M4尾翼稳定贫铀穿甲弹=Đạn xuyên giáp ổn định cánh đuôi M4 bằng uranium nghèo
M87光线=Tia M87
M87至尊佛光=M87 Chí Tôn Phật Quang
MAGI MAGI MAGIC=MAGI MAGI MAGIC
Masquerade=Masquerade
Metal=Metal
Me集团=Tập đoàn Me
Nasca=Nasca
Nasca（纳斯卡）=Nasca
N集团=Tập đoàn N
OOO=OOO
OOO驱动器=Driver OOO
One=One
Orange=Orange
Orange Arms=Orange Arms
Pine=Pine
PolePole=PolePole
PolePoleコーヒー馆=Quán cà phê PolePole
PolePole咖啡馆=Quán cà phê PolePole
Power=Power
Queen=Queen
Ra集团=Tập đoàn Ra
Rider Kick=Rider Kick
Rocket On=Rocket On
Ryugen（龙玄）=Ryugen
SIC=SIC
Sid（西德）=Sid
Skull=Skull
Smilodon=Smilodon
Soiya=Soiya
Soiya！=Soiya!
TPC远东总部=Tổng bộ Viễn Đông TPC
Taboo=Taboo
Taboo（禁忌）=Taboo
Taka=Taka
Terror=Terror
Terror（恐惧）=Terror
Three=Three
Tora=Tora
TrialB=TrialB
Trigger=Trigger
TryChaser2000=TryChaser2000
TryChaser2000(试验追迹者2000)=TryChaser 2000
TryChaser2000A=TryChaser2000A
Two=Two
UltApple=Ult Apple
UltChaser=UltChaser
UltChaser(究极追迹者)=UltChaser
Undead=Undead
Unknown=Unknown
V带扣=Khóa V
Weather=Weather
Wizard=Wizard
W世界=Thế giới W
W基地=Căn cứ W
W的世界=Thế giới W
W硬汉号=Hardboilder
W驱动器=W Driver
X战警：第一战=X-Men: Thế Hệ Đầu Tiên
X财团=Tập đoàn X
Yummy=Yummy
Zangetsu=Zangetsu
Zi-O=Zi-O
ZiO=Zi-O
ZiO世界=Thế giới ZiO
ZiO二阶=Zi-O Nhị Giai
Zio=Zio
Zu集团=Zu Group
babobo一族=Tộc Babobo
baboo一族=bộ tộc Baboo
baboo族=Tộc Baboo
baboo星球=Tinh cầu Baboo
kawagen=Kawagen
kivatⅢ世=Kivat Đệ Tam
zio=Zio
Ⅲ世=Thế hệ thứ 3
ダグバ=Daguba
一条先生=Ichijo tiên sinh
一条薫=Ichijo Kaoru
一条薰=Ichijo Kaoru
一条警官=Thanh tra Ichijo
一阳神功=Nhất Dương Thần Công
丁香花粉=Bột đinh hương
七侠虹猫=Thất Hiệp Hồng Miêu
七剑合璧=Thất Kiếm Hợp Bích
七大上神尊者=Thất Đại Thượng Thần Tôn Giả
万寿王=Vạn Thọ Vương
万相仙人=Vạn Tướng Tiên Nhân
万载泪泉=Vạn Tải Lệ Tuyền
三云咲子=Mikumo Sakiko
三井会社=Công ty Mitsui
三分教场=Tam Phân Giáo Trường
三十三天神力=Tam Thập Tam Thiên Thần Lực
三小只=ba đứa nhỏ
三摩地=Tam Ma Địa
三浦智子=Miura Tomoko
三田総合病院=Bệnh viện Tổng hợp Mita
三连城=Tam Liên Thành
三首万相=Tam Thủ Vạn Tướng
上主=Thượng Chủ
上主梵天=Thượng Chủ Phạm Thiên
上主那罗延=Thượng Chủ Narayana
上单狗头=Đường trên Đầu Chó
上城睦月=Kamijō Mutsuki
上翔一=Tsukasa Shouichi
不喜欢看书的我又来了=Tôi không thích đọc sách lại đến rồi
不幸女神【耶瑟陀】=Nữ thần bất hạnh [Yeshetha]
不死苏摩=Bất Tử Tô Ma
专职消防员=Lính cứu hỏa chuyên trách
世尊大梵天=Thế Tôn Đại Phạm Thiên
世尊梵天=Thế Tôn Phạm Thiên
世界树塔=Thế Giới Thụ Tháp
世界树财团=Yggdrasil Corporation
世界树集团=Yggdrasil Corporation
世界的破坏者Decade=Kẻ hủy diệt thế giới Decade
世纪王影月=Thế Kỷ Vương Kageyama
业果神=Nghiệp Quả Thần
业果神娑尼=Nghiệp Quả Thần Sa Ni
东·德盖亚=Đông · Đức Cái Á
东京站=Ga Tokyo
东京若叶保育员=Nhân viên trông trẻ Wakaba, Tokyo
东京警视厅=Sở Cảnh sát Thủ đô Tokyo
东京都警察厅=Sở Cảnh sát Thủ đô Tokyo
东光国=Đông Quang Quốc
东弗婆提=Đông Phất Bà Đề
东弗婆提洲=Đông Phất Bà Đề Châu
东方神乞=Đông Phương Thần Khất
东杜毗=Đông Đỗ Tì
东瀛四岛=Bốn đảo Đông Doanh
东瀛宣化号=Đông Doanh Tuyên Hóa Hiệu
东瀛紫气宗=Đông Doanh Tử Khí Tông
两个就可=hai cái liền có thể
两人目=hai người mắt
两人说道=hai người nói
两师兄弟=hai sư huynh đệ
中央区马喰町站=Ga Bakurocho, quận Chuo
中苏=Trung Tô
丰岛区=Toshima
临多=Rinto
临多部落=bộ lạc Rinto
丹巴=Đan Ba
久保川大厦=Tòa nhà Kubokawa
久良良岛屿=Cửu Lương Lương Đảo
之至阴=chí âm
乌丸启=Karasuma Hajime
乌格罗坦瓦=Ugrotanva
乌格罗迦=Ugroka
乌玛=Uma
乌贼古朗基=Unizaurus Gurongi
乌贼恶魔=Ác Ma Mực
乌辫若旋釜，恒河溅玉飞！=Ô biện nhược toàn phủ, Hằng hà tiên ngọc phi!
乌鲁鲁巨岩=Uluru Cự Nham
乌鸦尊者=Lord Crow
乌鸦种属=Crow Genus
乌龟大师=Sư phụ Rùa
乔·吉布肯=Joe Gibken
乔斯图跋=Jostubha
乔斯图跋宝石=Jewel Kaustubha
乔答摩=Gautama
乔答摩仙人=Kiều Đáp Ma tiên nhân
九空为一念，九空无界是意念的世界，在这里可以能外界之不能=Cửu Không Vi Nhất Niệm, Cửu Không Vô Giới Thị Ý Niệm Đích Thế Giới, Tại Giá Lý Khả Dĩ Năng Ngoại Giới Chi Bất Năng
九郎岳=Kurougatake
九郎岳遗迹=Di tích Kurogatake
九郎岳遺跡=Di tích Kurogatake
九郎岳陨坑事件=Sự kiện Hố thiên thạch Cửu Lang Nhạc
九阳大霹雳=Cửu Dương Đại Phích Lịch
乾坤任我行=Càn Khôn Nhậm Ngã Hành
乾燥枪=Dryer Gun
乾皇=Càn Hoàng
乾达摩陀那山=Càn Đạt Ma Đà Na Sơn
亀山=Kameyama
了他的心脏=hắn tâm tạng
二分时代=Nhị Phân Thời Đại
云无常=Vân Vô Thường
云神——娑罗尼尤=Vân Thần - Sāraṇyū
云神娑罗尼尤=Vân Thần Toa La Ni Vưu
云蝠=Vân Bức
云蝠军团=Vân Bức Quân Đoàn
云蝠盾=Vân Bức Thuẫn
云蝠神=Vân Bức Thần
云蝠阵=Vân Bức trận
云霆=Vân Đình
五代稔=Godai Minoru
五代雄介=Godai Yusuke
五子阿修罗=Ngũ Tử A Tu La
五行先天功=Ngũ Hành Tiên Thiên Công
五行忍者=Ngũ Hành Nhẫn Giả
五行晶石=Ngũ Hành Tinh Thạch
五行领域=Ngũ Hành Lĩnh Vực
五连者=Gorenger
五通庙=Ngũ Thông miếu
五通邪神=Ngũ Thông Tà Thần
五通镇=Ngũ Thông trấn
五雷化极手=Ngũ Lôi Hóa Cực Thủ
亚克迪斯号=Tàu Yacdes
亚刻=Ark
亚古鲁前辈=Aguru tiền bối
亚古鲁灵石=Aguile Stone
亚古鲁符印=Agul Rune
亚古鲁腰带=Arcle Đai Lưng
亚拉伦拉府=Government House
亚极陀=Agito
亚极陀(AgitΩ)=Agito
亚极陀捕获计划=Kế hoạch bắt giữ Agito
亚玛达姆灵石=Amadam Linh Thạch
亚穆纳河=Yamuna
亡月劫=Vong Nguyệt Kiếp
亲娘舅=cậu ruột
人狮=Nhân Sư
人狮那罗辛哈=Nhân Sư Na La Tân Ha
仁藤攻介=Nitou Kousuke
仓田剑二=Kurata Kenji
他日之因=ngày khác chi Nhân
他生渡=Tha Sinh Độ
仙剑的世界=Thế giới Tiên Kiếm
仙贝汤=Bánh gạo Senbei súp
仙风云体术=Tiên Phong Vân Thể Thuật
伊卡将军=Tướng quân Yka
伊狩凯=Ikari Gai
伊罗=Ila
伏斯亚=Phục Tư Á
伏斯亚人=Người Exif
伐兰妮=Phạt Lan Ni
伐摩那=Phạt Ma Na
伐楼那=Phạt Lâu Na
伐楼那之力=Phạt Lâu Na Chi Lực
伐楼那天=Phạt Lâu Na Thiên
伐樓那=Varuna
伐由=Phạt Do
伐由之力=Phạt Do Chi Lực
伐由天=Phạt Do Thiên
众友=Chúng Hữu
众友仙人=Chúng Hữu Tiên Nhân
众生由我灭=Chúng Sinh Do Ngã Diệt
众车苑=Chúng Xa Uyển
优多摩=Ưu Đa Ma
优多摩仙人=Ưu Đa Ma Tiên Nhân
伽亭=Già Đình
伽内什=Già Nội Thập
伽利玛=Galima
伽多鲁=Gadoru
伽奢南=Già Xa Nam
伽奢南达=Già Xa Nam Đà
伽旃延妮=Già Chiên Diên Ni
伽旃延那=Già Chiên Diên Na
伽罗尼米=Già La Ni Mễ
伽美戈=Gamego
伽陀神杵=Gada Thần Xử
伽陀神锤=Chùy Gada
伽雅泽=Gayaza
佐斯星系=Hệ sao Zoss
俏小龙=Tiếu Tiểu Long
修卡=Shocker
俱卢之野=Câu Lư Chi Dã
俱卢族=Kaurava
倩女世界=Thế giới Thiện Nữ
倩女幽魂世界=Thế giới Thiện Nữ U Hồn
假面骑士1号=Kamen Rider 1
假面骑士2号=Kamen Rider 2
假面骑士Abyss=Kamen Rider Abyss
假面骑士Beast=Kamen Rider Beast
假面骑士Blade=Kamen Rider Blade
假面骑士Chalice=Kamen Rider Chalice
假面骑士Chalice(卡利斯)=Kamen Rider Chalice
假面骑士Decade=Kamen Rider Decade
假面骑士Decade(帝骑)=Kamen Rider Decade
假面骑士Diend=Kamen Rider Diend
假面骑士Fourze=Kamen Rider Fourze
假面骑士Garren(格连)=Kamen Rider Garren
假面骑士Geiz=Kamen Rider Geiz
假面骑士Ixa=Kamen Rider Ixa
假面骑士J=Kamen Rider J
假面骑士Kiva=Kamen Rider Kiva
假面骑士Kiva-la=Kamen Rider Kiva-la
假面骑士Kuuga=Kamen Rider Kuuga
假面骑士Nadeshiko=Kamen Rider Nadeshiko
假面骑士OOO=Kamen Rider OOO
假面骑士RX=Kamen Rider RX
假面骑士Skull=Kamen Rider Skull
假面骑士W=Kamen Rider W
假面骑士Wizard=Kamen Rider Wizard
假面骑士ZiO=Kamen Rider Zi-O
假面骑士kiva-la=Kamen Rider Kivala
假面骑士一号=Kamen Rider 1
假面骑士亚古鲁=Giả Diện Kỵ Sĩ A Cổ Lỗ
假面骑士亚极陀=Kamen Rider Agito
假面骑士响鬼=Kamen Rider Hibiki
假面骑士巴隆=Kamen Rider Baron
假面骑士斩月=Kamen Rider Zangetsu
假面骑士甲斗=Kamen Rider Kabuto
假面骑士电王=Kamen Rider Den-O
假面骑士空我=Kamen Rider Kuuga
假面骑士部=Câu lạc bộ Kamen Rider
假面骑士铠武=Kamen Rider Gaim
假面骑士魔法师=Kamen Rider Wizard
假面骑士龙玄=Kamen Rider Ryugen
假面骑士龙骑=Kamen Rider Ryuki
傲剑山庄=Ngạo Kiếm Sơn Trang
傲慢之弓=Cung Ngạo Mạn
僧皇=Tăng Hoàng
元极摩柯无量=Nguyên Cực Ma Kha Vô Lượng
元正长老=Nguyên Chính trưởng lão
元空灭=Nguyên Không Diệt
元空间=Nguyên Không Gian
先天之法=Tiên Thiên chi pháp
光之力=Power of Light
光之国=Quốc gia Ánh sáng
光夏海=Hikari Natsumi
光头强哥=Quang Đầu Cường Ca
光实=Mitsuzane
光氏秘技笑穴指=Tuyệt kỹ Tiếu Huyệt Chỉ của dòng họ Hikari
光照相馆=Hiệu ảnh Hikari
光荣次郎=Hikari Eijiro
克劳恰=Khắc Lao Xa
克莱西斯要塞=Pháo đài Crisis
克里莫斯群岛=Quần đảo Kremos
全胜祭=Toàn Thắng Tế
全能型空我=Mighty Form Kuuga
全能形态=Dạng toàn năng
全能空我=Ultimate Kuuga
全能骑士踢=Đá Hiệp sĩ Toàn năng
八代蓝=Yashiro Ai
八哥鸟=chim sáo
八大不死神明=Bát Đại Bất Tử Thần Minh
八大恶魔=Bát Đại Ác Ma
八大恶魔篇=Bát Đại Ác Ma Thiên
八大魔气=Bát Đại Ma Khí
八大魔气篇=Bát Đại Ma Khí Thiên
八尾博士=Tiến sĩ Yawei
八王子区=Khu Hachioji
八王子驻地研究所=Viện nghiên cứu thường trú Hachioji
六勾玉轮回眼=Lục Câu Ngọc Luân Hồi Nhãn
六阳魁首=Lục Dương Khôi Thủ
兰巴=Lamba
兰巴阿修罗=Lan Ba A Tu La
兰帕尔特光弹=Đạn Ánh Sáng Rampart
关东医大病院=Bệnh viện Đại học Y Kanto
关谷真澄=Quan Cốc Chân Trừng
兽主=Thú Chủ
兽主法宝=Thú Chủ Pháp Bảo
内既有气=thể nội có khí
冈村可奈=Okamura Kana
冈村小姐=Cô Okamura
冥府之斧=Minh Phủ Chi Phủ
冰川城=Hikawa Makoto
冰川诚=Hikawa Makoto
冲绳色=Màu Okinawa
冷胭=Lãnh Yên
净化天使=Tịnh Hóa Thiên Sứ
净流=Tịnh Lưu
凄厉战士=Chiến binh kinh hoàng
凌云十八骑=Lăng Vân Thập Bát Kỵ
凌霄神殿=Lăng Tiêu Thần Điện
凤兮凤兮归故乡=Phượng hề phượng hề quy cố hương
凤凰大典=Phượng Hoàng Đại Điển
凤歌笑九天=phượng ca tiếu cửu thiên
凤舞天际=Phượng Vũ Thiên Tế
凯罗帕=Kairoppa
刀龙=Đao Long
切换者=Switcher
创世王=Sáng Thế Vương
创世王影月=Vua Sáng Thế Kageyama
创世纪驱动器=Sáng Thế Kỷ Khu Động Khí
创界山=Sáng Giới Sơn
初生究极空我=Growing Ultimate Kuuga
初生空我=Growing Form Kuuga
利吉迦=Lợi Cát Ca
利吉迦仙人=Lợi Cát Già Tiên Nhân
刺刃团=Thứ Nhận Đoàn
刺猬大师=Sư phụ Nhím
剑岳=Kiếm Nhạc
剑崎=Kenzaki
剑崎一真=Kenzaki Kazuma
剑川虹=Kengawa Koji
剑扫乾坤=Kiếm Tảo Càn Khôn
剑立一真=Tachibana Kazuma
剑蝎=Kiếm Hạt
剑蝎纵横行=Kiếm Hạt Túng Hoành Hành
力量之主=Lực Lượng Chi Chủ
功夫熊猫世界=Thế giới Kungfu Panda
加古川飞流=Kakogawa Hiryu
加州金色=Màu vàng California
加库玛贝塔=Gia Khố Mã Bối Tháp
加库玛阿尔法=Gia Khố Mã An Nhĩ Pháp
劫掠者摩托车=Mô tô Cướp Bóc
劫掠者机车=Raider Motorcycle
劫末之火=Kiếp Mạt Chi Hỏa
劫王=Kiếp Vương
勇莲=Dũng Liên
北俱卢=Bắc Câu Lô
北方冰原=Bắc Phương Băng Nguyên
北条警官=Cảnh sát Hojo
北条透=Hojo Toru
北海幼儿园=Bắc Hải Nhà trẻ
北饮狂刀聂人王=Bắc Ẩm Cuồng Đao Nhiếp Nhân Vương
匠神=Tượng Thần
匠神毗首羯磨=Vishwakarma
十二星座战士=Thập Nhị Tinh Tọa chiến sĩ
十二星座装甲=Thập Nhị Cung Tinh Tọa Trang Giáp
十二生肖动物=Thập Nhị Sinh Tiếu Động Vật
十二生肖动物篇=Thập Nhị Sinh Tiếu Động Vật Thiên
十二符咒=Thập Nhị Phù Chú
十大气忍=Thập Đại Khí Nhẫn
十字戏=Thập Tự Hí
十车=Thập Xa
十车王=Dasharatha
十里画廊=Thập Lí Họa Lang
十首=Thập Thủ
十首罗刹=Thập Thủ La Sát
十首罗波那=Thập Thủ La Bà Na
千叶站=Ga Chiba
千年僵尸王=Thiên Niên Cương Thi Vương
千年老树妖=Thiên Niên Lão Thụ Yêu
千本=ngàn bản/senbon
千眼的大神=Vị thần ngàn mắt
千首蛇王舍沙=Thiên Thủ Xà Vương Xá Sa
升华之力=Sức mạnh Thăng Hoa
升华天马弩=Rising Pegasus Bowgun
升华天马空我=Rising Pegasus Kuuga
升华泰坦剑=Rising Titan Sword
升华究极空我=Siêu việt Ultimate Kuuga
华丽贵族=Hoa Lệ Quý Tộc
卑弥乌=Bimyuu
南儋部州=Jambudvipa
南无初代奥特曼至尊佛=Nam mô Sơ Đại Ultraman Chí Tôn Phật
南无奥特佛之父=Nam mô Ultraman Chi Phụ
南无希瓦=Namo Shivaya
南无沙福林佛=Nam mô Sa Phước Lâm Phật
南无迪迦古佛=Nam mô Địch Gia Cổ Phật
南笛=Nam Địch
南阎浮提=Nam Diêm-phù-đề
南阎浮提州=Nam Diêm Phù Đề Châu
南阎浮提洲=Nam Diêm Phù Đề Châu
南麟剑首断帅=Nam Lân Kiếm Thủ Đoạn Soái
博物馆组织=Tổ Chức Bảo Tàng
卜洛=Bốc Lạc
卡多=Gatou/Tạp Đa
卡尼拉=Tạp Ni Lạp
卡拉法尔大帝=Karafar Đại Đế
卡玛苏尔=Tạp Mã Tô Nhĩ
卢茜尼=Lư Tây Ni
卢西檀=Lư Tây Đàn
原桑=Hara-san
友邻=Hữu Lân
友邻王=Hữu Lân Vương
双子怪盗=Song Tử Quái Đạo
双子飞碟=Song Tử Phi Điệp
双重驱动器=Double Driver
双马童=Song Mã Đồng
双马童天=Song Mã Đồng Thiên
双鱼判官=Song Ngư Phán Quan
变种人黑皇=Dị nhân Black King
古兰斯菲亚=Goulud Sphire
古姜国=Cổ Khương Quốc
古政贺男=Komassa Heo Nam
古昔仙人=Gu Xi Xianren
古朗基之王=Vua Gurongi
古朗基之王达古巴=Vua Gurongi Daguva
古藤林=Cổ Đằng Lâm
古贺政男=Koga Masao
古鲁达=Guruda
可奈=Kana
可奈酱=Kana-chan
台场=Odaiba
右国师府=Hữu Quốc Sư phủ
合成兽达兰比尔=Quái thú tổng hợp Daranbir
吉什金陀=Kishkindha
吉古罗=Cát Cổ La
吉吉迦=Kikasa
吉提迦=Cát Đề Ca
吉祥之音=Âm thanh cát tường
吉祥女神=Cát Tường Nữ Thần
吉纲参谋=Tham mưu trưởng Yoshitsugu
吉纲参谋长=Tham mưu trưởng Kitsuna
吉罗娑=Cát La Sa
吐浑=Tuhan
吠琉璃=Phệ Lưu Li
吠陀女神=Nữ thần Veda
吠陀守护者=Người bảo vệ Veda
吠陀守护者因陀罗=Thần Indra Người bảo vệ Veda
吠陀智人=Phệ Đà Trí Nhân
吴岛光实=Kureshima Mitsuzane
吴岛贵虎=Kureshima Takatora
员工掺杂体=Nhân Viên Tham Tạp Thể
周瑟=Chu Sắt
和平谷=Thung lũng Hòa Bình
咒蓝=Chú Lam
咻咻地——Spark！=Shushu di - Spark!
品川区=Quận Shinagawa
品红色=Màu đỏ tía
品红骑士=Hiệp sĩ Crimson
哈奴曼耆特=Hanuman
哈姆萨=Hamsa
哈斯底=Hastin
哈维拉塞尔=Harvey Russell
哈马行星=Hành tinh Hama
响尾蛇怪人=Quái nhân Rắn đuôi chuông
哑女=cô gái câm
哥布纽=Gobu Nu
哥莱姆=Golem
哥莱姆灵石=Golem Stone
唯敬=Duy Kính
唯清=Duy Thanh
商吉婆尼=Sanjivani
商吉婆尼之咒=Thương Cát Bà Ni Chi Chú
商吉婆尼咒=Chú Thương Cát Bà Ni
商波尊=Shambhu
商波罗=Shambala
啊尔何求=A Nhĩ Hà Cầu
善心之甲=Thiện Tâm Chi Giáp
善恶平衡器=Thiện Ác Bình Hành Khí
善见城=Thiện Kiến Thành
喜天仙人=Hỷ Thiên Tiên Nhân
喜林苑=Hỷ Lâm Uyển
喵绅士=Miêu thân sĩ
嗡拿马西瓦=Om Namah Shivaya
噬欲怪=Yummy
四大瑞兽=Tứ Đại Thụy Thú
四天玄男=Tứ Thiên Huyền Nữ
四方魔渡行=Tứ Phương Ma Độ Hành
四部吠陀=Tứ Bộ Vệ Đà
回元血手=Hồi Nguyên Huyết Thủ
回旋冲刺者号=Cyclone Dasher
因陀罗之弓=Cung Indra
因陀罗之矢=Mũi tên Indra
因陀罗之轮=Luân xa của Indra
因陀罗尼=Nhân Đà La Ni
因陀罗尼耶=Indraniye
因陀罗耆特=Nhân Đà La Kỳ Đặc
园咲=Sonozaki
园咲冴子=Sonozaki Saeko
园咲家=Gia tộc Sonozaki
园咲府邸=Dinh thự Sonozaki
园咲来人=Sonozaki Raimon
园咲琉兵卫=Sonozaki Ryubee
园咲若菜=Viên Tiếu Nhược Thái
园咲集团=Tập đoàn Sonozaki
园咲雾彦=Sonozaki Kirihiko
土忍者=Thổ Ninja
土魔兽=Thổ Ma Thú
圣主符咒=Thánh Chủ Phù Chú
圣城迦尸=Thánh Thành Ca Thi
圣心功=Thánh Tâm Công
圣心真气=Thánh Tâm Chân Khí
圣灵披风=Thánh Linh Phi Phong
圣辉星云=Tinh vân Thánh Huy
地之上神=Địa chi Thượng Thần
地之天使=Thiên sứ Đất
地之石=Đá Đất
地心之谷=Địa Tâm Chi Cốc
地极摩诃无量=Địa Cực Ma Kha Vô Lượng
地母昔弥=Địa Mẫu Tích Di
地狱大使=Đại sứ Địa ngục
地球之井=Giếng Trái Đất
地球和平联合组织=Tổ chức Liên hợp Hòa bình Trái Đất
地球图书馆=Thư viện Địa Cầu
地球巫女=Vu nữ Địa Cầu
地魁=Địa Khôi
坂田区=Khu Sakata
坟头草=cỏ mộ
坦达瓦=Tandava
埃尔斯巨岩=Tảng đá khổng lồ Els
城北大学=Đại học Johoku
城南大学=Đại học Jounan
城堡破坏者=Kẻ Phá Hoại Thành Trì
基加哥布纽=Giga Gebonew
基博隆=Kiboron
基基鲁=Gegiru
基基鲁游戏=Gegiru Game
基德隆=Kidlon
基德隆灵石=Linh thạch Kidoron
基德隆腰带=Gedoron Belt
基德鲁=Gegiru
基德鲁腰带=Đai lưng Gegeru
基里艾洛德之神=Thần Kirieloid
基里艾洛德预言家=Nhà tiên tri Kiri-elod
堤口夫人=Phu nhân Tsutsumiguchi
堤口惠美子=Tsutsumiguchi Emiko
塞巴斯蒂安—肖=Sebastian Shaw
塞巴斯蒂安肖=Sebastian Shaw
塞迪克科技公司=Công ty Khoa học Kỹ thuật Sedic
壳生女神=Xác Sinh Nữ Thần
复活者驾驭表头=Revive RideWatch
夏亚=Hạ Á/Char
夏海=Natsumi
夏目实加=Natsume Mika
夏目実加=Natsume Mika
夏目教授=Giáo sư Natsume
夏蜜柑=Natsumikan
夕瑶玄女=Tịch Dao Huyền Nữ
外浦海岸=Urakaigan
外祖母悖论=Nghịch lý bà ngoại
多刹迦=Đa Sát Ca
多摩市=Thành phố Tama
多摩市警察部=Sở Cảnh sát thành phố Tama
多摩江=Sông Tama
夜凌云=Dạ Lăng Vân
夜枭子=Dạ Kiêu Tử
夜柔吠陀=Yajurveda
大BOSS=Trùm Cuối
大修卡=Dai Shocker
大修卡城堡=Lâu đài Đại Tu Tạp
大修卡组织=Tổ chức Dai-Shocker
大兜虫=Kabutomushi/Bọ hung lớn
大力猫=Đại Lực Miêu
大力神发射井=Giếng phóng Đại Lực Thần
大力罗摩=Đại Lực La Ma
大哥斯拉=Đại Godzilla
大哥赎罪啊=Đại ca tha tội a
大地女神昔弥=Đại Địa Nữ Thần Tích Di
大天=Đại Thiên
大天之子=Đại Thiên Chi Tử
大天湿婆=Đại Thiên Shiva
大天生子=Đại Thiên Sinh Tử
大帝王=Đại Đế Vương
大文字隼=Daimonji Shun
大杉忠太=Osugi Chuta
大橙丸=Daidaimaru
大残虐=Dai-Zangyack
大残虐军团=Đại Tàn Bạo Quân Đoàn
大残虐帝国=Great Zangyack Empire
大自然灵心=Đại Tự Nhiên Linh Tâm
大迦那主=Đại Ca Na Chủ
大黑暗天=Đại Hắc Ám Thiên
大黑暗天法象=Đại Hắc Ám Thiên Pháp Tượng
大黑虎佛=Đại Hắc Hổ Phật
天之川=Thiên Chi Xuyên
天之川学园=Học viện Amanogawa
天之川学园都市=Thiên Chi Xuyên Học Viện Đô Thị
天之川高校=Trường trung học Amanogawa
天亮号=Thiên Lượng Hào
天亮号事件=Sự kiện tàu Tenrei
天使光环=Thiên Sứ Quang Hoàn
天兵队长=Đội trưởng Thiên Binh
天命圣教=Thiên Mệnh Thánh Giáo
天帝伏羲=Thiên Đế Phục Hy
天帝因陀罗=Thiên Đế Indra
天帝神殿=Thiên Đế Thần Điện
天帝阿耆尼=Thiên Đế Agni
天悬白练=Thiên Huyền Bạch Luyện
天授海螺=Thiên Thụ Hải Loa
天文开关=Công tắc thiên văn
天池十二杀手=Thiên Trì Thập Nhị Sát Thủ
天狼堂=Thiên Lang Đường
天狼法杖=Thiên Lang Pháp Trượng
天狼神功=Thiên Lang Thần Công
天狼门=Thiên Lang Môn
天玄神刃=Thiên Huyền Thần Nhận
天王路=Tennouji
天王路博史=Tennouji Hiroshi
天界判官=Thiên Giới Phán Quan
天界法庭=Thiên Giới Pháp Đình
天界警备队=Thiên Giới Cảnh Bị Đội
天真之主=Thiên Chân chi chủ
天神星乐园化计划=Kế hoạch Lạc Viên hóa Thiên Thần Tinh
天神星防护罩=Thiên Thần Tinh Phòng Hộ Tráo
天秤判官=Thiên Xứng Phán Quan
天空魔=Thiên Không Ma
天蛇杖=Thiên Xà Trượng
天蝎座使徒=Scorpio Zodiarts
天装战队=Tensou Sentai
天装战队护星者=Thiên Trang chiến đội Hộ Tinh Giả
天门观想法=Thiên Môn Quan Tưởng Pháp
天音老人=Thiên Âm lão nhân
天音谷=Thiên Âm Cốc
天音门=Thiên Âm Môn
天香公主=Thiên Hương Công Chúa
天马弩=Pegasus Bowgun
天马形态=Pegasus Form
天马空我=Pegasus Form Kuuga
天魔三噬=Thiên Ma Tam Phệ
天魔之刃=Thiên Ma Chi Nhận
天魔九噬=Thiên Ma Cửu Phệ
天魔乱舞大法=Thiên Ma Loạn Vũ Đại Pháp
天魔六欲五行破灭大混洞妙法=Thiên Ma Lục Dục Ngũ Hành Phá Diệt Đại Hỗn Động Diệu Pháp
天魔国=Thiên Ma Quốc
天魔大化=Thiên Ma Đại Hóa
天魔大霹雳=Thiên Ma Đại Phích Lịch
天魔女葵羽=Thiên Ma Nữ Quỳ Vũ
太古魔兽=Thái Cổ Ma Thú
太平二丁目富永公司总部大厦=Trụ sở chính Tòa nhà Công ty TNHH Tominaga, Taito 2-chome
太牙=Taiga
太白仙人=Thái Bạch tiên nhân
太白老爹=Thái Bạch Lão Đệ
太阳神甲=Thái Dương Thần Giáp
太阳神苏利耶=Thần Mặt Trời Surya
太阳神马=Thái Dương Thần Mã
太阴上人=Thái Âm Thượng Nhân
太阴宗=Thái Âm Tông
太阴玄冰阵=Thái Âm Huyền Băng Trận
头提头颅者=Đầu Đề Đầu Lư Giả
奇车王=Kỳ Xa Vương
奈奈=Nana
奈奈酱=Nana-chan
奈雀儿=Natsue
奔雷剑=Bôn Lôi Kiếm
奔雷剑主=Bôn Lôi Kiếm Chủ
奢耶=Jaya
奥古玛=Áo Cổ Mã
奥特之父=Ultra Father
奥特大力龙象飞踢=Ultraman Đại Lực Long Tượng Phi Thích
奥特曼世界=Thế Giới Ultraman
奥特签名=Chữ ký Ultraman
奥特赛文=Ultra Seven
女娲大神=Nữ Oa Đại Thần
女娲血玉=Nữ Oa Huyết Ngọc
女王乌鸦尊者=Nữ Vương Quạ Tôn Giả
女王蚂蚁尊者=Nữ Vương Kiến Tôn Giả
好好吃饭=ăn cơm thật ngon
如意神树=Như Ý Thần Thụ
如意神牛=Như Ý Thần Ngưu
如月弦太朗=Gentaro Kisaragi
妖星格拉斯=Yêu tinh Grass
妙光=Diệu Quang
妙相仙人=Diệu Tướng Tiên Nhân
妙竹=Diệu Trúc
妙见=Diệu Kiến
妙见神轮=Diệu Kiến Thần Luân
妙项=Diệu Hạng
娑尼=Sa Ni
娑底耶=Ta Để Gia
娑摩吠陀=Samaveda
娑罗室伐底女神=Nữ thần Sarasvati
娑罗室伐底女神之力=Ta Bà Thất Phạt Để Nữ Thần Chi Lực
娑罗室伐底河=Sông Toa La Thất Phạt Để
娑罗尼尤=Salarinju
娑羅室伐底=Sa La Thất Phạt Để
娜迦之王=Na Già Chi Vương
娜迦蛇王=Naga Xà Vương
婆力古=Bhrigu
婆毗文=Bà Tỳ Văn
婆罗多=Bharata
婆罗娑罗摩=Parashurama
孙尼塔=Sunita
孙跋=Tôn Bạt
孙跋阿修罗=Tôn Bạt A-tu-la
孝义黑三郎=Hiếu Nghĩa Hắc Tam Lang
宁三叉戟=Ninh Tam Xoa Kích
宇宙球体斯菲亚=Quả Cầu Vũ Trụ Sphia
宇宙钢铁龙=Long thép vũ trụ
宇宙钢铁龙古瓦木=Long thép vũ trụ Guwamu
安伽=An Già
安伽城=An Già Thành
安奢那=Anjana
安溪海底城=An Khê Hải Để Thành
安陀迦=Andhaka
安陀迦那=An Đà Ca Na
宗方副队长=Đội trưởng phó Munakata
宗武海岸=Bãi biển Munetake
定锁种子=Lock Seed
宝青坊=Bảo Thanh Phường
宝青坊主=Bảo Thanh Phường Chủ
审判之杖=Trượng Phán Quyết
室利因陀罗=Thất Lợi Nhân Đà La
室利那罗延=Sri Narayana
室建陀=Skanda
宿那山=Núi Sukuna
宿那鬼=Ác quỷ Sukuna
寒冰面具=Hàn Băng Diện Cụ
对方外出=đối phương ra ngoài
封印之石=Phong Ấn Thạch
小冴=Sae
小太牙=Tiểu Taiga
小泽澄子=Ozawa Sumiko
小渡=Wataru
小短腿=chân ngắn nhỏ
小稔=Minoru
小稔稔=Komu Minoru
小象神伽内什=Thần Voi Ganesha
小野寺雄介=Onodera Yusuke
小鱼水中游=Tiểu Ngư Thủy Trung Du
尘云=Trần Vân
尸之刀=Corpse Blade
尼嘉将军=Tướng quân Ni Gia
尼奢陀=Nishaadha
尼婆多迦婆遮=Ni Bà Đa Già Bà Che
尼孙跋=Ni Tôn Bạt
尼迦斯=Ni Ca Tư
尾上巧=Onoue Takumi
尾室隆弘=Omiro Takahiro
山之恶魔波刚=Ác ma núi Bagan
山北町立花小学=Yamakita Tachibana Elementary School
山君庙=Sơn Quân miếu
岗村老师=Thầy Okamura
岛升=Shima Noboru
岡村可奈=Okamura Kana
岩浆掺杂体=Nham Tương Tham Tạp Thể
崇皇时王=Grand Zi-O
崛井=Quật Tỉnh
崩德罗迦=Paundraka
崴尔兹=Wels
崴尔兹·吉尔=Warz Gill
川原=Kawahara
川原一步=Kawahara Ayumu
川原一路=Kawahara Ichiro
川原先生=Kawahara tiên sinh
川原愿=Kawahara Negai
川原正=Kawahara Tadashi
左翔太郎=Hidari Shotaro
巨人骑士=Cự Nhân Kỵ Sĩ
巨大吼声=cự đại tiếng rống
巨山相扑超魔兽=Quái thú Sumo Siêu Ma Núi Lớn
巨马战舰=Tàu chiến Kyoma
巨魔兵=Cự Ma Binh
巨魔团=Cự Ma Đoàn
巴乎迦=Ba Hô Già
巴夏=Basshaa
巴格达(baguda)=Baghdad
巴湿伽罗=Ba Thấp Già La
巴贝鲁=Baberu
布湿波迦=Bùshī bōjiā
布莱克警长=Cảnh trưởng Blake
布陀=Budha
布雷多兰=Buredoran
希特拉=Hi Tạp Lạp
帕媚陀拉妮=Patumtara
帕尔瓦蒂女神=Nữ thần Parvati
帕罗格=Paroga
帝国恶魔攻略计划=Kế hoạch chinh phục ác ma đế quốc
帝王石=Kingstone
常在仙人=Chang Zai Xianren
常磐庄吾=Tokiwa Sougo
干燥之雷=Khô Táo Chi Lôi
幻景酒店=Khách sạn Mirage
幽冥界八云易=U Minh Giới Bát Vân Dịch
幽怜=U Liên
幽灵螳螂=Bọ ngựa ma
广濑义人=Hirose Yoshito
广濑先生=Ông Hirose
广濑栞=Hirose Shiori
广袤神=Quảng Mậu Thần
广袤神阿迦奢=Quảng Mậu Thần A-ca-xá
广袤阿迦奢天=Quảng Mậu A Già Xa Thiên
庄吾=Trang Ngô
床界山=Sàng Giới Sơn
库摩兰妮=Kumolanani
底提=Dethius
底提之子=Đế Đề Chi Tử
底提耶=Ditiye
庚伮金刚杵=Geng Nu Kim Cang Chử
度母=Độ Mẫu
康纳基=Connarky
异域者=Inves
异域者游戏=Trò chơi Inves
异次元魔神艾塔尔加=Dị Thứ Nguyên Ma Thần艾塔尔加
异界伐楼那=Dị Giới Phạt Lâu Na
异界伐由=Dị Giới Phạt Do
异界因陀罗=Dị Giới Nhân Đà La
异界梵天=Phạm Thiên Dị Giới
异界毗湿奴=Tỳ Thấp Nô Dị Giới
异界毗首羯磨=Dị Giới Tỳ Thủ Yết Ma
异界苏利耶=Dị Giới Tô Lợi Gia
异界阿耆尼=Dị Giới A Kỳ Ni
异类Build=Another Build
异类Decade=Another Decade
异类ZiO=Another Zi-O
异类ZiO二阶=Another Zi-O Nhị Giai
异类亚极陀=Another Agito
异类大橙丸=Another Daidai Maru
异类甲斗=Another Kabuto
异类电王=Another Den-O
异类铠武=Another Gaim
引妖香=Dẫn Yêu Hương
弗栗多=Vritra
弥娜迦=Menaka
弥提罗国=Mithila
弥那迦山=Di Na Ca Sơn
弦太朗桑=Gentaro-san
彩虹魔境=Cầu Vồng Ma Cảnh
影子将军=Tướng Quân Bóng Tối
御殿场线=Gotenba Line
德伐波罗=Dvapara
德伽=Dogga
德克萨斯炮=Đức Khắc Tát Tư Pháo
德兰龙城堡=Lâu đài Doran
德拉姆车=Xe Dram
德髻=Đức Kế
心中一震=chấn động trong lòng
心水=Tâm Thủy
快乐星猫=Happy Star Cat
快活林酒坊=Khoái Hoạt Lâm Tửu Phường
快螳螂=Khoái Đường Lang
忿怒之塔=Tháp Phẫn Nộ
怒剑=Nộ Kiếm
怒剑狂刀=Nộ Kiếm Cuồng Đao
怔愣=sững sờ/giật mình
怛特罗=Đát Đặc La
怛罗=Tara
怛罗女神=Tara
怛（da）罗女神=Đát La Nữ Thần
怜悯之弓=Cung Thương Xót
怨嗟之堕=Oán Ta Chi Đọa
怪兽行星=Hành tinh quái vật
总武本线=Tổng Vũ Bản Tuyến
恐怖大王=Khủng Bố Đại Vương
恐惧掺杂体=Terror Dopant
恐惧沼泽=Đầm lầy Khủng bố
恐惧记忆体=Terror Memory
恒河女神=Hằng Hà Nữ Thần
恩·达古巴·杰巴=N-Daguva-Zeba
恰雅=Qià yǎ
恶鬼迦娜=Ác Quỷ Ca Na
恶魔小龙=Ác Ma Tiểu Long
悉多梵=Sita Phạm
悟饭=Gohan
悠悠然地道=khoan thai nói
悠木=Yuki
悲痛莫名=Bi Đau Mạc Danh
情欲阿修罗=Tình Dục A-tu-la
惊异全能空我=Amazing Mighty Kuuga
惊瑞之期=Kinh Thụy Chi Kỳ
愤怒之塔=Tháp Phẫn Nộ
戈冥=Gormin
戈冥战斗员=Chiến binh qua minh
成龙历险记】=Những cuộc phiêu lưu của Thành Long
我儿=ta nhi
我望光明=Garou Izumi
我等大师你=ta đợi Đại Sư ngươi
战极凌马=Chiến Cực Lăng Mã
战极驱动器=Sengoku Driver
战狼军团=Chiến Lang Quân Đoàn
战神迦希吉夜=Chiến Thần Già Hi Cát Dạ
戳眼者=Người Chọc Mắt
戴西斯星人=Người Dessis
戴西斯星系=Hệ Daiysis
手打=Teuchi/tay đánh
手持雷杵=Vajra-Holder
扶我起来我还能继续战斗=Đỡ ta dậy ta vẫn còn có thể tiếp tục chiến đấu
投山仙人=Đầu Sơn Tiên Nhân
护世神=Hộ Thế Thần
护世神毗湿奴=Hộ Thế Thần Tỳ Thấp Nô
护星红=Hộ Tinh Đỏ
拄着手杖=dựa vào thủ trượng
拉伊哈罗巴舞=Lai Haroba
拉克什米=Lakshmi
拉克什米女神=Lakshmi
拉集团=Nhóm Ra
拘湿伽=Câu Thấp Già
拘湿迦=Câu Thấp Ca
拘魂套索=Câu Hồn Sáo Tác
拟似记忆体=Giả Lập Memory
拿山君庙=Ná Sơn Quân Miếu
持金刚杵者=Trì Kim Cương Chử Giả
接龙=chơi đô-mi-nô/chơi domino
掺杂体=Dopant
提婆希那=Đề Bà Hi Na
提毗波=Dvipa
提迭=Die
提迭希那=Đề Điệt Hi Na
搀杂体=Dopant
搭帕=Đát Mạt
摄天剑=Nhiếp Thiên Kiếm
摩伽婆=Ma Già Bà
摩伽罗=Makara
摩伽罗之剑=Ma Già La Chi Kiếm
摩利坎杜=Marikandu
摩厘耶梵山=Ma Lị Gia Phạn Sơn
摩喜施末底=Mahishmati
摩多梨=Matali
摩奴=Manu
摩根德耶=Ma Căn Đức Gia
摩梨伽尸罗=Ma Lê Già Thi La
摩磋=Matsya
摩羯判官=Ma Kết Phán Quan
摩羯罗=Makara
摩耶之光=Ma Da Chi Quang
摩耶之力=Ma Da Chi Lực
摩耶城=Ma Da Thành
摩耶幻力=Maya Ảo Lực
摩耶幻术=Ma Da Huyễn Thuật
摩耶智慧=Trí tuệ Maya
摩耶苍穹=Ma Gia Thương Khung
摩耶迷宫=Ma Da Mê Cung
摩耶阿修=Ma Da A Tu La
摩耶阿修罗=Ma Gia A Tu La
摩西妮=Mohini
摩西沙=Moshisha
摩西沙阿修罗=Ma Tây Sa A Tu La
摩西湿=Ma Tây Thấp
摩诃因陀罗=Ma Ha Nhân Đà La
摩诃班达=Ma Ha Ban Đà
摩诃迦梨=Ma Ha Ca Lỵ
摩诃钵利=Ma Ha Bát Lợi
摩诃阿底提耶=Ma Ha A Để Đề Gia
摩鲁特=Marut
撒旦军刀=Satan Saber
敝衣=Bế Y
敝衣仙=Tệ Y Tiên
敝衣仙人=Tệ Y Tiên Nhân
文尼=Vinny
文底耶山=Vindhya
斗争时代=Đấu Tranh Thời Đại
斗真=Touma
斗真(Theos)=Tōma
斩侠大会=Trảm Hiệp Đại Hội
斩那牟质=Namuchi-Slayer
斯沃鲁兹=Swartz
斯菲亚球体=Hình cầu Sphia
斯菲亚生命体=Thực thể sống Sphia
新宿站=Ga Shinjuku
新宿警局=Sở cảnh sát Shinjuku
新日本桥站=Ga Shin-Nihombashi
新麦克斯炮=Tân Mạch Khắc Tư Pháo
方位者=Phương vị Giả
方块10=Rô 10
方块A=Rô A
方块K=Rô K
方大法师=Phương Đại Pháp Sư
旋风剑主=Toàn Phong Kiếm Chủ
无双军刀=Musou Saber
无形道=Vô Hình Đạo
无忧妙=Vô Ưu Diệu
无效卡=Thẻ Vô Hiệu
无极拈花指=Vô Cực Niêm Hoa Chỉ
无限麦克斯动力系统=Hệ thống động lực Max Vô Hạn
无限麦克斯系统=Hệ thống Max vô hạn
日出山=Nhật Xuất Sơn
日落山=Nhật Lạc Sơn
旱魔弗栗多=Hạn Ma Phất Lật Đa
时劫者=Time Jackers
时夜=Thời Dạ
时夜女神=Thời Dạ Nữ Thần
时空之力=Sức mạnh Thời Không
时空之壁=Bức tường Không-Thời gian
时空城=Thời Không Thành
时空界=Giới Thời Không
时空驱动器=Ziku-Driver
时间极限剑=Saikyo Girade
时间降临=Thời Gian Giáng Lâm
时间降临卡牌=Thẻ Thời Gian Giáng Lâm
明光院盖茨=Myōkōin Geiz
明台桥=Minh Đài Kiều
明度贝=Mindobe
昔弥=Tích Di
昔弥天=Tích Di Thiên
昔弥女神=Tích Di Nữ Thần
星之碎片=Mảnh vỡ Ngôi sao
星云体=Tinh Vân Thể
星座使徒=Apostle Chòm sao
星座使徒开关=Zodiac Astro Switch
星座开关=Astro Switches
星座战士=Tinh Tọa Chiến Sĩ
星座装甲=Tinh Tọa Trang Giáp
星徒开关=Công tắc Stardust
星猫=Tinh Miêu
星盘阵=Tinh Bàn Trận
星目阿修罗=Tinh Mục A Tu La
星辰母=Mẹ của Các Vì Sao
春滋泉=Xuân Tư Tuyền
春滋神泉=Xuân Tư Thần Tuyền
昴星女神=Mão Tinh Nữ Thần
昴星神=Pleiades
昴星高校=Subaru High School
普罗曼=Phổ La Mạn
普罗米斯=Prometheus
普里提=Phổ Lí Đề
普鲁沙=Phổ Lỗ Sa
景菁=Cảnh Tinh
晴人=Haruto
智人=Trí Nhân
智人迦玛帕拉=Trí Nhân Già Ma Ba Lạp
暗之力=Sức mạnh Bóng tối
暗夜牙血鬼=Fangire Bóng Đêm
暗黑Kiva=Dark Kiva
暗黑三叉戟=Ám Hắc Tam Xoa Kích
暗黑魔铠装=Ám Hắc Ma Khải Trang
暴力掺杂体=Bạo Lực Tham Tạp Thể
暴太郎战队=Avataro Sentai Donbrothers
暴躁因陀罗=Bạo Táo Nhân Đà La
暴躁苏利耶=Bạo Táo Tô Lợi Gia
暴风战戟=Storm Halberd
曜星=Diệu Tinh
曲女城=Khúc Nữ Thành
曼妲=Manda
曼度陀里=Mạn Độ Đà Lí
曼罗迦=Manasa
曼荼罗山=Mạn Đồ La Sơn
曼迦勒=Mạn Già Lặc
曼陀罗山=Mạn Đà La Sơn
曼陀罗山脉=Dãy núi Mandara
月之恶魔=Ác ma mặt trăng
月影信彦=Tsukikage Nobuhiko
月桂叶=Lá nguyệt quế
月神之子【布陀】=Con trai của Thần Mặt Trăng [Budha]
月神苏摩=Nguyệt Thần Soma
月铃母=Nguyệt Linh Mẫu
月魇=Nguyệt Yểm
月魇之刀=Nguyệt Yểm Chi Đao
有喜仙人=You Xi Xianren
朝比奈奈奈=Asahina Nana
木橘叶=Mộc Quất Diệp
木野先生=Ngài Kino
木野熏=Kino Kaoru
木野熏AgtiΩ=Kaoru Kino Agito
木野薫=Kino Kaoru
木野薰=Kino Kaoru
未晴=Misora
未来核心硬币=Huy chương Cốt lõi Tương lai
未来逢魔时王=Oma Zi-O tương lai
未知生命体=Unknown Lifeform
未知生命体对策组=Nhóm Biện pháp Đối phó Sinh vật Chưa biết
未确认生命体=Unidentified Life Form
未确认生命体22号=Sinh vật sống chưa xác định số 22
未确认生命体37号=Sinh vật chưa xác nhận số 37
未确认生命体42号=Unidentified Lifeform Số. 42
未确认生命体46号=Sinh vật sống chưa xác định số 46
未确认生命体47号=Sinh vật chưa xác nhận số 47
未确认生命体4号=Sinh vật chưa xác định số 4
未确认生命体事件=Vụ án sinh vật chưa xác định
未确认生命体档案=Hồ sơ Sinh vật chưa xác nhận
未确认生命体联合搜查总部=Tổng bộ điều tra liên hợp vật thể sống chưa xác định
未确认生命体联合搜查本部=Trụ sở Điều tra Liên hợp Sinh vật Chưa xác định
未确认生命体联合搜查部=Bộ phận Điều tra Chung về Sinh vật Sống Chưa được Xác nhận
未確認生命体=Unidentified Life Form
本金书=bản kim thư
机械冲天号=Machine Meteorstar
机械十年号=Machine Decader
机械哥斯拉=Mecha Godzilla
机械龙卷者=Machine Tornado
杀弗栗多=Vritra-Slayer
杂林苑=Tạp Lâm Uyển
杉田=Sugita
杉田警官=Thanh tra Sugita
李雾龙=Lý Vụ Long
杜兰塔克=Đỗ Lan Tháp Khắc
杜尔迦玛=Đỗ Nhĩ Già Ma
杜尔迦马=Durgama
杜摩陀耆尼=Đỗ Ma Đà Kỳ Ni
杜浑陀=Đỗ Hỗn Đà
杜鲁刚=Đỗ Lỗ Cương
杰克将军=Tướng Quân Jack
東都=Tokyo
杵瘤=Xử Lựu
松仓=Matsukura
松仓先生=Ông Matsukura
松仓贞雄=Sadao Matsukura
松仓部长=部長松倉
松倉=Matsukura
板桥区=Quận Itabashi
极光帷幕=Màn cực quang
极裕仙人=Vasishtha
极限疾风王牌=Cyclone Joker Xtreme
林业平=Lâm Nghiệp Bình
林氏王朝=Lâm Thị vương triều
林迦=Linga
林迦柱=Lâm Già Trụ
枫叶大阵=Phong Diệp Đại Trận
枫叶武士=Phong Diệp võ sĩ
柯尔=Kha Nhĩ/Cole/Cora
柯尔·沃克=Cole Walker
柳橙定锁种子=Orange Lock Seed
栃木县=Tỉnh Tochigi
栗原天音=Kurihara Amane
栗原遥香=Kurihara Haruka
核心开关=Hạch Tâm Khai Quan
核心硬币=Core Medal
根组织=Root
根部忍者=Root ninja
格兰雷恩=Gran Reign
格拉斯中校=Trung tá Glass
桑娜提=Tang Na Đề
桑布提=Sambūti
桔梨箩柚=Quất Lê La Dữu
梅花A=Chuồn A
梅花K=Chuồn K
梅花Q=Chuồn Q
梓诉=Tử Tố
梨俱吠陀=Rigveda
梨多=Rita
梵力=Phạm Lực
梵卵=Brahmanda
梵天之颅=Sọ Phạm Thiên
梵天界=Phạm Thiên Giới
梵湖=Phạm Hồ
梵颅=Phạn Lô
棕发女=Tóc Nâu Nữ
森美队=Sâm Mỹ Đội
棱镜耀光（剑与盾）=Prism Bicker
椿先生=Ông Tsubaki
椿医生=Bác sĩ Tsubaki
椿秀一=Tsubaki Shuichi
楞伽城=Lăng Già Thành
榊亚纪=Sakaki Aki
榎田=Enokida
榎田光=Enokida Hikari
榎田女士=Enokida-san
榎田教授=Giáo sư Enokida
樱井警官=Cảnh sát Sakurai
橄榄之国弗朗机=Nước Olive Phlang Cơ
橘朔也=Tachibana Sakuya
橘纯=Tachibana Jun
檀奴=Danu
檀奴之子=Đàn Nô Chi Tử
檀奴克=Đàn Nô Khắc
檀奴迦=Đàn Nô Già
檀那婆=Đàn Na Bà
檀那婆族=Đàn Na Bà Tộc
檀那婆普罗曼=Đàn Na Bà Phổ La Mạn
檀那婆王=Đàn Na Bà Vương
檀那婆王普罗曼=Vua Danava Proman
欧布=Uub
欧帕兹研究所=Viện Nghiên cứu Ooparts
欧应万=Âu Ứng Vạn
欧若拉之眼=Đôi mắt của Aurora
歌星贤吾=Utahoshi Kengo
正法之神=Chính Pháp Chi Thần
正法之网=Lưới Chánh Pháp
正法战士=Chiến binh chính pháp
正法神=Chính Pháp Thần
正理经=Chánh Lý Kinh
步氏神族=Bộ Thị Thần Tộc
武器掺杂体=Arms Dopant
武大强=Võ Đại Cường
武神Fourze=Vũ Thần Fourze
武神OOO=Vũ Thần OOO
武神W=Vũ Thần W
武神Wizard=Vũ Thần Wizard
武神铠武=Vũ Thần Gaim
武神骑士=Vũ Thần Rider
歩渊亭=Bộ Uyên Đình
死神博士=Doctor Shinigami
死神套索=Dây thòng lọng Thần Chết
死神阎摩=Tử Thần Diêm Ma
残虐军队=Zangyack Army
残虐帝国=Đế quốc Zangyack
残虐干部=Zangyack Cadre
比那迦=Pinaka
比那迦神弓=Pinaka
毕鲁萨鲁多=Tất Lỗ Tát Lỗ Đa
毕鲁萨鲁多人=Tất Lỗ Tát Lỗ Đa Nhân
毕鲁萨鲁多族长=Tộc trưởng Bilusaldo
毗奢密多罗=Vishwamitra
毗奢耶=Vijaya
毗娜达=Tỳ Na Đạt
毗娜迦=Pinaka
毗娜迦之弓=Cung Pinaka
毗娜迦神弓=Cung thần Pinaka
毗婆罗吉提=Tỳ Bà La Cát Đề
毗尸罗婆=Tỳ Thi La Bà
毗德尔跋=Vidarbha
毗恭吒=Tỳ Cung Tra
毗毗陀迦树=cây Vibhitaka
毗波制底=Tỳ Ba Chế Để
毗湿奴之力=Tỳ Thấp Nô Chi Lực
毗湿摩=Bhishma
毗罗=Tỳ La
毗羚陀=Tỳ Lăng Đà
毗老师=Thầy Tỳ
毗诃波提=Tỳ Ha Ba Đề
毗贡吒=Vaikuntha
毗达斯=Vitas
毗那夜迦=Vinayaka
毗里妮=Virini
毗首羯磨=Tỳ Thủ Yết Ma
毗首羯磨之妻=Tỳ Thủ Yết Ma Chi Thê
水之上神=Thủy chi Thượng Thần
水之天使=Thiên sứ Nước
水之恶魔=Ác ma nước
水元公园=Công viên Mizumoto
水城史朗=Mizushiro Shiro
水持=Svadhisthana
水星神=Thủy Tinh Thần
水母Undead=Undead Sứa
水泽水上乐园=Công viên nước Mizusawa
水火土风雷=Thủy Hỏa Thổ Phong Lôi
水牛古朗基=Gurongi Trâu Nước
水牛尊者=Minotaur Lord
水瓶判官=Thủy Bình Phán Quan
水神伐楼那=Thủy Thần Phạt Lâu Na
水神岛=Thủy Thần Đảo
水神王=Thủy Thần Vương
永安当=Vĩnh An Đương
永童仙人=Yong Tong Xianren
汉堡套餐=Hamburger Set
汉塔克=Hantake
江东区=Quận Koto
江東区=Koto
沙利耶迦=Sa Lợi Da Ca
沙漠死神内瑟斯=Sa Mạc Tử Thần Nasus
沙福林=Sa Phúc Lâm
沙罗宝多迦=Sa La Bảo Đa Ca
沢芽市=Zawame City
河野=Kouno
河野警官=Cảnh sát Kawano
泉比奈=Hina Izumi
法医鉴定科=Khoa Giám định Pháp y
波刚=Ba Cương
波士顿芬威球场=Sân vận động Fenway Park Boston
波罗跋娑=Ba La Bạt Sa
波陀罗=Patala
波陀罗之界=Patala Giới
波陀罗界=Ba Đà La Giới
泥犁=Nê lê
泥犁若=Nê lê nhược
泰坦剑=Titan Sword
泰坦形态=Titan Form
泰坦空我=Titan Kuuga
泰雷=Thái Lôi
泽井=Trạch Tỉnh
泽井总监=Tổng giám đốc Sawai
泽木=Sawaki
泽木先生=Ông Sawaki
泽木哲也=Sawaki Tetsuya
泽木雪菜=Sawaki Yukina
泽渡小姐=Cô Zawa-do
泽渡樱子=Sawatari Sakurako
洛佩=Lạc Bội
洛摩巴陀=Lạc Ma Ba Đà
津上=Tsugami
津上先生=Tsugami
津上家=Gia tộc Tsugami
津上府邸=Dinh thự Tsugami
津上翔一=Tsugami Shoichi
津奈姐姐=Tsuna tỷ tỷ
津奈美=Tsunami/Tân Nại Mỹ
洪呼王=Hồng Hô Vương
流浪武士=lang thang Samurai
浑天四绝=Hỗn Thiên Tứ Tuyệt
浑陀=Hỗn Đà
浣熊大师=Sư phụ Gấu Mèo
海蛇古朗基=Hải Xà Gurongi
海豚泳馆=Hồ bơi Dolphin
海贼战队=Kaizoku Sentai
海贼战队豪快红=Kaizoku Sentai Gokaiger
涉谷区=Shibuya-ku
涉谷站=Ga Shibuya
深海里沙=Risa Fukami
深蓝圆舞曲=Thâm Lam Viên Vũ Khúc
渡津者=Độ Tân Giả
温驽=Ôn Nô
港区东京塔=Tháp Tokyo khu Minato
港口公寓=Căn hộ Cảng
湿婆神力=Thấp Bà Thần Lực
湿润之雷=Ướt Át Chi Lôi
溺爱阿修罗=Nịch Ái A Tu La
滋集团=Nhóm Zuu
漆黑JOKER=Black Joker
漆黑空我=Kuga đen
潘库=Phan Khố
潘库宝盒=Hộp Bàn Khố
潘普洛纳古城=Cổ thành Pamplona
澤木哲也=Sawaki Tetsuya
澳国总统=Tổng thống Úc
火之上神普罗米斯=Hỏa chi Thượng Thần Prometheus
火之天使=Hỏa Chi Thiên Sứ
火天使=Thiên Sứ Lửa
火无定=Hỏa Vô Định
火星曼迦勒=Hỏa Tinh Mạn Già Lặc
火焰军刀=Kiếm lửa
火焰哥尔赞=Hỏa Diễm Gorzam
火神阿耆尼=Hỏa Thần A Kỳ Ni
火舞旋风=Hỏa Vũ Toàn Phong
火野映司=Eiji Hino
火鬼王=Hỏa Quỷ Vương
火魔兽=Hỏa Ma Thú
火麟飞=Hỏa Lân Phi
火龙果定锁种子=Dragon Fruit Lock Seed
灭世班达=Diệt Thế Ban Đà
灯熔山=Núi Touyou
灯熔山遗迹=Di tích núi Torō
灰狼拉夫尔=Sói xám Laffer
灵山引=Linh Sơn Dẫn
灵山掌=Linh Sơn Chưởng
灵山渡=Linh Sơn Độ
灵山门=Linh Sơn Môn
灵山门主=Linh Sơn môn chủ
灵泉宝玉=Linh Tuyền Bảo Ngọc
灵鱼摩蹉=Linh Ngư Ma Tha
灵龟库尔玛=Linh Quy Khố Nhĩ Mã
炎拳=Viêm Quyền
炎波泉=Viêm Ba Tuyền
炎波血刃=Viêm Ba Huyết Nhận
炎魔战士=Chiến binh Yan Ma
炎魔战士基里艾洛德人=Chiến binh Quỷ Lửa Kirieloid
炎魔战士基里艾洛德人二代=Chiến binh Quỷ Lửa Kirieloid II
烈火凤凰=Inferno Phoenix
烈火狮王=Liệt Hỏa Sư Vương
烟目=Yên Mục
烟目阿修罗=Yên Mục A Tu La
照井龙=Terui Ryu
照胆泉=Chiếu Đảm Tuyền
熊猫阿宝=Gấu trúc A Bảo
燕尾蝶牙血鬼=Fangire Bướm đuôi én
爱姆=Ahim
爱婆罗多=Airavata
爱神迦摩=Thần Tình Yêu Kama
爱罗婆多=Ai La Bà Đa
爱罗婆多主神庙=Ái La Bà Đa Chủ Thần Miếu
爱罗婆多神庙=Đền Airavata
爱罗婆罗=Ái La Bà La
片平久雄=Katahira Hisao
片平真由美=Katahira Mayumi
牙兰=Galan
牙蝙蝠族=Tộc Răng Dơi
牙血鬼=Fangire
牙血鬼之王=Chúa tể Fangire
牛战士=Ngưu Chiến Sĩ
牛节=Ngưu Tiết
牛节望=Uchchaihshravas
牛节王=Ngưu Tiết Vương
牟质=Mưu Chất
特命战队=Tokumei Sentai
特里库=Đặc Lí Khố
特雷达=Treta
特鲁妈妈=Mẹ Tulu
犀牛古朗基=Rhino Gurongi
狂刀怒剑=Cuồng Đao Nộ Kiếm
狂野Chalice(卡利斯)=Wild Chalice
狂野斩击者=Wild Slasher
狂雷天牢=Cuồng Lôi Thiên Lao
狗将军=Cẩu Tướng Quân
狗都不当=chó cũng không làm
独眼乌鸦尊者=Quạ Một Mắt Chúa Tể
独角仙噬欲怪=Bọ Cánh Cứng Phệ Dục Quái
独角兽座星座使徒=Unicorn Zodiarts
狮子树海=Sư Tử Thụ Hải
狮面=Sư Diện
狮面阿修罗=Sư Diện A Tu La
狼族古朗基=Gurongi tộc Sói
狼族古朗基之王=Vua Gurongi tộc sói
狼蛛Undead=Undead Nhện sói
狼鱼=Cá sói
猎户座星座使徒=Orion Zodiarts
猎犬座星座使徒=Canis Minor Zodiarts
猎隼尊者=Falcon Lord
猩猩乔治=Tinh tinh George
猪笼城寨=Lồng Heo Thành Trại
猪笼草异域者=Inves Cây Nắp Ấm
猫头鹰古朗基=Cú Guronji
猫头鹰尊者=Owl Lord
猴国=Hầu Quốc
獠牙x王牌=FangJoker
獠牙王牌=Fang Joker
玄冥之棺=Huyền Minh Chi Quan
玄冥黑洞=Huyền Minh Hắc Động
玄冰护体=Huyền Băng Hộ Thể
玄易子=Huyền Dịch Tử
玄武号=Huyền Vũ Hào
玄武号飞船=Phi thuyền Huyền Vũ
玄道观=Huyền Đạo Quán
玄阴剑晨=Huyền Âm Kiếm Thần
玉兔仙子=Ngọc Thố Tiên Tử
玉兔舱=Khoang Thỏ Ngọc
玉蟾宫=Ngọc Thiềm Cung
玉龙阴狐和合功=Ngọc Long Âm Hồ Hòa Hợp Công
王中因陀罗=Vương Trung Nhân Đà La
玛贝拉斯=Marvelous
玫瑰女=Nữ Hoa Hồng
珍珠贝牙血鬼=Pearl Fangire
班苏里笛=Ban Tô Lý Địch
班达阿修罗=Ban Đạt A Tu La
瑞兽凤血=Thụy Thú Phượng Huyết
瑞兽精元=Thụy Thú Tinh Nguyên
瓦龙=Ngõa Long
甘蔗族=Cam Giá Tộc
甘陀利=Cam Đà Lợi
甚至已经=thậm chí đã
生主达刹=Sinh Chủ Đạt Sát
田崎秀二=Tasaki Shuji
甲斗=Kabuto
甲虫牙血鬼=Fangire bọ cánh cứng
电环=Điện Hoàn
畏怖尊=Bhairava
疾风王牌=Cyclone Joker
疾风王牌黄金极限形态=Phong Tật Vương Bài Hoàng Kim Cực Hạn Hình Thái
白井农场=Nông trại Shirai
白井虎太郎=Shirai Kotaro
白发乌鸦尊者=White-haired Raven Lord
白暗游戏=Trò chơi Hakuan
白暗阶段=Giai đoạn trắng đen
白神普罗米斯=Hakushin Prometheus
白羊判官=Bạch Dương Phán Quan
白羊武士=Bạch Dương Võ Sĩ
白羊虚影=Bạch Dương Hư Ảnh
白色2号=White No. 2
白色保命形态=màu trắng Growing Form
白色初生形态=màu trắng Growing Form
白色初生空我=White Proto Kuuga
白色小蝙蝠=Dơi trắng nhỏ
白苗族=Bạch Miêu Tộc
白蛇缘起=Bạch Xà Duyên Khởi
白象之王=Bạch Tượng Chi Vương
白象爱罗婆多=Bạch Tượng Ai La Bà Đa
白鼠谷=Bạch Thử Cốc
白龙族=Bạch Long Tộc
百祭=Bách Tế
百草谷=Bách Thảo Cốc
盎伽=Áng Già
盖世五侠=Ngũ Hiệp Cái Thế
盖亚记忆体=Gaia Memory
盖图跋=Cái Đồ Bạt
盖达跋=Cái Đạt Bạt
盗取鲜花者=Kẻ trộm hoa
盘螭神云枪=Bàn Si Thần Vân Thương
相川始=Aikawa Hajime
相良克彦=Sagara Katsuhiko
真剑者=Shinkenger
真嗣=Shinji
真夜=Maya
真岛浩二=Majima Koji
真島浩二=Mashima Koji
真田良介=Chân Điền Lương Giới
真鱼=Mana
真鱼小姐=Tiểu thư Mana
真鱼酱=Mana-chan
睡熊猛醒=Thụy Hùng Mãnh Tỉnh
睦月安纱美=Mutsuki Asami
瞻巴拉=Chiêm Ba Lạp
瞿陀尼=Cù Đà Ni
知树=Tri Thụ
知秋一叶=Tri Thu Nhất Diệp
石化怪兽加库玛=Thạch Hóa Quái Thú Gia Khố Mã
破空术=Phá Không Thuật
破里剑者=Hurricaneger
碎天绝手=Toái Thiên Tuyệt Thủ
碳叶=Thán Diệp
磁力小丑=Từ Lực Tiểu Sửu
礼貌天帝=Thiên Đế Lễ Phép
礼赞三相神=Lễ tán Tam tướng thần
礼赞上主=Lễ tán Thượng chủ
礼赞仁慈的天帝=Ca ngợi Thiên Đế nhân từ
礼赞大天=Lễ tán Đại Thiên
礼赞天神=Lễ Tán Thiên Thần
礼赞持金刚杵者=Ca ngợi người giữ Kim Cang Chử
礼赞耶瑟陀=Lễ tán Da Sắt Đà
礼赞迦叶波仙人=Lễ Tán Ca Diệp Ba Tiên Nhân
礼赞那罗~那罗延=Lễ tán Nara~Narayana
神仙迷心丸=Thần Tiên Mê Tâm Hoàn
神光棒=Thần Quang Bổng
神光神波罗跋娑=Thần Quang Thần Ba La Bạt Ta
神劈=Thần Phách
神宫海藏=Jingu Kaizo
神将飞蓬=Thần Tướng Phi Bồng
神崎士郎=Shirō Kanzaki
神崎昭二=Kanzaki Shoji
神崎老师=Thầy Kanzaki
神明战甲=Thần minh chiến giáp
神武纪=Thần Võ Kỷ
神牛南笛=Nandi
神犬萨罗摩=Thần Khuyển Tát La Ma
神界天池=Thiên Trì Thần Giới
神盾巨蟹=Thần Thuẫn Cự Giải
神矛阿摩迦=Thần Mâu A Ma Già
神经断裂弹=Đạn cắt thần kinh
神象之王=Thần Tượng Chi Vương
神马高耳=Thần Mã Cao Nhĩ
神龙卷轴=Thần Long Quyển Trục
神龙秘籍=Thần Long Bí Kíp
祭主=Tế Chủ
祭主仙=Tế Chủ Tiên
祭主仙人=Tế Chủ Tiên Nhân
禁忌掺杂体=Cấm kỵ tạp chất
禁忌记忆体=Taboo Memory
福泽大厦=Tòa nhà Fukuzawa
秃顶乌鸦尊者=Bald Raven Lord
秃鹫古朗基=Gryphon Grongi
秋叶原站=Ga Akihabara
科学怪人族=Quái vật Frankenstein
科学警察研究所=Viện Nghiên Cứu Khoa Học Cảnh Sát
科技大厦=Tòa nhà Khoa học Công nghệ
科目三=Khoa mục 3
科警研=Viện Nghiên cứu Khoa học Cảnh sát
秦王绕柱=Tần vương nhiễu trụ
穆俱昆陀=Mukunda
穆湿伽=Mushika
究极之暗=Cực Hạn Hắc Ám
究极初生=Ultimate Born
究极初生空我=Ultimate Beginning Kuuga
究极力量=Sức mạnh Tối thượng
究极升华空我=Ultimate Rising Kuuga
究极形态=Ultimate Form
究极空我=Ultimate Kuuga
究极追迹者=Ultimate Chaser
究极黑暗=Ultimate Darkness
究极黑暗空我=Cực Ám Không Ngã
空我=Kuuga/ Không Ngã
空我世界=Thế giới Kuuga
空谷罪犯感化院=Trại cải huấn tội phạm Thung lũng Không
第一平行宇宙=Vũ trụ song song thứ nhất
第七平行宇宙=Vũ trụ song song thứ bảy
第三平行宇宙=Vũ trụ song song thứ ba
第二平行宇宙=Vũ trụ song song thứ hai
第五平行宇宙=Vũ trụ song song thứ năm
第六平行宇宙=Vũ trụ song song thứ sáu
第四平行宇宙=Vũ trụ song song thứ tư
笹山=Sasayama
笹山望见=Sasayama Nozomi
筏罗诃=Varaha
筱原佐惠子=Shinohara Saeko
篮紫光芒=xanh tím quang mang
米国总统=Tổng thống Mỹ
粗恶苑=Thô Ác Uyển
紗綾香=Sayaka
索兰达=Solanda
紫云剑主=Tử Vân Kiếm Chủ
紫云剑主莎丽=Tử Vân Kiếm Chủ Sally
紫云剑法=Tử Vân Kiếm Pháp
紫云真气=Tử Vân Chân Khí
紫兔=Tử Thỏ
紫玉佩=Tử Ngọc Bội
紫翼魔尊=Tử Dực Ma Tôn
红冠=Hồng Quán
红心A=Át cơ
红心K=Già cơ
红心K幽灵螳螂=Bọ ngựa ma cơ K
红渡=Wataru Kurenai
红烧牛肉面=Mì bò kho tàu
红色全能形态=màu đỏ Mighty Form
红色全能空我=màu đỏ Mighty Kuuga
红色空我=Kuuga đỏ
红花粉=Bột hồng hoa
红葵=Hồng Quỳ
红音也=Otoya Kurenai/Hong Otoya
约尼=Ước Ni
纱绫香=Sayaka
纳斯卡掺杂体=Nazca tạp chất
纳斯卡记忆体=Nazca Memory
纵意登仙步=Túng Ý Đăng Tiên Bộ
细胞硬币=Cell Medal
绫香=Ayaka
维摩纳斯=Vimanas
维摩那斯=Duy Ma Na Tư
维毗沙那=Vibhishana
维纳琴=Đàn Vina
绿色形态=Form màu lục
绿魔飞行器=Phi Thuyền Lục Ma
缚罪者=Phược Tội Giả
罗刹之王=La Sát Chi Vương
罗刹之王罗波那=La Sát Vương Ravana
罗刹十首=La Sát Thập Thủ
罗延=La Duyên
罗怙=La Hộ
罗毗=La Tỳ
罗睺星=Sao La Hầu
罗睺计都=Rahu Ketu
罗蒂=Rati
罗辛哈=Narasimha
羊面=Dương Diện
美咲抚子=Misaki Nadeshiko
美杉=Misugi
美杉义彦=Misugi Yoshihiko
美杉太一=Misugi Taiichi
美杉家=Misugi Gia
美杉教授=Misugi Giáo sư
美森队=Đội Mĩ Sâm
群山之翼=Cánh núi non
翔一=Shoichi
翔太郎=Shotaro
翡翠之刃=Phỉ Thúy Chi Nhận
翡翠僵尸=Cương thi Ngọc Bích
耀光圣盾=Bicker Shield
老七剑=Lão Thất Kiếm
老了=già rồi/già
老天皇=Lão Thiên Hoàng
老山羊=Lão Sơn Dương
老虎古朗基=Tiger Gurongi
耶瑟陀=Gia Sắt Đà
耶瑟陀女神=Gia Sắt Đà Nữ Thần
联合搜查部=Bộ phận Điều tra Liên hợp
聚元宝鼎=Tụ Nguyên Bảo Đỉnh
肥仔聪=Phì Tử Thông
胜166=Thắng 166
胜利队=Đội Chiến Thắng
胜利飞燕号=Victory Flier
胡狼尊者=Jackal Lord
自杀仙人=Tiên Nhân Tự Tử
至净法=Chí Tịnh Pháp
舍沙=Shesha
舍波罗=Shebala
舍脂=Xá Chi
舍脂之主=Xá Chi Chi Chủ
般度族=Pandava
艾勃隆=Ngải Bột Long
芦河翔一=Ashikawa Shoichi
芭璐芭=Baluba
花尾=Hoa Vĩ
花道On Stage=Hanamichi On Stage
苇原=Ashihara
苇原先生=Ngài Ashihara
苇原凉=Ryo Ashihara
苇轭=Veeyoga
苍月奥特曼=Ultraman Trăng Xanh
苍穹下的孤狼=Cang Qiong Xia De Gu Lang/Con sói cô độc dưới bầu trời
苏利耶之子=Tô Lợi Da Chi Tử
苏利耶之子娑尼=Tô Lợi Gia Chi Tử Sa Ni
苏利耶天=Tô Lợi Da Thiên
苏摩天=Tô Ma Thiên
苏摩耶=Tô Ma Gia
苏摩酒=rượu Soma
苏维妮=Suvini
苏羯罗=Sukra
苏羯罗仙人=Tiên nhân Sukra
苏羯罗导师=Đạo sư Tô Yết La
苏羯里婆=Sugriva
苏羯（jie）罗=Sukra
苏陀罗=Sutala
苏陀罗之王=Tô Đà La Chi Vương
苏陀罗之界=Tô Đà La Chi Giới
苏陀罗界=Tô Đà La Giới
苗条俊=Miêu Điều Tuấn
若叶幼儿园=Nhà trẻ Wakaba
若菜公主=Công chúa Wakana
苦力强=Khổ Lực Cường
英武天神=Valiant Deva
茂茂=Mậu Mậu
草莓定锁种子=Hạt giống Lock Strawberry
草莓装甲=Strawberry Armor
荒川区=Quận Arakawa
莫仇=Mạc Cừu
莫将=Mạc Tương
莱奴迦=Lai Nô Già
莲目=Liên Mục
菊石兽=Cúc Thạch Thú
萨克蒂=Sakti
萨克蒂之力=Tát Khắc Đế Chi Lực
萨克蒂女神=Nữ Thần Shakti
萨奇帕提=Tát Kỳ Mạt Đề
萨罗摩=Tát La Ma
葛·伽多鲁·巴=Ge Garudoruba
葛·伽雅泽·基=Ge-Gayaza-Gi
葛·卜洛·古=Ge-Buroru-Gu
葛·巴达·巴=Ge Badada Ba
葛·查查璐·巴=Ge Chachiru Ba
葛兰花=Hoa Kanak Champa
葛叶纮太=Kazuraba Kouta
葛叶纮汰=Katsuraba Kouta
葛集团=Tập đoàn Ge
葛集团最强三人=The Strongest Three of the Ge Group
葛饰2号=Katsushika Số 2
葛饰区=Quận Katsushika
葦原涼=Ashihara Ryo
葫芦娃大战变形金刚=Hồ Lô Oa đại chiến Biến Hình Kim Cương
葵羽=Quỳ Vũ
葵羽玄女=Quỳ Vũ Huyền Nữ
蒙平原=Mông Bình Nguyên
蒙达苏尔=Mông Đạt Tô Nhĩ
蓝兔=Lam Thỏ
蓝色行星的爱=Tình Yêu Hành Tinh Xanh
蓝花楹咖啡店=Tiệm cà phê Jacaranda
蓝葵=Lam Quỳ
藤甲军团=Đằng Giáp Quân Đoàn
虎头佛母森多玛=Hổ Đầu Phật Mẫu Sâm Đa Mã
虎魄刀=Đao Hổ Phách
虎魄空间=Không gian Hổ Phách
虎鲸天使=Thiên thần Orca
虎鲸尊者=Hổ Kình Tôn Giả
虬藤翻潦浪，灿然额前辉！=Cù đằng phiên lạo lãng, Sán nhiên ngạch tiền huy!
虹猫=Hồng Miêu
虹猫仗剑走天涯=Hồng Miêu Trượng Kiếm Tẩu Thiên Nhai
虹猫蓝兔=Hồng Miêu Lam Thố
虹猫蓝兔七侠传世界=Hồng Miêu Lam Thố Thất Hiệp Truyện thế giới
虹猫蓝兔世界=Thế giới Hồng Miêu Lam Thỏ
虹蓝=Hồng Lam
虹蓝七侠传=Hồng Lam Thất Hiệp Truyện
蚁蛭=Nghĩ Điệt
蚁蛭仙人=Nghĩ Điệt Tiên Nhân
蚂蚁女王尊者=Nữ hoàng kiến Tôn giả
蚂蚁尊者=Ant Lord
蛇女曼罗迦=Xà Nữ Mạn La Già
蛇床=Xà Sàng
蛇床者=Xà sàng giả
蛇母=Xà Mẫu
蛇母迦德卢=Xà Mẫu Ca Đức Lâu
蛇王婆苏吉=Xà Vương Vasuki
蛇王舍沙=Xà Vương Xá Sa
蜀山灵脉=Thục Sơn linh mạch
蜘蛛古朗基=Gourongi Nhện
蜜瓜=Melon
蜜瓜能量=Năng lượng Dưa lưới
蜜瓜防御盾=Khiên phòng ngự Dưa lưới
蜥蜴尊者=Lizard Lord
蝎子女=Thiết Nữ
蝎子尊者=Bọ Cạp Tôn Giả
蝎子王龙莹=Hạt Tử Vương Long Oánh
蝗虫古朗基=Gurongi Châu Chấu
蝘蜓座星座使徒=Chamaeleon Zodiarts
蝙蝠古朗基=Dơi Gurongi
蝙蝠战团=Biên Bức Chiến Đoàn
蝰蛇武装直升机=Trực thăng vũ trang Viper
蝶野润一=Chouno Junichi
螳螂古朗基=Gurongi Bọ ngựa
螳螂古朗基伽利玛=Mantis Gurongi Garima
螳螂噬欲怪=Bọ Ngựa Phệ Dục Quái
螳螂尊者=Đường Lang Tôn Giả
血种阿修罗=Asura Huyết Chủng
行政部长=Bộ trưởng hành chính
行星斯菲亚=Hành tinh Sphia
补卢山=Bổ Lư Sơn
补卢罗婆娑=Bổ Lư La Bà Sa
补米伽=Bhumika
补罗私底耶=Bổ La Tư Để Da
袖浦海岸=Bãi biển Sodegaura
被缚者=Người bị trói
西工厂=Nhà máy phía Tây
西方水域=Thủy Vực Phương Tây
西木=Tây Mộc
西瓜定锁种子=Watermelon Lock Seed
西瞿陀尼=West Godhaniya
解脱者=Giải Thoát Giả
詹巴拉=Chiêm Ba Lạp
詹琉璃=Chiêm Lưu Li
警卫追迹者=Người theo đuổi bảo vệ
警察部=Bộ phận Cảnh sát
警視庁=Sở Cảnh sát
警视庁=Sở Cảnh sát
讫利多=Krita
设阇卢祇那=Shatrughna
诃利=Hari
诃利阿修罗=Hà Lợi A Tu La
诃德莉=Ha Đức Lị
诃拉=Ha Lạp
诃拉诃拉=Halahala
诃拉诃拉之毒=Độc Hala Hala
诃拉诃拉之箭=Mũi tên Hala Hala
诃耶羯里婆=Ha Da Yết Lí Bà
试验追迹者=Thí Nghiệm Truy Tích Giả
试验追迹者2000=Thí Nghiệm Người Truy Đuổi 2000
诸世纪=Các thế kỷ
诸天之门=Chư Thiên Chi Môn
诸天：从破坏之王开始=Chư Thiên: Bắt đầu từ Vua Phá Hoại
谢拉德=Sherard
谷峨站=Gaga Station
象面=Tượng Diện
象魔=Tượng Ma
象魔阿修罗=Tượng Ma A Tu La
豪快三叉戟=Gokai Trident
豪快变身=Gokai Change
豪快戟=Gokai Spear
豪快手机=Gokai Cellular
豪快手枪=Gokai Gun
豪快粉=Gokai Pink
豪快红=Gokai Red
豪快绿=Gokai Green
豪快者=Gokaiger
豪快蓝=Gokai Blue
豪快银=Gokai Silver
豪快飞船=Gokai Galleon
豪快马刀=Gokai Saber
豪快黄=Gokai Yellow
豪猪古朗基=Porcupine Gurongi
豹尊者=Báo Tôn Giả
豹尾脚=Báo Vĩ Cước
贝琉多拉=Belial Dora
财团X=Tổ chức X
财富女神拉克什米=Nữ thần Tài Lộc Lạp Khắc Thập Mễ
财神俱毗罗=Thần Tài Kubera
贤吾=Kengo
贪欲者=Greeed
贪欲阿修罗=Tham Dục A-tu-la
贪狼剑=Tham Lang Kiếm
赛亚人=người Saiyan
赤炎火龙阵=Xích Diễm Hỏa Long Trận
赫尔海姆之森=Heim Helheim Forest
起始之夜=Đêm Khởi Đầu
起源之女=Maiden of Beginning
超兽战士=Siêu Thú Chiến Sĩ
超兽战队=Siêu Thú Chiến Đội
超兽武装=Siêu Thú Vũ Trang
超兽神=Siêu Thú Thần
超能力研究所=Viện nghiên cứu siêu năng lực
超越Gills=Exceed Gills
超越形态=Beyond Form
超银河王=Siêu Ngân Hà Vương
跃动追迹者=Rising Chaser
跋伽=Bạt Già
跋兰妮=Bạt Lan Ni
跋录吉=Bạt Lục Cát
跋陀罗=Bhadra
路长官=Lộ trưởng quan
身披金闪衣=Golden-Clad
车底国=Nước Chedi
辛希嘉=Tân Hi Gia
辛杜拉=Tân Đỗ La
辛辣天塞=Shinra Tensei
辩才天女=Biện Tài Thiên Nữ
辰巳真嗣=Tatsumi Shinji
达兹纳=Tazuna
达刹=Daksha
达尔蒂=Đạt Nhĩ Đế
达尔蒂·玛塔=Đạt Nhĩ Đế · Mã Tháp
达录那=Daruna
达拉姆=Đạt Lạp Mỗ
达摩洞=Đạt Ma Động
达摩衍蒂=Damayanti
达湿罗=Đạt Thấp La
达玛鲁=Damaru
达玛鲁鼓=Đạt Ma Lỗ Cổ
达达=Đạt Đạt
达陀利耶=Đạt Đà Lợi Da
远东总部=Tổng bộ Viễn Đông
连者钥匙=Ranger Key
迦利=Già Lợi
迦叶波=Ca Diếp Ba
迦叶波仙人=Ca Diếp Ba Tiên Nhân
迦娄陀=Ca Lâu Đà
迦尔吉=Kalki
迦尸=Già Thi
迦尸之城=Ca Thi Chi Thành
迦尸城=Ca Thi Thành
迦希吉夜=Kashyapa
迦德卢=Kadru
迦拘吒迦=Ca Câu Tra Ca
迦旃延妮=Ca Chiên Diên Ni
迦旃延那=Katyayana
迦梨女神=Nữ thần Kali
迦梨时代=Ca Lỵ Thời Đại
迦楼罗=Già Lâu La/Garuḍa/Garuda
迦楼罗族=Gia Lâu La Tộc
迦玛帕拉=Già Ma Mạt Lạp
迦罗尼弥=Ca La Ni Di
迦陵频迦鸟=Ca Lăng Tần Già Điểu
迦频奢罗鸟=Ca Tần Xa La Điểu
迪利波=Địch Lợi Ba
迪迦世界=Thế giới Tiga
迪迦奥特曼世界=Thế giới Ultraman Tiga
迷失驱动器=Lost Driver
迷魂台=Mê Hồn Đài
追迹者=TryChaser
追迹者2000=Tracer 2000
逢魔=Oma
達古巴=Daguba
遨游四海求其凰=Ngao du tứ hải cầu kỳ hoàng
遮那迦=Janaka
那兰奇=Na Lan Kỳ
那吒俱伐罗=Na Tra Câu Phạt La
那牟质=Na Mâu Chất
那罗=Nara
那罗延=Narayana
那罗辛哈=Narasimha
那罗迦=Na La Ca
那罗陀=Narada
那罗陀仙人=Narada Tiên nhân
邪蛟=Tà Giao
邪血劫=Tà Huyết Kiếp
邪迪=Tà Diga
郭北镇=Quách Bắc Trấn
酱爆=Tương Bạo
里婆蒂=Lý Bà Đế
里蜀山=Lý Thục Sơn
重力球=Trọng Lực Cầu
重名者钵利=Trùng Danh Giả Bát Lợi
野猪化身=Dã Trư Hóa Thân
野猪筏罗诃=Dã Trư Phiệt La Ha
野瑞=Dã Thụy
量产型特殊摩托车TryChaser2000A=Mô tô đặc chủng sản xuất hàng loạt TryChaser 2000A
金书中的内容=kim thư bên trong nội dung
金刚菩提子=Kim Cương Bồ Đề Tử
金刚身阿修罗=Kim Cang Thân Asura
金叉罗=Kim Xoa La
金发男=Tóc Vàng Nam
金床=Kim Sàng
金床阿修罗=Kim Sàng A Tu La
金忍者=Kim Ninja
金星之神=Kim Tinh Chi Thần
金星仙人=Tiên nhân Kim Tinh
金毛恶鬼=Ác quỷ tóc vàng
金灶沐=Kim Táo Mộc
金牛战车=Kim Ngưu Chiến Xa
金狼百兽王=Kim Lang Bách Thú Vương
金目和金床=Kim Mục và Kim Sàng
金目阿修罗=Kim Mục A Tu La
金目阿修罗王=Kim Mục A Tu La Vương
金翅鸟迦楼罗=Kim Sí Điểu Già Lâu La
金蜈火毒=Kim Ngô Hỏa Độc
金象族=Kim Tượng tộc
金铜龟尊者=Kim Đồng Quy Tôn Giả
金鞭溪=Kim Tiên Khê
金鞭溪客栈=Kim Tiên Khê Khách Sạn
金龙戈尔德拉斯=Kim Long Goldras
钢之蕾=Nụ Thép
钢甲铁面人=Người Mặt Sắt Bọc Thép
钢铁之针=Kim châm sắt
钱江大坝=Tiền Giang Đại Bá
钵利=Bát Lợi
钵利王=Bát Lợi Vương
钵利阿修罗王=Bát Lợi A Tu La Vương
钵底=Bát Để
钵罗诃罗陀=Bát La Ha La Đà
钵那=Bát-Na
钵那阿修罗=Bát Na A Tu La
铁心岛=Thiết Tâm Đảo
铁血星=Tinh cầu Thiết Huyết
铁血星人=Người Sắt Máu
铁血星球=Thiết Huyết Tinh Cầu
铁首=Thiết Thủ
铁鬃灰熊=Thiết Tông Hôi Hùng
铃木深央=Suzuki Mio
铅白豹尊者=Tôn giả Báo trắng chì
铠武=Gaimu
铠武街舞团=Đội nhảy đường phố Gaimu
铠甲勇士刑天=Khải Giáp Dũng Sĩ Hình Thiên
银铜龟尊者=Ngân Đồng Quy Tôn Giả
银龙希尔巴贡=Ngân Long希尔巴贡
铸剑池=Chú Kiếm Trì
链隙=Crack
锐金剑气=Nhuệ Kim Kiếm Khí
锯锹Undead=Undead Bọ Que Cưa
锹螳蝗联组=Kuwagata Kamakiri Batta Combo
長野県=Nagano
长崎公园=Công Viên Nagasaki
长暗仙人=Trường Ám Tiên Nhân
长生不死之神=Trường Sinh Bất Tử Chi Thần
长野县=Tỉnh Nagano
长野县九郎岳=Núi Kurou thuộc tỉnh Nagano
长野县警察部=Sở cảnh sát tỉnh Nagano
长野县警视厅=Sở cảnh sát tỉnh Nagano
长野県=Tỉnh Nagano
长颈鹿锯锹=Bọ Que Cưa Hươu Cao Cổ
関東医大病院=Bệnh viện Y khoa Kanto
门矢=Kadoya
门矢士=Kadoya Tsukasa
门矢小夜=Sayo Kadoya
闪耀亚极陀=Shining Agito
闪耀王剑=Shining Calibur
闪闪爱=Lấp lánh yêu
闭关这么久=bế quan lâu như vậy
闰土=Nhuận Thổ
阎摩使=Sứ giả Diêm Ma
阎摩判官=Diêm Ma Phán Quan
阎摩城=Diêm Ma Thành
阎摩天=Diêm Ma Thiên
阎浮提树=Cây Jambu
阎浮树=Cây Diêm Phù
阎浮树叶=Diêm Phù Thụ Diệp
阎蜜=Diêm Mật
阿修罗女舍脂=A Tu La Nữ Xá Chi
阿修罗导师=Đạo sư A Tu La
阿修罗王金目=A Tu La Vương Kim Mục
阿修罗王钵利=Asura Vương Bali
阿修罗神殿=A Tu La Thần Điện
阿修罗蒙达苏尔=A Tu La Mông Đạt Tô Nhĩ
阿修罗金床=Giường Vàng Asura
阿修罗阿鲁纳=A Tu La Aruna
阿修罗陀罗迦=Asura Taraka
阿利耶迦=A Lợi Da Ca
阿努波=A Nậu Ba
阿奋=A Phấn
阿奴苏耶=A Nô Tô Gia
阿娑妮=A Sa Ni
阿婆罗=A Bà La
阿尼罗=Anila
阿布婆=A Bố Bà
阿库德斯=Akudosu
阿库德斯吉尔=Akudos Gill
阿底=Adi
阿底利=A Để Lợi
阿底利仙人=Atri tiên nhân
阿底提=Adieti
阿底提耶=A Để Đề Gia
阿拉克什米=A Lạp Khắc Thập Mễ
阿摩迦=A Ma Già
阿摩迦之矛=A Ma Già Chi Mâu
阿斯多山=A Tư Đa Sơn
阿格尼亚=Agniya
阿沃索希=A-wo-suo-xi
阿特曼林迦=Atman Linga
阿玛达姆=Amadam
阿瑞斯号=Ares Hào
阿瑞斯号战舰=Chiến hạm Ares
阿耆=A Kỳ
阿耆尼=A Kỳ Ni
阿耆尼之影=A Kỳ Ni Chi Ảnh
阿耆尼天=A Kỳ Ni Thiên
阿耆（qi）尼=Agini
阿诃利耶=A Kha Lợi Gia
阿诃姆=Aham
阿达婆吠陀=Atharvaveda
阿迈=A Mại/Amai
阿迦=A Già
阿迦奢=A Già Xa
阿迦奢之力=A Già Xá Chi Lực
阿迦提耶=A Ca Đề Da
阿迦沙耶=Akasha
阿迪湿婆=A Địch Thấp婆
阿迪瑜吉=A Địch Du Già
阿逾陀=Ayodhya
阿逾陀国=A Du Đà Quốc
阿逾陀城池=Thành A Du Đà
阿那罗=Anala
阿闼婆吠陀=Atharvaveda
阿鲁纳=A Lỗ Nạp
阿鲁诺=Aruna
陀兰那=Đà Lan Na
陀娑羯里婆=Đà Sa Yết Lí Bà
陀提遮=Đà Đề Già
陀提遮仙人=Đà Đề Già Tiên Nhân
陀罗迦=Draka
陀罗迦阿修罗=Tu La Đà La Ca
陆惊天=Lục Kinh Thiên
降龙神丐=Hàng Long Thần Cái
除障者伽内什=Trừ Chướng Giả Già Nội Thập
隅田公园=Công viên Sumida
隐连者=Kakuranger
难胜=Nan Thắng
雄介=Yusuke
雄贤=Hùng Hiền
雅典娜一号=Athena 1
雨花剑=Vũ Hoa Kiếm
雨花剑主=Vũ Hoa Kiếm Chủ
雪山女神=Tuyết Sơn Nữ Thần
雪山族=Tuyết Sơn Tộc
雪山王=Tuyết Sơn Vương
雪山神女=Tuyết Sơn Thần Nữ
雪山神女帕尔瓦蒂=Nữ thần Tuyết Sơn Parvati
雪岛上人=Tuyết Đảo Thượng Nhân
雪晶夫人=Tuyết Tinh phu nhân
雪舍利=Tuyết Xá Lợi
雷克萨斯游泳学校=Trường bơi Lexus
雷土灵珠=Lôi Thổ Linh Châu
雷姆·康纳基=Rem Kannagi
雷无向=Lôi Vô Hướng
雷杵阵=Lôi Xử Trận
雷电交加=Lôi Điện Giao Gia
雷电恶魔=Ác ma sấm sét
雷电恶魔中苏=Lôi Điện Ác Ma Trung Tô
雷遁星云=Lôi Độn Tinh Vân
雷魔兽=Lôi Ma Thú
雾岛拓=Kirishima Taku
霍丽嘉=Holiqa
露兜花=Hoa Lộ Đâu
露卡=Luka
露卡·米露菲=Luka Millfy
露露耶=Lộ Lộ Gia
霸王装甲=Bá Vương Trang Giáp
青光剑=Thanh Quang Kiếm
青光剑主=Thanh Quang Kiếm Chủ
青木原森林=Rừng Aokigahara
青颈=Thanh Kình
青颈之主=青颈之主 - Chúa tể cổ xanh
青龙形态=Dragon Form
青龙族=Thanh Long Tộc
青龙棍=Thanh Long Côn/Dragon Rod
青龙空我=Dragon Form Kuuga
青龙降魔=Thanh Long Hàng Ma
静修林=Tĩnh Tu Lâm
革命进行曲=Bản hành khúc Cách mạng
靳韵翠=Cận Vận Thúy
韩偓=Hàn Ác
音效卡=Thẻ Âm Thanh
顶礼那罗延=Đỉnh Lễ Na La Diên
须摩利=Sumali
须藤雾彦=Sudo Kirihiko
顾留芳=Cố Lưu Phương
颜盈=Nhan Doanh
風谷真魚=Kazaya Mana
风之上神=Phong chi Thượng Thần
风之恶魔=Ác ma gió
风云天诀=Phong Vân Thiên Quyết
风早小学=Trường Tiểu học Kazahaya
风神伐由=Phong Thần Phạt Do
风群之主=Phong Quần Chi Chủ
风耀=Phong Diệu
风谷小姐=Cô Phong Cốc
风谷教授=Giáo sư Kazaya
风谷真鱼=Kazaya Mana
风谷老师=Thầy Kazatani
风都=Fuuto
风都久保川=Kubokawa Futo
风都塔=Futo Tower
风都电台=Đài Phát Thanh Fuuto
风雷妖鸟=Phong Lôi Yêu Điểu
风魔兽=Phong Ma Thú
飞燕一号=Phi Yến 1
飞燕二号=Phi Yến Nhị Hào
飞龙再生=Phi Long Tái Sinh
食为先=Thực Vi Tiên
食人鱼古朗基=Gurongi cá hổ piranha
食人鱼古朗基「魅·比婪·基」=Gurongi cá hổ Piranha "Me·Biran·Gi"
食火仙人=Thực Hỏa Tiên Nhân
饰玉=Kazutama
饰玉三郎=Osamu Saburo
饰玉店长=Quản lý tiệm trang sức ngọc
饰玉老爹=Ông già Shodama
香醉山=Hương Túy Sơn
马三娘=Mã Tam Nương
马克48重型线导鱼雷=Ngư lôi dẫn đường hạng nặng Mark 48
马克50=Mark 50
马克50战甲=Áo Giáp Mark 50
马克50钢铁战甲=Áo giáp sắt Mark 50
马喰町站=Ga Bakurochō
马提迦婆多=Matika婆多
马特斯亚=Mattysia
马首阿修罗=Mã Thủ A Tu La
驱纹戒斗=Kumen Kaito
驾驭表头=Rider Watch
驾驭贩卖号=Ride Vendor
骄生=Kiêu Sinh
骄生阿修罗=Kiêu Sinh A Tu La
骄罗毗耶=Kiêu La Tỳ Da
骑士卡盒剑=Kiếm hộp thẻ Rider
骑士指环=Nhẫn Hiệp Sĩ
骷髅女=Khô Lâu Nữ
骸之镰=Hài Chi Liêm
高司舞=Takatsukasa Mai
高耳=Cao Nhĩ
鬈发城=Quyền Phát Thành
鬼叉罗=Quỷ Xoa La
鬼影兵团=Quỷ Ảnh Binh Đoàn
鬼影军团=Quỷ Ảnh Quân Đoàn
鬼影军团篇=Quỷ Ảnh Quân Đoàn Thiên
鬼影巨魔=Quỷ Ảnh Cự Ma
鬼影忍者=Quỷ Ảnh Ninja
鬼影王国=Quỷ Ảnh Vương Quốc
鬼王九尾狐=Quỷ Vương Cửu Vĩ Hồ
魅集团=Nhóm Me
魅集团古朗基=Me Group Gurongi
魔化大天神=Ma Hóa Đại Thiên Thần
魔化天使=Ma Hóa Thiên Sứ
魔怪诃拉诃拉=Ma quái Hô-la-hô-la
魔法连者=Magiranger
魔王金垫子=Quỷ vương Đệm Vàng
魔王金眼睛=Quỷ vương Mắt Vàng
魔皇之铠=Áo giáp Ma Hoàng
鱼人族=Người cá
鲨鱼古朗基=Guarongi Cá Mập
鲸鲨族=Kình Sa Tộc
鲸鲨王=Kình Sa Vương
鳄魔=Ngạc Ma
鳄魔兵团=Ngạc Ma Binh Đoàn
鳄鱼利兹=Cá sấu Liz
鳄鱼帮=Băng Cá Sấu
鸣海事务所=Văn phòng Narumi
鸣海亚树子=Narumi Akiko
鸣海侦探事务所=Văn phòng thám tử Narumi
鸣海庄吉=Narumi Soukichi
鸯耆罗=Angiras
鸯耆罗仙人=Angiras
鹰虎蝗联组=Taka Tora Batta Combo
鹰雀鹫联组=Taka Kujaku Condor Combo
麒麟套装=Kỳ Lân Sáo Trang
麒麟甲=Kỳ Lân Giáp
麻生冬美=Aso Fuyumi
麻鹬山=Ma Úc Sơn
黄泉之镋=Hoàng Tuyền Chi Đảng
黄金太阳神甲=Hoàng Kim Thái Dương Thần Giáp
黄金山羊=Hoàng Kim Sơn Dương
黄金极限=Gold Xtreme
黄金果实争夺战=Hoàng Kim Quả Thực Tranh Đoạt Chiến
黄金行星=Hoàng Kim Hành Tinh
黑三郎=Hắc Tam Lang
黑云巨人=Hắc Vân Cự Nhân
黑小虎=Hắc Tiểu Hổ
黑山神拳=Hắc Sơn Thần Quyền
黑影王国=Vương quốc Bóng tối
黑手帮=Hắc Thủ Bang
黑无情=Hắc Vô Tình
黑暗星云=Tinh vân Hắc ám
黑暗的支配者加坦杰厄=Kẻ thống trị bóng tối Gatanothor
黑暗蝗虫=Dark Hopper
黑暗蝗虫号=Dark Hopper
黑暗行星古兰斯菲亚=Hành tinh Hắc ám Guransufia
黑暗迪迦=Diga Bóng Tối
黑暗金属=Dark Metal
黑桃A=Bích A
黑桃K=Bích K
黑海深渊=Hắc Hải Thâm Uyên
黑目=Hắc Mục
黑神斗真=Kurokami Touma
黑色2号=Black No. 2
黑色究极空我=Hắc Sắc Cứu Cực Không Ngã
黑色空我=Kuga Đen
黑虎大佛=Hắc Hổ Đại Phật
黑虎崖=Hắc Hổ Nhai
黑虎洞=Hắc Hổ Động
黑魔王=Hắc Ma Vương
黑鹰传书=Hắc Ưng Truyền Thư
黑龙剑=Hắc Long Kiếm
鼠后=Thử Hậu
鼠族大祭司=Thử tộc Đại Tế Tư
龙小组=Long Tiểu Tổ
龙莹=Long Oánh
龙骑世界=Thế giới Ryuki
龟山警部=Thanh tra Kameyama
龟种古朗基=Gurongi Rùa
玛帕星=Hành tinh Mapa
布鲁将军=Tướng quân Blue
三星球=Ngọc Tam Tinh
一星球=Ngọc Nhất Tinh
玛帕星人=Người Mapa
星球毁灭弹=Chiêu hủy diệt hành tinh
银河巡警加克传=Hành Tinh Tuần Tra Jaco
龙珠Z：一夫当关的最后决战=Dragon Ball Z: Trận Chiến Cuối Cùng
纳江星=Hành tinh Najian
万多行星=Hành tinh Wanda
天空般宁静的心灵，闪电般迅猛的速度=Tâm hồn tĩnh lặng như bầu trời, tốc độ nhanh như chớp giật
气息感应=Cảm nhận khí
沙拉达星=Hành tinh Salad
瞬间移动术=Dịch Chuyển Tức Thời
灵气回溯=Linh Khí Khôi Phục
封妖师=Phong Yêu Sư
封妖阵=Phong Yêu Trận
79号行星=Hành tinh số 79
80号星域=Khu vực sao số 80
邱夷=Qui Ui
博葛星=Planet Boggs
二星球=Ngọc Nhị Tinh
宇宙快递公司=Công ty Chuyển phát nhanh Vũ trụ
宇宙杀手组织=Tổ chức Sát thủ Vũ trụ
培植星球=Hành tinh Saibaiman
北银河西面=Phía Tây Ngân Hà Bắc
丰神大人=Phong Thần Đại Nhân
普依博士=Tiến Sĩ Puyi
恶魔普依一族=Ác Ma Puyi
卡夏星=Hành tinh Caxia
西娅星系=Hệ Ngân hà Shea
尤加尔星人=Người Yugal
北银河南部=Nam Ngân Hà Bắc
奥隆星=Hành tinh Orlon
光弹冲击=Quang Đạn Xung Kích
巴尼行星=Hành tinh Barney
祖诺星=Hành Tinh Zuno
弗利萨总部行星=Hành Tinh Tổng Bộ Frieza
毛豆炖肉汤=Canh Đậu Nành Thịt Hầm
四方界王=Tứ Phương Giới Vương
加沃=Gia Ngõa
雨洛无声=Vũ Lạc Vô Thanh
意识修行=Tu Hành Ý Thức
加百人王都=Vương đô của người Gabar
加百人=người Gaber
元气强化=Cường Hóa Nguyên Khí
阿尔塔遗迹=Di tích Aruta
龙珠超=Dragon Ball Super
举利斯族=Tộc Julis
拼搏精神=Tinh Thần Phấn Đấu
上级战士=Chiến Binh Cấp Cao
极西区域=Khu vực Cực Tây
培植人=Người Saiyan nhân tạo
蓝扉=Lam Phi
希金矿石=Khoáng Thạch Hikin
霹雳星=Tích Lịch Tinh
法斯格警员=Cảnh Sát Fasug
太阳珠=Ngọc Mặt Trời
布拉菈=Bura La
巴布行星=Hành tinh Bab
琉璃星体=Lưu Ly Tinh Thể
VIP章节=Chương VIP
子越=Tử Việt
赛菲舰队=Hạm đội Sephi
索诺丽冒险团=Đoàn thám hiểm Sonori
席迪尔兄弟=Anh em Sidiel
巴布大人=Đại Nhân Babu
尚波一族=Bộ tộc Appule
巴布人=người Papu
超级一星龙珠=Siêu Ngọc Rồng Một Sao
地月系统=Hệ thống Trái Đất - Mặt Trăng
巨猿罗岚=La Lan Đại Khỉ
巨猿力量=Sức Mạnh Đại Khỉ
沃兹夫星球=Hành tinh Vozuf
巨猿化=Đại Tinh Hóa
东南西北四大银河=Tứ Đại Ngân Hà Đông Tây Nam Bắc
第182章 种仙豆（20更！)=Chương 182: Trồng Đậu Thần
转移术=Dịch Chuyển Thuật
东界王神阿辛=Đông Kaioshin Shin
二世大人=Nhị Thế Đại Nhân
巨猿形态=Đại Khỉ đột
布里夫斯夫妇=Vợ chồng Briefs
辛辣四人组=Bộ Tứ Gia Vị
德雷先生=Ông Dore
贝帕行星=Hành Tinh Bappa
雨隆星域=Tinh Vực Vũ Long
巴尔星域=Tinh Vực Bar
索达星=Hành tinh Soda
奥尔德行星=Hành tinh Old
水晶星球=Hành Tinh Pha Lê
贝帕星人=Người Bepa
布雷奇星人=Người Brench
佐尔德星人=Người Xayda
克维拉机甲战队=Đội Cơ Giáp Cooler
克鲁德军=Quân Đoàn King Cold
卡鲁博士=Tiến Sĩ Kahl
银河监狱=Nhà ngục Ngân hà
玛帕行星=Hành tinh Mapa
四星龙珠=Ngọc Rồng Bốn Sao
兔子军团=Đội Thỏ
史拉古星=Hành Tinh Slug
斯卡行星=Hành tinh Ska
弗德行星=Hành tinh Furd
艾尔提拉行星=Hành tinh Airtila
银河佣兵平台=Nền Tảng Lính Đánh Thuê Ngân Hà
斯卡星系=Hệ Sao Ska
奥菲星球=Hành tinh Ophie
第230章 史拉古的恨意（二合一）=Chương 230: Hận ý của Slug
魔凶星=Hành tinh Makyo
残像拳=Tàn Ảnh Quyền
娜美克星人村落长老=Trưởng Làng Namek
史拉古大王=Đại vương Slug
藤族人=Người Vine
魔光冲击=Ma Quang Xung Kích
超级毁灭波=Siêu Sóng Hủy Diệt
奥菲星=Tinh Orphée
拟态超级赛亚人=Siêu Saiyan Giả Dạng
第21届天下第一武道会=Thiên Hạ Đệ Nhất Võ Đạo Hội lần thứ 21
四强赛=Vòng bán kết
第250章 弗利萨的关心=Chương 250: Sự quan tâm của Frieza
娜美克星大长老=Đại trưởng lão Namek
织女星座=Chòm sao Chức Nữ
精神树的果实=quả của Cây Thần
梦幻之神="Thần Rồng Ước Mơ"
拟态猿化=Ngụy Tinh Hóa Khỉ
超红状态=Trạng thái Super Saiyan God Super Saiyan
金瞳状态=Trạng thái Kim Đồng
淳朴的布罗利=Broly Chất Phác
史拉古军团=Quân đoàn Slug
卡里克势力=Thế lực Garlic
蓝鍂石=Lam Tinh Thạch
界王神坡塔拉耳环=Bông Tai Potara của Kaioshin
特战队伍=Đội đặc nhiệm
白兰星=Hành tinh Blanc
法斯格巡警=Tuần tra viên Fass
卡里克二世=Garlick Jr.
巴布军团=Quân đoàn Bab
魔凶星势力=Thế lực Ma Hung Tinh
五行山八卦炉=Bát Quái Lò ở Ngũ Hành Sơn
安宁大人=Người lớn An Ninh
多络行星=Hành tinh Doro
希金=Hy Kim
天使维斯=Thiên Sứ Whis
鲁兰德星盗团=Băng Hải Tặc Ruland
刺猬人=Người Nhím
第22星区=Khu vực Sao thứ 22
兹尔行星=Hành Tinh Zir
迪尔普依=Dir Pui
莫斯普依=Mos Pui
祖诺大人=Thần Zuno
创神星=Hành tinh Sáng Tạo
第22届武道会=Giải đấu Võ Thuật Thế Giới lần thứ 22
四星球=Ngọc Tứ Tinh
第21届=Lần thứ 21
第22届=Lần thứ 22
鸭嘴魔族=Ma tộc mỏ vịt
超级赛亚人‘超越’形态=Super Saiyan 'Vượt Giới Hạn'
超级赛亚人‘全功率’=Super Saiyan 'Full Power'
普依女王=Nữ Hoàng Pui Pui
多林寺=Đa Lâm Tự
银河神话=Ngân Hà Thần Thoại
索诺丽教学班=Lớp học của Sonori
帕拉伽斯先生=Ngài Paragus
布尔玛小姐=Cô Bulma
梅珊达星=Hành Tinh Meshanda
未来特兰克斯=Trunks tương lai
人造人沙鲁=Android Cell
第21届武道会=Giải Võ Thuật Thế Giới Lần Thứ 21
新生比克=Piccolo con
智慧型娜美克星人=người Namek hệ Trí Tuệ
医疗型娜美克星人=người Namek hệ Chữa Trị
战斗型娜美克星人=người Namek hệ Chiến Đấu
赛亚人篇=saga Saiyan
娜美克星篇=saga Namek
人造人篇=saga Android
魔人布欧篇=saga Majin Buu
人造人1号=Android 1
人造人8号=Android 8
东魔王=Đông Ma Vương
254号大陆=Đại Lục Số 254
三重炼狱之门=Tam Trọng Luyện Ngục Chi Môn
森罗炼狱=Sâm La Luyện Ngục
恶魔普依=Ác Ma Pui Pui
唐格行星=Hành Tinh Tangge
金属沙维扎=Metal Coora
赤瞳模式=Chế Độ Xích Đồng
鲁璐=Lu Lu
中央计算机=Máy Tính Trung Tâm
魔窟星系=Hệ Ngân Hà Ma Quật
青藤星系=Hệ Ngân Hà Thanh Đằng
赤瞳形态=Hình thái Xích Đồng
比高星=Hành tinh Biko
东南小岛=Hòn đảo Đông Nam
木瓜岛=Đảo Papaya
武术之神="Võ Thuật Chi Thần"
竞武馆=Khu thi đấu
新气功炮=Khí Công Pháo cải tiến
魔光线=Ma Quang Tuyến
加帕王=Vua Gappa
玛斯鲁塔=Musle Tower
第22届天下第一武道会=Thiên Hạ Đệ Nhất Võ đạo hội lần thứ 22
武道寺=Võ Đạo Tự
孙悟饭老爷子=Son Gohan
太上老君安宁=Thái Thượng Lão Quân An Ninh
阴间蛇道=Xà Đạo Âm Phủ
宇宙商业总部=Trụ sở Thương mại Vũ trụ
培植人种子=Hạt giống Saibaiman
伊芙莉薇=Eve Livie
娜美克星星系=Hệ Namek
尖嘴魔族=Ma tộc mỏ nhọn
地球老天神=Thượng Đế Trái Đất
菲罗伊行星=Hành tinh Frieza
宇宙屏障=Tường Vũ Trụ
万能胶囊总部=Tập Đoàn Capsule
人造人14号=Android 14
人造人15号=Android 15
阴间黄泉=Âm Gian Hoàng Tuyền
人造人改造=Cải tạo Android
普通超级赛亚人=Siêu Xayda thông thường
肌肉形态=Dạng cơ bắp
罗岚先生=Luo Lan tiên sinh
超级贝吉塔=Super Vegeta
超级神之龙=Super Shenron
蓝色水晶=Pha Lê Xanh
大宇宙天使=Thiên Sứ Vũ Trụ
弗利萨行星=Hành tinh Frieza
中央神星=Thần Tinh Trung Tâm
时空戒指=Nhẫn thời gian
41号次级世界=Thế giới thứ cấp số 41
超神水=Siêu Thần Thủy
布里夫斯太太=Bà Briefs
地球龙珠=Ngọc Rồng Địa Cầu
娜美克星人史拉古=Người Namek Slug
第四级序列=Cấp độ thứ tư
红珠子=Hồng Châu
深蓝水晶=Pha Lê Xanh Thẳm
超级赛亚人‘超越’阶段=Super Saiyan 'Beyond' Stage
武道服=Võ phục
波多族=Tộc Bột Đa
鲁卡博士=Tiến sĩ Luud
全功率状态=Trạng thái toàn công suất
武道宗师武泰斗=Võ Thái Đấu
第23届的天下第一武道会=Giải đấu Võ Thuật Thế Giới lần thứ 23
地球的天神=Thượng Đế Trái Đất
超级娜美克星人=Siêu Namekian
金瞳变身=Biến Hình Kim Nhãn
育儿舱=Buồng Nuôi Dưỡng
东魔王艾莫斯=Đông Ma Vương Aimos
恶魔曼布索=Ác Ma Manbuso
虚假天堂=Thiên Đường Giả Tạo
贝吉塔王子=Hoàng Tử Vegeta
贝吉塔小队=Đội Vegeta
弗利萨军=Quân Frieza
地球神殿=Điện Kami
天神神力=Thần lực của Thượng Đế
贝吉塔行星=Hành Tinh Vegeta
银河巡警加克=Jaco Tuần Tra Ngân Hà
龙珠超-布罗利=Dragon Ball Super: Broly
赛菲利亚女王=Nữ hoàng Selyphria
太空回廊=Hành Lang Vũ Trụ
银河巡警总部=Trụ sở Tuần tra Ngân Hà
211号大陆=Lục địa số 211
梅尔斯巡警=Tuần Tra Viên Merus
武道擂台=Võ Đài
银河王=Vua Ngân Hà
兰纳星=Lana Tinh
乌图星系=Hệ Ngân Hà Utu
破坏神波蒙弗=Thần Hủy Diệt Mosco
女王亲卫队=Đội cận vệ Nữ hoàng
66950银星=Ngân Tinh 66950
金属人=Người Kim Loại
梅珊达行星=Hành tinh Mesanda
晶莹战队=Đội chiến tinh thể
和萨大人=Lãnh chúa Hassa
萨大人=Ngài Hosa
宇宙巡警组织=Tổ Chức Tuần Tra Vũ Trụ
银河大会=Đại Hội Ngân Hà
金属机铠人=Người máy Metal
沙拉达星系=Hệ Sadala
沙拉达战队=Đội Chiến Binh Salad
梅露提丝女王=Nữ Hoàng Melutis
金瞳超级赛亚人=Siêu Xayda Mắt Vàng
许愿珠=Ngọc Ước Nguyện
金瞳赛亚人=Super Saiyan Mắt Vàng
蓝水水晶=Tinh Thể Lam
界王大人=Giới Vương Đại Nhân
大神官大人=Đại Thiên Sứ
金瞳超级赛亚人全功率=Siêu Saiya Kim Đồng Toàn Công Suất
预备破坏神=Ứng Cử Viên Thần Hủy Diệt
赤瞳超级赛亚人=Super Saiyan Mắt Đỏ
西魔王=Tây Ma Vương
金瞳超级赛亚人2=Siêu Xay-da Cấp 2 Kim Đồng
超功率=Siêu Công Suất
培植人星球=Hành tinh trồng cây
克鲁德大王=King Cold
第25届天下第一武道会=Giải đấu Thiên Hạ Đệ Nhất Võ Đạo Hội lần thứ 25
混沌理论=Lý thuyết hỗn loạn
克鲁德军团=Binh Đoàn Cold
四大银河系=Tứ Đại Ngân Hà
银河尽头=Tận Cùng Ngân Hà
全功率=Full Power
中都=Trung Đô
东之都卫星城=Thành Tinh Vệ Đông Đô
黄泉流光=Hoàng Tuyền Lưu Quang
鲁璐魔女=Phù thủy Lulu
毁灭冲击波=Grand Smasher
最强战队=Đội Chiến Binh Mạnh Nhất
气合炮=Khí Công Pháo
弗利萨大王=Đại Vương Frieza
奥黛摩尔=Oud Moore
梅露女王=Nữ hoàng Melus
孙悟空先生=Tôn Ngộ Không tiên sinh
阿莉丝小公主=Công Chúa Alice
茨莱=Cải Lạp
藤族少女=Thiếu nữ tộc Teng
阿斯卡莉公主=Công chúa Asukari
红石星武道会=Giải đấu võ thuật hành tinh Hồng Thạch
破坏神星=Hành Tinh Thần Hủy Diệt
全王力之大会=Giải Đấu Sức Mạnh
斯啤利托=Không cần dịch
造神星=Tạo Thần Tinh
南部城市=Thành phố phía Nam
红带缎军团=Hồng Binh Đoàn
未来少年=Thiếu niên tương lai Trunks
布里夫斯家族=Gia Tộc Briefs
罗岚老师=Sư phụ Rolan
猿化赛亚人=Saiyan Hóa Khỉ
娜美克星人大长老=Trưởng Lão Namek
红石星=Hồng Thạch Tinh
苏诺女神=Thần Suno
西面地区=Khu vực phía Tây
小货车=Xe tải nhỏ
地球天神=Thượng Đế Trái Đất
玛斯鲁塔地区=Khu vực Masluta
45号次级世界=Thế giới thứ cấp số 45
38号次级世界=Thế giới thứ cấp số 38
人造人13号=Android 13
乌木博士=Tiến sĩ U Mộc
神秘形态=Trạng thái Tiềm Năng
太空岛=Đảo Vũ Trụ
西北八十公里=Tây Bắc 80 km
中之都=Trung Đô
第26届天下第一武道会=Thiên Hạ Đệ Nhất Võ Đạo Hội lần thứ 26
第612章 撒旦=Chương 612: Satan
第23届天下第一武道会=Giải đấu Võ thuật Thế giới lần thứ 23
魔二代=Piccolo Jr.
四身拳=Tứ Thân Quyền
猫国王=Quốc vương Mèo
闪电形态=Dạng Tia Chớp
阿斯卡莉战队=Đội Ascari
完美常态=Trạng thái hoàn hảo
全功率死亡光线=Tia tử thần toàn lực
元气循环=Tuần Hoàn Nguyên Khí
世界格斗大赛=Giải đấu Võ Thuật Thế Giới
南之都=Thành phố phía Nam
织女星座第27主星系=Hệ sao Chức Nữ chính thứ 27
梅露利亚女王=Nữ hoàng Meluria
许愿星=Ngọc Rồng
波纳多=Porunga
红神龙=Rồng Thần Đỏ
蓝神龙=Rồng Thần Xanh
高阶神灵的语言=Thần ngữ cao cấp
巴布星=Hành Tinh Babidi
安琪星域=Tinh Vực An琪
神之语=Ngôn ngữ của Thần
金色神龙=Thần Rồng Vàng
红色神龙=Hồng Thần Long
蓝色神龙=Lam Thần Long
巴布星系=Hệ Babidi
利斯族=Tộc Lyth
力之大会=Giải đấu Sức mạnh
纳西亚星=Hành tinh Naxia
焰火攻击=Hỏa Diễm Công Kích
东界王星=Hành tinh Đông Giới Vương
南界王=Nam Giới Vương
魔窟星域=Tinh Vực Ma Quật
弗莱行星=Hành tinh Frieza
神与神=Trận chiến giữa các vị thần
魔窟星=Hành tinh Ma Quật
第32层=Tầng 32
第50层=Tầng 50
第55层=Tầng 55
第52层=Tầng 52
爆能流星=Blaster Meteor
46号星域=Tinh vực số 46
完全体状态=Trạng thái hoàn hảo
闪电沙鲁=Super Perfect Cell
幽冥粉碎波=U Minh Phấn Toái Ba
古维沙=Gu Visha
司图诺行星=Hành Tinh Stuno
宇宙神灵=Thần Vũ Trụ
全能量状态=Trạng Thái Full Power
东之都=Thủ Đô Phía Đông
兰纳星人=Người Lanna
第23届武道会=Thiên Hạ Đệ Nhất Võ Đạo Hội lần thứ 23
星辰全空击=Tinh Thần Toàn Không Kích
波蒙弗雷=Không tìm thấy bản dịch phổ biến
菲露利亚=Không tìm thấy bản dịch phổ biến
星光炸裂=Không tìm thấy bản dịch phổ biến
多多鸟=Đa Đa Điểu
火焰冲击=Ngọn Lửa Xung Kích
人造人19号=Android 19
超红赛亚人超功率=Super Saiyan God Super Saiyan Kaioken
GT世界=Thế giới GT
银星机铠人玛林塔=Marinta người máy Ngân Tinh
第27届天下第一武道会=Giải đấu Thiên Hạ Đệ Nhất Võ Đạo Hội lần thứ 27
霹雳钢=Không có thông tin về từ này trong Dragon Ball nên sẽ giữ nguyên
超大气功=Không có thông tin về từ này trong Dragon Ball nên sẽ giữ nguyên
电击地狱弹=Không có thông tin về từ này trong Dragon Ball nên sẽ giữ nguyên
亚德拉特星人=Người Yardrat
东龙星=Đông Long Tinh
第684章 托起超级龙珠的女人=Chương 684: Người Phụ Nữ Nâng Viên Ngọc Rồng Siêu Cấp
第45号次级宇宙=Vũ trụ cấp thấp số 45
第38号次级世界=Thế giới cấp thấp số 38
魔人形态=Dạng Majin
全王宙系第七宇宙=Toàn Vương Trụ Hệ Vũ Trụ Thứ 7
希望龙神=Hy Vọng Long Thần
大盛博士=Tiến Sĩ Briefs
艾纪=Age
心灵空间秘术=Bí thuật Không Gian Tâm Linh
龙珠超次元乱战=Dragon Ball Multiverse
坡塔拉耳环=Bông tai Potara
超级赛亚人1=Siêu Xayda cấp 1
赛菲利亚姐姐=Chị Seripa
娜美克星龙珠=Ngọc Rồng Namek
猿化=Hóa Khỉ Đột Biến/Hóa Khỉ Cuồng Bạo
超次元乱战=Giải Đấu Đa Chiều Không Gian
新娜美克星=Namek Mới
娜美克星神龙=Rồng thần Namek
龙珠Z=Dragon Ball Z
贝吉塔王=Vua Vegeta
银河战士布钦=Bujin chiến binh ngân hà
19号宇宙=Vũ trụ số 19
贯穿光束=Tia Xuyên Thấu
邪恶爆弹=Bom Ác Quỷ
次元崩裂炮=Pháo Phân Rã Chiều Không Gian
8号宇宙=Vũ trụ số 8
6号宇宙=Vũ trụ 6
15号宇宙=Vũ trụ 15
邪恶布欧=Ma Bư
12号宇宙=Vũ trụ số 12
意识修炼=Tu luyện ý thức
超级悟饭=Super Gohan
神秘悟饭=Mystic Gohan
野比饭=Gohan Nồi Cơm Điện
杰比特神=Kibito Shin
20号宇宙=Vũ trụ 20
万帕星=Hành tinh Vampa
艾纪773年=Năm Age 773
艾纪794年=Năm Age 794
爆破轰击=Bạo Phá Oanh Kích
爆破流星=Bạo Phá Lưu Tinh
4号宇宙=Vũ trụ số 4
17号宇宙=Vũ trụ số 17
巨量流星=Cự Lượng Lưu Tinh
虚空置换术=Hoán Đổi Không Gian
超级赛亚人·红色=Super Saiyan God
传超赛亚人=Super Saiyan Huyền Thoại
胖布欧=Mập Buu
完全体沙鲁=Cell Hoàn Hảo
加力炮=Garlik Ho
金发兰琪=Lunch tóc vàng
原始布欧=Kid Buu
9号宇宙=Vũ trụ số 9
10号宇宙=Vũ trụ số 10
万国惊天掌=Vạn Quốc Kinh Thiên Chưởng
11号宇宙=Vũ trụ số 11
气合拳=Khí Hợp Quyền
心灵空间=Không Gian Tâm Linh
第二级序列=Cấp Độ Thứ Hai
神级赛亚人=Siêu Xayda Cấp Thần
1号宇宙=Vũ trụ số 1
南界王神=Nam Giới Vương Thần
北界王神=Bắc Giới Vương Thần
红龙珠=Ngọc Rồng Đỏ
武道星球=Hành Tinh Võ Đạo
16号宇宙孙悟饭=Son Gohan vũ trụ 16
13号宇宙=Vũ trụ 13
3号宇宙=Vũ trụ 3
12号宇宙特兰克斯=Trunks vũ trụ 12
外域三十六区=36 Vùng Ngoài
普兰特星球=Planet Plant
普兰特星人=Người Plant
加斯卡科=Gasca Khắc
西界王神=Tây Kaioshin
超级布欧=Super Buu
界王空间=Giới Vương Không Gian
界王神星=Giới Vương Thần Tinh
巴达克之章=Bardock: Cha của Goku
龙珠Z 一个人的最终决战=Dragon Ball Z: Trận Chiến Cuối Cùng Cô Độc
卡娜沙星=Hành Tinh Kanassa
黄金巨猿=Khỉ Đột Vàng
一星龙=Yi Xing Long
超级赛亚人之神·蓝发形态=Siêu Xayda Thần Thánh Dạng Lam
超级赛亚人·蓝色=Siêu Xayda Blue
普兰特星=Hành tinh Plant
赛亚人女王=Nữ hoàng Saiyan
布尔兹波=Bulz Wave
欧勒吉=Oozaru
大天女=Đại Thiên Nữ
诺斯艾利斯=Noth Eleus
普兰特行星=Hành Tinh Plant
星空炮=Tinh Không Pháo
究极破坏弹=Tuyệt Chiêu Huỷ Diệt
破坏神欧勒吉=Thần Hủy Diệt Oleji
破坏神波蒙弗雷=Thần Hủy Diệt Pomunfre
编号13号的神星=Thần Tinh số 13
伊染大人=Đại nhân Izo
第548次龙神选拔=Tuyển chọn Long Thần lần thứ 548
超次元大赛=Giải Đấu Đa Vũ Trụ
41号宇宙=Vũ trụ số 41
龙神试炼=Long Thần Thí Luyện
时空之海=Biển Thời Không
南方龙域=Long Vực Phía Nam
亚托拉克龙族=Á Thoát Lạp Khắc Long Tộc
龙神台=Long Thần Đài
龙神伊染=Long Thần Iren
蓝龙珠=Ngọc Rồng Xanh
地球神龙=Rồng Thần Địa Cầu
萨拉玛神力=Thần lực Zalama
宙系=Trụ Hệ
风里希=Phong Lí Hi
亚力斯=Á Lực Tư
王历=Vương Lịch
超级赛亚人之神·蓝色=Super Saiyan God Super Saiyan
7号宇宙=Vũ trụ số 7
神之龙=Rồng Thần Siêu Cấp
超级神龙=Super Shenron
龙神宫=Long Thần Cung
神历49年=Thần Lịch năm 49
16号宇宙=Vũ Trụ Số 16
全王外域十三区=Khu 13 Ngoại Vực của Zen-Oh
18号宇宙=Vũ Trụ Số 18
阿包=A Bao
神星=Thần Tinh
瓦鲁迦人=Người Varga
原始沙鲁=Cell Nguyên Thủy
超次元比赛=Giải đấu Siêu Thứ Nguyên
宇宙恶魔一族=Ác ma vũ trụ
赤瞳赛亚人=Siêu Xayda Mắt Đỏ
罗岚的=của Ro Lạn
艾玛博士=Tiến sĩ Emma
悟饭布欧=Gohan Buu
比克布欧=Piccolo Buu
悟天克斯布欧=Gotenks Buu
人造人21号=Android 21
超级赛亚人4=Super Saiyan 4
9号次级宇宙=Vũ trụ thứ cấp số 9
北部海域=Vùng biển phía Bắc
鹤仙人=Hạc Tiên Nhân
第三级序列力量=Sức mạnh cấp độ 3
三十六区=Khu 36
排骨饭=Pai Ku Han
诺莱人=Người Nolai
亚德拉特星=Hành Tinh Yardrat
西界王=Kaiō Tây
西银河=Ngân Hà Tây
天国武道会=Thiên Quốc Võ Đạo Hội
魔人摩蒙曼=Majin Mamonman
亚神界=Á Thần Giới
精神树=Thần Tinh Thụ
上神大人=Thượng Thần đại nhân
东界王=Đông Giới Vương
融合术=Thuật Hợp Thể
东界王神=Kaioshin Đông
魔人21号=Majin Android 21
自在意境=Bản Năng Vô Cực - Ý Cảnh
美达摩尔星融合术=Thuật Hợp Thể Metamor
判神之力=Sức mạnh Phán Thần
龙神之力=Sức mạnh Rồng Thần
全王外域13号神星=Thần tinh số 13 Ngoại Vực của Zen-oh
第793章 孙悟空的超3！=Chương 793: Super Saiyan 3 của Son Goku!
第28届天下第一武道会=Đại hội võ thuật Thiên Hạ Đệ Nhất lần thứ 28
超级赛亚人全功率=Super Saiyan Full Power
超级赛亚人超功率=Super Saiyan Ultra Power
超级赛亚人全能量状态=Super Saiyan Full Energy State
精神树果实=Trái cây Thần Khí
梅露提丝=Mê Lạp Típ
万帕行星=Hành tinh Vampa
闪时=Độ Trễ Thời Gian/Thiên Thạch Thời Gian
破坏神象帕=Thần Hủy Diệt Champa
天使神杖=Thần Trượng Thiên Sứ
兆境=Ultra Instinct Sign
美达摩尔星人=Người Metamor
阴阳通道=Thông đạo Âm Dương
北银河星域=Ngân hà phía Bắc
多多鸟星球=Hành tinh Dodoria
灰色吉连=Jiren Xám
破坏神贝鲁蒙德=Thần Hủy Diệt Belmod
兹恩行星=Hành tinh Zun
普依一族=Tộc Pui
泗水星=Hành Tinh Sissi
境界神=Thần Cảnh Giới
佐昆行星=Hành tinh Zokun
龙珠超剧场版布罗利=Dragon Ball Super: Broly
龙神赐福守护者亚力斯=Người Bảo Hộ Ban Phước Thần Rồng Aris
星空拳=Tinh Không Quyền
万象拳=Vạn Tượng Quyền
空斩=Không Trảm
神空击=Thần Không Kích
神斩=Thần Trảm
神之御技=Thần Chi Ngự Kỹ
藤蔓魔物=Đằng Mạn Ma Vật
精神高塔=Tháp Tinh Thần
西丰=Tây Phong
金字塔时光屋=Thời Gian Ốc Kim Tự Tháp
神灵序列=Thứ Tự Thần Linh
小丑破坏神贝鲁蒙德=Thần Hủy Diệt Belmod
莫罗修=Moro Xiu
全王规则=Luật lệ của Zeno
梅兹提佩丝=Mezuti Pes
司神殿=Tư Thần Điện
龙神星=Long Thần Tinh
苍神=Thương Thần
橙星=Orange Star
地球王国=Vương quốc Trái Đất
撒旦先生=Mr. Satan
地球天界=Thiên Giới Trái Đất
天界神殿=Điện Kami
鹤仙流=Hạc Tiên phái
舞空术=Bukujutsu
南部変身幼稚园=Trường Mẫu Giáo Biến Hình Nam
凉景山=Lương Cảnh Sơn
冰雪星球=Hành tinh Băng Giá
宇宙智慧种族=Chủng Tộc Vũ Trụ Thông Minh
基纽队长=Đội Trưởng Ginyu
也兰特星人=Người Yadrats
旧神官莫罗修=Thần Quan Moro
主时空=Thế Giới Chính
13号神星=Thần Tinh số 13
界王神凯伊=Kaio-shin Kai
龙神菲欧斯=Thần Rồng Phios
天使之力=Thiên Sứ Chi Lực
骄傲战队=Đội Tuần Tra Kiêu Hãnh
恶魔种子=Hạt giống Ác Ma
小丑破坏神=Thần Hủy Diệt hề Belmond
龙 thần サラマ=Thần Rồng Zalama
黑星七龙珠=Ngọc Rồng Hắc Tinh
龙珠GT=Dragon Ball GT
卡达兹之子=Con trai của Kattatz
艾玛 và Tiểu Cell=Emma và Tiểu Cell
空神宙系=Vũ trụ Không Thần
萨拉玛大人=Đại nhân Zalama
菲欧斯大人=Đại nhân Phios
预知鱼=Cá Tiên Tri
象帕大人=Thần Hủy Diệt Champa
比鲁斯大人=Thần Hủy Diệt Beerus
预言鱼=Cá Tiên Tri
碧海晴天=Bích Hải Tình Thiên
阴间地狱=Địa ngục Âm gian
万能胶囊集团=Tập đoàn Capsule
北界王星=Hành tinh của Kaiō Bắc
黄泉蛇道=Xà Đạo
摩蒙曼=Mô Mông Mạn
全空击=Toàn Không Kích
第858章 神击！！=Chương 858: Thần Kích!!
见习龙神加布=Thực Tập Long Thần Gabu
超蓝=Super Saiyan Blue
超红=Super Saiyan God
次元神=Thần Không Gian
诺娅=Nặc Á
神官莫罗修=Thần Quan Moro
神之挪移=Dịch Chuyển Thần Thánh
旧神官=Thần Quan Cổ Đại
南银河=Ngân hà phía Nam
第十一宇宙=Vũ trụ thứ 11
见习龙神=Thần Rồng Tập Sự
界王神洛而=Kaioshin Loe
破坏神西多拉=Thần Hủy Diệt Sidra
海怪破坏神金=Thần Hủy Diệt Hải Quái Jin
第四宇宙=Vũ Trụ Thứ 4
第八宇宙=Vũ Trụ Thứ 8
第五宇宙=Vũ Trụ Thứ 5
全王宫殿=Cung điện Zen-Oh
全王宇宙=Vũ trụ của Zen-Oh
见习界王神=Kaioshin tập sự
龙珠超·布罗利=Dragon Ball Super: Broly
自在极意功=Bản năng vô cực
塔利斯卡=Taliska
龟仙屋=Kame House
第29届天下第一武道会=Giải đấu Thiên Hạ Đệ Nhất Võ Đạo Hội lần thứ 29
橙星市=Thành phố Orange Star
马吉尼亚=Majin Vegeta
人造人17号=Android 17
人造人18号=Android 18
人造人16号=Android 16
少年组=Bảng Thiếu Niên
银河管理者=Người quản lý Ngân Hà
魔人艾玛=Majin Emma
北界王=Bắc Kaiō
老天神=Thượng Đế
阿斯卡莉=Không rõ
赛菲利亚=Không rõ
梅露利亚=Không rõ
布荔=Không rõ
福瓦=Không rõ
界王神格瓦斯=Kaioshin Gowasu
第十宇宙=Vũ trụ thứ 10
大界王神欧尔=Đại Kaioshin Oor
全王宙系内域=Khu vực bên trong vũ trụ của Zeno
斯波比奇兄弟=Anh em Spopovich
金发主持人=Người dẫn chương trình tóc vàng
沙鲁游戏=Đại Hội Cell
界王星=Hành Tinh Kaio
终极闪光=Final Flash
凯琳圣地=Thánh Địa Karin
武道市=Võ Đạo Thị
界王神前辈=Tiền bối Kaioshin
十五代前的界王神=Kaioshin tiền nhiệm đời thứ 15
腾龙图案=Hoa văn Đằng Long
全王=Toàn Vương
上位龙神=Thượng Vị Long Thần
第九宇宙=Vũ trụ thứ 9
第十二宇宙=Vũ trụ thứ 12
全王神谱=Toàn Vương Thần Phổ
全王世界=Thế Giới Toàn Vương
第900章 退休后的破坏神去了哪里？=Chương 900: Thần Hủy Diệt sau khi về hưu đã đi đâu?
龙神萨拉玛=Long Thần Zalama
全王外域=Ngoại Vực Zeno
全王外域三十六区=36 Khu Vực Ngoại Vực Zeno
全王宙系=Trụ Hệ Zeno
界王神阿辛=Kaioshin Shin
破坏神比鲁斯=Thần hủy diệt Beerus
黑暗魔法师巴比迪=Phù thủy bóng tối Babidi
众神会议=Hội nghị Thần
15代前的老界王神=Lão Kaioshin 15 đời trước
橙星高中=Trường Cao Trung Orange Star
梅珊达星球=Hành tinh Mesanda
龙珠之完美世界=Dragon Ball: Thế Giới Hoàn Mỹ
全王力量大会=Giải đấu sức mạnh của Zen-Oh
破坏神界=Thế giới Thần Hủy Diệt
超级13号=Super Android 13
杰比特先生=Ngài Kibito
万能胶囊公司=Công ty Capsule
橙星中学=Trường Trung Học Ngôi Sao Cam
全王内域=Lãnh Địa Zen-Oh
阿尔塔人布荔=Bulchi người Aralt
悟空先生=Ngài Goku
赛菲女王=Nữ hoàng Saiyan
阿尔塔人=Người Arlia
弗利萨军团=Quân đoàn Frieza
银河巡警组织=Tổ Chức Tuần Tra Ngân Hà
银河佣兵组织=Tổ Chức Lính Đánh Thuê Ngân Hà
神之气=Khí Thần
界王神剑=Kiếm Kaioshin
西之都=Thành phố phía Tây
小沙鲁=Cell Jr.
第918章 孙悟饭，跟我一起回去！=Chương 918: Son Gohan, đi theo ta trở về!
大界王星=Đại Giới Vương Tinh
占卜婆婆=Bà Bói
云泽比特高地=Cao nguyên Yunzabit
孙布拉=Son Bra
界王神界=Giới Vương Thần Giới
凯琳塔=Tháp Karin
超级赛亚人2全能量=Siêu Xayda cấp 2 toàn năng lượng
微小沙鲁=Tiểu Cell
龙珠战士=Chiến binh Rồng Thần
魔界之王达普拉=Dabura, Vua Ma Giới
超级赛亚人2=Super Saiyan 2
魔界之王=Ma Giới Chi Vương
D员=Đảng viên
普依=Pui Pui
力量神=Thần Sức Mạnh
全天冲击波=Full-Day Impact Wave
超红赛亚人=Super Saiyan God
超蓝赛亚人=Super Saiyan Blue
东银河=Ngân Hà Đông
梅菲拉达高塔=Tháp Mephilada
赛菲=Saiyan
阿斯卡莉军团=Quân đoàn Ascari
美达摩尔星=Hành tinh Metamor
琉树星=Hành tinh Ryuju
拉姿丽=Lazuli
青藤星=Hành tinh Thanh Đằng
拉彼斯=Lapis
罗岚=La Lan
灭神星=Hành tinh Diệt Thần
界王神福瓦=Kaioshin Fuwa
超级龙珠=Ngọc Rồng Siêu Cấp
蓝发兰琪=Launch tóc xanh
第六宇宙=Vũ trụ thứ 6
超级赛亚人全能量形态=Super Saiyan Full Power
超爆弹=Omega Blaster
神击=God Impact
自在极境=Bản năng vô cực - Ultra Instinct
自在兆境=Dấu hiệu của Bản năng vô cực - Ultra Instinct Sign
北银河=Ngân Hà phía Bắc
克鲁德王=King Cold
亚尔培王=King Arale
娜美克星人=Người Namek
宇宙恶魔=Ác quỷ vũ trụ
普益=Pui Pui
银河巡警=Tuần tra viên Ngân Hà
银河佣兵=Lính đánh thuê Ngân Hà
赛菲势力=Thế lực Saiyan
沙拉达行星=Hành tinh Salad
布里夫斯博士=Tiến sĩ Brief
魔神摩蒙曼=Ma Thần Moominman
超级赛亚人3=Siêu Saiyan cấp 3
