100150=100150
2150=2150
AgitΩ=Agito
Arcle=Arcle
CD=CD
Daguba=Daguba
Daguva=Daguva
FY1=FY1
Gurongi=Gurongi
Henshin=Henshin
Kuuga=Kuuga
Tả Chưởng Môn=Tả Chưởng Môn
What’s the f**k=What’s the f**k
daguba=Daguba
daguva=Daguva
diss=diss
henshin=henshin
joker=joker
kuuga=kuuga
pua=PUA
qinggong=Thanh Công
‘牙’字=【 nha 】 tự
《山溪剑法》=《Sơn Khê Kiếm Pháp》
《药王经》=Kinh Dược Vương
《青城五门会盟四条》=Bốn điều của Hội minh Ngũ Môn Thanh Thành
一、二级=cấp 1, 2
一个大目标=một cái đại mục tiêu
一人之下，万人之上=dưới một người, trên vạn người
一代妖帝=Nhất Đại Yêu Đế
一剑断天=Nhất Kiếm Đoạn Thiên
一剑断天楚断=Nhất Kiếm Đoạn Thiên Sở Đoạn
一剑西来=Nhất Kiếm Tây Lai
一剑飞花=Nhất Kiếm Phi Hoa
一半一半=5—5
一双儿女=một đôi nhi nữ
一叶剑法=Nhất Diệp Kiếm Pháp
一叶灵剑=Nhất Diệp Linh Kiếm
一叶知秋=Nhất Diệp Tri Thu
一字电剑=Nhất Tự Điện Kiếm
一定要得到=nhất định phải lấy được
一尊大佛=một tôn đại phật
一指之禅=Nhất Chỉ Chi Thiền
一昧真火=Nhất Vị Chân Hỏa
一月寒梅杀=Nhất Nguyệt Hàn Mai Sát
一月梅花寒=Nhất Nguyệt Mai Hoa Hàn
一气日月流星掷=Nhất Khí Nhật Nguyệt Lưu Tinh Trịch
一气朝阳剑=Nhất Khí Triều Dương Kiếm
一点纯阳在心中，万法自在手中掌=Nhất điểm Thuần Dương tại trong tâm, Vạn pháp tự tại trong tay chưởng
一片云雾=một đám vân vụ
一片冰心向玉壶=Nhất Phiến Băng Tâm Hướng Ngọc Hồ
一直蹦=một mực nhảy
一线牵=Nhất Tuyến Khiên
一阶法术略=nhất giai pháp thuật lược
一顿=một trận¦một bữa¦một chầu¦một lần¦một hồi¦cùng¦cùng nhau¦một chầu¦cho ăn¦ngừng lại¦ngừng một lát¦một chầu¦dừng lại¦ngừng lại
一鸣剑=Nhất Minh Kiếm
一鹤灵剑=Nhất Hạc Linh Kiếm
一龙=nhất long
一龙之力=nhất long chi lực
丁乘风=Đinh Thừa Phong
丁公子=Đinh công tử
丁双=Đinh Song
丁海=Đinh Hải
丁灵中=Đinh Linh Trung
丁白云=Đinh Bạch Vân
七分舵=bảy phân đà
七十三种=73 loại
七十三般绝技=Bảy mươi ba tuyệt kỹ
七十余丈远=cách đó hơn 70 trượng
七十点的=70 điểm
七国国战=Thất Quốc Quốc Chiến
七大系法术=Thất Đại Hệ Pháp Thuật
七妙人=Thất Diệu Nhân
七子=Thất Tử
七宝真君=Thất Bảo Chân Quân
七宝真君赵求一=Thất Bảo Chân Quân Triệu Cầu Nhất
七巧书生=Thất Xảo Thư Sinh
七巧锁心剑=Thất Xảo Tỏa Tâm Kiếm
七情七伤剑法=Thất Tình Thất Thương Kiếm Pháp
七星七绝剑法=Thất Tinh Thất Tuyệt Kiếm Pháp
七星剑阵=Thất Tinh Kiếm Trận
七月流火=Thất Nguyệt Lưu Hỏa
七杀星宿毒=Thất Sát Tinh Tú Độc
七杀星宿海=Thất Sát Tinh Tú Hải
七步响尾壁蛇=Xà vách đuôi chuông bảy bước
七步响尾壁龙=Thất Bộ Hưởng Vĩ Bích Long
七绝上人=Thất Tuyệt thượng nhân
七舍=thất xá
七色长生果=Thất Sắc Trường Sinh Quả
七阶=Bậc bảy
万世剑师=Vạn Thế Kiếm Sư
万剑诀=Vạn Kiếm Quyết
万剑轮回=Vạn Kiếm Luân Hồi
万剑轮回大阵=Vạn Kiếm Luân Hồi Đại Trận
万剑阵图=Vạn Kiếm Trận Đồ
万土之刺=Vạn Thổ Chi Thứ
万土屏障=Vạn Thổ Bình Chướng
万大平=Vạn Đại Bình
万战棍法=Vạn Chiến Côn Pháp
万招洞=Vạn Chiêu Động
万春流=Vạn Xuân Lưu
万棍朝天=Vạn Côn Triều Thiên
万毒之蛟=Vạn Độc Chi Giao
万毒寒光障=Vạn Độc Hàn Quang chướng
万毒彩虫=Vạn Độc Thải Trùng
万毒洞=Vạn Độc Động
万毒王蛇=Vạn Độc Vương Xà
万清王=Vạn Thanh Vương
万火在心=Vạn Hỏa tại tâm
万琦=Vạn Kỳ
万般杀气=Vạn Bàn Sát Khí
万良=Vạn Lương
万花剑法=Vạn Hoa Kiếm Pháp
万蛇化龙心法=Vạn Xà Hóa Long Tâm Pháp
万蛇圣地=Vạn Xà Thánh Địa
万蛇山庄=Vạn Xà Sơn Trang
万蝠林=Vạn Dơi Lâm
万血邪身=Vạn Huyết Tà Thân
万象阁=Vạn Tượng Các
万载凝冰=Vạn Tải Ngưng Băng
万载寒铁=Vạn Tải Hàn Thiết
万邪血身=Vạn Tà Huyết Thân
万马堂=Vạn Mã đường
万龙归宗=Vạn Long Quy Tông
丈人山=Trượng Nhân Sơn
三万三千六百五十九根白眉针=Ba vạn ba ngàn ba trăm năm mươi chín cây Bạch Mi Châm
三五十丈=ba mươi năm mươi trượng
三佛琉璃塔=Tam Phật Lưu Ly Tháp
三光=Tam Quang
三光公子=Tam Quang Công Tử
三光少主=Tam Quang Thiếu Chủ
三十六张上古符咒=Ba mươi sáu tấm thượng cổ phù chú
三十天才培养计划=Kế hoạch Bồi dưỡng 30 Thiên Tài
三千大道=Tam Thiên Đại Đạo
三坛会海=Tam Đàn Hội Hải
三坛会海大神=Tam Đàn Hội Hải Đại Thần
三姊妹峰=Tam Tỷ Muội Phong
三宗=Tam Tông
三宗之乱=Tam Tông Chi Loạn
三宗五峰=Tam Tông Ngũ Phong
三尺青锋=Tam Xích Thanh Phong
三才剑阵=Tam Tài Kiếm Trận
三杀剑仙=Tam Sát Kiếm Tiên
三极归一=Tam Cực Quy Nhất
三清=Tam Thanh
三湘=Tam Tương
三环水域=Tam Hoàn Thủy Vực
三绝=tam tuyệt
三道长剑=Tam đạo trường kiếm
三重佛塔=Tam Trọng Phật Tháp
上人级=Thượng Nhân Cấp
上升期=tăng lên giai đoạn
上原始=bên trên nguyên thủy
上古水猿=Thượng Cổ Thủy Viên
上古火蛛=Thượng Cổ Hỏa Chu
上古神龙=Thượng Cổ Thần Long
上古魔神血剑劈天法=Thượng Cổ Ma Thần Huyết Kiếm Phách Thiên Pháp
上善若水=Thượng Thiện Nhược Thủy
上天不仁=thượng thiên bất nhân
上头的命令=cấp trên mệnh lệnh
上官丹凤=Thượng Quan Đan Phượng
上官府=Thượng Quan Phủ
上官木=Thượng Quan Mộc
上官金虹=Thượng Quan Kim Hồng
上官青=Thượng Quan Thanh
上官飞=Thượng Quan Phi
上官飞燕=Thượng Quan Phi Yến
上林苑=Thượng Lâm Uyển
上清宫圣灯亭=Thượng Thanh Cung Thánh Đăng Đình
上清神光=Thượng Thanh thần quang
上进阶=thượng tiến giai
下品灵石=Hạ Phẩm Linh Thạch
下雨了=trời mưa
不下=không dưới
不不不=không không không
不入地狱=không xuống địa ngục
不再那么=không còn như vậy
不学不学=không học không học
不小幅度=không nhỏ biên độ
不怎么好=không hề tốt đẹp gì
不想出现=không muốn xuất hiện
不死地=Bất Tử Địa
不死文明之主=Bất Tử Văn Minh Chi Chủ
不死果=Bất Tử Quả
不死树=Bất Tử Thụ
不死药=Bất Tử Dược
不用求=không cần cầu
不等=phạm vi
不老神泉=Bất Lão Thần Tuyền
与我家传=cùng ta gia truyền
世上=trên đời
丘独=Khâu Độc
丙火真雷=Bính Hỏa Chân Lôi
东亭阁=Đông Đình các
东南=Đông Nam
东境=Đông Cảnh
东大街=Đông Đại Nhai
东大门=Đông Đại Môn
东峰=Đông Phong
东峰八剑仙=Đông Phong Bát Kiếm Tiên
东峰朝阳峰=Đông Phong Triều Dương Phong
东方七十二卫=Đông Phương Thất Thập Nhị Vệ
东方叔叔=Đông Phương thúc thúc
东方妖=Đông Phương Yêu
东方独=Đông Phương Độc
东林镇=Đông Lâm trấn
东海=Đông Hải
东海玉箫=Đông Hải Ngọc Tiêu
东蒙=Đông Mông
东陆县=Đông Lục Huyện
丝帕=Khăn lụa
丢了=ném¦mất tích¦đã đánh mất¦ném¦làm mất đi¦mất đi¦ném đi¦vứt đi¦mất rồi
两=lượng
两个窟窿=hai cái lỗ thủng
两人的头=đầu của hai người
两人的气息=hai người khí tức
两仪微尘生死大阵=Lưỡng Nghi Vi Trần Sinh Tử Đại Trận
两大妖皇=Lưỡng Đại Yêu Hoàng
两天照顾=hai ngày chiếu cố
两岸猿声啼不住=Hai bờ vượn kêu không dứt
两岸猿声蹄不住=Lưỡng Ngạn Viên Thanh Đề Bất Trụ
两江会馆=Lưỡng Giang hội quán
两饷=hai mức lương
严于=Nghiêm Vu
严立本=Nghiêm Lập Bản
严重的伤势=nghiêm trọng thương thế
个大目标=cái đại mục tiêu
中一股=bên trong một cỗ
中举行=bên trong cử hành
中低层=trung hạ tầng
中原八义=Trung Nguyên Bát Nghĩa
中原剑仙=Trung Nguyên Kiếm Tiên
中原地带=Trung Nguyên Địa Đới
中品灵石=Trung Phẩm Linh Thạch
中土=Trung Thổ
中天灵剑=Trung Thiên Linh Kiếm
中央天朝=Trung Ương Thiên Triều
中峰=Trung Phong
中庸=Trung Dung
中庸广场=Trung Dung Quảng Trường
中正剑=Trung Chính Kiếm
中正和平斋=Trung Chính Hòa Bình Trai
中正平和斋=Trung Chính Bình Hòa Trai
中用多=có ích nhiều
中秋=Trung Thu
丹方的=đan phương
丹梯=Đan Thê
丹药文明=Đan Dược Văn Minh
为什么大哥=vì sao đại ca
主人=chủ nhân
主角模板=nhân vật chính mô bản
乃父之风=chính phụ chi phong
义愤填膺的=lòng đầy căm phẫn
之低微=thấp kém
之力的=chi lực
之大乐=niềm vui lớn lao
之敌手=địch thủ
乌云踏雪=Ô Vân Đạp Tuyết
乌鞘=Ô Sao
乐于=Nhạc Vu
乐厚=Nhạc Hậu
乐天黄酒=Lạc Thiên Hoàng Tửu
乐山大佛=Lạc Sơn Đại Phật
乔冷=Kiều Lãnh
乔峰=Kiều Phong
乔思陆=Kiều Tư Lục
乔耿=Kiều Cảnh
乔良=Kiều Lương
乔飞渡=Kiều Phi Độ
九代剑仙=Cửu Đại Kiếm Tiên
九代长老=Cửu Đại Trưởng Lão
九华七剑=Cửu Hoa Thất Kiếm
九华丹=Cửu Hoa Đan
九华仙门=Cửu Hoa Tiên Môn
九华地狱=Cửu Hoa Địa Ngục
九华山=Cửu Hoa Sơn
九华峰=Cửu Hoa Phong
九天十地一千九百神针=Cửu Thiên Thập Địa Nhất Thiên Cửu Bách Thần Châm
九天十地破魔神梭=Cửu Thiên Thập Địa Phá Ma Thần Toa
九天十地齐毒血河=Cửu Thiên Thập Địa Tề Độc Huyết Hà
九天玄经=Cửu Thiên Huyền Kinh
九天碧霄雷电术=Cửu Thiên Bích Tiêu Lôi Điện Thuật
九天罡风=Cửu Thiên Cương Phong
九天都篆神雷大法=Cửu Thiên Đô Triện Thần Lôi Đại Pháp
九宫剑阵=Cửu Cung Kiếm Trận
九幽阴气=Cửu U Âm Khí
九弦无形剑=Cửu Huyền Vô Hình Kiếm
九弦无形剑气=Cửu huyền vô hình kiếm khí
九折九转=cửu chiết cửu chuyển
九象九虎=cửu tượng cửu hổ
九重水瀑布=Cửu Trọng Thủy Bộc Bố
九阳功=Cửu Dương Công
九阳大法=Cửu Dương Đại Pháp
九阶=Bậc chín
九雷轰顶=Cửu Lôi Oanh Đỉnh
九鬼血魔于子禁=Cửu Quỷ Huyết Ma Vu Tử Cấm
九龙游山河=cửu long du sơn hà
乡绅=hương thân
书剑于丹青=Thư Kiếm Vu Đan Thanh
书卫=Thư Vệ
书香世家=thư hương thế gia
乾坤戒=Nhẫn Không Gian
了望法术=Pháp thuật nhìn xa
二十招之内=trong vòng 20 chiêu
二千岁境=Nhị Thiên Tuế Cảnh
二头鲍=Bào ngư hai đầu
于人豪=Vu Nhân Hào
于化物=Vu Hóa Vật
于机子=Vu Cơ Tử
于机悠=Vu Cơ Du
于清瓜=Vu Thanh Qua
于雄天=Vu Hùng Thiên
云中子秘卷=Vân Trung Tử Bí Quyển
云之剑意=Vân Chi Kiếm Ý
云兔=Vân Thỏ
云兽=Vân Thú
云剑龙=Vân Kiếm Long
云台之峰=Vân Đài Chi Phong
云州=Vân châu
云平=Vân Bình
云狐=Vân Hồ
云狗=Vân Cẩu
云狮=Vân Sư
云狼=Vân Lang
云猫=Vân Miêu
云生云灭=Vân Sinh Vân Diệt
云系=Vân Hệ
云系云虎=Vân Hệ Vân Hổ
云系剑法=Vân Hệ Kiếm Pháp
云系心法=Vân Hệ Tâm Pháp
云系灵兽=Linh thú hệ Mây
云膳殿=Vân Thiện Điện
云舒云卷=Vân Thư Vân Quyển
云舒云展=vân thư vân triển
云萌=Vân Manh
云虎=Vân Hổ
云蛟=Vân Giao
云袖雪=Vân Tụ Tuyết
云谷=Vân Cốc
云逸=Vân Dật
云阳府=Vân Dương phủ
云阳谷=Vân Dương Cốc
云雾宫=Vân Vụ Cung
云雾宫云膳殿=Vân Vụ Cung Vân Thiện Điện
云雾心经=Vân Vụ Tâm Kinh
云雾茶庄=Vân Vụ trà trang
云雾重重=Vân Vụ Trùng Trùng
云雾雨蒙蒙=Vân Vụ Vũ Mông Mông
云霞防御法罩=Vân Hà Phòng Ngự Pháp Tráo
云鲸=Vân Kình
云龙十变=Vân Long Thập Biến
云龙十变心法=Vân Long Thập Biến Tâm Pháp
云龙变=Vân Long Biến
云龙心法=Vân Long Tâm Pháp
云龙殿=Điện Vân Long
云龙第八变椒图变=Vân Long Đệ Bát Biến Tiêu Đồ Biến
五、百六=Năm, sáu trăm
五个十=Năm mươi
五仙盟=Ngũ Tiên minh
五仙门=Ngũ Tiên Môn
五六倍之多=nhiều gấp 5-6 lần
五分舵=Ngũ phân đà
五十六间=năm mươi sáu gian
五台山=Ngũ Đài sơn
五大仙门=Ngũ Đại Tiên Môn
五大夫剑=Ngũ Đại Phu Kiếm
五大妖侯=Ngũ Đại Yêu Hầu
五太五德拳=Ngũ Thái Ngũ Đức Quyền
五好青年=năm tốt thanh niên
五子峰=Ngũ Tử Phong
五宝=Ngũ Bảo
五宝道人=Ngũ Bảo Đạo Nhân
五山会盟=Ngũ Sơn Hội Minh
五峰=Ngũ Phong
五峰大比=Ngũ Phong Đại Tỷ
五巧灵珑心=Ngũ Xảo Linh Lung Tâm
五帝=Ngũ Đế
五帝五皇剑道=Ngũ Đế Ngũ Hoàng Kiếm Đạo
五帝五皇轮回剑道=Ngũ Đế Ngũ Hoàng Luân Hồi Kiếm Đạo
五帝全道=Ngũ Đế Toàn Đạo
五帝剑=Ngũ Đế Kiếm
五帝剑道=Ngũ Đế Kiếm Đạo
五帝华盖=Ngũ Đế Hoa Cái
五帝轮回=Ngũ Đế Luân Hồi
五帝轮回剑道=Ngũ Đế Luân Hồi Kiếm Đạo
五月草长莺飞剑法=Ngũ Nguyệt Thảo Trường Oanh Phi Kiếm Pháp
五毒天水=Ngũ Độc Thiên Thủy
五淫神魔阵=Ngũ Dâm Thần Ma Trận
五火七禽功法=Ngũ Hỏa Thất Cầm Công Pháp
五皇剑道=Ngũ Hoàng Kiếm Đạo
五皇轮回剑道=Ngũ Hoàng Luân Hồi Kiếm Đạo
五绝神功=Ngũ Tuyệt Thần Công
五色剑道=Ngũ Sắc Kiếm Đạo
五色劫云=Ngũ Sắc Kiếp Vân
五色劫云丹=Ngũ Sắc Kiếp Vân Đan
五色华盖=Ngũ Sắc Hoa Cái
五色洞=Ngũ Sắc Động
五色轮回剑道=Ngũ Sắc Luân Hồi Kiếm Đạo
五色门=Ngũ Sắc Môn
五虎断门刀=Ngũ Hổ Đoạn Môn Đao
五行剑意=Ngũ Hành Kiếm Ý
五行剑道=Ngũ Hành Kiếm Đạo
五行妖侯=Ngũ Hành Yêu Hầu
五行相畏=Ngũ hành tương úy
五行轮回=Ngũ Hành Luân Hồi
五行轮回剑道=Ngũ Hành Luân Hồi Kiếm Đạo
五轮宫=Ngũ Luân Cung
五轮殿=Ngũ Luân Điện
五连峰=Ngũ Liên Phong
五重佛塔=Ngũ Trọng Phật Tháp
五门会盟=Ngũ Môn Hội Minh
五霄御雷真诀=Ngũ Tiêu Ngự Lôi Chân Quyết
亚古鲁=Arcle
亚奇=Archie
亚玛达姆=Amadam
些大=
些大道=chút ít đại đạo
交好自己=giao hảo chính mình
亭儿=Đình nhi
亲翰门=Thân Hàn Môn
人剑合一=Nhân Kiếm Hợp Nhất
人剑魂=Nhân Kiếm Hồn
人大上=nhân lớn hơn
人妖混合室=Nhân Yêu Hỗn Hợp Thất
人小心翼翼=nhân cẩn thận dè dặt
人生百年如白驹=Nhân sinh bách niên như bạch câu
人的意思=nhân ý tứ
人的气息=người khí tức
人的身份= nhân thân phận
人皮画卷=bức tranh da người
人间美味=nhân gian mỹ vị
仅有的=chỉ có
仈 Jiǔ 不离十了=tám chín phần mười
从母豹=từ báo cái
仓颉=Thương Hiệt
他不等=hắn không đợi
仙中大罗金仙=Tiên Trung Đại La Kim Tiên
仙之文明=Văn minh tiên
仙人桥=Tiên Nhân Kiều
仙华=Tiên Hoa
仙华一峰=Tiên Hoa nhất phong
仙华峰=Tiên Hoa Phong
仙古文明=Tiên Cổ Văn Minh
仙古文明之主=Tiên Cổ Văn Minh Chi Chủ
仙子香=Tiên Tử Hương
仙学院=Tiên viện
仙掌=Tiên Chưởng
仙掌平台=Tiên Chưởng Bình Đài
仙掌平地=Tiên Chưởng Bình Địa
仙桥天乐=Tiên Kiều Thiên Nhạc
仙灵岛=Tiên Linh Đảo
仙灵石=Tiên Linh Thạch
仙锻=Tiên Đốn
仙门=Tiên Môn
仙露=Tiên Lộ
代掌门=Đại Chưởng Môn
令东来=Lệnh Đông Lai
令师妹=Lệnh Sư Muội
令狐冲=Lệnh Hồ Xung
以服众=lấy phục chúng
以武立国=dùng võ lập quốc
以狠斗狠=lấy ngoan đấu ngoan
以直报怨=dĩ trực báo oán
仰天池=Ngưỡng Thiên Trì
任务楼=Nhiệm Vụ Lâu
任教主=Nhậm giáo chủ
任晴雨=Nhậm Tình Vũ
任独=Nhậm Độc
任碧凝=Nhậm Bích Ngưng
伊哭=Y Khốc
伊夜哭=Y Dạ Khốc
伍云氏=Ngũ Vân Thị
伍召=Ngũ Triệu
伍子胥=Ngũ Tử Tư
伍门=Ngũ Môn
伏骞=Phục Khiên
众人心=đám người tâm
会一直在=sẽ một mực tại
伞骨中藏剑=tán cốt trung tàng kiếm
伸缩灵剑=Thân Súc Linh Kiếm
似梦非梦浑天照鉴大法=Tựa Mộng Phi Mộng Hồn Thiên Chiếu Giám Đại Pháp
但是对于=nhưng đối với
位男子=vị nam tử
何以服众=làm sao phục chúng
何烽街=Hà Phong đường phố
何长风=Hà Trường Phong
余杭镇=Dư Hàng Trấn
佛古文明=Phật Cổ Văn Minh
佛古文明之主=Phật Cổ Văn Minh Chi Chủ
佛宝=Phật Bảo
使多大的=dùng bao nhiêu
使用兵刃=sử dụng binh khí
侠客行剑法=Hiệp Khách Hành Kiếm Pháp
便切得=liền cắt đến
便可以了=liền có thể
保定府=Bảo Định phủ
俞清岱=Du Thanh Đại
俞清臣=Du Thanh Thần
俞清舟=Du Thanh Chu
修仙家族=tu tiên gia tộc
修仙界=giới tu tiên
修仙记=tu tiên ký
修出=tu ra
修炼成精=tu luyện thành tinh
修罗=Tu La
修罗袋=Tu La Đại
修罗角=Tu La Giác
修罗骨刀=Tu La Cốt Đao
修补神魂=tu bổ thần hồn
候人雄=Hầu Nhân Hùng
候兄=Hầu huynh
倚天国=Ỷ Thiên Quốc
倩女幽魂=Thiến Nữ U Hồn
假面骑士=Kamen Rider
假龙伏壁=Giả Long Phục Bích
做哥哥的=làm ca ca
傀儡令=Lệnh Khôi Lỗi
傀儡术=Thuật khôi lỗi
傅冲=Phó Xung
傅浩=Phó Hạo
傅鹰=Phó Ưng
傲寒六诀=Ngạo Hàn Lục Quyết
儒之文明=Nho Chi Văn Minh
元————凌————=Nguyên————Lăng————
元元=Nguyên Nguyên
元元上人=Nguyên Nguyên Thượng Nhân
元元师伯=Nguyên Nguyên sư bá
元元师兄=Nguyên Nguyên sư huynh
元凌=Nguyên Lăng
元凌上人=Nguyên Lăng Thượng Nhân
元凌山=Nguyên Lăng Sơn
元国=Nguyên Quốc
元始九印=Nguyên Thủy Cửu Ấn
元始天尊=Nguyên Thủy Thiên Tôn
元始太初=Nguyên Thủy Thái Sơ
元始昆仑印=Nguyên Thủy Côn Luân Ấn
元始洞玄篇=Nguyên Thủy Động Huyền Thiên
元始灵剑=Nguyên Thủy Linh Kiếm
元婴主宰=Nguyên Anh Chủ Tể
元婴化生=Nguyên Anh hóa sinh
元晋=Nguyên Tấn
元神=Nguyên Thần
元阳=Nguyên Dương
元阳上人=Nguyên Dương Thượng Nhân
元阳师伯=Nguyên Dương Sư Bá
先天元磁微尘针=Tiên Thiên Nguyên Từ Vi Trần Châm
先天道体=Tiên Thiên Đạo Thể
光明=Quang Minh
光明妖皇=Quang Minh Yêu Hoàng
光明妖皇方邪=Quang Minh Yêu Hoàng Phương Tà
光明顶光明宫=Quang Minh Đỉnh Quang Minh Cung
光线=tia sáng¦ánh sáng
光芒=quang mang
光辉与神的儿女=Quang Huy dữ Thần đích nhi nữ
光雨=quang vũ
入微=Nhập Vi
全真=Toàn Chân
八哥身上=chim sáo trên thân
八百里流沙界，三千弱水深，万物入得其中来，任你天神不能回=Tám trăm dặm Lưu Sa giới, ba ngàn Nhược Thủy sâu thẳm, vạn vật vào được trong đó, mặc cho thiên thần cũng không thể trở về.
八翼身法=Bát Dực Thân Pháp
八阶=Bậc tám
公子少爷=công tử thiếu gia
公子羽=Công Tử Vũ
公孙兰=Công Tôn Lan
公孙摩云=Công Tôn Ma Vân
公孙断=Công Tôn Đoạn
公孙雨=Công Tôn Vũ
公羊慈=Công Dương Từ
六人=sáu người
六大天之御帝=Lục Đại Thiên Chi Ngự Đế
六扇门=Lục Phiến Môn
六捆=sáu bó
六绝=lục tuyệt
六绝剑=Lục Tuyệt Kiếm
六翼金蚕=Lục Dực Kim Tàm
六翼金蚕蛊=Lục Dực Kim Tàm Cổ
六芒之阵=Lục Mang Chi Trận
六象=lục tượng
六道水系剑意=Lục Đạo Thủy Hệ Kiếm Ý
六铁则剑圣=Lục Thiết Tắc Kiếm Thánh
兰亭序=Lan Đình Tự
兰花阁=Lan Hoa các
关中=Quan Trung
兴云庄=Hưng Vân trang¦Hưng Vân Trang
兴高采烈的=cao hứng bừng bừng
其上=bên trên đó
其中=trong đó
其人格=kỳ nhân cách
其它剑=cái khác kiếm
养吾=Dưỡng Ngô
养吾剑=Dưỡng Ngô Kiếm
养吾剑法=Dưỡng Ngô Kiếm Pháp
养吾剑灵=Dưỡng Ngô Kiếm Linh
养吾灵剑=Dưỡng Ngô Linh Kiếm
养法=Dưỡng Pháp
养法和尚=Dưỡng Pháp Hòa Thượng
养父母的安全=an toàn của cha mẹ nuôi
兽潮=thú triều
兽背上的=trên lưng thú
内修炼=nội tu luyện
内气境=nội khí cảnh
内罡境界=Nội Cương cảnh giới
内罡的境界=Nội Cương cảnh giới
冠仲=Quan Trọng
冥之极=Minh Chi Cực
冥八=Minh Bát
冥剑子=Minh Kiếm Tử
冥杖客=Minh Trượng Khách
冥笔翁=Minh Bút Ông
冬神玄冥=Đông Thần Huyền Minh
冬藏剑式=Đông Tàng Kiếm Thức
冯天雨=Phùng Thiên Vũ
冰之剑意=Băng Chi Kiếm Ý
冰冻三尺一日寒=Băng Đống Tam Xích Nhất Nhật Hàn
冰冻天霜冷长河=Băng Đống Thiên Sương Lãnh Trường Hà
冰天雪地无处藏=Băng Thiên Tuyết Địa Vô Xứ Tàng
冰寒剑仙=Băng Hàn Kiếm Tiên
冰封天地称王道=Băng Phong Thiên Địa Xưng Vương Đạo
冰山易倒山岳倾=Băng Sơn Dịch Đảo Sơn Nhạc Khuynh
冰极九重天剑法=Băng Cực Cửu Trọng Thiên Kiếm Pháp
冰极无双=Băng Cực Vô Song
冰湖=Băng Hồ
冰潜鸟=Băng Tiềm Điểu
冰痕累累中者伤=Băng Ngân Lũy Lũy Trung Giả Thương
冰祖=Băng Tổ
冰祖御冰化水之法=Băng Tổ Ngự Băng Hóa Thủy Chi Pháp
冰祖李冰=Băng Tổ Lý Băng
冰罩万里紫麟妖王=Băng Tráo Vạn Lý Tử Lân Yêu Vương
冰蛇=Băng Xà
冰蛟=Băng Giao
冲天灵剑=Xung Thiên Linh Kiếm
冲虚=Trùng Hư
冷寂=Lãnh Tịch
冷战=rùng mình¦ớn lạnh
冷血=Lãnh Huyết
冷雨四方=Lãnh Vũ Tứ Phương
冷香小筑=Lãnh Hương tiểu trúc
净乐宫=Tịnh Nhạc Cung
准仙帝=Chuẩn Tiên Đế
凌云=Lăng Vân
凌云洞=Lăng Vân Động
凌玉珠=Lăng Ngọc Châu
凌玉落=Lăng Ngọc Lạc
凌空=Lăng Không
凌落石=Lăng Lạc Thạch
凌驾灵剑=Lăng Giá Linh Kiếm
凝合灵兽诀=Ngưng Hợp Linh Thú Quyết
凝脂小公主=Tiểu công chúa Ngưng Chi
凡人之躯=phàm nhân chi khu
凡马=phàm mã
凤仪门=Phượng Nghi Môn
凤凰浴火诀=Phượng Hoàng Dục Hỏa Quyết
凤凰涅盘=Phượng Hoàng Niết Bàn
凤求凰=Phượng Cầu Hoàng
凤舞箭=Phượng Vũ Tiễn
凶姓=hung tính
凶猛的一塌糊涂=hung mãnh kinh khủng
凶龙=hung long
凸现出来=hiện rõ¦nổi bật lên
出云=Xuất Vân
出云七老=Xuất Vân Thất Lão
出云之试=Thử thách Xuất Vân
出云仙剑=Xuất Vân Tiên Kiếm
出云仙境=Xuất Vân Tiên Cảnh
出云剑阵=Kiếm trận Xuất Vân
出云无极大阵=Xuất Vân Vô Cực Đại Trận
出云无极结界=Xuất Vân Vô Cực Kết Giới
出云祖师=Xuất Vân Tổ Sư
出尔反尔了=nói một đằng làm một nẻo
刀羊=Đao Dương
刀难罗=Đao Nan La
刘改之=Lưu Cải Chi
刘晋元=Lưu Tấn Nguyên
刘沐=Lưu Mộc
刘过=Lưu Quá
刚才那样=vừa rồi dạng này
初得大道=Sơ Đắc Đại Đạo
别赶=đừng đuổi
到中土=tới Trung Thổ
到手的猎物=tới tay con mồi¦con mồi tới tay
刺天峰=Thứ Thiên Phong
刺头儿=cái của nợ
前阴=tiền âm
剑主=Kiếm Chủ
剑之子=Kiếm Chi Tử
剑之文明=Kiếm Chi Văn Minh
剑仙=Kiếm Tiên
剑仙凌落石=Kiếm Tiên Lăng Lạc Thạch
剑仙秀之剑仙孙秀丽=Kiếm Tiên Tú Chi Kiếm Tiên Tôn Tú Lệ
剑侯=Kiếm Hầu
剑到架到=kiếm đặt ở
剑古文明=Kiếm Cổ Văn Minh
剑圣=Kiếm Thánh
剑圣境界=Kiếm Thánh cảnh giới
剑圣级=Kiếm Thánh cấp
剑宗=Kiếm Tông
剑宗叶秦=Kiếm Tông Diệp Tần
剑宗周鹤=Kiếm Tông Chu Hạc
剑师=Kiếm Sư
剑断天=Kiếm Đoạn Thiên
剑术一条龙=Kiếm Thuật Nhất Điều Long
剑术的才能=kiếm thuật tài năng
剑气=Kiếm khí
剑气三宗=Kiếm Khí Tam Tông
剑气令=Kiếm Khí Lệnh
剑气冲霄堂=Kiếm Khí Xung Tiêu Đường
剑气化罡术=Kiếm Khí Hóa Cương Thuật
剑气宗=Kiếm Khí Tông
剑流星剑法=Kiếm Lưu Tinh Kiếm Pháp
剑王=Kiếm Vương
剑王级=Kiếm Vương cấp
剑皇=Kiếm Hoàng
剑皇之境=Kiếm Hoàng Chi Cảnh
剑皇级=Kiếm Hoàng cấp
剑真=Kiếm Chân
剑神=Kiếm Thần
剑蛇=Kiếm Xà
剑贪=Kiếm Tham
剑贪凌云=Kiếm Tham Lăng Vân
剑道=Kiếm Đạo
剑道三昧=Kiếm Đạo Tam Muội
剑道修为=Kiếm Đạo Tu Vi
剑道室=Kiếm Đạo Thất
剑道无量术=Kiếm Đạo Vô Lượng Thuật
剑道明心典=Kiếm Đạo Minh Tâm Điển
剑长老=Kiếm Trưởng Lão
剑门=Kiếm Môn
剑门令=Kiếm Môn Lệnh
剑鹰=Kiếm Ưng
副掌门天丑老人=Phó chưởng môn Thiên Sửu Lão nhân
力摩智宗师=Lực Ma Trí Tông Sư
功夫高手=công phu cao thủ
动物八珍=Động vật bát trân
劲风扑面而来=kình phong đập vào mặt
劳子=Lao Tử
劳财=lao tài
勾魂摄心大法=Câu Hồn Nhiếp Tâm Đại Pháp
化功大法=Hóa Công Đại Pháp
化土乾元功=Hóa Thổ Càn Nguyên Công
化月=Hóa Nguyệt
化月道姑=Hóa Nguyệt Đạo Cô
化海镇眼流泉宝塔=Hóa Hải Trấn Nhãn Lưu Tuyền Bảo Tháp
化玄冥法=Hóa Huyền Minh Pháp
化生三天=hóa sinh tam thiên
化蝶道人=Hóa Điệp Đạo Nhân
化血大法=Hóa Huyết Đại Pháp
化邪剑法=Hóa Tà Kiếm Pháp
化龙=Hóa Long
北凌山=Bắc Lăng Sơn
北境=Bắc Cảnh
北境大古国=Bắc Cảnh Đại Cổ Quốc
北大门=Bắc Đại Môn
北宫=Bắc Cung
北岳=Bắc Nhạc
北峰=Bắc Phong
北峰之主=Bắc Phong Chi Chủ
北峰之劫=Kiếp nạn Bắc Phong
北峰六剑仙=Bắc Phong Lục Kiếm Tiên
北峰秘剑云龙摆尾=Bắc Phong Bí Kiếm Vân Long Bãi Vĩ
北杨=Bắc Dương
北极万载寒冰=Bắc Cực Vạn Tải Hàn Băng
北极中天紫微天帝=Bắc Cực Trung Thiên Tử Vi Thiên Đế
北极寒青之冰=Bắc Cực Hàn Thanh Chi Băng
北海=Bắc Hải
匹狼=thớt lang
十万妖魔=Thập Vạn Yêu Ma
十三门恶阵=Thập Tam Môn Ác Trận
十代真传弟子=Đệ tử chân truyền đời thứ mười
十倍=mười lần¦gấp mười¦ thập bội¦gấp 10 lần¦gấp mười lần
十全大毒汤=Thập Toàn Đại Độc Thang
十全大补丹=Thập Toàn Đại Bổ Đan
十分堂=Thập Phân Đường
十大真传弟子=Thập Đại Chân Truyền Đệ Tử
十海酒=Thập Hải Tửu
十王=Thập Vương
十王剑=Thập Vương Kiếm
十王剑法=Thập Vương Kiếm Pháp
十王峰=Thập Vương Phong
十甲子神木劫=Thập Giáp Tử Thần Mộc Kiếp
十绝关=Thập Tuyệt Quan
十象=thập tượng
十象之力=thập tượng chi lực
十龙=thập long
千叶禅师=Thiên Diệp Thiền Sư
千年万毒蝎=Thiên Niên Vạn Độc Hạt
千年剑法=Thiên Niên Kiếm Pháp
千手罗刹=Thiên Thủ La Sát
千手菩提功=Thiên Thủ Bồ Đề Công
千秋血锁式=Thiên Thu Huyết Khóa Thức
千里江陵一日还=Thiên Lý Giang Lăng Nhất Nhật Hoàn
千重浪击卷=Thiên Trọng Lãng Kích Quyền
千雾剑仙莫垂垂=Thiên Vụ Kiếm Tiên Mạc Thùy Thùy
半步宗师=Bán Bộ Tông Sư
半蛟=Bán Giao
华国=Hoa Quốc
华山=Hoa Sơn
华山七十二路基础剑法=Hoa Sơn Thất Thập Nhị Lộ Cơ Sở Kiếm Pháp
华山三宗=Tam tông Hoa Sơn
华山东峰=Đông Phong Hoa Sơn
华山五峰=Hoa Sơn Ngũ Phong
华山仙门=Hoa Sơn Tiên Môn
华山剑宗=Hoa Sơn Kiếm Tông
华山剑气宗=Hoa Sơn Kiếm Khí Tông
华山剑法=Hoa Sơn Kiếm Pháp
华山北峰=Hoa Sơn Bắc Phong
华山北峰云台峰=Đỉnh Vân Đài, Bắc Phong, Hoa Sơn
华山北峰云龙心法=Hoa Sơn Bắc Phong Vân Long Tâm Pháp
华山基础七十二路剑=Hoa Sơn Cơ Sở Thất Thập Nhị Lộ Kiếm
华山气宗=Hoa Sơn Khí Tông
华山祖庭=Hoa Sơn Tổ Đình
华山陆掌门=Hoa Sơn Lục Chưởng Môn
华师兄=Hoa sư huynh
卓一航=Trác Nhất Hàng
卓不党=Trác Bất Đảng
卓凌云=Trác Lăng Vân
南冥大法=Nam Minh Đại Pháp
南冥逍遥法=Nam Minh Tiêu Dao Pháp
南境=Nam Cảnh
南境三国=Tam quốc Nam Cảnh
南境考核=Nam Cảnh Khảo Hạch
南大门=Nam Đại Môn
南天大侠=Nam Thiên đại hiệp
南宫倩=Nam Cung Thiến
南宫八剑=Nam Cung Bát Kiếm
南宫哲=Nam Cung Triết
南宫奇=Nam Cung Kỳ
南宫岳=Nam Cung Nhạc
南宫慧=Nam Cung Tuệ
南宫无伤=Nam Cung Vô Thương
南宫猎=Nam Cung Liệp
南宫白=Nam Cung Bạch
南山剑法=Nam Sơn Kiếm Pháp
南岩=Nam Nham
南岳=Nam Nhạc
南峰=Nam Phong
南明离火剑=Nam Minh Ly Hỏa Kiếm
南海=Nam Hải
南海一剑乔飞渡=Nam Hải Nhất Kiếm Kiều Phi Độ
南海上人=Nam Hải Thượng Nhân
南海仙门=Nam Hải Tiên Môn
南海剑斩玄冥子=Nam Hải Kiếm Trảm Huyền Minh Tử
南海剑法=Nam Hải Kiếm Pháp
南海剑首=Kiếm Thủ Nam Hải
南海玄冥仙门=Nam Hải Huyền Minh Tiên Môn
南海酿=Nam Hải Niệu
南秋=Nam Thu
南诏国=Nam Chiếu Quốc
博日剑=Bác Nhật Kiếm
卧薪剑法=Ngọa Tân Kiếm Pháp
卫悲=Vệ Bi
卫满涯=Vệ Mãn Nhai
印鱼=Ấn Ngư
压盖满了=áp đầy
原东峰八剑仙=Nguyên Đông Phong Bát Kiếm Tiên
原始洪荒=Nguyên Thủy Hồng Hoang
原随云=Nguyên Tùy Vân
去恼指=Khứ Não Chỉ
去烦恼指=Khứ Phiền Não Chỉ
去走私了=đi buônn lậu
参合灵剑=Tham Hợp Linh Kiếm
又来生意=lại có sinh ý
双枯血剑=Song Khô Huyết Kiếm
双枯道人=Song Khô Đạo Nhân
双门主=Song Môn Chủ
发现没有=không phát hiện
取水竹=ống tre lấy nước
受洗礼=thụ tẩy lễ
变得清晰起来=trở nên rõ ràng
口粗气=cái thở mạnh
古代文字=cổ đại văn tự
古墓国=Cổ Mộ Quốc
古墓国刘过=Cổ Mộ Quốc Lưu Quá
古朗基=Gurongi
古柏森森=Cổ Bách Sâm Sâm
古灵石=Cổ Linh Thạch
古秦=Cổ Tần
古秦国=Cổ Tần Quốc
古篆=Cổ Triện
古超=Cổ Siêu
古铜殿=Cổ Đồng Điện
古陶府=Cổ Đào Phủ
古龙=Cổ Long
古龙世界=Cổ Long thế giới
另一只手掌=một cái khác thủ chưởng
叫小= bảo tiểu
叫小舞，=kêu Tiểu Vũ
可危险=có thể nguy hiểm
史夫人=Sử phu nhân
史扬天=Sử Dương Thiên
史明廷=Sử Minh Đình
叶侯=Diệp Hầu
叶公=Diệp Công
叶圆=Diệp Viên
叶天=Diệp Thiên
叶孤城=Diệp Cô Thành
叶孤然=Diệp Cô Nhiên
叶师叔=Diệp Sư Thúc
叶平安=Diệp Bình An
叶开=Diệp Khai
叶开山=Diệp Khai Sơn
叶方=Diệp Phương
叶清一=Diệp Thanh Nhất
叶清顺=Diệp Thanh Thuận
叶狐=Diệp Hồ
叶秀珠=Diệp Tú Châu
叶笑=Diệp Tiếu
叶紫须=Diệp Tử Tu
叶阳融=Diệp Dương Dung
叶飞=Diệp Phi
叶香芝=Diệp Hương Chi
号水令=Hiệu Thủy Lệnh
司南=Tư Nam
司徒右=Tư Đồ Hữu
司徒左=Tư Đồ Tả
司徒红=Tư Đồ Hồng
司徒道馆=Tư Đồ Đạo Quán
司晨客=Ti Thần Khách
司赫=Tư Hách
司马博=Tư Mã Bác
司马师兄=Sima Sư Huynh
司马师弟=Tư Mã sư đệ
司马浩=Tư Mã Hạo
司马清贵=Tư Mã Thanh Quý
司马烟=Tư Mã Yên
司马长白=Tư Mã Trường Bạch
吃瘪了=ăn quả đắng
同人文=đồng nhân văn
名目繁多=Danh Mục Phồn Đa
后阴=hậu âm
向右使=Hướng hữu sứ
吕义=Lữ Nghĩa
吕凤先=Lữ Phụng Tiên
吕小树=Lữ Tiểu Thụ
君子剑=Quân Tử Kiếm
君子剑仙=Quân Tử Kiếm Tiên
君子剑方儒=Quân Tử Kiếm Phương Nho
君子剑法=Quân Tử Kiếm Pháp
君要臣死，臣不得不死=Quân muốn thần chết, thần không thể không chết
吞吐元气=Thôn Thổ Nguyên Khí
含难罗=Hàm Nan La
听雨小筑=Thính Vũ Tiểu Trúc
听雨小院=Thính Vũ Tiểu Viện
听风小院=Thính Phong tiểu viện
吴七=Ngô Thất
吴刚=Ngô Cương
吴子差=Ngô Tử Sai
吸星大法=Hấp Tinh Đại Pháp
告了个罪=cáo cái tội
员丘山=Viên Khâu Sơn
周中庸=Chu Trung Dung
周坦然=Chu Thản Nhiên
周天仪=Chu Thiên Nghi
周子衡=Chu Tử Hành
周师伯=Chu sư bá
周师叔祖=Chu Sư Thúc Tổ
周悟=Chu Ngộ
周李氏=Chu Lý thị
周润=Chu Nhuận
周清玄=Chu Thanh Huyền
周长发=Chu Trường Phát
味江恶龙=Vị Giang Ác Long
呵呵笑=cười ha ha
命剑魂=Mệnh Kiếm Hồn
命魂=Mệnh Hồn
和田七=và Điền Thất
和谐灵剑=Hài Hòa Linh Kiếm
咯咯=khanh khách
品会=phẩm hội
哈哈儿=Cáp Cáp Nhi
哪咤=Na Tra
唐兄=Đường huynh
唐国=Đường Quốc
唐天仪=Đường Thiên Nghi
唐天容=Đường Thiên Dung
唐天纵=Đường Thiên Tung
唐若悠=Đường Nhược Du
唐诗剑法=Đường Thi Kiếm Pháp
唐诗川=Đường Thi Xuyên
唯一道=duy nhất đạo
喜、怒、忧、思、悲、恐、惊=Hỉ, Nộ, Ưu, Tư, Bi, Khủng, Kinh
喜之剑意=Hỉ Chi Kiếm Ý
喝花酒=uống hoa tửu
嗷嗷叫着=ngao ngao kêu
嗷嗷的=ngao ngao
四大妖王=Tứ Đại Yêu Vương
四海来袭=Tứ Hải Lai Tập
四色妖王=Tứ Sắc Yêu Vương
四言诗剑=Tứ Ngôn Thi Kiếm
四象=Tứ Tượng
回云子=Hồi Vân Tử
回去之后=trở về sau khi
回锅肉=Thịt quay lại
回阳真水=hồi dương chân thủy
回风上人=Hồi Phong Thượng Nhân
回风舞柳剑=Hồi Phong Vũ Liễu Kiếm
回风落雁剑=Hồi Phong Lạc Nhạn Kiếm
回风落雁剑法=Hồi Phong Lạc Nhạn Kiếm Pháp
图纹=đồ văn
圆定=Viên Định
圆融剑仙=Viên Dung Kiếm Tiên
圆融剑仙叶阳融=Viên Dung Kiếm Tiên Diệp Dương Dung
圆融剑法=Viên Dung Kiếm Pháp
圆融灵剑=Viên Dung Linh Kiếm
土之剑=Kiếm Thổ Chi
土之剑意=Thổ Chi Kiếm Ý
土人=Thổ nhân
土元气=Thổ nguyên khí
土兵=Thổ binh
土兽=Thổ thú
土刀=Thổ đao
土刺=thổ thứ
土刺术=thổ thứ thuật
土剑=Thổ kiếm
土牛=Thổ ngưu
土狮=Thổ sư
土王令=Thổ Vương Lệnh
土皇=Thổ Hoàng
土皇剑道=Thổ Hoàng Kiếm Đạo
土系=Hệ Thổ
土系剑意=Thổ Hệ Kiếm Ý
土系法术=Pháp thuật hệ Thổ
土系灵兽=Thổ Hệ Linh Thú
土虎=Thổ hổ
土蛇=Thổ xà
土蝼=Thổ Lâu
土马=Thổ mã
土魔=Thổ Ma
土魔骨刺=Cốt thích Thổ Ma
圣国=Thánh Quốc
圣姑=Thánh Cô
圣帝=Thánh Đế
圣心诀=Thánh Tâm Quyết
圣母洞=Thánh Mẫu Động
圣皇=Thánh Hoàng
在不朽=tại bất hủ
在什么=tại cái gì
在催动=tại thôi động
在身=trên thân
在齐=đầy đủ
地仙之祖=Địa Tiên Chi Tổ
地剑=Địa Kiếm
地剑无对=Địa Kiếm Vô Đối
地剑无对周清玄=Địa Kiếm Vô Đối Chu Thanh Huyền
地剑魂=Địa Kiếm Hồn
地底妖魔=dưới mặt đất yêu ma
地底战剑=Địa Để Chiến Kiếm
地底战剑赵无极=Địa Để Chiến Kiếm Triệu Vô Cực
地底火山=núi lửa lòng đất
地术拳=Địa Thuật Quyền
地狱骑士=Địa Ngục Kỵ Sĩ
地腹火=Địa Phúc Hỏa
地行蜘蛛人=Địa Hành Tri Chu Nhân
地行蜘蛛人兵器=Vũ khí của người nhện hành địa
地行蜘蛛壳=Vỏ nhện hành địa
地长老=Địa Trưởng Lão
地门=Địa Môn
地魂=Địa Hồn
地龙=Địa Long
坏规矩=hư quy củ
垂暮剑仙=Thùy Mộ Kiếm Tiên
垂暮剑法=Thùy Mộ Kiếm Pháp
垂暮灵剑=Thùy Mộ Linh Kiếm
域外传送阵=Trận Truyền Tống Vực Ngoài
基础法术=trụ cột pháp thuật
堕地崖=Đọa Địa Nhai
堡城门=Bảo Thành môn
境州=Cảnh châu
墨竹妖王=Mặc Trúc Yêu Vương
夏侯星=Hạ Hầu Tinh
夏虫不知冰=Hạ Trùng Bất Tri Băng
外府=ngoại phủ
多大教=nhiều đại giáo
多快的=bao nhanh
多快的速度=bao nhiêu nhanh tốc độ
多情剑客=Đa Tình Kiếm Khách
多情剑客无情剑=Đa Tình Kiếm Khách Vô Tình Kiếm
多罗叶指=Đa La Diệp Chỉ
多谢大师=đa tạ đại sư
多财=đa tài
多财富=nhiều tài phú
夜叉=Dạ Xoa
夜帝剑法=Dạ Đế Kiếm Pháp
大上许多=lớn hơn rất nhiều
大不好=đại bất hảo
大五行剑气=Đại Ngũ Hành kiếm khí
大五行剑阵=Đại Ngũ Hành Kiếm Trận
大佛=Đại Phật
大元=Đại Nguyên
大元国=Đại Nguyên Quốc
大剑师=Đại Kiếm Sư
大力威怒金刚=Đại Lực Uy Nộ Kim Cương
大力金刚掌=Đại Lực Kim Cương Chưởng
大华国=Đại Hoa Quốc
大古一点红=Đại Cổ Nhất Điểm Hồng
大古国=Đại Cổ Quốc
大叶=Đại Diệp
大叶国=Đại Diệp Quốc
大吴=Đại Ngô
大吴国=Đại Ngô Quốc
大唐国=Đại Đường Quốc
大圆满=Đại Viên Mãn
大地化蛟=Đại Địa Hóa Giao
大地化蛟诀=Đại Địa Hóa Giao Quyết
大地君王=Đại Địa Quân Vương
大地抖动=đại địa run run
大地漩涡掌=Đại Địa Toàn Ốc Chưởng
大地苍牛=Đại Địa Thương Ngưu
大小周天=đại tiểu chu thiên
大希无形=Đại Hy Vô Hình
大平湖=Đại Bình hồ
大庸国=Đại Dung Quốc
大庸国主=Đại Dung Quốc Chủ
大庸城=Đại Dung Thành
大庸皇城=Hoàng thành Đại Dung
大恐惧=đại khủng bố
大手脚=đại thủ cước
大摔碑手=Đại Suất Bi Thủ
大无相功=Đại Vô Tướng Công
大日之极=Đại Nhật Chi Cực
大日剑=Đại Nhật Kiếm
大日剑仙=Đại Nhật Kiếm Tiên
大日剑意=Đại Nhật Kiếm Ý
大日剑法=Đại Nhật Kiếm Pháp
大日灵剑=Đại Nhật Linh Kiếm
大日炎炎=Đại Nhật Viêm Viêm
大日煌煌=Đại Nhật Hoàng Hoàng
大日降落=Đại Nhật Giáng Lạc
大昆仑=Đại Côn Luân
大易国=Đại Dịch Quốc
大晋=Đại Tấn
大晋国=Đại Tấn Quốc
大本源=đại bổn nguyên
大梦仙门=Đại Mộng Tiên Môn
大梦剑法=Đại Mộng Kiếm Pháp
大梦功法=Đại Mộng Công Pháp
大梦心法=Đại Mộng Tâm Pháp
大梦殿=Đại Mộng Điện
大梦真人=Đại Mộng Chân Nhân
大法华寺=Đại Pháp Hoa Tự
大法华寺七十二绝技=Đại Pháp Hoa Tự Thất Thập Nhị Tuyệt Kỹ
大法华师=Đại Pháp Hoa Sư
大法华式招式=Đại Pháp Hoa Thức Chiêu Thức
大法华虎爪手=Đại Pháp Hoa Hổ Trảo Thủ
大渡河=Đại Độ Hà
大灾=đại tai
大瑞国=Đại Thụy Quốc
大皱眉头=nhíu chặt lông mày
大神魂石=Đại Thần Hồn Thạch
大禅师=đại thiện sư
大秦=Đại Tần
大秦国=Đại Tần Quốc
大移穴法=Đại Di Huyệt Pháp
大紫阳手=Đại Tử Dương Thủ
大纪=Đại Kỉ
大老爸=Đại Lão Ba
大胃王=đại vị vương
大胡子=râu quai nón¦chòm râu dài¦đại hồ tử¦râu quai hàm¦râu ria rậm rạp¦râu rậm
大衍国=Đại Diễn quốc
大街上=đường cái bên trên
大越=Đại Việt
大越国=Đại Việt Quốc
大道境=Đại Đạo Cảnh
大道法则丹=Đại Đạo Pháp Tắc Đan
大金刚石=Đại Kim Cương Thạch
大闸蟹=Cua lông
大阿修罗=Đại A Tu La
大雄宝殿=Đại Hùng Bảo Điện
大雪山=Đại Tuyết Sơn
大雪山烂陀寺=Đại Tuyết Sơn Lạn Đà Tự
大食堂=đại thực đường
天、地、玄、黄=thiên , địa , huyền , hoàng
天下百姓=thiên hạ bách tính
天丑老人=Thiên Sửu Lão Nhân
天书=Thiên Thư
天关=Thiên Quan
天净之水=Thiên Tịnh Chi Thủy
天剑=Thiên Kiếm
天剑无双=Thiên Kiếm Vô Song
天剑魂=Thiên Kiếm Hồn
天台=Thiên Đài
天吃星=Thiên Cật Tinh
天啊=thiên a
天圆上人=Thiên Viên Thượng Nhân
天圆宗师=Thiên Viên Tông Sư
天地之中=thiên địa chi trung
天地之门=Thiên Địa Chi Môn
天地二魂=Thiên Địa Nhị Hồn
天地元气=Thiên Địa Nguyên Khí
天地命三魂=Thiên Địa Mệnh Tam Hồn
天地法则=Thiên Địa Pháp Tắc
天地法相=Thiên Địa Pháp Tướng
天外飞仙=Thiên Ngoại Phi Tiên
天大差距=thiên đại chênh lệch
天大恐惧=thiên đại khủng bố
天子剑法=Thiên Tử Kiếm Pháp
天子心法=Thiên Tử Tâm Pháp
天子酒=Thiên Tử Tửu
天尊木=Thiên Tôn Mộc
天尘哥哥=Thiên Trần ca ca
天山=Thiên Sơn
天山九阳手=Thiên Sơn Cửu Dương Thủ
天山剑法=Thiên Sơn Kiếm Pháp
天山折天手=Thiên Sơn Chiết Thiên Thủ
天峰=Thiên Phong
天师道教=Thiên Sư Đạo Giáo
天帝=Thiên Đế
天帝御阳=Thiên Đế Ngự Dương
天帝灭众仙=Thiên Đế Diệt Chúng Tiên
天庭=Thiên Đình
天心=Thiên Tâm
天悟石=Thiên Ngộ Thạch
天才楼=Lầu Thiên Tài
天星易变=Thiên Tinh Dịch Biến
天机仙门=Thiên Cơ Tiên Môn
天机妙算罗盘御敌法=Thiên Cơ Diệu Toán La Bàn Ngự Địch Pháp
天机散令=Thiên Cơ Tán Lệnh
天机斗数=Thiên Cơ Đấu Số
天权=Thiên Quyền
天权毒=Thiên Quyền Độc
天枢=Thiên Xu
天枢毒=Thiên Xu Độc
天柱=Thiên Trụ
天柱峰=Thiên Trụ Phong
天桥奇景=Thiên Kiều Kỳ Cảnh
天榜=Thiên Bảng
天残老人=Thiên Tàn Lão Nhân
天涯明月刀=Thiên Nhai Minh Nguyệt Đao
天灵圆满丹=Thiên Linh Viên Mãn Đan
天然防护罩=Thiên nhiên phòng hộ tráo
天牢=Thiên Lao
天王斩鬼刀=Thiên Vương Trảm Quỷ đao
天玑=Thiên Cơ
天玑位=Thiên Cơ Vị
天玑毒=Thiên Cơ Độc
天璇=Thiên Toàn
天璇毒=Thiên Toàn Độc
天生的=trời sinh
天界=Thiên Giới
天皇大帝=Thiên Hoàng Đại Đế
天禽=Thiên Cầm
天禽老人=Thiên Cầm lão nhân
天移地转=Thiên Di Địa Chuyển
天竺佛指=Thiên Trúc Phật Chỉ
天筑关=Thiên Trúc Quan
天绅倒悬=Thiên Thân Đảo Huyền
天罡星=Thiên Cương Tinh
天翻地覆大挪移身=Thiên Phiên Địa Phúc Đại Na Di Thân
天老爷=thiên lão gia
天花散花=Thiên Hoa Tán Hoa
天蝠=Thiên Dực
天蝠向东飞=Thiên Dực Hướng Đông Phi
天谴之地=Thiên Khiển Chi Địa
天长地久长春造化功=Thiên Trường Địa Cửu Trường Xuân Tạo Hóa Công
天青骓=Thiên Thanh Chuy
天音寺=Thiên Âm Tự
天魁星=Thiên Khôi Tinh
天魂=Thiên Hồn
天魔丹=Thiên Ma Đan
天魔乱世典=Thiên Ma Loạn Thế Điển
天魔血遁大法=Thiên Ma Huyết Độn Đại Pháp
天魔解体丹=Thiên Ma Giải Thể Đan
天魔阵=Thiên Ma Trận
天龙=Thiên Long
天龙八部=Thiên Long Bát Bộ
天龙化音灵剑=Thiên Long Hóa Âm Linh Kiếm
天龙雕=Thiên Long Điêu
太上太极拳=Thái Thượng Thái Cực Quyền
太上泉=Thái Thượng Tuyền
太乙混元气=Thái Ất Hỗn Nguyên Khí
太乙真人=Thái Ất Chân Nhân
太乙秘卷=Thái Ất Bí Quyển
太乙长生经=Thái Ất Trường Sinh Kinh
太初指=Thái Sơ Chỉ
太古=Thái Cổ
太和宫=Thái Hòa Cung
太和山=Thái Hòa Sơn
太大了=quá lớn
太子坡=Thái Tử Pha
太岁=Thái Tuế
太岳三青峰=Thái Nhạc Tam Thanh Phong
太极剑=Thái Cực Kiếm
太极剑法=Thái Cực Kiếm Pháp
太极玄清道=Thái Cực Huyền Thanh Đạo
太极神剑=Thái Cực Thần Kiếm
太湖=Hồ Thái
太白玄石=Thái Bạch Huyền Thạch
太白玄铁=Thái Bạch Huyền Thiết
太白陨石=Thái Bạch Vẫn Thạch
太白陨铁=Thái Bạch Vẫn Thiết
太行山=Thái Hành Sơn
太过猛=quá mức mạnh mẽ
太过猛烈=quá mức cường liệt
太阳元气=Thái Dương nguyên khí
太阳古经=Thái Dương Cổ Kinh
太阳星主=Thái Dương Tinh Chủ
太阴星主=Thái Âm Tinh Chủ
夫差=Phu Sai
头犀牛=đầu tê ngưu
头顶庆云=Đỉnh đầu khánh vân
夺命十三剑=Đoạt Mệnh Thập Tam Kiếm
夺命十三式=Đoạt Mệnh Thập Tam Thức
夺命连环三仙剑=Đoạt Mệnh Liên Hoàn Tam Tiên Kiếm
夺命金钱=đoạt mệnh kim tiền
夺天机=đoạt thiên cơ
奇变偶不变=kì biến ngẫu bất biến
奇门七绝剑阵=Kỳ Môn Thất Tuyệt Kiếm Trận
奉天之命，代天之夺，中央天朝，高天上圣大慈仁者玉皇大天尊玄穹高上帝=Phụng Thiên Chi Mệnh, Đại Thiên Chi Đoạt, Trung Ương Thiên Triều, Cao Thượng Thiên Thánh Đại Từ Nhân Giả Ngọc Hoàng Đại Thiên Tôn Huyền Khung Cao Thượng Đế
奔日飞剑=Bôn Nhật Phi Kiếm
奥萝尔=Auror
奥萝洛= Ororo
女娲=Nữ Oa
女皇女帝=Nữ Hoàng Nữ Đế
女菩萨=Nữ Bồ Tát
她玉手中=nàng ngọc thủ bên trong
她肉=nàng thịt
好哇=tốt a
好汉庄=Hảo Hán trang
好的丹炉=hảo đan lô
好龙仙门=Hảo Long Tiên Môn
好龙剑法=Hảo Long Kiếm Pháp
好龙心法=Hảo Long Tâm Pháp
如同高山上=như là cao sơn thượng
如日中升=Như Nhật Trung Thăng
如日中天=Như Nhật Trung Thiên
如日中天灵剑=Như Nhật Trung Thiên Linh Kiếm
如日初升=Như Nhật Sơ Thăng
如日灵剑=Như Nhật Linh Kiếm
如月=như trăng¦như nguyệt
妖侯=Yêu Hầu
妖国=Yêu Quốc
妖娆=yêu nhiêu
妖帝=Yêu Đế
妖火麒=Yêu Hỏa Kỳ
妖火麟=Yêu Hỏa Lân
妖狼=yêu lang
妖王=Yêu Vương
妖皇=Yêu Hoàng
妖魔=Yêu Ma
妖魔化猩周天转阵=Yêu Ma Hóa Tinh Chu Thiên Chuyển Trận
妖魔圣姑=Yêu Ma Thánh Cô
妖魔圣帝=Yêu Ma Thánh Đế
妖魔圣帝东方妖=Yêu Ma Thánh Đế Đông Phương Yêu
妖魔圣帝任独=Yêu Ma Thánh Đế Nhậm Độc
始之祖龙=Thủy Chi Tổ Long
姓淡泊=tính đạm bạc
威能=uy năng
威长征=Uy Trường Chinh
娘的=nương
嫁衣神功=Giá Y Thần Công
嫁衣魔功=Giá Y Ma Công
嫖=phiêu
嫦娥=Hằng Nga
嫸道人=Thiện đạo nhân
子母魔=Tử Mẫu Ma
子母鱼=Tử Mẫu Ngư
孙会=Tôn Hội
孙俊义=Tôn Tuấn Nghĩa
孙奎=Tôn Khuê
孙子兵法=Binh pháp Tôn Tử
孙子剑法=Tôn Tử Kiếm Pháp
孙定音=Tôn Định Âm
孙小红=Tôn Tiểu Hồng
孙师叔祖=Tôn sư thúc tổ
孙晨=Tôn Thần
孙有厚=Tôn Hữu Hậu
孙棠=Tôn Đường
孙武=Tôn Vũ
孙清池=Tôn Thanh Trì
孙秀丽=Tôn Tú Lệ
孙秀青=Tôn Tú Thanh
孙逵=Tôn Quỳ
孙驼子=Tôn Đà Tử¦Tôn đà tử
孟才=Mạnh Tài
孟晋=Mạnh Tấn
孟白=Mạnh Bạch
孟轻薇=Mạnh Khinh Vy
孤云子=Cô Vân Tử
孤云野鹤=Cô Vân Dã Hạc
孤云飘渺刺=Cô Vân Phiêu Miểu Thích
孤剑无名=Cô Kiếm Vô Danh
孤尘子=Cô Trần Tử
孤心剑=Cô Tâm Kiếm
孤心剑仙独孤叶=Cô Tâm Kiếm Tiên Độc Cô Diệp
孤心剑独孤叶=Cô Tâm Kiếm Độc Cô Diệp
学海=học hải
学海无涯=học hải vô nhai
孩子的身上=hài tử trên thân
宁天尘=Ninh Thiên Trần
宁子振=Ninh Tử Chấn
守之剑意=Thủ Chi Kiếm Ý
安然剑=An Nhiên Kiếm
安知=An Tri
宋仕君=Tống Sĩ Quân
宋冬夏=Tống Đông Hạ
宋别离=Tống Biệt Ly
宋剑九=Tống Kiếm Cửu
宋南山=Tống Nam Sơn
宋叔=Tống Thúc
宋大川=Tống Đại Xuyên
宋师叔=Tống Sư Thúc
宋悲风=Tống Bi Phong
宋春秋=Tống Xuân Thu
宋清桥=Tống Thanh Kiều
宋炽=Tống Sí
宋破浪=Tống Phá Lãng
宗室子弟=tông thất tử đệ
宗师=Tông Sư
宗师境=Tông Sư Cảnh
宗族势力=tông tộc thế lực
宗老会=Tông Lão Hội
官牙=quan nha
官道=Quan Đạo
宛若是=giống như là
宝瓶口=Bảo Bình Khẩu
宝盒里=bảo hạp bên trong
宝盒里面=bảo hạp bên trong
宝蛟县=Bảo Giao huyện
实在=thực sự¦chân thực¦đích thực¦đích xác¦quả thực¦quả tình¦kì thực¦thật ra¦chắc chắn¦cẩn thận¦kỹ¦khéo¦tốt¦bây giờ¦thật sự¦thực ra
容易的事情=dễ dàng sự tình
宿命=Định mệnh
寂法和尚=Tịch Pháp hòa thượng
寂法大师=Tịch Pháp Đại Sư
寂灭指=Tịch Diệt Chỉ
密不透风=Mật Bất Thấu Phong
密剑七十二式=Mật Kiếm Thất Thập Nhị Thức
密宗=Mật Tông
密宗布达寺=Mật Tông Bố Đạt Tự
密林七十二式=Mật Lâm Thất Thập Nhị Thức
密林深深=Mật Lâm Thâm Thâm
密林深藏=Mật Lâm Thâm Tàng
寒冰真气=Hàn Băng Chân Khí
寒毒鸟=Hàn Độc Điểu
寒炫=Hàn Huyễn
寒蚿=Hàn Hiên
寒血心法=Hàn Huyết Tâm Pháp
寒髓=hàn tủy
察迹=Sát Tích
对于气的锻炼=đối với khí rèn luyện
对月图卷=Đối Nguyệt Đồ Quyển
封万=Phong Vạn
封寒=Phong Hàn
封灵牌=Phong Linh Bài
封灵阵=Phong Linh Trận
射雕国=Xạ Điêu Quốc
射雕英雄传=Xạ Điêu Anh Hùng Truyện
将黑金=đem ám kim
尉迟繁炽=Úy Trì Phồn Trí
小不点的=tiểu bất điểm
小伍长=tiểu ngũ trưởng
小和尚=tiểu hòa thượng
小型仙门=Tiểu Tiên Môn
小女子=tiểu nữ tử
小孟子=Tiểu Mạnh Tử
小布点=tiểu bất điểm
小师=Tiểu Sư
小无相功=Tiểu Vô Tướng Công
小李飞刀=Tiểu Lý Phi Đao
小狗贼=tiểu cẩu tặc
小神魂石=Tiểu Thần Hồn Thạch
小红帽=cô bé quàng khăn đỏ
小舞姐=Tiểu Vũ tỷ
小菊=Tiểu Cúc
小西施公主=Tiểu Tây Thi Công Chúa
小还丹=Tiểu Hoàn Đan
小陆子=Tiểu Lục Tử
小青=Tiểu Thanh
小青云山=Tiểu Thanh Vân sơn
小须弥袋=Tiểu Tu Di Đại
小鱼儿=Tiểu Ngư Nhi
小鸿蒙=Tiểu Hồng Mông
小鸿蒙环境=Môi trường Tiểu Hồng Mông
小黑=Tiểu Hắc
小齐王=Tiểu Tề Vương
少林神拳=Thiếu Lâm Thần Quyền
少英=Thiếu Anh
少阳剑君=Thiếu Dương Kiếm Quân
尚云芳=Thượng Vân Phương
尚大师=Thượng đại sư
尚天明=Thượng Thiên Minh
尚天羽=Thượng Thiên Vũ
尚师傅=Thượng sư phó
尚王府=Thượng Vương phủ
尚老=Thượng lão
尝胆剑法=Thường Đởm Kiếm Pháp
尾鳍=Vây đuôi
屈清臣=Khuất Thanh Thần
屠麟=Giết Lân
山之剑意=Sơn Chi Kiếm Ý
山岳大地之威=Sơn Nhạc Đại Địa Chi Uy
山岳诀=Sơn Nhạc Quyết
山泉雾潭=Sơn Tuyền Vụ Đàm
山溪之上白云飞=Sơn Khê Chi Thượng Bạch Vân Phi
山系剑法=Sơn Hệ Kiếm Pháp
山西雁=Sơn Tây Nhạn
山重剑法=Sơn Trọng Kiếm Pháp
山雨欲来风满楼=Sơn Vũ Dục Lai Phong Mãn Lâu
岱宗如何=Đại Tông Như Hà
岳世庭=Nhạc Thế Đình
岳亭=Nhạc Đình
岳忠浩=Nhạc Trung Hạo
岳阳府=Nhạc Dương phủ
岷山=Minh Sơn
岷江=Mân Giang
岷江三妖=Minh Giang Tam Yêu
岷江三妖兽=Minh Giang Tam Yêu Thú
岷江三妖水猿王=Ba yêu của Mẫn Giang, Thủy Viên Vương
岷江三妖河=Minh Giang Tam Yêu Hà
峥儿=Tranh Nhi
峻拔=tuấn bạt
崆峒=Không Đồng
崆峒仙门=Khống Đồng Tiên Môn
崩剑式=Băng Kiếm Thức
嵩山伯=Sùng Sơn Bá
嵩阳=Tung Dương
嵩阳铁剑=Tung Dương Thiết Kiếm
巡山心法=Tuần Sơn Tâm Pháp
左亭=Tả Đình
左横=Tả Hoành
巨兽=Cự thú
巨型灵兽=Linh thú khổng lồ
巨大的火球=cự đại hỏa cầu
巨头=Cự đầu
巨犀=cự tê
巨魔山峭=Cự Ma Sơn Tiếu
巫墓=Vu Mộ
巫支祁=Vu Chi Kỳ
巫术启蒙=Vu Thuật Khải Mông
巫王=Vu Vương
师傅=Sư phụ
师兄好=sư huynh hảo
师叔=Sư thúc
师叔祖=Sư thúc tổ
师妃仙=Sư Phi Tiên
师妹=Sư muội
师娘周氏=Sư nương Chu thị
希夷剑法=Hy Di Kiếm Pháp
帝京=Đế Kinh
帝剑=Đế Kiếm
帝剑法=Đế Kiếm Pháp
帝姬=Đế Cơ
帝帝式=Đế Đế Thức
帝皇无双=Đế Hoàng Vô Song
帝都=Đế Đô
帝都五轮宫=Ngũ Luân Cung Đế Đô
席应情=Tịch Ứng Tình
幡龙柱=Phiên Long Trụ
干将仙剑=Can Tương Tiên Kiếm
平时的=bình thường
平独鹤=Bình Độc Hạc
年就可以= năm liền có thể
年怜=Niên Liên
年怜武=Niên Liên Vũ
年长的=lớn tuổi¦chính là
幻影猫=huyễn ảnh miêu
幻心草=Huyễn Tâm Thảo
幽意=U Ý
幽景=cảnh u tĩnh
幽灵豹=U Linh Báo
幽鸟鸣春图=U Điểu Minh Xuân Đồ
广成子秘卷=Quảng Thành Tử Bí Quyển
广成秘卷=Quảng Thành Bí Quyển
庄主=Chủ Trang
庖丁解牛=Bào Đinh Giải Ngưu
庞飞侠=Bàng Phi Hiệp
建木=Kiến Mộc
建木之云=Kiến Mộc Chi Vân
建武国=Kiến Vũ quốc
建章宫=Kiến Chương Cung
开了眼=mở mắt
开山剑法=Khai Sơn Kiếm Pháp
开明兽=Khai Minh Thú
开辟=mở ra
开阳=Khai Dương
开阳毒=Khai Dương Độc
异兽=Dị thú
异度空间=Dị Độ Không Gian
弃天帝=Khí Thiên Đế
弃峰仙华峰=Khí Phong Tiên Hoa Phong
引雷剑=Dẫn Lôi Kiếm
引雷术=Dẫn Lôi Thuật
弘日=Hoằng Nhật
弘月道姑=Hoằng Nguyệt Đạo Cô
弟弟妹妹=đệ đệ muội muội
张三娘=Trương tam nương
张元海=Trương Nguyên Hải
张凤武=Trương Phượng Vũ
张凤汐=Trương Phượng Tịch
张唐=Trương Đường
张大善人=Trương đại thiện nhân
张宽=Trương Khoan
张小凡=Trương Tiểu Phàm
张旭=Trương Húc
张显民=Trương Hiển Dân
张清山=Trương Thanh Sơn
张清溪=Trương Thanh Khê
张画宇=Trương Họa Vũ
张菁=Trương Tinh
张虚玄=Trương Hư Huyền
张褚氏=Trương Chử thị
张道陵=Trương Đạo Lăng
张金鰲=Trương Kim Ngao
张青书=Trương Thanh Thư
张青山=Trương Thanh Sơn
弧形剑=Hồ Hình kiếm
弱得可以=yếu đến ghê gớm
弱水=Nhược Thủy
弱水三千，独取一瓢=Nhược Thủy ba ngàn, chỉ lấy một gáo
弱水域=Nhược Thủy Vực
归来后=trở về sau khi
当当作响=đương đương rung động
当然对=dĩ nhiên đối
彩云灵剑=Thải Vân Linh Kiếm
彩云追月=Thải Vân Truy Nguyệt
彭大鹏=Bành Đại Bằng
彭岳=Bành Nhạc
彭烈=Bành Liệt
影视剧=phim điện ảnh và truyền hình
彼此身份=hai bên thân phận
很辣=rất cay
徐敏君=Từ Mẫn Quân
徐玄真=Từ Huyền Chân
徒让我发笑=khiến cho ta bật cười
得跟头禽兽=giống như đầu cầm thú
御兽宗门=ngự thú tông môn
御剑=Ngự kiếm
御剑期=Ngự Kiếm Kỳ
御剑行空=Ngự Kiếm Hành Không
御剑飞行=Ngự kiếm phi hành
御驾亲临=ngự giá thân lâm
微乎其微了=cực kỳ bé nhỏ
心中=trong lòng
心慧=Tâm Tuệ
心树=Tâm Thụ
心树大师=Tâm Thụ đại sư
心法=Tâm Pháp
心潮澎湃=cảm xúc bành trướng
心灯=Tâm Đăng
心灵控制=tâm linh khống chế
心烛=Tâm Chúc
心眉大师=Tâm Mi đại sư
心经=Tâm Kinh
心鉴=Tâm Giám
忍辱剑法=Nhẫn Nhục Kiếm Pháp
忘情之书=Vong Tình Chi Thư
忘情天书=Vong Tình Thiên Thư
忙活了=bận rộn
忧之剑意=Ưu Chi Kiếm Ý
快之剑意=Khoái Chi Kiếm Ý
快慢十七式=Khoái Mạn Thập Thất Thức
快慢十七路=Khoái Mạn Thập Thất Lộ
怎么好=làm thế nào tốt
怎么开=làm sao mở
怎么开辟=làm sao khai tích
怒之剑意=Nộ Chi Kiếm Ý
怒雷剑法=Nộ Lôi Kiếm Pháp
怜年=Liên Niên
怜星=Liên Tinh
怜红楼=Liên Hồng lâu
思过之路=Tư Quá Chi Lộ
思过峰=Tư Quá Phong
思过崖=Vách Tư Quá
恐龙=Khủng long
息土=Tức Thổ
息衍之土=Tức Diễn Chi Thổ
恶吏=ác lại
恶雕=Ác Điêu
恶鲧=Ác Cổn
悍天一击=Hãn Thiên Nhất Kích
悟道宝阁=Ngộ Đạo Bảo Các
悬崖勒马=Huyền Nhai Lặc Mã
悲天恨地=Bi Thiên Hận Địa
悲风戚秋=Bi Phong Thích Thu
悲风戚秋之毒=Bi Phong Thích Thu Chi Độc
情关七念=Tình Quan Thất Niệm
情形=tình thế¦tình hình
惊天一剑=Kinh Thiên Nhất Kiếm
惊天之剑=Kinh Thiên Chi Kiếm
惊蛟会=Kinh Giao hội
惊雷峰=Kinh Lôi Phong
惯姓=quán tính
慕容=Mộ Dung
慕容一皇=Mộ Dung Nhất Hoàng
慕容九=Mộ Dung Cửu
慕容公子=Mộ Dung công tử
慕容冲=Mộ Dung Xung
慕容国=Mộ Dung Quốc
慕容夫妇=Mộ Dung phu phụ
慕容失=Mộ Dung Thất
慕容家=Mộ Dung gia
慕容家族=Mộ Dung gia tộc
慕容映雪=Mộ Dung Ánh Tuyết
慕容暗=Mộ Dung Ám
慕容永=Mộ Dung Vĩnh
慕容皇复=Mộ Dung Hoàng Phục
慕容菡=Mộ Dung Hạm
慕容龙皇=Mộ Dung Long Hoàng
慕若兰=Mộ Nhược Lan
慢之剑意=Mạn Chi Kiếm Ý
懵懵懂懂的=tỉnh tỉnh mê mê
戈壁=sa mạc
戊己四诀=Mậu Kỷ Tứ Quyết
成中宽=Thành Trung Khoan
成清余=Thành Thanh Dư
我的儿子=ta nhi tử
我看到你=ta nhìn thấy ngươi
我自己=chính ta
我辈仙侠中人=Bọn ta Tiên Hiệp trong người
战帖=chiến thiếp
战战兢兢的=nơm nớp lo sợ
战清勇=Chiến Thanh Dũng
战灵兽=chiến linh thú
战灵火猴=Chiến Linh Hỏa Hầu
战灵电蛇=Chiến Linh Điện Xà
战灵金兽=Chiến Linh Kim Thú
战灵风狼=Chiến Linh Phong Lang
战神万战录=Chiến Thần Vạn Chiến Lục
房门前=trước cửa phòng
手头紧张=tình hình kinh tế khẩn trương
手掌桎梏=bàn tay ràng buộc
手足之间=tay chân ở giữa
打得兴起=đánh cho hứng khởi
托大了=khinh thường
托山掌=Thác Sơn Chưởng
执道友=chấp đạo hữu
扫六合=quét ngang trên trời dưới đất
技能列表=kỹ năng danh sách
把自己卖=đem mình bán
抓天之掌=Trảo Thiên Chi Chưởng
折子冲=Chiết Tử Xung
折掉了=gãy mất
抢丹=Tranh Đan
拂尘剑=Phất Trần Kiếm
拈花一笑=Niêm Hoa Vi Tiếu
拈花指=Niêm Hoa Chỉ
拜佛峰=Bái Phật Phong
拜月=Bái Nguyệt
拭剑=Thí Kiếm
拱极门=Củng Cực Môn
拳倾天下=Quyền Khuynh Thiên Hạ
拼命剑冷血=Tính Mạng Kiếm Lãnh Huyết
指点我的=chỉ điểm ta
捂了捂额头=che trán
掌心神雷=chưởng tâm thần lôi
掌教师兄=Chưởng giáo sư huynh
掌门=Chưởng môn
掌门人=Chưởng môn nhân
掌门人楚断=Chưởng môn nhân Sở Đoạn
掌风呼啸=chưởng phong gào thét
掠夺之王=Tước Đoạt Chi Vương
接引式=Tiếp Dẫn Thức
接近不死=tiếp cận bất tử
搏杀技巧=chém giết kỹ xảo
摄魂大法=Nhiếp Hồn Đại Pháp
摇光=Dao Quang
摇光毒=Diêu Quang Độc
摇魂钟=Dao Hồn Chung
摘星台=Trích Tinh Đài
摘星子=Trích Tinh Tử
摘月客=Trích Nguyệt Khách
摘花=hái hoa¦Trích Hoa
摘花生=hái đậu phộng
摩云十四式=Ma Vân Thập Tứ Thức
摩诃指=Ma Ha Chỉ
操气弹=Sōkidan
收字诀=Thu Tự Quyết
攻帝式=Công Đế Thức
敖炉生=Ngao Lô Sinh
教授给=giáo thụ cho
散魔三十六星=Tán Ma Tam Thập Lục Tinh
数以百计=hàng trăm¦tính ra hàng trăm¦số lượng hàng trăm
数以百计的=hàng trăm
整改=chỉnh cải
整曰=đều nói
文化=văn hóa
文明之主=Chủ nhân văn minh
文玉树=Văn Ngọc Thụ
文蛛=Văn Chu
斗月修罗门=Đấu Nguyệt Tu La Môn
斗转星移=Đấu Chuyển Tinh Di
斗转星移大法=Đấu Chuyển Tinh Di Đại Pháp
斜月=Tà Nguyệt
断刀左横=Đoạn Đao Tả Hoành
断惊涛=Đoạn Kinh Đào
断水剑轩辕十二=Đoạn Thủy Kiếm Hiên Viên Thập Nhị
断浪=Đoạn Lãng
断魂钩=Đoạn Hồn Câu
新华山=Hoa Sơn Mới
新客=tân khách
新客户=tân khách hộ
新掌门=Chưởng môn mới
新的家族=mới gia tộc
方乾坤=Phương Càn Khôn
方云河=Phương Vân Hà
方儒=Phương Nho
方寸=Phương Thốn
方师叔=Phương Sư Thúc
方应看=Phương Ứng Khán
方振衣=Phương Chấn Y
方歌之=Phương Ca Chi
方正剑=Phương Chính Kiếm
方正居=Phương Chính Cư
方淡=Phương Đạm
方清正=Phương Thanh Chính
方玉飞=Phương Ngọc Phi
方生=Phương Sinh
方能保证=mới có thể bảo chứng
方觉晓仙剑=Phương Giác Hiểu Tiên Kiếm
方邪=Phương Tà
方铁石=Phương Thiết Thạch
方随风=Phương Tùy Phong
方面的才能=phương diện tài năng
族群中央=tộc đàn trung ương
无上剑门=Vô Thượng Kiếm Môn
无上回神丹=Vô Thượng Hồi Thần Đan
无上大教=Vô Thượng Đại Giáo
无上金身=Vô Thượng Kim Thân
无伤剑仙南宫无伤=Kiếm Tiên Vô Thương Nam Cung Vô Thương
无剑=Vô Kiếm
无剑仙门=Vô Kiếm Tiên Môn
无双无对=Vô Song Vô Đối
无双无对，气凝一剑=Vô Song Vô Đối, Khí Ngưng Nhất Kiếm
无名=Vô Danh
无声无色剑法=Vô Thanh Vô Sắc Kiếm Pháp
无形剑气=Vô Hình Kiếm Khí
无形剑门=Vô Hình Kiếm Môn
无形无影针=Vô Hình Vô Ảnh Châm
无形无质=Vô Hình Vô Chất
无心无肝天丑老人=Vô Tâm Vô Can Thiên Sửu Lão Nhân
无敌名=vô địch danh
无敌名的=vô địch danh
无生老人=Vô Sinh Lão Nhân
无生遗宫=Vô Sinh Di Cung
无相劫指=Vô Tướng Kiếp Chỉ
无相古佛=Vô Tướng Cổ Phật
无相大禅师=Vô Tướng đại thiện sư
无相银僧=Vô Tướng Ngân Tăng
无绵雪山=Vô Miên Tuyết Sơn
无色无相剑法=Vô Sắc Vô Tướng Kiếm Pháp
无边落木=Vô Biên Lạc Mộc
无边血剑式=Vô Biên Huyết Kiếm Thức
无逍子=Vô Tiêu Tử
日中天=Nhật Trung Thiên
日之剑意=Nhật Chi Kiếm Ý
日光之弧=Nhật Quang Chi Hồ
日光剑！昊阳正中！=Nhật Quang Kiếm! Hạo Dương Chính Trung!
日光怒杀=Nhật Quang Nộ Sát
日月之行=Nhật Nguyệt Chi Hành
日月五星剑阵=Nhật Nguyệt Ngũ Tinh Kiếm Trận
日照大师=Nhật Chiếu Đại Sư
日照香炉生紫烟=Nhật Chiếu Hương Lô Sinh Tử Yên
日精轮=Nhật Tinh Luân
日轮剑=Nhật Luân Kiếm
日轮剑！昊天火劫！=Nhật Luân Kiếm! Hạo Thiên Hỏa Kiếp!
时间流逝=thời gian trôi qua
昆仑=Côn Luân
昆仑仙门=Côn Luân Tiên Môn
昆仑剑法=Côn Luân Kiếm Pháp
昆仑古=Côn Luân Cổ
昆仑天关=Côn Luân Thiên Quan
昆仑山=Côn Lôn Sơn
昆仑建木=Côn Luân Kiến Mộc
昆明池=Côn Minh Trì
昊天火劫=Hạo Thiên Hỏa Kiếp
昊影九蚀=Hạo Ảnh Cửu Thức
昊火天劫=Hạo Hỏa Thiên Kiếp
明光宫=Minh Quang Cung
明平门=Minh Bình Môn
明玉功=Minh Ngọc Công
明镜姥姥=Minh Kính Mỗ Mỗ
易出来=dịch ra
易大经=Dịch Đại Kinh
易容=dịch dung
易筋化仙经=Dịch Cân Hóa Tiên Kinh
易筋经=Dịch Cân Kinh
易经锻骨篇=Dịch Kinh Đoán Cốt Thiên
易身形=dịch thân hình
星宿剑法=Tinh Tú Kiếm Pháp
星宿海=Tinh Tú Hải
星宿老仙=Tinh Tú Lão Tiên
星月魔宗=Tinh Nguyệt Ma Tông
星汉灿烂=Tinh Hán Xán Lạn
星移大法=Tinh Di Đại Pháp
星辰暴雨箭=Tinh Thần Bạo Vũ Tiễn
星辰河砂=Tinh Thần Hà Sa
星辰贴=tinh thần thiếp
星辰风缚术=Tinh Thần Phong Phược Thuật
春之剑仙=Xuân Chi Kiếm Tiên
春之剑仙南宫慧=Xuân Chi Kiếm Tiên Nam Cung Tuệ
春江潮水连海平=Xuân Giang Triều Thủy Liên Hải Bình
春风化雨=Xuân Phong Hóa Vũ
是中土=là Trung Thổ
是从小紫=là từ Tiểu Tử
是否为真=phải chăng là thật
是我娘亲=là ta mẫu thân
是雨族=là Vũ tộc
晃动=lay động¦lắc lư¦hoảng động¦đu đưa¦chớp lên¦đung đưa
晋人=Người Tấn
晋元=Tấn Nguyên
晋元二国=Hai nước Tấn và Nguyên
晋北双秀=Tấn Bắc song tú
晋国=Tấn Quốc
晋国考核=Kỳ thi tuyển chọn của Tấn quốc
晋武帝=Tấn Vũ Đế
晋荣帝=Tấn Vinh Đế
普意大师=Phổ Ý đại sư
晰道人=Tích đạo nhân
暗剑山庄=Ám Kiếm Sơn Trang
暗夜噬血=Ám Dạ Phệ Huyết
暮之剑仙=Mộ Chi Kiếm Tiên
暮之剑意=Mộ Chi Kiếm Ý
暮光之城=Mộ Quang Chi Thành
暴之剑意=Bạo Chi Kiếm Ý
暴雨=Bạo Vũ
暴雨剑意=Bạo Vũ Kiếm Ý
暴雨术=Bạo Vũ Thuật
暴雨狂风=Bạo Vũ Cuồng Phong
暴雨阴魔梨花阳魔针=Bạo Vũ Âm Ma Lê Hoa Dương Ma Châm
曰=ngày¦viết¦gọi¦nói
曰上=mặt trời lên trên
曲江池=Khúc Giang Trì
曲粮精酒=Khúc Lương Tinh Tửu
更加得意=càng thêm đắc ý
更加得意得很=thậm chí còn đắc ý hơn
曹寿熊=Tào Thọ Hùng
曾伦=Tằng Luân
替天之盟=Thay Trời Chi Minh
替天盟=Thay Thiên Minh
最好的丹炉=tốt nhất đan lô
月下狐=Nguyệt Hạ Hồ
月光小虫虫=Nguyệt Quang Tiểu Trùng Trùng
月城湖=Hồ Nguyệt Thành
月湖小筑=Nguyệt Hồ Tiểu Trúc
月精轮=Nguyệt Tinh Luân
月考=nguyệt khảo
有什么伤势=có cái gì thương thế
有凤来仪=Hữu Phụng Lai Nghi
有天鹏=có thiên bằng
有明就有暗=có minh thì có ám
有生员=có sinh viên
有谅可原=có thể thông cảm
有身价=có giá trị bản thân
有门长=có môn trưởng
有风范=có phong phạm
望月心法=Vọng Nguyệt Tâm Pháp
朝思梦想=triêu tư mộng tưởng
朝辞白帝彩云间=Triều Từ Bạch Đế Thải Vân Gian
朝阳=Triều Dương
朝阳一气剑=Triều Dương Nhất Khí Kiếm
朝阳剑意=Triều Dương Kiếm Ý
朝阳台=Triều Dương Đài
朝阳峰=Triều Dương Phong
朝阳心法=Triều Dương Tâm Pháp
朝阳玉女云雾紫霞图大阵=Triều Dương Ngọc Nữ Vân Vụ Tử Hà Đồ Đại Trận
朝阳靴=Triều Dương Hài
木一半=Mộc Nhất Bán
木之剑意=Mộc Chi Kiếm Ý
木皇剑道=Mộc Hoàng Kiếm Đạo
木系=Hệ Mộc
木系剑意=Mộc Hệ Kiếm Ý
木道人=Mộc đạo nhân
木道法华大会=Mộc Đạo Pháp Hoa Đại Hội
木道法华盛会=Đại hội Pháp Hoa Mộc Đạo
木鲸=Mộc Kình
未央宫=Vị Ương Cung
未时=Mùi thì
未来身体=tương lai thân thể
末法之眼=Mạt Pháp Chi Nhãn
末法真实之眼=Mạt Pháp Chân Thật Chi Nhãn
末那识=Mạt Na Thức
本命法则=Bản mệnh pháp tắc
朱八一=Chu Bát Nhất
朱果=Chu Quả
朱腾云=Chu Đằng Vân
机会继续=cơ hội tiếp tục
机灵=cơ linh
杀妻求道荆还真=Sát Thê Cầu Đạo Kinh Hoàn Chân
杂剑仙=Tạp Kiếm Tiên
杂剑仙西门乱=Tạp Kiếm Tiên Tây Môn Loạn
李二侠=Lý Nhị Hiệp
李佛道=Lý Phật Đạo
李元成=Lý Nguyên Thành
李元白=Lý Nguyên Bạch
李冰=Lý Băng
李周氏=Lý Chu Thị
李大叔=Lý đại thúc
李大婶=Lý Đại Thẩm
李季阳=Lý Quý Dương
李家=Lý Gia
李家庄=Lý Gia Trang
李寻梦=Lý Tầm Mộng
李寻欢=Lý Tầm Hoan
李少爷=Lý Thiếu Gia
李师兄=Lý sư huynh
李度安=Lý Độ An
李探花=Lý thám hoa
李晟碑=Lý Thịnh Bi
李求欢=Lý Cầu Hoan
李沐=Lý Mộc
李清暮=Lý Thanh Mộ
李清灭=Lý Thanh Diệt
李燕北=Lý Yến Bắc
李盗=Lý Đạo
李老把头=Lý lão bả đầu
李虚玄=Lý Hư Huyền
李过之=Lý Quá Chi
李逍遥=Lý Tiêu Dao
李靖=Lý Tịnh
村长=thôn trưởng
村长的话=thôn trưởng lời nói
杜医师=Đỗ Y Sư
杜杀=Đỗ Sát
杜武=Đỗ Vũ
来吧=đến đây đi
杨公塔=Dương Công Tháp
杨大=Dương Đại
杨大胡子=Dương đại hồ tử
杨帮主=Dương bang chủ
杨开心=Dương Khai Tâm
杨承祖=Dương Thừa Tổ
杨某=Dương mỗ
杨箓禅=Dương Lục Thiện
杰出子弟=kiệt xuất tử đệ
松果腺=Tuyến tùng
极乐峒=Cực Nhạc động
极乐峒主=Cực Nhạc động chủ
极于剑= cực tại kiếm
极其大气=cực kì đại khí
极其大气的=cực kì đại khí
极道剑子=Cực Đạo Kiếm Tử
极道剑子方乾坤=Cực Đạo Kiếm Tử Phương Càn Khôn
林仙儿=Lâm Tiên Nhi
林依星=Lâm Y Tinh
林天南=Lâm Thiên Nam
林诗音=Lâm Thi Âm
林铃铃=Lâm Linh Linh
枝繁叶茂=Chi Phồn Diệp Mậu
枯禅大师=Khô Thiền Đại Sư
柔云剑术=Nhu Vân Kiếm Thuật
柔云剑法=Nhu Vân Kiếm Pháp
柔云千转=Nhu Vân Thiên Chuyển
柔水心法=Nhu Thủy Tâm Pháp
查看过记忆=tra xét ký ức
柯师傅=Kha sư phó
柯炎生=Kha Viêm Sinh
柳东来=Liễu Đông Lai
柳叶儿=Liễu Diệp Nhi
柳叶青青=Liễu Diệp Thanh Thanh
柳师妹=Liễu Sư Muội
柳树=Liễu Thụ
柳残心=Liễu Tàn Tâm
柴天贵=Sài Thiên Quý
柴小官人=Sài tiểu quan nhân
柴帮=sài bang
柴教头=Sài giáo đầu
柴行=sài hành
柴豹=Sài Báo
标志性的=tiêu chí tính
栋梁型人物=nhân vật trụ cột
树繁木炽剑法=Thụ Phồn Mộc Xí Kiếm Pháp
树繁枝炽一百八十八剑=Thụ Phồn Chi Xí Nhất Bách Bát Thập Bát Kiếm
树繁枝炽一百八十八式=Thụ Phồn Chi Sí Nhất Bách Bát Mươi Tám Thức
树繁枝炽一百八十八路=Thụ Phồn Chi Sí một trăm tám mươi tám lộ
树里=trên cây
核心思想=hạch tâm tư tưởng
桂宫=Quế Cung
桃源宫=Đào Nguyên Cung
桃熟=đào chín
桃红柳绿=Đào hồng liễu lục
桃花令=Đào Hoa Lệnh
桃花剑仙慕若兰=Đào Hoa Kiếm Tiên Mộ Nhược Lan
桃花国=Đào Hoa Quốc
桃花春涨洞门关=Đào hoa xuân trướng động môn quan
桃花源=Đào Hoa Nguyên
桃花源记=Đào Hoa Nguyên Ký
桑三娘=Tang Tam Nương
梅二先生=Mai nhị tiên sinh
梅大先生=Mai đại tiên sinh
梅花庵=Mai Hoa am
梅花盗=Mai Hoa Đạo
梵音=Phạn Âm
棋卫=Kỳ Vệ
森森=dày đặc
植物四珍=Thực vật tứ trân
椒图=Tiêu Đồ
椒图变=Tiêu Đồ Biến
楚师伯=Sở sư bá
楚师叔=Sở sư thúc
楚师叔祖=Sở Sư Thúc Tổ
楚平渊=Sở Bình Uyên
楚掌门=Sở Chưởng Môn
楚断=Sở Đoạn
楚浪=Sở Lãng
楚踏香=Sở Đạp Hương
楚飞=Sở Phi
楼舍=lâu xá
横扫六合=hoành tảo lục hợp
横练功法=hoành luyện công pháp
橙色长生果=Trường Sinh Quả màu cam
欢喜菩萨=Hoan Hỉ Bồ Tát
欧阳丁=Âu Dương Đinh
欧阳亭=Âu Dương Đình
欧阳宗师=Âu Dương Tông Sư
欧阳情=Âu Dương Tình
欧阳独法=Âu Dương Độc Pháp
欧阳知晓=Âu Dương Tri Hiểu
欧阳锋寒宗师=Âu Dương Phong Hàn Tông Sư
欲界七魔=Dục Giới Thất Ma
正东=Chính Đông
正北=Chính Bắc
正反神功=Chính Phản Thần Công
正大光明的=quang minh chính đại
正道=Chính đạo
正道仙门=chính đạo tiên môn
此举能成=nó có thể được thực hiện
此毒草=loại độc thảo này
此生=đời này
步山=Bộ Sơn
武举人=võ cử nhân
武古文明=Võ Cổ Văn Minh
武古文明之主=Võ Cổ Văn Minh Chi Chủ
武备阁=Võ Bị các
武学世家=võ học thế gia
武当=Võ Đang
武当七子=Võ Đang Thất Tử
武当仙门=Võ Đang Tiên Môn
武当剑法=Võ Đang Kiếm Pháp
武当剑阵=Võ Đang Kiếm Trận
武当少阳剑君=Võ Đang Thiếu Dương Kiếm Quân
武当山=Võ Đang Sơn
武当纯阳剑=Võ Đang Thuần Dương Kiếm
武当纯阳剑气=Võ Đang Thuần Dương Kiếm Khí
武当纯阳功=Võ Đang Thuần Dương Công
武海上人=Võ Hải Thượng Nhân
武神无敌=Võ Thần Vô Địch
武秀才=võ tú tài
武考=võ khảo
武陵仙门=Võ Lăng Tiên Môn
武陵剑法=Võ Lăng Kiếm Pháp
武陵山=Võ Lăng Sơn
武陵山无生遗宫=Võ Lăng Sơn Vô Sinh Di Cung
武陵府=Võ Lăng Phủ
武魂殿中=Vũ Hồn Điện bên trong
死之剑意=Ý kiếm Tử
死宅神功=Tử Trạch Thần Công
殃云天降=Ương Vân Thiên Giáng
残阳峰=Tàn Dương Phong
段千=Đoạn Thiên
段师傅=Đoạn sư phó
段庆之=Đoạn Khánh Chi
殷商=Ân Thương
殷师伯=Ân Sư Bá
殷无忌=Ân Vô Kỵ
殷正=Ân Chính
殷清亭=Ân Thanh Đình
毁灭之蛇=Hủy Diệt Chi Xà
毒手药王=Độc Thủ Dược Vương
毒手道兄=Độc Thủ đạo huynh
毒水区=Độc Thủy Khu
毒水域=Độc Thủy Vực
毒王蟹=Độc Vương Giải
毒蛇=Độc Xà
毒蝗=Độc Hoàng
毒谷=Độc Cốc
毗沙门天王=Tỳ Sa Môn Thiên Vương
毛沧海=Mao Thương Hải
气元斩=Kienzan
气宗=Khí Tông
气宗心法=Khí Tông Tâm Pháp
气宗西峰=Khí Tông Tây Phong
气的锻炼=rèn luyện khí
气运七子=Khí Vận Thất Tử
氪金流=khắc kim lưu
水之剑意=Thủy Chi Kiếm Ý
水到渠成的=nước chảy thành sông
水剑楼=Thủy Kiếm Lâu
水夜叉=Thủy Dạ Xoa
水师姐=Thủy sư tỷ
水母阴姬=Thủy Mẫu Âm Cơ
水泡术=Thủy Bào Thuật
水潇潇碧天愁=Thủy Tiêu Tiêu Bích Thiên Sầu
水火剑楼=Thủy Hỏa Kiếm Lâu
水火合流=Thủy Hỏa Hợp Lưu
水火楼=Thủy Hỏa Lâu
水火道人=Thủy Hỏa Đạo Nhân
水牛王=Thủy Ngưu Vương
水猿出海诀=Thủy Viên Xuất Hải Quyết
水猿王=Thủy Viên Vương
水皇=Thủy Hoàng
水皇剑道=Thủy Hoàng Kiếm Đạo
水皇大手=Thủy Hoàng Đại Thủ
水皇天劫=Thủy Hoàng Thiên Kiếp
水皇天威之剑=Thủy Hoàng Thiên Uy Chi Kiếm
水箭术=Thủy Tiễn Thuật
水系=Hệ Thủy
水系仙骨=Thủy hệ tiên cốt
水系剑意=Thủy Hệ Kiếm Ý
水系灵骨=Thủy hệ linh cốt
水缚术=Thủy Phược Thuật
水蛇王=Thủy Xà Vương
水锥术=Thủy Trùy Thuật
水镜县=Thủy Kính Huyện
水镜州=Thủy Kính Châu
水镜术=Thủy Kính Thuật
永和九年=Vĩnh Hòa Cửu Niên
永炎之火=Vĩnh Viêm Chi Hỏa
求仙人=cầu tiên nhân
汉白玉=Hán Bạch Ngọc
江云帆=Giang Vân Phàm
江兄=Giang huynh
江公子=Giang công tử
江别鹤=Giang Biệt Hạc
江大=Đại học Giang
江家=Giang gia
江少游=Giang Thiếu Du
江枫=Giang Phong
江河长生诀=Giang Hà Trường Sinh Quyết
江湖客=Giang Hồ Khách
江琳师姐=Giang Lâm sư tỷ
江直下=Giang Trực Hạ
江贵=Giang Quý
江郎=Giang Lang
江阴县=Huyện Giang Âm
江阴府=Giang Âm Phủ
江阴烧刀子=Giang Âm Thiêu Đao Tử
汤陈义=Thang Trần Nghĩa
沈三娘=Thẩm Tam Nương
沈汉生=Thẩm Hán Sinh
沈洋=Thẩm Dương
沈羽=Thẩm Vũ
沈落=Thẩm Lạc
沈霞=Thẩm Hà
沙棠=Sa Đường
沙魔=Sa Ma
沙魔骨刺=Cốt thích Sa Ma
没有上你的当=không bị ngươi lừa
河大=Đại học Hà
河阳=Hà Dương
法之子=Pháp Chi Tử
法之文明=Pháp Chi Văn Minh
法则归一=Pháp Tắc Quy Nhất
法则归一境=Pháp tắc quy nhất cảnh
法力=Pháp lực
法力高强=pháp lực cao cường
法华石=Pháp Hoa Thạch
法古文明=Pháp Cổ Văn Minh
法古文明之子=Pháp Cổ Văn Minh Chi Tử
法号日照=Pháp hiệu Nhật Chiếu
法宝周天仪=Pháp Bảo Chu Thiên Nghi
法宝文明=Pháp Bảo Văn Minh
法宝环境宫=Pháp Bảo Hoàn Cảnh Cung
法师=Pháp sư
法师终结者=Pháp Sư Chung Kết Giả
法斯诺行省=Pháp Tư Nặc Hành tỉnh
法术=Pháp Thuật
法术攻击=pháp thuật công kích
法术文明=Pháp Thuật Văn Minh
法灵帝姬=Pháp Linh Đế Cơ
法道=Pháp Đạo
法道室=Pháp Đạo Thất
法长老=Pháp Trưởng Lão
波涛=sóng gió
泥头车=xe ben
泥瓦巷=Bùn Ngói ngõ hẻm
泪枯道人=Lệ Khô Đạo Nhân
泰山=Thái Sơn
泰山十八盘=Thái Sơn Thập Bát Bàn
泰山基剑=Thái Sơn Cơ Kiếm
泰山派=Thái Sơn Phái
泼墨大写意=Bát Mặc Đại Tả Ý
泼墨披麻剑法=Bát Mặc Phi Ma Kiếm Pháp
泽被苍生=Trạch Bị Thương Sinh
洛南商州=Lạc Nam Thương Châu
洛峰主=Lạc Phong chủ
洛神虚步=Lạc Thần Hư Bộ
洞天=Động Thiên
洞查万界神鉴大法=Đỗng Tra Vạn Giới Thần Giám Đại Pháp
洞洞波=Dōdōha
洪荒始龙=Hồng Hoang Thủy Long
活血散=Hoạt Huyết Tán
活霸王=Hoạt Bá Vương
流云飞袖=Lưu Vân Phi Tụ
流外之民=Dân Lưu Ngoại
浅地仙门=Thiển Địa Tiên Môn
浅海区域的=biển cạn khu vực
浅草剑法=Thiển Thảo Kiếm Pháp
浊气下沉=trọc khí hạ xuống
浑天万象罗盘=Hồn Thiên Vạn Tượng La Bàn
浩法=Hạo Pháp
浩然灵剑=Hạo Nhiên Linh Kiếm
浮游九变=Phù Du Cửu Biến
海上明月共潮生=Hải Thượng Minh Nguyệt Cộng Triều Sinh
海中火=Hải Trung Hỏa
海之剑意=Hải Chi Kiếm Ý
海内咸服=hải nội hàm phục
海卷心杀剑法=Hải Quyển Tâm Sát Kiếm Pháp
海武上人=Hải Vũ thượng nhân
海狗=Hải Cẩu
海狗肾=hải cẩu thận
海狮=Hải Sư
海猴酒=Hải Hầu Tửu
海珍鸟=Hải Trân Điểu
海羊=Hải Dương
海虎=Hải Hổ
海蛇=Hải Xà
海见=Hải Kiến
海豹=Hải Báo
海贪道人=Hải Tham Đạo Nhân
海镜=Hải Kính
海陵上人=Hải Lăng Thượng nhân
海马=Hải Mã
海龙=Hải Long
淡红色毛发=bộ lông màu đỏ nhạt
淡薄剑=Đạm Bạc Kiếm
深厚的修为=thâm hậu tu vi
深蓝哥哥=Thâm Lam ca ca
深达=sâu đến¦sâu tới¦xâm nhập
混元境界=Hỗn Nguyên cảnh giới
混元巅峰=Hỗn Nguyên đỉnh phong
混天镯=Hỗn Thiên Trạc
混洞=Hỗn Độn
混洞境=Hỗn Động Cảnh
混铁棍=Hỗn Thiết Côn
清净府地=Thanh Tịnh Phủ Địa
清净心经=Thanh Tịnh Tâm Kinh
清明=Thanh Minh
清明河上图=Thanh Minh Thượng Hà Đồ
清气=Thanh khí
清池=Thanh Trì
清泉=suối trong
清泉兄=Thanh Tuyền huynh
清瘦男子=gầy gò nam tử
清虚心法=Thanh Hư Tâm Pháp
清虚道德秘卷=Thanh Hư Đạo Đức Bí Quyển
清音曲=Thanh Âm Khúc
清风=Thanh Phong
清风仙剑=Thanh Phong Tiên Kiếm
渣女=tra nữ
温泉=ôn tuyền
游兄=Du huynh
游公子=Du công tử¦Du Công Tử
游大哥=Du đại ca
游少侠=Du thiếu hiệp
游某=Du mỗ
游老弟=Du lão đệ
游腾=Du Đằng
游荃蕙=Du Thuyên Huệ
游贤侄=Du hiền điệt
游龙剑客=Du Long kiếm khách
游龙生=Du Long Sinh
湖之剑意=Hồ Chi Kiếm Ý
溪云初起日沉阁=Khê Vân Sơ Khởi Nhật Trầm Các
溪仙馆图=Khê Tiên Quán Đồ
滚球=lăn bóng
满天花雨=Mãn Thiên Hoa Vũ
滴水不漏=Tích Thủy Bất Lậu
潇湘剑客=Tiêu Tương kiếm khách
潘大少=Phan đại thiếu
潘少安=Phan Thiếu An
潜力=Tiềm Lực
潜力石=Đá tiềm lực
激进之中=tăng lên nhanh bên trong
灌顶大法=Quán Đỉnh Đại Pháp
火不焚=lửa không cháy
火之剑意=Hỏa Chi Kiếm Ý
火剑客=Hỏa Kiếm Khách
火剑楼=Hỏa Kiếm Lâu
火灵珠=Hỏa Linh Châu
火烧阿房宫=Hỏa Thiêu A Phòng Cung
火焰珠=Hỏa Diễm Châu
火焰鸟=Hỏa Diễm Điểu
火爆大虾=Tôm xào cay
火犴=Hỏa Hãn
火猴=Hỏa Hầu
火猿=Hỏa Viên
火皇=Hỏa Hoàng
火皇剑道=Hỏa Hoàng Kiếm Đạo
火皇天威之剑=Hỏa Hoàng Thiên Uy Chi Kiếm
火神剑意=Hỏa Thần Kiếm Ý
火系=Hệ Hỏa
火红的=hoả hồng
火虎=Hỏa Hổ
火长老=Hỏa Trưởng Lão
火雀剑=Hỏa Tước Kiếm
火鳞灵剑=Hỏa Lân Linh Kiếm
火鸦壶=Hỏa Nha Hồ
火麟鸟=Hỏa Lân Điểu
火龙起九霄=Hỏa Long Khởi Cửu Tiêu
灭元剑=Diệt Nguyên Kiếm
灭元剑朱八一=Diệt Nguyên Kiếm Chu Bát Nhất
灭剑=Diệt Kiếm
灵丹=linh đan
灵丹的药力=linh đan dược lực
灵剑=Linh Kiếm
灵山之上=Linh Sơn chi thượng
灵犀一指=Linh Tê Nhất Chỉ
灵石=Linh thạch
灵秀峰=Linh Tú phong
灵虚国=Linh Hư Quốc
灵虚道长=Linh Hư đạo trưởng
灵蝠身法=Linh Phúc Thân Pháp
炎之剑意=Viêm Chi Kiếm Ý
炎夜叉=Viêm Dạ Xoa
炎珠=Viên viêm châu
炎虎=viêm hổ
炎辉府=Viêm Huy phủ
炸狐=Trát Hồ
炸狐心=Trát Hồ Tâm
点我的=điểm ta
炼体成罡=luyện thể thành cương
炼天门=Luyện Thiên môn
炼气境界=Luyện Khí cảnh giới
炼气期=Luyện Khí Kỳ
炼虚修士=Luyện Hư tu sĩ
炽之一式=Trí Chi Nhất Thức
炽之剑意=Sí Chi Kiếm Ý
炽意剑意=Xích Ý Kiếm Ý
炽阳=Sí Dương
烂陀寺=Lạn Đà Tự
烂院寺=Lạn Viện Tự
烈姓=nóng tính
烈曰=liệt nhật
烈火妖侯=Liệt Hỏa Yêu Hầu
烈火旗=Liệt Hỏa Kỳ
烈焰飞剑=Liệt Diễm Phi Kiếm
烈阳上人=Liệt Dương Thượng Nhân
烈风上人=Liệt Phong Thượng Nhân
烛明=Chúc Minh
烟波杏霭图=Yên Ba Hạnh Ải Đồ
焰光剑仙=Diễm Quang Kiếm Tiên
焰光剑仙聂晨风=Diễm Quang Kiếm Tiên Nhiếp Thần Phong
焰光双轮=Diễm Quang Song Luân
照鉴镜=Chiếu Giám Kính
熊孩子的身上=hùng hài tử trên thân
熊掌=Gấu chưởng
熊猩=Hùng Tinh
熔岩=Dong Nham
熔岩剑客=Kiếm khách dung nham
熔岩剑客南秋=Dung Nham Kiếm Khách Nam Thu
熔岩剑客无眉南秋=Kiếm Khách Dung Nham Vô Mi Nam Thu
熔岩剑意=Dung Nham Kiếm Ý
熔岩天灾=Dung Nham Thiên Tai
熔岩末日=Nham Dung Mạt Nhật
燕二=Yến Nhị
燕二宗师=Yến Nhị Tông Sư
燕北=Yến Bắc
燕十三=Yến Thập Tam
燕双杀=Yến Song Sát
燕双飞=Yến Song Phi
燕回闪=Yến Hồi Thiểm
燕师伯=Yến sư bá
燕师兄=Sư huynh Yến
燕师叔祖=Yến sư thúc tổ
燕师祖=Yên Sư Tổ
燕掌门=Yến chưởng môn
燕梁歌=Yến Lương Ca
燕狂人=Yến Cuồng Nhân
燕狂徒=Yến Cuồng Đồ
燕祖师=Yến Tổ Sư
燕窝=Tổ yến
燕苍天=Yến Thương Thiên
燕返=Yến Phản
燕雪=Yến Tuyết
爱乐之城=Ái Nhạc Chi Thành
爱晚亭=Ái Vãn Đình
爱欲天王=Ái Dục Thiên Vương
牙帮=Nha Bang
牙贴=nha thiếp
牛笔=ngưu bút
牧师=Mục sư
犵雕=Ngọ Điêu
狂喜若望=cuồng hỉ nhược vọng
狂流=cuồng lưu
狂风剑法=Cuồng Phong Kiếm Pháp
狂风过境=Cuồng Phong Quá Cảnh
狄云=Địch Vân
狄飞惊=Địch Phi Kinh
狐尾摇动=đuôi cáo lay động
狐族=Hồ Tộc
狐死留皮=Hồ tử lưu bì
狐火大铠=Hồ Hỏa Đại Khải
狐长老=Hồ trưởng lão
狗肉=Thịt chó
独剑仙=Độc Kiếm Tiên
独剑仙石冲天=Độc Kiếm Tiên Thạch Xung Thiên
独孤叶=Độc Cô Diệp
独孤师叔=Độc Cô sư thúc
独孤枭=Độc Cô Kiêu
独掌玄冥门大权=Độc chưởng Huyền Minh Môn đại quyền
独秀=Độc Tú
独行天下三十六天罡=Độc Hành Thiên Hạ Tam Thập Lục Thiên Cương
独行天下宫=Độc Hành Thiên Hạ Cung
狴犴=Tỳ Ngưu
狴犴变=Tỳ Ngạn Biến
狻猊=Toan Nghê
狻猊变=Toan Nghê Biến
猎千秋=Liệp Thiên Thu
猎士令=Liệp Sĩ Lệnh
猎士林=Liệp Sĩ Lâm
猎魔掌柜=Chưởng quỹ Thợ Săn Quỷ
猛玛魔象=Mãnh Mã Ma Tượng
猛的一塌糊涂=mạnh mẽ kinh khủng
猩唇=Môi vượn
猩猩滩=Tinh Tinh Than
猫族=Miêu Tộc
猫玩耗子=mèo vờn chuột
献果神君=Hiến Quả Thần Quân
猴脑=Óc khỉ
猿公神剑=Thần Kiếm Khỉ
玄之极=Huyền Chi Cực
玄之蛇=Huyền Chi Xà
玄元化=Huyền Nguyên Hóa
玄冥=Huyền Minh
玄冥之杀=Huyền Minh Chi Sát
玄冥二极=Huyền Minh Nhị Cực
玄冥仙门=Huyền Minh Tiên Môn
玄冥化蛇=Huyền Minh Hóa Xà
玄冥化龙诀=Huyền Minh Hóa Long Quyết
玄冥双蛇剑法=Huyền Minh Song Xà Kiếm Pháp
玄冥大阵=Huyền Minh Đại Trận
玄冥子=Huyền Minh Tử
玄冥宫=Huyền Minh Cung
玄冥极冰=Huyền Minh Cực Băng
玄冥真冰=Huyền Minh Chân Băng
玄冥真解=Huyền Minh Chân Giải
玄冥门=Huyền Minh Môn
玄冥阵图=Huyền Minh Trận Đồ
玄冥陵阴=Huyền Minh Lăng Âm
玄冥陵阴，蛰虫盖臧=Huyền Minh Lăng Âm, Triết Trùng Cái Tang
玄奥妙式=Huyền Áo Diệu Thức
玄寂=Huyền Tịch
玄岳门=Huyền Nhạc Môn
玄幻世界=huyền huyễn thế giới
玄泥麻捆绳=Huyền Nê Ma Khổn Thằng
玄火=Huyền Hỏa
玄火双眼=Huyền Hỏa Song Nhãn
玄火双眼周悟=Huyền Hỏa Song Nhãn Chu Ngộ
玄琴客=Huyền Cầm Khách
玄画子=Huyền Họa Tử
玄笔翁=Huyền Bút Ông
玄铁=Huyền Thiết
玄阴万兽幡=Huyền Âm Vạn Thú Phiên
玄阴聚毒幡=Huyền Âm Tụ Độc Phiên
玄鹿客=Huyền Lộc Khách
玉佩=ngọc bội
玉天=Ngọc Thiên
玉女峰=Ngọc Nữ Phong
玉娘子=Ngọc Nương Tử
玉宸真经=Ngọc Thần Chân Kinh
玉真上人=Ngọc Chân Thượng Nhân
玉简令=Ngọc Giản Lệnh
玉箫前辈=Ngọc Tiêu tiền bối
玉绯剑=Ngọc Phi Kiếm
玉罗刹=Ngọc La Sát
玉英宫=Ngọc Anh Cung
玉莲花=hoa sen ngọc
玉虚宫=Ngọc Hư Cung
玉虚开天功=Ngọc Hư Khai Thiên Công
玉虚洞真经=Ngọc Hư Động Chân Kinh
玉衡=Ngọc Hành
玉衡毒=Ngọc Hành Độc
玉辇=ngọc liễn
玉面神拳秦重=Ngọc Diện Thần Quyền Tần Trọng
玉鼎真人=Ngọc Đỉnh Chân Nhân
王一抓=Vương Nhất Trảo
王东林=Vương Đông Lâm
王中令=Vương Trung Lệnh
王之剑意=Vương Chi Kiếm Ý
王公贵族=vương công quý tộc
王小虎=Vương Tiểu Hổ
王府=vương phủ¦Vương Phủ
王府之中=Vương phủ bên trong
王怜花=Vương Liên Hoa
王总管=Vương Tổng Quản
王猛=Vương Mãnh
王石头=Vương Thạch Đầu
王羲之=Vương Hy Chi
王重德=Vương Trọng Đức
现代都市=hiện đại đô thị
现任峰主方儒=Phong chủ đương nhiệm Phương Nho
现银=hiện ngân
珠光宝气阁=Châu Quang Bảo Khí các
珠树=Châu Thụ
班察巴那=Ban Sát Ba Na
琴卫=Cầm Vệ
琼华=Quỳnh Hoa
琼华宫=Quỳnh Hoa Cung
瑶池仙境=Dao Trì Tiên Cảnh
瓦厂=xưởng ngói
瓷盘=Khay sứ
生化危机=Sinh Hóa Nguy Cơ
生姓淡泊=sinh tính đạm bạc
生死判官=Sinh Tử Phán Quan
生死轮回=Luân hồi Sinh Tử
生死轮回之盘=Sinh Tử Luân Hồi Chi Bàn
甩开他的手=hất ra hắn tay
田七=Điền Thất
田伯光=Điền Bá Quang
田句=Điền Cú
田国=Nước Điền
田树槐=Điền Thụ Hòe
甲字号= hiệu chữ giáp
申时=Thân thì
电无极=Điện Vô Cực
电系=Hệ Điện
电长老=Điện Trưởng Lão
画卫=Họa Vệ
画圆剑=Họa Viên Kiếm
留白小题诗=Lưu Bạch Tiểu Đề Thi
疯寿丹=Phong Thọ Đan
疯狂的心=điên cuồng
疾风=Tật Phong
痛下狠手=thống hạ ngoan thủ
瘴气谷=Trướng Khí Cốc
癸丑=Quý Sửu
登云楼=Đăng Vân lâu
登天之基=đăng thiên chi cơ
白之剑道=Bạch Chi Kiếm Đạo
白二侠=Bạch nhị hiệp
白云仙境=Bạch Vân Tiên Cảnh
白云出岫=Bạch Vân Xuất Tụ
白云天洞=Bạch Vân Thiên Động
白云庄=Bạch Vân trang
白光纳日月，紫气排斗牛=Bạch quang nạp nhật nguyệt, tử khí bài đấu ngưu
白剑客南宫白=Bạch Kiếm Khách Nam Cung Bạch
白发鹰王=Bạch Phát Ưng Vương
白天羽=Bạch Thiên Vũ
白师傅=Bạch sư phó
白帝=Bạch Đế
白帝剑道=Bạch Đế Kiếm Đạo
白帝斩=Bạch Đế Trảm
白帝灵剑=Bạch Đế Linh Kiếm
白帝金皇剑道=Bạch Đế Kim Hoàng Kiếm Đạo
白开心=Bạch Khai Tâm
白曰里=bạch nhật bên trong
白杨林=Bạch Dương lâm
白海波=Bạch Hải Ba
白狐长老=Bạch Hồ Trưởng Lão
白猿=Bạch Viên
白猿剑尊=Bạch Viên Kiếm Tôn
白猿宗=Bạch Viên Tông
白猿宗师=Bạch Viên Tông Sư
白猿宗师袁不凡=Bạch Viên Tông Sư Viên Bất Phàm
白眉针=Bạch Mi Châm
白眉针盒=Bạch Mi Châm Hạp
白石城=Bạch Thạch Thành
白虹贯日=Bạch Hồng Quán Nhật
白蝠=Bạch Dực
白衣人=Bạch Y Nhân
白角龙=Bạch Giác Long
白进宝=Bạch Tiến Bảo
白飞惊=Bạch Phi Kinh
白骨吹=Bạch Cốt Xuy
白鹤泉=Bạch Hạc Tuyền
白龙=Bạch Long
白龙倒淹海=Bạch Long Đảo Yêm Hải
百万战役=Bách Vạn Chiến Dịch
百丈桥=Bách Trượng Kiều
百变千幻云雾一千三百式=Bách Biến Thiên Huyễn Vân Vụ Nhất Thiên Tam Bách Thức
百变千幻云雾一千零八剑=Bách Biến Thiên Huyễn Vân Vụ Nhất Thiên Linh Bát Kiếm
百国考核=Bách Quốc Khảo Hạch
百家不收方散问=Bách Gia Bất Thâu Phương Tán Vấn
百岁坊=Bách Tuế phường
百川归海=Bách Xuyên Quy Hải
百年一梦沧桑过=Bách niên nhất mộng thương tang quá
百年剑法=Bách Niên Kiếm Pháp
百年好合=bách niên hảo hợp
百年长青木=Bách Niên Trường Thanh Mộc
百无忌=Bách Vô Kỵ
百矿省=Bách Khoáng tỉnh
百矿省大沙漠=Bách Khoáng Tỉnh Đại Sa Mạc
百积=Bách Tích
百花芳怡=Bách Hoa Phương Di
百花行=Bách Hoa Hành
百花院=Bách Hoa viện
百贫=Bách Bần
百贫国=Bách Bần Quốc
的人马=nhân mã
的卡片=tấm card
的官人=quan nhân
的局限=cực hạn
的师= sư
的师父= sư phụ
的情绪中=cảm xúc bên trong
的脸上=mặt bên trên
的话=lời nói¦mà nói
的面子上=mặt mũi bên trên
皇拳=Hoàng Quyền
皇拳帝剑=Hoàng Quyền Đế Kiếm
皇拳惊天=Hoàng Quyền Kinh Thiên
皇级天劫=Hoàng Cấp Thiên Kiếp
皮骨皆炼=Bì Cốt Giai Luyện
盐良镇=Diêm Lương trấn
盗得经=Đạo Đắc Kinh
盟主祖千秋=Minh Chủ Tổ Thiên Thu
直挂云帆寄沧海=Trực Quải Vân Phàm Ký Thương Hải
相差了=chênh lệch
眉州=Mi châu
眉须=mày râu
看青鳞鹰=nhìn Thanh Lân Ưng
真传弟子楼=Chân Truyền Đệ Tử Lâu
真剑王=Chân Kiếm Vương
真实血眼=Chân Thực Huyết Nhãn
真武七截剑阵=Chân Võ Thất Tiệt Kiếm Trận
真武七截阵=Chân Võ Thất Tuyệt Trận
真武丹=Chân Võ Đan
真武仙剑=Chân Võ Tiên Kiếm
真武大殿=Chân Võ Đại Điện
真武洞=Chân Võ Động
真武洞天=Chân Võ Động Thiên
真气雄浑=chân khí hùng hồn
真的=thật
真龙=Chân Long
真龙身=chân long thân
真龙降临=Chân Long Giáng Lâm
真龙魄=Chân Long Phách
眼下=lúc này¦trước mắt
睚眦=Nha Tí
睚眦变=Nha Tư Biến
瞠目结舌的=nghẹn họng nhìn trân trối
知秋灵剑=Tri Thu Linh Kiếm
知空上人=Tri Không Thượng Nhân
石之剑意=Thạch Chi Kiếm Ý
石冲天=Thạch Xung Thiên
石刻=Thạch Khắc
石映月=Thạch Ánh Nguyệt
石朝阳=Thạch Triều Dương
石清臣=Thạch Thanh Thần
石秀雪=Thạch Tú Tuyết
石锥术=thạch trùy thuật
石默=Thạch Mặc
砂系=sa hệ
砂系灵兽=Sa Hệ Linh Thú
砍脑袋剑法=Khảm Não Đại Kiếm Pháp
破坏规矩=phá hư quy củ
破水潜光轮=Phá Thủy Tiềm Quang Luân
破的关=phá quan
破碎虚空=Phá Toái Hư Không
碎帝式=Toái Đế Thức
碎星冰棱=Toái Tinh Băng Lăng
碎石裂地=toái thạch liệt địa
碧溪垂钓图=Bích Khê Thùy Điếu Đồ
碧玉宫=Bích Ngọc Cung
碧碧莲塘=Bích Bích Liên Đường
碧落天=Bích Lạc Thiên
碧血双蛇=Bích Huyết Song Xà
磐岩村=Bàn Nham thôn
磨石=Ma Thạch
祖千来=Tổ Thiên Lai
祖千秋=Tổ Thiên Thu
祖千秋宗师=Tổ Thiên Thu Tông Sư
祖祭灵=Tổ Tế Linh
祖龙=Tổ Long
祝一虹=Chúc Nhất Hồng
祝君豪=Chúc Quân Hào
神功秘籍=thần công bí tịch
神月演大光=thần nguyệt diễn đại quang
神游太虚=Thần Du Thái Hư
神灵=Thần Linh
神灵子=thần linh tử
神秘的少年=thần bí thiếu niên
神行千变=Thần Hành Thiên Biến
神行百变=Thần Hành Bách Biến
神识=thần thức
神轮=Thần Luân
神通境界=Thần Thông cảnh giới
神通强者=Thần Thông cường giả
神门十三剑=Thần Môn Thập Tam Kiếm
神门穴=Thần Môn Huyệt
神魂=Thần Hồn
神魂江=Thần Hồn Giang
神魂石=Thần Hồn Thạch
神魂结晶=Thần Hồn Kết Tinh
神龙=Thần Long
神龙九折=Thần Long Cửu Chiết
神龙九折剑法=Thần Long Cửu Chiết Kiếm Pháp
神龙吐珠=Thần Long Thổ Châu
禀含=chứa
禅理=thiền lý
离别梭=Ly Biệt Toa
离奇谷=Ly Kỳ Cốc
秀之剑仙=Tú Chi Kiếm Tiên
秀之剑仙孙秀丽=Tú Chi Kiếm Tiên Tôn Tú Lệ
秋之剑意=Thu Chi Kiếm Ý
种方法=loại phương pháp
种洗=chủng tẩy
种种灵药=đủ loại linh dược
种菜鸟=loại thái điểu
秘剑夺命连环三仙剑=Bí Kiếm Đoạt Mệnh Liên Hoàn Tam Tiên Kiếm
秣陵别雪=Mạt Lăng Biệt Tuyết
秦三哥=Tần tam ca
秦三爷=Tần tam gia
秦公子=Tần công tử
秦嗣藩=Tần Tự Phiên
秦国=Tần Quốc
秦孝仪=Tần Hiếu Nghi
秦梦魂=Tần Mộng Hồn
秦江堰=Tần Giang Yển
秦皇=Tần Hoàng
秦皇鱼=Tần Hoàng Ngư
秦羽先=Tần Vũ Tiên
秦重=Tần Trọng
秦雷=Tần Lôi
秦霜=Tần Sương
移花宫=Di Hoa cung
移花穿玉=Di Hoa Xuyên Ngọc
程先生=Trình tiên sinh
程节=Trình Tiết
空手夺白刃=tay không tiếp dao sắc
空手接白刃=tay không tiếp dao sắc
空谷林=Không Cốc Lâm
空间类法术=Pháp thuật loại không gian
立劈为两半=bổ thành hai nửa
竟敢打这样的赌=lại dám đánh cược như vậy
童小五=Đồng Tiểu Ngũ
童百年=Đồng Bách Niên
竹荪=Trúc sung
笑弥陀=Tiếu Di Đà
符咒=bùa chú
符真铁=Phù Chân Thiết
第一环=Vòng thứ nhất
第一破洞大渡河=Đại Độ Hà, Lỗ Hổng Thứ Nhất
第一重天地元气=Đệ Nhất Trọng Thiên Địa Nguyên Khí
第七代=Đệ Thất Đại
第七分堂=Đệ Thất Phân Đường
第七分舵=Phân Đà thứ bảy
第七重金丹大成=Đệ Thất Trọng Kim Đan Đại Thành
第三重凝练神魂=Đệ Tam Trọng Ngưng Luyện Thần Hồn
第九代=Đệ Cửu đại
第九重三极归一=Đệ Cửu Trọng Tam Cực Quy Nhất
第二环=Vòng thứ hai
第二重二千年寿=Đệ Nhị Trọng Nhị Thiên Niên Thọ
第五重御使双剑=Đệ Ngũ Trọng Ngự Sử Song Kiếm
第八代=Đệ Bát Đại
第八重淬练灵剑=Đệ Bát Trọng Thối Luyện Linh Kiếm
第六张令牌=tấm lệnh bài thứ sáu
第六重成就虚丹=Đệ Lục Trọng Thành Tựu Hư Đan
第十代=Thế hệ thứ mười
第十分堂=Đệ Thập Phần Đường
第十分舵=Phân Đà thứ mười
第十堂主=Đệ Thập Đường Chủ
第十重大圆满=Đệ Thập Trọng Đại Viên Mãn
第四分舵=Phân Đà thứ tư
第四重成就元神=Đệ Tứ Trọng Thành Tựu Nguyên Thần
筑基的=Trúc Cơ
简二先生=Giản nhị tiên sinh
简单的道理=đơn giản đạo lí
算定乾坤元凌上人=Toán Định Càn Khôn Nguyên Lăng Thượng Nhân
管帐查帐=quản lý sổ sách
米万钟=Mễ Vạn Chung
米粮=thóc gạo
精、气、神=tinh, khí, thần
精神意念=tinh thần ý niệm
紧锣密鼓的=khua chiên gõ trống
紧难罗=Khẩn Nan La
紫微天帝大法=Tử Vi Thiên Đế Đại Pháp
紫气=Tử Khí
紫气宗师叶紫须=Tử Khí Tông Sư Diệp Tử Tu
紫翠丹宫=Tử Thúy Đan Cung
紫色星河=tử sắc tinh hà
紫色长生果=Trường Sinh Quả màu tím
紫袍=Áo bào tím
紫袍副天使=Tử Bào Phó Thiên Sứ
紫袍的尊者=Tôn Giả Áo Tím
紫金丹=Tử Kim Đan
紫霞上人=Tử Hà Thượng Nhân
紫霞千里=Tử Hà Thiên Lý
紫霞千里心法=Tử Hà Thiên Lý Tâm Pháp
紫霞宗师=Tử Hà Tông Sư
紫霞师伯=Tử Hà Sư Bá
紫霞百里段庆之=Tử Hà Bách Lý Đoạn Khánh Chi
紫面二郎=Tử Diện nhị lang
紫麟妖王=Tử Lân Yêu Vương
紫麟蛟王=Tử Lân Giao Vương
紫龙一君临=Tử Long Nhất Quân Lâm
繁剑客=Phồn Kiếm Khách
繁华似锦=Phồn Hoa Tự Cẩm
繁弦急管=Phồn Huyền Cấp Quản
繁文缛节=Phồn Văn Nhục Tiết
繁炽剑=Phồn Trí Kiếm
红剑客司徒红=Hồng Kiếm Khách Tư Đồ Hồng
红孟尝=Hồng Mạnh Thường
红帽=mũ đỏ
红橙黄绿蓝靛紫=Đỏ, cam, vàng, lục, lam, chàm, tím
红色长生果=Trường Sinh Quả màu đỏ
红鞋子=Hồng Hài Tử
红龙=Hồng Long
纪国=Kỉ quốc
纪富贵=Kỷ Phú Quý
纪峥=Kỷ Tranh
纪昌=Kỷ Xương
纯纯=tinh khiết¦thuần thuần¦tinh khiết trong tinh khiết
纯阳无极=Thuần Dương Vô Cực
纯阳气=Thuần Dương Khí
纳兰=Nạp Lan
纳兰二国主=Na Lạp Nhị Quốc Chủ
纳兰德=Nạp Lan Đức
纽龙棍=nữu long côn
线下面基=offline gặp mặt
练体=Luyện Thể
练体期=Luyện Thể kỳ
练子虚=Luyện Tử Hư
练气期=Luyện Khí kỳ
练神剑仙=Luyện Thần Kiếm Tiên
细柳生姿=tế liễu sinh tư
细犬=mảnh khuyển
细犬形=mảnh khuyển hình
终南仙门=Chung Nam Tiên Môn
终南大法=Chung Nam Đại Pháp
终有时=Chung Hữu Thì
经=kinh
绕指柔=Nhiễu Chỉ Nhu
绕指柔剑=Nhiễu Chỉ Nhu Kiếm
绕指柔剑法=Nhiễu Chỉ Nhu Kiếm Pháp
给人参=cho nhân sâm
绝世天才=Tuyệt thế thiên tài
绝世存在=tuyệt thế tồn tại
绝世燕苍天=Tuyệt Thế Yến Thương Thiên
绝学之一=tuyệt học chi nhất
绝学之一的=tuyệt học một trong
统领不了=thống lĩnh không được
绣玉谷=Tú Ngọc cốc
绯玉剑=Phi Ngọc Kiếm
综合=Tổng Hợp
绾绾=Oản Oản
绿色长生果=Trường Sinh Quả màu xanh lá
绿袍光焰宗师=Lục Bào Quang Diễm Tông Sư
绿龙=Lục Long
罂粟=Anh túc
罗汉=La Hán
罗汉岩=La Hán Nham
羊羔美酒=Dương Cao Mỹ Tửu
羊角魔=Dương Giác Ma
美誉=mỹ dự
群友=quần hữu
羽化升龙经=Vũ Hóa Thăng Long Kinh
翁天杰=Ông Thiên Kiệt
翁家庄=Ông gia trang
翻天三掌=Phiên Thiên Tam Chưởng
翻江龙=Phiên Giang Long
老人手持=lão nhân tay cầm
老人身躯=lão nhân thân thể
老卡尔=lão Carl¦lão Tạp Nhĩ
老君阁=Lão Quân Các
老把头=lão bả đầu
老油皮=lão du bì
老神仙=Lão Thần Tiên
老苗=Lão Miêu
老药=lão dược
老药师=lão dược sư
老虎的=lão hổ
老霄顶=Đỉnh Lão Tiêu
老黄牛=lão hoàng ngưu
考核天使=Thiên sứ khảo hạch
耐力=Nại Lực
聂愁风=Nhiếp Sầu Phong
聂晨风=Nhiếp Thần Phong
肃之剑意=Túc Chi Kiếm Ý
肚痛=Đổn Thống
肝=gan
肝帝=gan đế
背鳍=Vây lưng
胡不归=Hồ Bất Quy
胡晓彤=Hồ Hiểu Đồng
胡月生=Hồ Nguyệt Sinh
胡道人=Hồ đạo nhân
胥塘=Tư Đường
胸鳍=Vây ngực
能力列表=năng lực danh sách
能量攻击=năng lượng công kích
脆败=bại dứt khoát
臀鳍=Vây hậu môn
自在孤云野鹤之剑=Tự Tại Cô Vân Dã Hạc Chi Kiếm
至上灵剑=Chí Thượng Linh Kiếm
至于堂主=về phần đường chủ
至纯之力=Chí Thuần Chi Lực
舍利灵丹=Xá Lợi linh đan
舟沉=thuyền chìm
般若掌=Bát Nhã Chưởng
般若掌法=Bát Nhã Chưởng Pháp
良师=lương sư
色空剑=Sắc Không Kiếm
艾特=@(a còng)
芙蓉=Phù Dung
花无涯=Hoa Vô Nhai
花月奴=Hoa Nguyệt Nô
花满楼=Hoa Mãn Lâu
花白凤=Hoa Bạch Phượng
花菜汤=Canh súp lơ
花蜂=Hoa Phong
花间剑法=Hoa Gian Kiếm Pháp
花间宗=Hoa Gian Tông
花间集=Hoa Gian Tập
花雕=Hoa điêu
花魂仙法=Hoa Hồn Tiên Pháp
苍之剑道=Thương Chi Kiếm Đạo
苍土妖侯=Thương Thổ Yêu Hầu
苍松迎客=Thương Tùng Nghênh Khách
苍生=Chúng sinh
苍茫山=Thương Mang sơn
苍虚之无=Thương Hư Chi Vô
苍鹰峰=Thương Ưng Phong
苍鹰翔宇诀=Thương Ưng Tường Vũ Quyết
苍黄土气=Khương Hoàng Thổ Khí
苍黄巨掌=Thương Hoàng Cự Chưởng
苏二侠=Tô nhị hiệp
苏少英=Tô Thiếu Anh
苏川星=Tô Xuyên Tinh
苏川江=Tô Xuyên Giang
苏川河=Tô Xuyên Hà
苏樱=Tô Anh
苏汤=Tô Thang
苏相梦=Tô Tương Mộng
苗壮=Miêu Tráng
若希若夷=Nhược Hi Nhược Di
苦舟阁=Khổ Chu các
范蠡=Phạm Lãi
荆无命=Kinh Vô Mệnh
荆无求=Kinh Vô Cầu
荆棘之路=Kinh Cức Chi Lộ
荆求直=Kinh Cầu Trực
荆花峰=Kinh Hoa phong
荆赫生=Kinh Hách Sinh
荆还真=Kinh Hoàn Chân
荆错=Kinh Thác
草上飞=Thảo Thượng Phi
草圣=Thảo Thánh
草长莺飞=Cỏ mọc chim oanh bay
荒古=Hoang Cổ
荒古文明=Hoang Cổ Văn Minh
荡帝式=Đãng Đế Thức
药丹=đan dược
药之力=dược lực
药柴市=Dược Sài thị
药王堂=Dược Vương Đường
药王府=Dược Vương phủ
莫一兮=Mạc Nhất Hề
莫千变=Mạc Thiên Biến
莫垂垂=Mạc Thùy Thùy
莫大掌门=Mạc Đại Chưởng Môn
莫奇=Mạc Kỳ
莫子鸣=Mạc Tử Minh
莫子鹤=Mạc Tử Hạc
莫柳=Mạc Liễu
莫离=Mạc Ly
莫邪仙剑=Mạc Tà Tiên Kiếm
莫野王=Mạc Dã Vương
莲心湖=Liên Tâm hồ
莲花=Liên Hoa
莲花小筑=Liên Hoa Tiểu Trúc
莲花居=Liên Hoa Cư
莲花峰=Liên Hoa Phong
莲花洛神剑=Liên Hoa Lạc Thần Kiếm
莲花真解=Liên Hoa Chân Giải
莺飞燕舞=Oanh bay yến múa
菊豆=Cúc Đậu
菩提祖师=Bồ Đề tổ sư
菩提老祖=Bồ Đề lão tổ
菩提达摩=Bồ Đề Đạt Ma
菩提达摩祖师=Bồ Đề Đạt Ma Tổ Sư
萌动的心=manh động tâm
萧咪咪=Tiêu Mị Mị
萧四无=Tiêu Tứ Vô
萧家=Tiêu gia
萧峰雄=Tiêu Phong Hùng
萧氏=Tiêu thị
萧雄峰=Tiêu Hùng Phong
萧风=Tiêu Phong
落凤彩霞=Lạc Phượng Thải Hà
落叶归根=lá rụng về cội
落地无声=lạc địa vô thanh
落天雕=Lạc Thiên Điêu
落燕击=Lạc Yến Kích
落英缤纷=hoa rơi lả tả
落雁宫=Lạc Nhạn Cung
落雁峰=Lạc Nhạn Phong
落雨七十二路剑法=Lạc Vũ 72 Lộ Kiếm Pháp
落霞剑仙沈霞=Lạc Hà Kiếm Tiên Thẩm Hà
落霞山=Lạc Hà sơn
葡萄酒=Rượu nho
葬杀地狱=Táng Sát Địa Ngục
葵花记=Quỳ Hoa Kí
蒲牢=Bồ Lao
蒲牢变=Bồ Lao Biến
蓝月怡=Lam Nguyệt Di
蓝色长生果=Trường Sinh Quả màu xanh lam
蔷薇夫人=Sắc Vi phu nhân
蔽日青纱帐=Bế Nhật Thanh Sa Trướng
薛冰=Tiết Băng
薛可=Tiết Khả
藏书阁=Tàng Thư Các
藏剑楼=Tàng Kiếm lâu
藏边=Tàng Biên
藏锋图=Tàng Phong Đồ
虎象龙=hổ tượng long
虎长老=Hổ Trưởng Lão
虎面枭=Hổ Diện Kiêu
虚假记忆=hư giả ký ức
虚玄=Hư Huyền
虚空子=Hư Không Tử
虚长老=Hư Trưởng Lão
虞二=Ngu Nhị
虞二先生=Ngu Nhị tiên sinh
虱蛊=Sắt Cổ
蚀日剑法=Thực Nhật Kiếm Pháp
蚀阴=Thực Âm
蚊长老=Văn Trưởng Lão
蛇之蛇=Xà Chi Xà
蛇剑=Xà Kiếm
蛇剑怜年=Xà Kiếm Liên Niên
蛇族=Xà Tộc
蛇长老=Xà Trưởng Lão
蛇骨草=xà cốt thảo
蛇鱼镇=Xà Ngư trấn
蛊术=Cổ thuật
蛊王=Cổ Vương
蛛网大法=Chu Võng Đại Pháp
蛟形=Giao hình
蛟形鸡冠=Gáy hình giao long
蛰虫盖臧=Chập Trùng Cái Tạng
蜀山=Thục Sơn
蜀山仙学院=Thục Sơn Tiên Viện
蜀山派=Thục Sơn Phái
蝠妖=Phúc Yêu
蝠族=Bức Tộc
蝠王一笑=Phúc Vương Nhất Tiếu
蝠王身法=Phúc Vương Thân Pháp
蝠老二=Phúc Lão Nhị
蝠长老=Phúc trưởng lão
融冰斩=Dung Băng Trảm
螭吻=Li Vẫn
螭吻变=Li vẫn Biến
血云大法=Huyết Vân Đại Pháp
血云大法残篇=Tàn Phiên Huyết Vân Đại Pháp
血云灵兽=Huyết Vân Linh Thú
血剑=Huyết Kiếm
血剑七子=Huyết Kiếm Thất Tử
血剑仙门=Huyết Kiếm Tiên Môn
血剑变仙司南=Huyết Kiếm Biến Tiên Tư Nam
血剑堂=Huyết Kiếm Đường
血剑无影=Huyết Kiếm Vô Ảnh
血剑洞=Huyết Kiếm Động
血剑老祖=Huyết Kiếm Lão Tổ
血剑门=Huyết Kiếm Môn
血变剑仙=Huyết Biến Kiếm Tiên
血变剑仙司南=Huyết Biến Kiếm Tiên Tư Nam
血姬子母魔=Huyết Cơ Tử Mẫu Ma
血幻剑仙=Huyết Huyễn Kiếm Tiên
血库洞=Huyết Khố Động
血影=Huyết Ảnh
血影虚幻=Huyết Ảnh Hư Ảo
血影飘香=Huyết Ảnh Phiêu Hương
血战万世=Huyết Chiến Vạn Thế
血手印=Huyết Thủ Ấn
血手杜杀=Huyết Thủ Đỗ Sát
血枯道人=Huyết Khô Đạo Nhân
血武洞=Huyết Võ Động
血母=Huyết Mẫu
血母魔=Huyết mẫu ma
血河大阵=Huyết Hà Đại Trận
血海冻原=Huyết Hải Đống Nguyên
血海种魔大法=Huyết Hải Chủng Ma Đại Pháp
血海飘香=Huyết Hải Phiêu Hương
血珠=Huyết châu
血神洞=Huyết Thần Động
血祭剑术=Huyết Tế Kiếm Thuật
血腾鼎=Huyết Đằng Đỉnh
血舞轮回=Huyết Vũ Luân Hồi
血菩提=Huyết Bồ Đề
血衣人=Huyết Y Nhân
血雨剑仙=Huyết Vũ Kiếm Tiên
血雾剑仙=Huyết Vụ Kiếm Tiên
血馒头=bánh bao máu
血魔剑仙=Huyết Ma Kiếm Tiên
血魔缠心法=Huyết Ma Triền Tâm Pháp
血魔降生=Huyết Ma Giáng Sinh
血龙摆尾=Huyết Long Bãi Vĩ
行动自如=tự do đi lại¦Freedom of Movement
行宫之中=hành cung bên trong
行蜘蛛人=Hành Tri Chu Nhân
补虚损=bổ hư tổn
袁不凡=Viên Bất Phàm
袁秋云=Viên Thu Vân
袖雪灵剑=Tụ Tuyết Linh Kiếm
裂帝式=Liệt Đế Thức
裘千=Cừu Thiên
裘星=Cừu Tinh
裴万君=Bùi Vạn Quân
裴东流=Bùi Đông Lưu
裴云=Bùi Vân
褚林光=Chử Lâm Quang
西南=Tây Nam
西域=Tây Vực
西境=Tây Cảnh
西大门=Tây Đại Môn
西峰=Tây Phong
西施=Tây Thi
西海=Tây Hải
西王母=Tây Vương Mẫu
西门乱=Tây Môn Loạn
西门吹雪=Tây Môn Xuy Tuyết
西门玉=Tây Môn Ngọc
西青门=Tây Thanh Môn
要具=phải có
要长生=muốn trường sinh
见微=kiến vi
观梅山=Quan Mai Sơn
观梅山庄=Quan Mai sơn trang
解体丹=Giải Thể Đan
解剑池=Giải Kiếm Trì
言障=ngôn chướng
言香主=Ngôn hương chủ
让他伤势=để cho hắn thương thế
讲法坛=Giảng Pháp Đàn
诛仙四剑经=Tru Tiên Tứ Kiếm Kinh
诛杀令=tru sát lệnh
诞生的=đản sinh
说书先生=thuyết thư tiên sinh
说这个的时候=nói cái này thời điểm
说难=nói khó
请仙扶鸾=thỉnh tiên phù loan
诸侯心法=Chư Hầu Tâm Pháp
诸国大比=chư quốc đại bỉ
诸多大教=rất nhiều đại giáo
诸多天骄=chư đa thiên kiêu
诸多法则=Chư Đa Pháp Tắc
诸天恨气=Chư Thiên Hận Khí
诸天火神劫=Chư Thiên Hỏa Thần Kiếp
诸天血剑=Chư Thiên Huyết Kiếm
诸葛刚=Gia Cát Cương
诸葛格=Gia Cát Cách
诸葛雷=Gia Cát Lôi
诺丁=Nặc Đinh
谁说也不信=Thùy Thuyết Dã Bất Tín
谈应手=Đàm Ứng Thủ
谢天灵=Tạ Thiên Linh
谢晓峰=Tạ Hiểu Phong
谢狗=Tạ Cẩu
象鼻=Vòi voi
象龙=Tượng Long
豹胎=Bào thai báo
贱奴=tiện nô
贺华之=Hạ Hoa Chi
贺清鹤=Hạ Thanh Hạc
贺钟之=Hạ Chung Chi
赏花会=thưởng hoa hội
赑屃=Bệ Ngưu
赑屃变=Bí Hí Biến
赛华佗=Tái Hoa Đà
赤之剑道=Xích Chi Kiếm Đạo
赤帝=Xích Đế
赤帝剑道=Xích Đế Kiếm Đạo
赤帝火皇剑道=Xích Đế Hỏa Hoàng Kiếm Đạo
赤火鸟=Xích Hỏa Điểu
赤焰=Xích Diễm
赤焰妖王=Xích Diễm Yêu Vương
赤砂剑=Xích Sa Kiếm
赤罗刹=Xích La Sát
赤翼妖王=Xích Dực Yêu Vương
赤色=Xích Sắc
赤色剑道=Xích Sắc Kiếm Đạo
赤龙=Xích Long
赤龙仙门=Xích Long Tiên Môn
走井剑仙=Tẩu Tỉnh Kiếm Tiên
走井剑凌落石=Tẩu Tỉnh Kiếm Lăng Lạc Thạch
走神了=thất thần
赵乾坤=Triệu Càn Khôn
赵伯才=Triệu Bá Tài
赵全海=Triệu Toàn Hải
赵南=Triệu Nam
赵天言=Triệu Thiên Ngôn
赵寒=Triệu Hàn
赵无极=Triệu Vô Cực
赵桐=Triệu Đồng
赵正义=Triệu Chính Nghĩa
赵求一=Triệu Cầu Nhất
赵鹤=Triệu Hạc
超古代=siêu cổ đại
超级大佬=siêu cấp đại lão
超级富二代=siêu cấp phú nhị đại
越国=Việt Quốc
越女剑=Việt Nữ Kiếm
越女剑神=Việt Nữ Kiếm Thần
越女宗=Việt Nữ Tông
越女小青=Việt Nữ Tiểu Thanh
越女神剑=Việt Nữ Thần Kiếm
越女阿青=Việt Nữ A Thanh
越女韦青=Việt Nữ Vi Thanh
越子夫=Việt Tử Phu
越王宗=Việt Vương Tông
越秀=Việt Tú
越青山=Việt Thanh Sơn
越鹤=Việt Hạc
越鹿山=Việt Lộc Sơn
趴蝮=Bá Hạ
跟定义父=cùng định nghĩa phụ
路侯府=Lộ Hầu phủ
路菲菲=Lộ Phỉ Phỉ
路钟祥=Lộ Chung Tường
踯躅花=Trích Trúc Hoa
踯躅花君方邪=Chích Trúc Hoa Quân Phương Tà
踯躅花开方邪=Trích Trục Hoa Khai Phương Tà
蹬腿=duỗi chân
身无彩凤双飞翼=Thân Vô Thải Phượng Song Phi Dực
身死道销=Thân tử Đạo tiêu
躺山=Thảng sơn
车平=Xa Bình
轩法一=Hiên Pháp Nhất
轩辕=Hiên Viên
轩辕十二=Hiên Viên Thập Nhị
轩辕飞剑=Hiên Viên Phi Kiếm
转天轮=Chuyển Thiên Luân
轮回=Luân hồi
轮回之力=Luân Hồi Chi Lực
轮回剑道=Luân Hồi Kiếm Đạo
轮回峰=Luân Hồi Phong
轮回洞天=Luân Hồi Động Thiên
轮转如意=luân chuyển như ý
软木=nhuyễn mộc
较大的=khá lớn
辛龙子=Tân Long Tử
辟毒法螺=Tị Độc Pháp Loa
辟邪的=Tịch Tà
辣子煎泥鳅=Lươn chiên ớt
边城浪子=Biên Thành Lãng Tử
边浩=Biên Hạo
达古巴=Daguva
达摩=Đạt Ma
达摩剑法=Đạt Ma Kiếm Pháp
达摩易筋经=Đạt Ma Dịch Cân Kinh
达蒙=Damon
迅雷剑法=Tấn Lôi Kiếm Pháp
过于浓烈的=vô cùng nồng nặc
还真的=vẫn đúng là
这个=cái này
这么=như thế
这会=lúc này
这几曰=những ngày này
这厮=cái thằng này
这样=như vậy
这次=lần này
这种灵药=loại này linh dược
这等=loại này
这说这个=nói về chuyện này
这说这个的时候，=nói chuyện này thời điểm,
这辈=đời này
这边=bên này
这里=trong này
进取心=tiến thủ tâm
进宝=Tiến Bảo
进攻力=Tấn Công Lực
连城仙门=Liên Thành Tiên Môn
连城剑法=Liên Thành Kiếm Pháp
连晃动=liên tục lắc lư
迦叶菩萨=Ca Diếp Bồ Tát
迷魂潭=Mê Hồn Đàm
追月鞭=Truy Nguyệt tiên
追踪术=Truy Tung Thuật
追风剑=Truy Phong kiếm
追风剑客=Truy Phong kiếm khách
追风蜈蚣=Truy Phong Ngô Công
逍遥=Tiêu Dao
逍遥仙门=Tiêu Dao Tiên Môn
逍遥子=Tiêu Dao Tử
逍遥居=Tiêu Dao Cư
通个气=thông cái khí
通天塔=Tháp Thông Thiên
通天火爪=Thông Thiên Hỏa Trảo
通晓祖师=Thông Hiểu Tổ Sư
通灵花=Thông Linh Hoa
速度室=Tốc Độ Thất
速鱼=Tốc Ngư
道台=đạo đài
道家=Đạo gia
道德经=Đạo Đức Kinh
道心种魔大法=Đạo Tâm Chủng Ma Đại Pháp
遗失之地=Di Thất Chi Địa
遮天青纱帐=Giá Thiên Thanh Sa Trướng
邓开=Đặng Khai
那么=như vậy
那厮=cái thằng kia
那边=bên kia
邪道门派=Tà Đạo Môn Phái
邪魔外道=tà ma ngoại đạo
郑重=trịnh trọng
郭乡绅=Quách hương thân
郭侃=Quách Khản
郭威=Quách Uy
郭富=Quách Phú
郭嵩阳=Quách Tung Dương
酒之剑意=Tửu Chi Kiếm Ý
酒剑仙=Tửu Kiếm Tiên
酒剑仙陆元=Tửu Kiếm Tiên Lục Nguyên
酱肉丝=Thịt kho
酸菜鱼=Cá chua
醉剑=Túy Kiếm
醉剑仙=Túy Kiếm Tiên
醉剑无测=Túy Kiếm Vô Trắc
采菊东篱下，悠然见南山=Thái cúc đông ly hạ, du nhiên kiến Nam Sơn
释摩智=Thích Ma Trí
释武天宗师=Thích Võ Thiên Tông Sư
里克=Riku
里赤眉=Lý Xích My
重得=lần nữa
重武国=Trọng Vũ quốc
重水区=Trọng Thủy Khu
重水域=Trọng Thủy Vực
野姓=dã tính
金丹=Kim Đan
金之剑意=Kim Chi Kiếm Ý
金九龄=Kim Cửu Linh
金侯飞剑=Kim Hầu Phi Kiếm
金刚不坏之身=Kim Cương Bất Hoại Chi Thân
金刚不坏身=Kim Cương Bất Hoại Thân
金刚菩萨身=Kim Cương Bồ Tát Thân
金刚霸体=Kim Cương Bá Thể
金器=Kim khí
金壁天仓=Kim Bích Thiên Thương
金庚毒蜂=Ong độc Kim Canh
金气=Kim khí
金皇=Kim Hoàng
金皇剑道=Kim Hoàng kiếm đạo
金眼神狍=Kim Thần Thần Bao
金系=Hệ Kim
金系剑意=Kim Hệ Kiếm Ý
金系法术=Kim Hệ Pháp Thuật
金翅凤凰=Kim Sí Phượng Hoàng
金老总=Kim Lão tổng
金色光雨=màu vàng quang vũ
金蛛=Kim Chu
金袍=Kim bào
金钱帮=Kim Tiền bang
金镯=kim trạc
金雁横空=Kim Nhạn Hoành Không
金鞭岩=Kim Tiên Nham
金风白=Kim Phong Bạch
金鲸=Kim Kình
金鹏王朝=Kim Bằng vương triều
金龙珠=Kim Long Châu
金龙震天地=Kim Long Chấn Thiên Địa
针对于自己=nhằm vào chính mình
钟于剑=chung tại kiếm
钟大小姐=Chung Đại tiểu thư
钟姓=Họ Chung
钟婉=Chung Uyển
钟家=Chung Gia
钟家老祖=Chung Gia Lão Tổ
钟灵=Chung Linh
钟眉=Chung Mi
钟秋=Chung Thu
钟紫烟=Chung Tử Yên
钟贺明=Chung Hạ Minh
钢力士=Colossus
钢毛铁猪=Cương Mao Thiết Trư
钦原=Khâm Nguyên
铁中侠=Thiết Trung Hiệp
铁传甲=Thiết Truyền Giáp
铁剑仙门=Thiết Kiếm Tiên Môn
铁剑剑法=Thiết Kiếm Kiếm Pháp
铁剑线势=Thiết Kiếm Tuyến Thế
铁器=Thiết Khí
铁姑=Thiết Cô
铁开诚=Thiết Khai Thành
铁战=Thiết Chiến
铁手君子=Thiết Thủ Quân Tử
铁无双=Thiết Vô Song
铁木耳=Thiết Mộc Nhĩ
铁笛先生=Thiết Địch tiên sinh
铜墙铁壁大阵=Đồng Tường Thiết Bích Đại Trận
铜雀台=Đồng Tước Đài
银僧=Ngân Tăng
银耳=Mộc nhĩ trắng
银蛇剑法=Ngân Xà Kiếm Pháp
锐木妖侯=Duệ Mộc Yêu Hầu
锐木旗=Duệ Mộc Kỳ
错帝式=Thác Đế Thức
锦医卫=Cẩm Y Vệ
镇世级=Trấn Thế Cấp
镇世级剑法=Trấn Thế Cấp Kiếm Pháp
镇岳=Trấn Nhạc
镇岳剑=Trấn Nhạc Kiếm
镇岳灵剑=Trấn Nhạc Linh Kiếm
镇峰剑法=Trấn Phong Kiếm Pháp
镖局=tiêu cục
长久之策=kế sách lâu dài
长乐宫=Trường Lạc Cung
长奔=trường bôn
长春不老久久造化功=Trường Xuân Bất Lão Cửu Cửu Tạo Hóa Công
长春居=Trường Xuân Cư
长歌=Trường Ca
长生=Trường Sinh
长生七重=Trường Sinh Thất Trọng
长生不死诀=Trường Sinh Bất Tử Quyết
长生九重=Trường Sinh Cửu Trọng
长生五重=Trường Sinh Ngũ Trọng
长生八重=Trường Sinh Bát Trọng
长生六重=Trường Sinh Lục Trọng
长生十重=Trường Sinh Thập Trọng
长生境=Trường Sinh Cảnh
长生期=Trường Sinh Kỳ
长生果=Trường Sinh Quả
长生洞=Trường Sinh Động
长生经=Trường Sinh Kinh
长生道果=Đạo quả Trường Sinh
长生问道=Trường Sinh Vấn Đạo
长空栈道=Trường Không Sạn Đạo
长老任务=trưởng lão nhiệm vụ
长老团=Trưởng Lão Đoàn
长虹剑=Trường Hồng Kiếm
长袖善舞=trường tụ thiện vũ
长长眼=trường trường nhãn
长风破浪终有时=Trường phong phá lãng chung hữu thì
长风破浪终有时，直挂云帆济沧海=Trường Phong Phá Lãng chung hữu thì, trực quải vân phàm tế thương hải
门心法=môn tâm pháp
门长=môn trưởng
问心斋=Vấn Tâm Trai
阎老板=Diêm lão bản
阎铁珊=Diêm Thiết San
防御力=Phòng Ngự Lực
阳云府=Dương Vân Phủ
阳云谷=Dương Vân Cốc
阳圆灵剑=Dương Viên Linh Kiếm
阳澄湖=Dương Trừng hồ
阳符经=Dương Phù Kinh
阴九幽=Âm Cửu U
阴无姬=Âm Vô Cơ
阴无极=Âm Vô Cực
阴阳=Âm Dương
阴阳倒刃剑法=Âm Dương Đảo Nhận Kiếm Pháp
阴阳太极图=Hình Thái Cực Âm Dương
阴阳真经=Âm Dương Chân Kinh
阴风搜魂手=Âm Phong Sưu Hồn Thủ
阵法宗师张虚玄=Trận Pháp Tông Sư Trương Hư Huyền
阿修罗=A Tu La
阿弥陀佛=A Di Đà Phật
阿星=A Tinh
阿青=A Thanh
附带的=bổ sung
陆云=Lục Vân
陆元=Lục Nguyên
陆六=Lục Lục
陆六胜=Lục Lục Thắng
陆北=Lục Bắc
陆四眉=Lục Tứ Mi
陆地爬行兽=Quái thú bò trên cạn
陆小凤=Lục Tiểu Phụng
陆掌门=Chưởng môn Lục
陆柏=Lục Bách
陆清涛=Lục Thanh Đào
陆芷苡=Lục Chỉ Ỷ
陇西=Lũng Tây
陈哥=Trần ca
陈年黑米=gạo đen lâu năm
陈景=Trần Cảnh
陈烛=Trần Chúc
降魔棍=Hàng Ma Côn
降龙二十八掌=Giáng Long Nhị Thập Bát Chưởng
险、辣、阴、狠=Hiểm, Lạt, Âm, Hận
陵海上人=Lăng Hải Thượng Nhân
隐仙岩=Ẩn Tiên Nham
隐忍到现在=ẩn nhẫn đến bây giờ
隐皇堡=Ẩn Hoàng Bảo
雁过拔毛=nhạn bay qua cũng nhổ một cọng lông
雄家=Hùng gia
雄山之上=hùng sơn bên trên
雅木茶=Yamcha
雌雄双股灵剑=Thư Hùng Song Cổ Linh Kiếm
雨之剑意=Vũ Chi Kiếm Ý
雨打飞丝剑法=Vũ Đả Phi Ti Kiếm Pháp
雨落七十二式=Vũ Lạc Thất Thập Nhị Thức
雨落七十二路剑法=Vũ Lạc 72 Lộ Kiếm Pháp
雪之剑意=Tuyết Chi Kiếm Ý
雪山仙门=Tuyết Sơn Tiên Môn
雪山剑法=Tuyết Sơn Kiếm Pháp
雪山烂陀寺=Tuyết Sơn Lạn Đà Tự
雪山老祖=Tuyết Sơn Lão Tổ
雪景山水图=Tuyết Cảnh Sơn Thủy Đồ
雪猬=Tuyết Vị
雪白狐裘=Tuyết Bạch Hồ Cừu
雪盈=Tuyết Doanh
雪舞冰消剑法=Tuyết Vũ Băng Tiêu Kiếm Pháp
零汀剑仙=Linh Đinh Kiếm Tiên
雷之凤凰=Lôi Chi Phượng Hoàng
雷之剑意=Lôi Chi Kiếm Ý
雷之化龙诀=Lôi Chi Hóa Long Quyết
雷之文明=Lôi Chi Văn Minh
雷之神灵=Lôi Chi Thần Linh
雷厉风行=Lôi Lệ Phong Hành
雷无极=Lôi Vô Cực
雷穴鱼=Lôi Huyệt Ngư
雷系=Hệ Lôi
雷蛟=Lôi Giao
雷霆=Lôi Đình
雷龙=Lôi Long
雾之剑意=Vụ Chi Kiếm Ý
雾剑仙=Vụ Kiếm Tiên
雾系剑法=Vụ Hệ Kiếm Pháp
霁雪=tuyết tan
震北钟=Chấn Bắc Chung
震泽=Chấn Trạch
霍一步=Hoắc Nhất Bộ
霍休=Hoắc Hưu
霍天青=Hoắc Thiên Thanh
霍金先生=Hawking tiên sinh
霸气无双=Bá Khí Vô Song
霸老大=Bá lão đại
青之剑道=Thanh Chi Kiếm Đạo
青云坊市=Thanh Vân phường thị
青云门=Thanh Vân Môn
青儿=Thanh Nhi
青剑客=Thanh Kiếm Khách
青剑客上官青=Thanh Kiếm Khách Thượng Quan Thanh
青城=Thanh Thành
青城五山=Thanh Thành Ngũ Sơn
青城五门会盟=Thanh Thành Ngũ Môn Hội Minh
青城仙门=Thanh Thành Tiên Môn
青城六绝剑=Thanh Thành Lục Tuyệt Kiếm
青城六绝剑雨=Thanh Thành Lục Tuyệt Kiếm Vũ
青城山=Thanh Thành Sơn
青城神魂江=Thanh Thành Thần Hồn Giang
青城茶=Trà Thanh Thành
青墨竹王=Thanh Mặc Trúc Vương
青天老爷=thanh thiên lão gia
青山隐隐=Thanh Sơn Ẩn Ẩn
青帝=Thanh Đế
青帝剑光=Thanh Đế Kiếm Quang
青帝剑道=Thanh Đế Kiếm Đạo
青帝木皇剑道=Thanh Đế Mộc Hoàng Kiếm Đạo
青木剑道=Thanh Mộc Kiếm Đạo
青楼女子=thanh lâu nữ tử
青海=Thanh Hải
青瀛=Thanh Doanh
青灵剑法=Thanh Linh Kiếm Pháp
青竹剑=Thanh Trúc kiếm
青竹巷=Hẻm Thanh Trúc
青纱剑法=Thanh Sa Kiếm Pháp
青纹道长=Thanh Văn đạo trưởng
青药仙门=Thanh Dược Tiên Môn
青药门=Thanh Dược Môn
青衣=Thanh Y
青衣人=Thanh Y Nhân
青衣楼=Thanh Y lâu
青衣楼主=Thanh Y lâu chủ
青角龙=Thanh Giác Long
青锋=Thanh Phong
青风观=Thanh Phong quan
青魔手=Thanh Ma Thủ
青龙升大地=Thanh Long Thăng Đại Địa
静湖灵剑=Tĩnh Hồ Linh Kiếm
靛色长生果=Trường Sinh Quả màu chàm
非凡马=phi phàm mã
非金丹=không phải kim đan
面对生死=đối mặt sinh tử
鞭尸剑法=Tiên Thi Kiếm Pháp
鞭神西门柔=Tiên Thần Tây Môn Nhu
韦东奇=Vi Đông Kỳ
韦陀掌=Vi Đà Chưởng
韦陀菩萨=Vi Đà Bồ Tát
韦青=Vi Thanh
韩青柏=Hàn Thanh Bách
音魂定杀剑=Âm Hồn Định Sát Kiếm
音魂定杀剑法=Âm Hồn Định Sát Kiếm Pháp
顶峰了=đỉnh phong
项一飞=Hạng Nhất Phi
顾兮=Cố Tịch
顾家=Cố gia
顾秋水=Cố Thu Thủy
顾迷=Cố Mê
顾道人=Cố Đạo Nhân
领袖峰=Lãnh Tụ phong
颠倒乾坤五行移行大法=Điên Đảo Càn Khôn Ngũ Hành Di Hành Đại Pháp
颤巍巍的=run lẩy bẩy
颤颤巍巍的=run run rẩy rẩy
风不惑=Phong Bất Hoặc
风中劲草=Phong Trung Kính Thảo
风之剑意=Phong Chi Kiếm Ý
风之文明=Phong Chi Văn Minh
风云一百零八剑=Phong Vân 108 Kiếm
风云一百零八式=Phong Vân Nhất Bách Linh Bát Thức
风云剑客=Phong Vân kiếm khách
风云急变=Phong Vân Cấp Biến
风动天灭=Phong Động Thiên Diệt
风卷残楼=Phong Quyển Tàn Lâu
风吹云卷=Phong Xuy Vân Quyển
风呼啸=gió gào thét
风啸雨=Phong Khiếu Vũ
风圣腿=Phong Thánh Thối
风圣腿法=Phong Thánh Thối Pháp
风圣腿法之动风云=Phong Thánh Thối Pháp Chi Động Phong Vân
风圣腿法之神风怒嚎=Phong Thánh Thối Pháp Chi Thần Phong Nộ Hào
风圣腿法之风旋天转=Phong Thánh Thối Pháp Chi Phong Toàn Thiên Chuyển
风圣腿法之风涌九天=Phong Thánh Thối Pháp Chi Phong Dũng Cửu Thiên
风圣降世=Phong Thánh Giáng Thế
风旋而下=Phong Toàn Nhi Hạ
风流云散=Phong Lưu Vân Tán
风狼=Phong Lang
风神腿=Phong Thần Thối
风系=Hệ Phong
风系剑意=Phong hệ kiếm ý
风行子=Phong Hành Tử
风赫烈=Phong Hách Liệt
风起云涌=Phong Khởi Vân Dũng
风雨江湖=Phong Vũ Giang Hồ
风雪七十二式=Phong Tuyết Thất Thập Nhị Thức
飒露紫=Táp Lộ Tử
飞剑客=Phi Kiếm Khách
飞升=Phi thăng
飞卫=Phi Vệ
飞天剑=Phi Thiên Kiếm
飞天剑仙=Phi Thiên Kiếm Tiên
飞天剑仙楚飞=Phi Thiên Kiếm Tiên Sở Phi
飞天剑法=Phi Thiên Kiếm Pháp
飞天灵剑=Phi Thiên Linh Kiếm
飞快的=Nhanh chóng
飞打飞雨剑法=Phi Đả Phi Vũ Kiếm Pháp
飞燕仙剑=Phi Yến Tiên Kiếm
飞燕剑法=Phi Yến Kiếm Pháp
飞燕惊仙=Phi Yến Kinh Tiên
飞燕斩=Phi Yến Trảm
飞燕盘旋=Phi Yến Bàn Toàn
飞索横空=Phi Tác Hoành Không
飞花掌=Phi Hoa Chưởng
飞雁门=Phi Nhạn môn
飞雨剑仙秦盈=Phi Vũ Kiếm Tiên Tần Doanh
飞鲸帮=Phi Kình bang
飞龙=Phi Long
飞龙剑法=Phi Long Kiếm Pháp
飞龙探云手=Phi Long Tham Vân Thủ
食人草=Thực Nhân Thảo
食月天犬=Thực Nguyệt Thiên Khuyển
食月犬=Thực Nguyệt Khuyển
食月血脉=Thực Nguyệt huyết mạch
饕餮=Đao Thiết
饕餮变=Thao Thiết Biến
香帅=Hương Soái
香菇=Nấm hương
马亦云=Mã Diệc Vân
马烽=Mã Phong
马秀真=Mã Tú Chân
马空群=Mã Không Quần
马车主人=xe ngựa chủ nhân
驼峰=Bướu lạc đà
骆方涯=Lạc Phương Nhai
高佬明=Cao Lão Minh
高天上圣大慈仁者玉皇大天尊玄穹高上帝=Cao Thiên Thượng Thánh Đại Từ Nhân Giả Ngọc Hoàng Đại Thiên Tôn Huyền Khung Cao Thượng Đế
高明=Cao Minh
高等许多=cao hơn nhiều
高长枫=Cao Trường Phong
魂不附体=mất hồn mất vía¦hồn vía lên mây¦sợ mất vía
魏无牙=Ngụy Vô Nha
魏无羡=Ngụy Vô Tiện
魏明凡=Ngụy Minh Phàm
魏皓=Ngụy Hạo
魔之大神=Ma Chi Đại Thần
魔之文明=Ma Chi Văn Minh
魔木崖=Ma Mộc Nhai
魔气法宝=Ma Khí Pháp Bảo
魔法书=Magic book
魔狱万象轮=Ma Ngục Vạn Tượng Luân
魔皇=Ma Hoàng
魔道=Ma Đạo
魔钟=Ma Chung
魔钟霸体=Ma Chung Bá Thể
魔门=Ma Môn
鱼帮=ngư bang
鱼肠剑=Ngư Tràng kiếm
鱼肠短剑=Ngư Trường đoản kiếm
鱼行=ngư hành
鱼过留鳞=cá bơi để lại vày
鱼龙会=Ngư Long hội
鲍大楚=Bảo Đại Sở
鲸鱼吞水=Kình Ngư Thôn Thủy
鸟语林=Điểu Ngữ Lâm
鸡冠=Mào gà
鸡血兰=kê huyết lan
鸿蒙=Hồng Mông
鹤长老=Hạc Trưởng Lão
鹰翅石=Đá Ưng Sí
鹿台=Lộc Đài
鹿尾=Đuôi hươu
鹿筋=Gân hươu
麒麟=Kỳ Lân
麻辣三鲜=Ba món ba cay
黄字=Hoàng tự
黄山林=Hoàng sơn lâm
黄帝=Hoàng Đế
黄帝剑道=Hoàng Đế Kiếm Đạo
黄帝土皇剑道=Hoàng Đế Thổ Hoàng Kiếm Đạo
黄慕侠=Hoàng Mộ Hiệp
黄文豹=Hoàng Văn Báo
黄日华=Huỳnh Nhật Hoa
黄河九曲任碧凝=Hoàng Hà Cửu Khúc Nhậm Bích Ngưng
黄清化=Hoàng Thanh Hóa
黄色长生果=Trường Sinh Quả màu vàng
黄蓉蓉=Hoàng Dung Dung
黄衫=Hoàng Sam
黄金一代=Thế hệ Hoàng Kim
黄门长=Hoàng môn trưởng
黄鸡=Hoàng Kê
黄鸡大师=Hoàng Kê đại sư
黄鹂鸟=Chim vàng anh
黄龙妖王=Hoàng Long Yêu Vương
黄龙妖王轩辕一=Hoàng Long Yêu Vương Hiên Viên Nhất
黍米=Thử Mễ
黑之剑道=Hắc Chi Kiếm Đạo
黑剑客慕容暗=Hắc Kiếm Khách Mộ Dung Ám
黑帝=Hắc Đế
黑帝剑道=Hắc Đế Kiếm Đạo
黑帝水皇剑道=Hắc Đế Thủy Hoàng Kiếm Đạo
黑教=Hắc Giáo
黑暗=Hắc Ám
黑暗剑慕容暗=Hắc Ám Kiếm Mộ Dung Ám
黑暗妖皇=Hắc Ám Yêu Hoàng
黑暗魔帝荆还真=Hắc Ám Ma Đế Kinh Hoàn Chân
黑暗魔皇=Hắc Ám Ma Hoàng
黑暗魔皇荆还真=Hắc Ám Ma Hoàng Kinh Hoàn Chân
黑木崖=Hắc Mộc Nhai
黑水河=Hắc Thủy Hà
黑水王蛇=Hắc Thủy Vương Xà
黑色劫云丹=Hắc Sắc Kiếp Vân Đan
黑钟=hắc chung
黑铁时代=Thời đại Hắc Thiết
黑面君=Hắc Diện Quân
黑风老妖=Hắc Phong Lão Yêu
黑龙=Hắc Long
黑龙吞日月=Hắc Long Thôn Nhật Nguyệt
黯然销魂=Ảm Nhiên Tiêu Hồn
齐国=Nước Tề
齐天大圣=Tề Thiên Đại Thánh
齐天山=Tề Thiên Sơn
齐家子弟=Tề gia con cháu
齐思明=Tề Tư Minh
齐浩之=Tề Hạo Chi
齐王府=Tề Vương phủ
龙凤双灵剑=Long Phượng Song Linh Kiếm
龙四海=Long Tứ Hải
龙四爷=Long tứ gia
龙威=Long Uy
龙子=Long Tử
龙小云=Long Tiểu Vân
龙帝=Long Đế
龙游苍穹=Long Du Thương Khung
龙炎之神=Long Viêm Chi Thần
龙爪手=Long Trảo Thủ
龙生九子=Long Sinh Cửu Tử
龙神庙=Long Thần Miếu
龙腾虎跃=long đằng hổ dược
龙虎飞升经=Long Hổ Phi Thăng Kinh
龙血脉=long huyết mạch
龙越千峰=Long Việt Thiên Phong
龙躯的=long khu
龙首剑=Long Thủ Kiếm
龙鲨=Long Sa
龙鲸=Long Kình
龟甲=Quy Giáp
龟蛇二将=Quy Xà nhị tướng
龟蛇二山=Quy Xà Nhị Sơn