两人目=hai người mắt
两师兄弟=hai sư huynh đệ
李雾龙=Lý Vụ Long
甚至已经=thậm chí đã
豹尾脚=Báo Vĩ Cước
虹蓝七侠传=Hồng Lam Thất Hiệp Truyện
快螳螂=Khoái Đường Lang
老七剑=Lão Thất Kiếm
俏小龙=Tiếu Tiểu Long
熊猫阿宝=Gấu trúc A Bảo
神龙秘籍=Thần Long Bí Kíp
神龙卷轴=Thần Long Quyển Trục
盖世五侠=Ngũ Hiệp Cái Thế
和平谷=Thung lũng Hòa Bình
翡翠之刃=Phỉ Thúy Chi Nhận
浣熊大师=Sư phụ Gấu Mèo
刺猬大师=Sư phụ Nhím
翡翠僵尸=Cương thi Ngọc Bích
乌龟大师=Sư phụ Rùa
天魔之刃=Thiên Ma Chi Nhận
紫云真气=Tử Vân Chân Khí
黑鹰传书=Hắc Ưng Truyền Thư
神仙迷心丸=Thần Tiên Mê Tâm Hoàn
鳄鱼帮=Băng Cá Sấu
功夫熊猫世界=Thế giới Kungfu Panda
酱爆=Tương Bạo
苦力强=Khổ Lực Cường
东方神乞=Đông Phương Thần Khất
肥仔聪=Phì Tử Thông
降龙神丐=Hàng Long Thần Cái
天香公主=Thiên Hương Công Chúa
达摩洞=Đạt Ma Động
火舞旋风=Hỏa Vũ Toàn Phong
九阳大霹雳=Cửu Dương Đại Phích Lịch
天魔大霹雳=Thiên Ma Đại Phích Lịch
天魔大化=Thiên Ma Đại Hóa
大黑虎佛=Đại Hắc Hổ Phật
金鞭溪=Kim Tiên Khê
雨花剑主=Vũ Hoa Kiếm Chủ
奔雷剑主=Bôn Lôi Kiếm Chủ
旋风剑主=Toàn Phong Kiếm Chủ
十里画廊=Thập Lí Họa Lang
紫云剑主莎丽=Tử Vân Kiếm Chủ Sally
狂刀怒剑=Cuồng Đao Nộ Kiếm
雅典娜一号=Athena 1
哈维拉塞尔=Harvey Russell
鳄鱼利兹=Cá sấu Liz
灰狼拉夫尔=Sói xám Laffer
猩猩乔治=Tinh tinh George
马克48重型线导鱼雷=Ngư lôi dẫn đường hạng nặng Mark 48
格拉斯中校=Trung tá Glass
雷电交加=Lôi Điện Giao Gia
虹蓝=Hồng Lam
天门观想法=Thiên Môn Quan Tưởng Pháp
黑虎大佛=Hắc Hổ Đại Phật
快活林酒坊=Khoái Hoạt Lâm Tửu Phường
黑无情=Hắc Vô Tình
战狼军团=Chiến Lang Quân Đoàn
天魔乱舞大法=Thiên Ma Loạn Vũ Đại Pháp
蝙蝠战团=Biên Bức Chiến Đoàn
破空术=Phá Không Thuật
天魔三噬=Thiên Ma Tam Phệ
青龙降魔=Thanh Long Hàng Ma
雨花剑=Vũ Hoa Kiếm
孝义黑三郎=Hiếu Nghĩa Hắc Tam Lang
斩侠大会=Trảm Hiệp Đại Hội
青光剑主=Thanh Quang Kiếm Chủ
百草谷=Bách Thảo Cốc
青光剑=Thanh Quang Kiếm
灵泉宝玉=Linh Tuyền Bảo Ngọc
天狼法杖=Thiên Lang Pháp Trượng
天狼神功=Thiên Lang Thần Công
一阳神功=Nhất Dương Thần Công
七剑合璧=Thất Kiếm Hợp Bích
藤甲军团=Đằng Giáp Quân Đoàn
天狼堂=Thiên Lang Đường
黑三郎=Hắc Tam Lang
枫叶大阵=Phong Diệp Đại Trận
紫云剑法=Tử Vân Kiếm Pháp
风云天诀=Phong Vân Thiên Quyết
狂雷天牢=Cuồng Lôi Thiên Lao
枫叶武士=Phong Diệp võ sĩ
鼠族大祭司=Thử tộc Đại Tế Tư
女娲大神=Nữ Oa Đại Thần
地心之谷=Địa Tâm Chi Cốc
紫玉佩=Tử Ngọc Bội
六阳魁首=Lục Dương Khôi Thủ
元极摩柯无量=Nguyên Cực Ma Kha Vô Lượng
云无常=Vân Vô Thường
天池十二杀手=Thiên Trì Thập Nhị Sát Thủ
回元血手=Hồi Nguyên Huyết Thủ
食为先=Thực Vi Tiên
地极摩诃无量=Địa Cực Ma Kha Vô Lượng
瑞兽凤血=Thụy Thú Phượng Huyết
万载泪泉=Vạn Tải Lệ Tuyền
鬼叉罗=Quỷ Xoa La
十大气忍=Thập Đại Khí Nhẫn
金叉罗=Kim Xoa La
五雷化极手=Ngũ Lôi Hóa Cực Thủ
圣心真气=Thánh Tâm Chân Khí
纵意登仙步=Túng Ý Đăng Tiên Bộ
邪血劫=Tà Huyết Kiếp
瑞兽精元=Thụy Thú Tinh Nguyên
北方冰原=Bắc Phương Băng Nguyên
寒冰面具=Hàn Băng Diện Cụ
圣心功=Thánh Tâm Công
金灶沐=Kim Táo Mộc
火无定=Hỏa Vô Định
雷无向=Lôi Vô Hướng
东瀛紫气宗=Đông Doanh Tử Khí Tông
他生渡=Tha Sinh Độ
颜盈=Nhan Doanh
三分教场=Tam Phân Giáo Trường
扶我起来我还能继续战斗=Đỡ ta dậy ta vẫn còn có thể tiếp tục chiến đấu
喵绅士=Miêu thân sĩ
胜166=Thắng 166
不喜欢看书的我又来了=Tôi không thích đọc sách lại đến rồi
紫翼魔尊=Tử Dực Ma Tôn
闪闪爱=Lấp lánh yêu
啊尔何求=A Nhĩ Hà Cầu
詹琉璃=Chiêm Lưu Li
幽冥界八云易=U Minh Giới Bát Vân Dịch
凤兮凤兮归故乡=Phượng hề phượng hề quy cố hương
遨游四海求其凰=Ngao du tứ hải cầu kỳ hoàng
无极拈花指=Vô Cực Niêm Hoa Chỉ
碎天绝手=Toái Thiên Tuyệt Thủ
老天皇=Lão Thiên Hoàng
南麟剑首断帅=Nam Lân Kiếm Thủ Đoạn Soái
北饮狂刀聂人王=Bắc Ẩm Cuồng Đao Nhiếp Nhân Vương
劫王=Kiếp Vương
贪狼剑=Tham Lang Kiếm
僧皇=Tăng Hoàng
锐金剑气=Nhuệ Kim Kiếm Khí
步氏神族=Bộ Thị Thần Tộc
东瀛宣化号=Đông Doanh Tuyên Hóa Hiệu
悲痛莫名=Bi Đau Mạc Danh
无形道=Vô Hình Đạo
温驽=Ôn Nô
冷胭=Lãnh Yên
五行领域=Ngũ Hành Lĩnh Vực
剑蝎纵横行=Kiếm Hạt Túng Hoành Hành
剑蝎=Kiếm Hạt
四方魔渡行=Tứ Phương Ma Độ Hành
九空为一念，九空无界是意念的世界，在这里可以能外界之不能=Cửu Không Vi Nhất Niệm, Cửu Không Vô Giới Thị Ý Niệm Đích Thế Giới, Tại Giá Lý Khả Dĩ Năng Ngoại Giới Chi Bất Năng
剑扫乾坤=Kiếm Tảo Càn Khôn
天魔九噬=Thiên Ma Cửu Phệ
众生由我灭=Chúng Sinh Do Ngã Diệt
玄冰护体=Huyền Băng Hộ Thể
大黑暗天法象=Đại Hắc Ám Thiên Pháp Tượng
乾坤任我行=Càn Khôn Nhậm Ngã Hành
铸剑池=Chú Kiếm Trì
明台桥=Minh Đài Kiều
四大瑞兽=Tứ Đại Thụy Thú
惊瑞之期=Kinh Thụy Chi Kỳ
铁心岛=Thiết Tâm Đảo
水神岛=Thủy Thần Đảo
水神王=Thủy Thần Vương
长生不死之神=Trường Sinh Bất Tử Chi Thần
神武纪=Thần Võ Kỷ
浑天四绝=Hỗn Thiên Tứ Tuyệt
傲剑山庄=Ngạo Kiếm Sơn Trang
歩渊亭=Bộ Uyên Đình
玄阴剑晨=Huyền Âm Kiếm Thần
剑岳=Kiếm Nhạc
天魔六欲五行破灭大混洞妙法=Thiên Ma Lục Dục Ngũ Hành Phá Diệt Đại Hỗn Động Diệu Pháp
陆惊天=Lục Kinh Thiên
麒麟套装=Kỳ Lân Sáo Trang
鳄魔兵团=Ngạc Ma Binh Đoàn
黑虎洞=Hắc Hổ Động
鼠后=Thử Hậu
白鼠谷=Bạch Thử Cốc
五行晶石=Ngũ Hành Tinh Thạch
千年老树妖=Thiên Niên Lão Thụ Yêu
白蛇缘起=Bạch Xà Duyên Khởi
右国师府=Hữu Quốc Sư phủ
太阴宗=Thái Âm Tông
玉龙阴狐和合功=Ngọc Long Âm Hồ Hòa Hợp Công
五通邪神=Ngũ Thông Tà Thần
五通镇=Ngũ Thông trấn
五通庙=Ngũ Thông miếu
山君庙=Sơn Quân miếu
拿山君庙=Ná Sơn Quân Miếu
郭北镇=Quách Bắc Trấn
千年僵尸王=Thiên Niên Cương Thi Vương
金蜈火毒=Kim Ngô Hỏa Độc
鬼王九尾狐=Quỷ Vương Cửu Vĩ Hồ
太阴玄冰阵=Thái Âm Huyền Băng Trận
宝青坊主=Bảo Thanh Phường Chủ
太阴上人=Thái Âm Thượng Nhân
蛇母=Xà Mẫu
宝青坊=Bảo Thanh Phường
乾皇=Càn Hoàng
五行先天功=Ngũ Hành Tiên Thiên Công
韩偓=Hàn Ác
赤炎火龙阵=Xích Diễm Hỏa Long Trận
知秋一叶=Tri Thu Nhất Diệp
麒麟甲=Kỳ Lân Giáp
梓诉=Tử Tố
天悬白练=Thiên Huyền Bạch Luyện
达达=Đạt Đạt
大黑暗天=Đại Hắc Ám Thiên
聚元宝鼎=Tụ Nguyên Bảo Đỉnh
凤舞天际=Phượng Vũ Thiên Tế
紫兔=Tử Thỏ
邪蛟=Tà Giao
玉兔仙子=Ngọc Thố Tiên Tử
钱江大坝=Tiền Giang Đại Bá
灵山渡=Linh Sơn Độ
灵山引=Linh Sơn Dẫn
灵山掌=Linh Sơn Chưởng
灵山门主=Linh Sơn môn chủ
黑龙剑=Hắc Long Kiếm
雪山族=Tuyết Sơn Tộc
莫仇=Mạc Cừu
凌云十八骑=Lăng Vân Thập Bát Kỵ
莫将=Mạc Tương
怒剑=Nộ Kiếm
怒剑狂刀=Nộ Kiếm Cuồng Đao
雪舍利=Tuyết Xá Lợi
雪岛上人=Tuyết Đảo Thượng Nhân
七侠虹猫=Thất Hiệp Hồng Miêu
科目三=Khoa mục 3
马三娘=Mã Tam Nương
金鞭溪客栈=Kim Tiên Khê Khách Sạn
紫云剑主=Tử Vân Kiếm Chủ
倩女幽魂世界=Thế giới Thiện Nữ U Hồn
诸世纪=Các thế kỷ
八大恶魔=Bát Đại Ác Ma
八大魔气=Bát Đại Ma Khí
八大不死神明=Bát Đại Bất Tử Thần Minh
十二生肖动物=Thập Nhị Sinh Tiếu Động Vật
十二符咒=Thập Nhị Phù Chú
圣主符咒=Thánh Chủ Phù Chú
八大恶魔篇=Bát Đại Ác Ma Thiên
十二生肖动物篇=Thập Nhị Sinh Tiếu Động Vật Thiên
鬼影军团篇=Quỷ Ảnh Quân Đoàn Thiên
八大魔气篇=Bát Đại Ma Khí Thiên
布莱克警长=Cảnh trưởng Blake
黑影王国=Vương quốc Bóng tối
潘库=Phan Khố
大自然灵心=Đại Tự Nhiên Linh Tâm
尼嘉将军=Tướng quân Ni Gia
洛佩=Lạc Bội
林氏王朝=Lâm Thị vương triều
恐怖大王=Khủng Bố Đại Vương
山之恶魔波刚=Ác ma núi Bagan
东瀛四岛=Bốn đảo Đông Doanh
蝰蛇武装直升机=Trực thăng vũ trang Viper
M4尾翼稳定贫铀穿甲弹=Đạn xuyên giáp ổn định cánh đuôi M4 bằng uranium nghèo
帝国恶魔攻略计划=Kế hoạch chinh phục ác ma đế quốc
巨山相扑超魔兽=Quái thú Sumo Siêu Ma Núi Lớn
大力神发射井=Giếng phóng Đại Lực Thần
睡熊猛醒=Thụy Hùng Mãnh Tỉnh
小鱼水中游=Tiểu Ngư Thủy Trung Du
黑山神拳=Hắc Sơn Thần Quyền
周瑟=Chu Sắt
鬼影兵团=Quỷ Ảnh Binh Đoàn
雷电恶魔中苏=Lôi Điện Ác Ma Trung Tô
橄榄之国弗朗机=Nước Olive Phlang Cơ
潘普洛纳古城=Cổ thành Pamplona
月之恶魔=Ác ma mặt trăng
水之恶魔=Ác ma nước
雷电恶魔=Ác ma sấm sét
风之恶魔=Ác ma gió
亚拉伦拉府=Government House
澳国总统=Tổng thống Úc
米国总统=Tổng thống Mỹ
牛战士=Ngưu Chiến Sĩ
乌鲁鲁巨岩=Uluru Cự Nham
黑手帮=Hắc Thủ Bang
虎头佛母森多玛=Hổ Đầu Phật Mẫu Sâm Đa Mã
方大法师=Phương Đại Pháp Sư
神明战甲=Thần minh chiến giáp
欧若拉之眼=Đôi mắt của Aurora
路长官=Lộ trưởng quan
龙小组=Long Tiểu Tổ
冲绳色=Màu Okinawa
加州金色=Màu vàng California
伊卡将军=Tướng quân Yka
潘库宝盒=Hộp Bàn Khố
波士顿芬威球场=Sân vận động Fenway Park Boston
空谷罪犯感化院=Trại cải huấn tội phạm Thung lũng Không
波刚=Ba Cương
地魁=Địa Khôi
瓦龙=Ngõa Long
西木=Tây Mộc
中苏=Trung Tô
咒蓝=Chú Lam
恶魔小龙=Ác Ma Tiểu Long
阿奋=A Phấn
老山羊=Lão Sơn Dương
刀龙=Đao Long
特鲁妈妈=Mẹ Tulu
埃尔斯巨岩=Tảng đá khổng lồ Els
成龙历险记】=Những cuộc phiêu lưu của Thành Long
鬼影王国=Quỷ Ảnh Vương Quốc
迷魂台=Mê Hồn Đài
凤凰大典=Phượng Hoàng Đại Điển
鬼影军团=Quỷ Ảnh Quân Đoàn
天音门=Thiên Âm Môn
天音老人=Thiên Âm lão nhân
天音谷=Thiên Âm Cốc
金忍者=Kim Ninja
土忍者=Thổ Ninja
红烧牛肉面=Mì bò kho tàu
鬼影忍者=Quỷ Ảnh Ninja
鳄魔=Ngạc Ma
五行忍者=Ngũ Hành Nhẫn Giả
巨魔兵=Cự Ma Binh
巨魔团=Cự Ma Đoàn
鬼影巨魔=Quỷ Ảnh Cự Ma
刺刃团=Thứ Nhận Đoàn
灵山门=Linh Sơn Môn
天命圣教=Thiên Mệnh Thánh Giáo
玉蟾宫=Ngọc Thiềm Cung
怪兽行星=Hành tinh quái vật
妖星格拉斯=Yêu tinh Grass
大哥斯拉=Đại Godzilla
机械哥斯拉=Mecha Godzilla
虹猫蓝兔=Hong Mao Lan Tu
伏斯亚人=Người Exif
伏斯亚=Phục Tư Á
虹猫仗剑走天涯=Hồng Miêu Trượng Kiếm Tẩu Thiên Nhai
天狼门=Thiên Lang Môn
马克50战甲=Áo Giáp Mark 50
绿魔飞行器=Phi Thuyền Lục Ma
棕发女=Tóc Nâu Nữ
金发男=Tóc Vàng Nam
马克50=Mark 50
X战警：第一战=X-Men: Thế Hệ Đầu Tiên
塞巴斯蒂安—肖=Sebastian Shaw
金狼百兽王=Kim Lang Bách Thú Vương
铁鬃灰熊=Thiết Tông Hôi Hùng
马克50钢铁战甲=Áo giáp sắt Mark 50
塞巴斯蒂安肖=Sebastian Shaw
武大强=Võ Đại Cường
快乐星猫=Happy Star Cat
善恶平衡器=Thiện Ác Bình Hành Khí
十二星座战士=Thập Nhị Tinh Tọa chiến sĩ
天界法庭=Thiên Giới Pháp Đình
星座战士=Tinh Tọa Chiến Sĩ
天兵队长=Đội trưởng Thiên Binh
狗将军=Cẩu Tướng Quân
天神星乐园化计划=Kế hoạch Lạc Viên hóa Thiên Thần Tinh
十二星座装甲=Thập Nhị Cung Tinh Tọa Trang Giáp
天神星防护罩=Thiên Thần Tinh Phòng Hộ Tráo
大力猫=Đại Lực Miêu
天界判官=Thiên Giới Phán Quan
白羊虚影=Bạch Dương Hư Ảnh
星座装甲=Tinh Tọa Trang Giáp
白羊武士=Bạch Dương Võ Sĩ
黑云巨人=Hắc Vân Cự Nhân
磁力小丑=Từ Lực Tiểu Sửu
双子飞碟=Song Tử Phi Điệp
金牛战车=Kim Ngưu Chiến Xa
霸王装甲=Bá Vương Trang Giáp
华丽贵族=Hoa Lệ Quý Tộc
神盾巨蟹=Thần Thuẫn Cự Giải
烈火狮王=Liệt Hỏa Sư Vương
巨人骑士=Cự Nhân Kỵ Sĩ
净化天使=Tịnh Hóa Thiên Sứ
太白老爹=Thái Bạch Lão Đệ
天使光环=Thiên Sứ Quang Hoàn
魔化天使=Ma Hóa Thiên Sứ
魔化大天神=Ma Hóa Đại Thiên Thần
葫芦娃大战变形金刚=Hồ Lô Oa đại chiến Biến Hình Kim Cương
上单狗头=Đường trên Đầu Chó
闰土=Nhuận Thổ
水瓶判官=Thủy Bình Phán Quan
双鱼判官=Song Ngư Phán Quan
天秤判官=Thiên Xứng Phán Quan
摩羯判官=Ma Kết Phán Quan
白羊判官=Bạch Dương Phán Quan
星猫=Tinh Miêu
欧应万=Âu Ứng Vạn
黑魔王=Hắc Ma Vương
虹猫=Hồng Miêu
雪晶夫人=Tuyết Tinh phu nhân
蓝兔=Lam Thỏ
神将飞蓬=Thần Tướng Phi Bồng
北海幼儿园=Bắc Hải Nhà trẻ
唯清=Duy Thanh
仙风云体术=Tiên Phong Vân Thể Thuật
摄天剑=Nhiếp Thiên Kiếm
风雷妖鸟=Phong Lôi Yêu Điểu
创界山=Sáng Giới Sơn
沙福林=Sa Phúc Lâm
里蜀山=Lý Thục Sơn
红葵=Hồng Quỳ
蓝葵=Lam Quỳ
天魔国=Thiên Ma Quốc
天帝伏羲=Thiên Đế Phục Hy
迦楼罗族=Gia Lâu La Tộc
天魔女葵羽=Thiên Ma Nữ Quỳ Vũ
白苗族=Bạch Miêu Tộc
专职消防员=Lính cứu hỏa chuyên trách
景菁=Cảnh Tinh
靳韵翠=Cận Vận Thúy
四天玄男=Tứ Thiên Huyền Nữ
春滋泉=Xuân Tư Tuyền
炎波血刃=Viêm Ba Huyết Nhận
盘螭神云枪=Bàn Si Thần Vân Thương
天玄神刃=Thiên Huyền Thần Nhận
唯敬=Duy Kính
女娲血玉=Nữ Oa Huyết Ngọc
夕瑶玄女=Tịch Dao Huyền Nữ
雷土灵珠=Lôi Thổ Linh Châu
太古魔兽=Thái Cổ Ma Thú
春滋神泉=Xuân Tư Thần Tuyền
永安当=Vĩnh An Đương
古姜国=Cổ Khương Quốc
葵羽玄女=Quỳ Vũ Huyền Nữ
茂茂=Mậu Mậu
林业平=Lâm Nghiệp Bình
玄道观=Huyền Đạo Quán
雷魔兽=Lôi Ma Thú
古藤林=Cổ Đằng Lâm
云霆=Vân Đình
安溪海底城=An Khê Hải Để Thành
炎波泉=Viêm Ba Tuyền
火鬼王=Hỏa Quỷ Vương
凌霄神殿=Lăng Tiêu Thần Điện
照胆泉=Chiếu Đảm Tuyền
风魔兽=Phong Ma Thú
天蛇杖=Thiên Xà Trượng
圣灵披风=Thánh Linh Phi Phong
神界天池=Thiên Trì Thần Giới
土魔兽=Thổ Ma Thú
顾留芳=Cố Lưu Phương
至净法=Chí Tịnh Pháp
蜀山灵脉=Thục Sơn linh mạch
水火土风雷=Thủy Hỏa Thổ Phong Lôi
虹猫蓝兔七侠传世界=Hồng Miêu Lam Thố Thất Hiệp Truyện thế giới
毕鲁萨鲁多=Tất Lỗ Tát Lỗ Đa
葵羽=Quỳ Vũ
毕鲁萨鲁多族长=Tộc trưởng Bilusaldo
迪迦奥特曼世界=Thế giới Ultraman Tiga
炎魔战士基里艾洛德人二代=Chiến binh Quỷ Lửa Kirieloid II
炎魔战士基里艾洛德人=Chiến binh Quỷ Lửa Kirieloid
基里艾洛德之神=Thần Kirieloid
变种人黑皇=Dị nhân Black King
仙剑的世界=Thế giới Tiên Kiếm
地球和平联合组织=Tổ chức Liên hợp Hòa bình Trái Đất
远东总部=Tổng bộ Viễn Đông
蒙平原=Mông Bình Nguyên
黑暗的支配者加坦杰厄=Kẻ thống trị bóng tối Gatanothor
行星斯菲亚=Hành tinh Sphia
飞燕一号=Phi Yến 1
火魔兽=Hỏa Ma Thú
火焰哥尔赞=Hỏa Diễm Gorzam
贝琉多拉=Belial Dora
新麦克斯炮=Tân Mạch Khắc Tư Pháo
黄金行星=Hoàng Kim Hành Tinh
毕鲁萨鲁多人=Tất Lỗ Tát Lỗ Đa Nhân
久良良岛屿=Cửu Lương Lương Đảo屿
石化怪兽加库玛=Thạch Hóa Quái Thú Gia Khố Mã
飞燕二号=Phi Yến Nhị Hào
引妖香=Dẫn Yêu Hương
重力球=Trọng Lực Cầu
菊石兽=Cúc Thạch Thú
加库玛阿尔法=Gia Khố Mã An Nhĩ Pháp
加库玛贝塔=Gia Khố Mã Bối Tháp
铁血星球=Thiết Huyết Tinh Cầu
佐斯星系=Hệ sao Zoss
泽井=Trạch Tỉnh
兰帕尔特光弹=Đạn Ánh Sáng Rampart
露露耶=Lộ Lộ Gia
铁血星人=Người Sắt Máu
克里莫斯群岛=Quần đảo Kremos
宇宙球体斯菲亚=Quả Cầu Vũ Trụ Sphia
戴西斯星系=Hệ Daiysis
宇宙钢铁龙=Long thép vũ trụ
吉纲参谋长=Tham mưu trưởng Kitsuna
无限麦克斯系统=Hệ thống Max vô hạn
宇宙钢铁龙古瓦木=Long thép vũ trụ Guwamu
斯菲亚球体=Hình cầu Sphia
戴西斯星人=Người Dessis
斯菲亚生命体=Thực thể sống Sphia
胜利飞燕号=Victory Flier
基里艾洛德预言家=Nhà tiên tri Kiri-elod
炎魔战士=Chiến binh Yan Ma
铁血星=Tinh cầu Thiết Huyết
迪迦世界=Thế giới Tiga
德克萨斯炮=Đức Khắc Tát Tư Pháo
六勾玉轮回眼=Lục Câu Ngọc Luân Hồi Nhãn
辛辣天塞=Shinra Tensei
阿瑞斯号战舰=Chiến hạm Ares
铠甲勇士刑天=Khải Giáp Dũng Sĩ Hình Thiên
骷髅女=Khô Lâu Nữ
飞龙再生=Phi Long Tái Sinh
沙漠死神内瑟斯=Sa Mạc Tử Thần Nasus
阿瑞斯号=Ares Hào
哥布纽=Gobu Nu
奥古玛=Áo Cổ Mã
知树=Tri Thụ
塞迪克科技公司=Công ty Khoa học Kỹ thuật Sedic
泽井总监=Tổng giám đốc Sawai
吉纲参谋=Tham mưu trưởng Yoshitsugu
苍月奥特曼=Ultraman Trăng Xanh
幽怜=U Liên
钢甲铁面人=Người Mặt Sắt Bọc Thép
宗方副队长=Đội trưởng phó Munakata
无限麦克斯动力系统=Hệ thống động lực Max Vô Hạn
邪迪=Tà Diga
宿那山=Núi Sukuna
宿那鬼=Ác quỷ Sukuna
黑暗行星古兰斯菲亚=Hành tinh Hắc ám Guransufia
虎魄刀=Đao Hổ Phách
合成兽达兰比尔=Quái thú tổng hợp Daranbir
格兰雷恩=Gran Reign
真田良介=Chân Điền Lương Giới
艾勃隆=Ngải Bột Long
希特拉=Hi Tạp Lạp
达拉姆=Đạt Lạp Mỗ
TPC远东总部=Tổng bộ Viễn Đông TPC
亚克迪斯号=Tàu Yacdes
八尾博士=Tiến sĩ Yawei
黑暗迪迦=Diga Bóng Tối
基加哥布纽=Giga Gebonew
胜利队=Đội Chiến Thắng
德拉姆车=Xe Dram
自杀仙人=Tiên Nhân Tự Tử
时空界=Giới Thời Không
古兰斯菲亚=Goulud Sphire
彩虹魔境=Cầu Vồng Ma Cảnh
银龙希尔巴贡=Ngân Long希尔巴贡
森美队=Sâm Mỹ Đội
异次元魔神艾塔尔加=Dị Thứ Nguyên Ma Thần艾塔尔加
时空城=Thời Không Thành
野瑞=Dã Thụy
崛井=Quật Tỉnh
狮子树海=Sư Tử Thụ Hải
美森队=Đội Mĩ Sâm
金龙戈尔德拉斯=Kim Long Goldras
庚伮金刚杵=Geng Nu Kim Cang Chử
奥特赛文=Ultra Seven
奥特之父=Ultra Father
南无迪迦古佛=Nam mô Địch Gia Cổ Phật
光之国=Quốc gia Ánh sáng
南无初代奥特曼至尊佛=Nam mô Sơ Đại Ultraman Chí Tôn Phật
南无沙福林佛=Nam mô Sa Phước Lâm Phật
南无奥特佛之父=Nam mô Ultraman Chi Phụ
M87至尊佛光=M87 Chí Tôn Phật Quang
奥特大力龙象飞踢=Ultraman Đại Lực Long Tượng Phi Thích
天空魔=Thiên Không Ma
卡拉法尔大帝=Karafar Đại Đế
蓝色行星的爱=Tình Yêu Hành Tinh Xanh
奥特签名=Chữ ký Ultraman
M87光线=Tia M87
哈马行星=Hành tinh Hama
光头强哥=Quang Đầu Cường Ca
黑虎崖=Hắc Hổ Nhai
倩女世界=Thế giới Thiện Nữ
虹猫蓝兔世界=Thế giới Hồng Miêu Lam Thỏ
虎魄空间=Không gian Hổ Phách
黑小虎=Hắc Tiểu Hổ
玄武号飞船=Phi thuyền Huyền Vũ
蝎子女=Thiết Nữ
超兽神=Siêu Thú Thần
元空间=Nguyên Không Gian
蝎子王龙莹=Hạt Tử Vương Long Oánh
青龙族=Thanh Long Tộc
白龙族=Bạch Long Tộc
龙莹=Long Oánh
暗黑魔铠装=Ám Hắc Ma Khải Trang
奥特曼世界=Thế Giới Ultraman
超兽战队=Siêu Thú Chiến Đội
黑海深渊=Hắc Hải Thâm Uyên
玄冥黑洞=Huyền Minh Hắc Động
雷遁星云=Lôi Độn Tinh Vân
Lisa姐=Lisa tỷ
babobo一族=Tộc Babobo
baboo族=Tộc Baboo
暗黑三叉戟=Ám Hắc Tam Xoa Kích
亡月劫=Vong Nguyệt Kiếp
第七平行宇宙=Vũ trụ song song thứ bảy
baboo一族=bộ tộc Baboo
第五平行宇宙=Vũ trụ song song thứ năm
云蝠=Vân Bức
第四平行宇宙=Vũ trụ song song thứ tư
鲸鲨族=Kình Sa Tộc
元正长老=Nguyên Chính trưởng lão
鲸鲨王=Kình Sa Vương
夜枭子=Dạ Kiêu Tử
云蝠阵=Vân Bức trận
云蝠神=Vân Bức Thần
金象族=Kim Tượng tộc
泰雷=Thái Lôi
超兽武装=Siêu Thú Vũ Trang
星云体=Tinh Vân Thể
超兽战士=Siêu Thú Chiến Sĩ
苗条俊=Miêu Điều Tuấn
玄武号=Huyền Vũ Hào
云蝠军团=Vân Bức Quân Đoàn
baboo星球=Tinh cầu Baboo
圣辉星云=Tinh vân Thánh Huy
风耀=Phong Diệu
玄冥之棺=Huyền Minh Chi Quan
玄易子=Huyền Dịch Tử
火麟飞=Hỏa Lân Phi
夜凌云=Dạ Lăng Vân
元空灭=Nguyên Không Diệt
云蝠盾=Vân Bức Thuẫn
第六平行宇宙=Vũ trụ song song thứ sáu
第一平行宇宙=Vũ trụ song song thứ nhất
第二平行宇宙=Vũ trụ song song thứ hai
第三平行宇宙=Vũ trụ song song thứ ba
诸天之门=Chư Thiên Chi Môn
诸天：从破坏之王开始=Chư Thiên: Bắt đầu từ Vua Phá Hoại
