一乐老板=Ichiraku lão bản
不可……能=không thể……nào
不等=không đợi¦không giống nhau¦không bằng¦không bằng nhau¦không giống¦không đều¦không chờ¦không đều¦bất đồng
为天下第一流=là thiên hạ đệ nhất lưu
五怒狂雷=Ngũ Nộ Cuồng Lôi
五百年前=năm trăm năm trước¦500 năm trước
亦非常人=cũng phi thường nhân
休书=hưu thư
传说中的龙元=trong truyền thuyết long nguyên
位神秘=vị thần bí
千川=Chikawa
千川拓=Chikawa Taku
同代天骄=cùng thế hệ Thiên kiêu
地也空=đất cũng không
太极重意而不重形=Thái Cực trọng ý mà không trọng hình
如此了得=cao minh như thế
宁头儿=Ninh đầu nhi
守护神龙=thủ hộ thần long
屠龙之力=Đồ Long chi lực
感谢先生=cảm tạ tiên sinh
愤怒的龙吟=phẫn nộ long ngâm
昭成天皇=Chiêu Thành Thiên Hoàng
更加厚实=càng thêm bền chặt
武先生=Võ tiên sinh
武家=Võ gia
武氏=Võ thị¦Võ Thị
治理天下会=quản lý Thiên Hạ Hội
浑身周围=toàn thân chu vi
灭人心神=Diệt Nhân Tâm Thần
的天下会=Thiên Hạ Hội
神材=thần tài
神父=thần phụ
神话级数=thần thoại cấp số
神龙的躯体=thần long thân thể
能力大部分=năng lực đại bộ phận
解开血脉=giải khai huyết mạch
豪放开口=hào phóng mở miệng
豪放开口道=hào phóng mà nói
道道轨迹=đạo đạo quỹ tích
铲除自己的=diệt trừ bản thân
霍家庄=Hoắc gia trang
龙不与蛇居=long không cùng xà cư
龙凤龟麟=Long Phượng Quy Lân