一招秒杀=nhất chiêu miểu sát
三万八千两=38,000 lượng
三十六计走为上策=ba mươi sáu kế chuồn là thượng sách
不无可能=không phải là không thể
不远处山峰=đỉnh núi không xa
两人走了=hai người đi rồi
何掌门的=Hà chưởng môn
何掌门的弟子=Hà chưởng môn đệ tử
几十年内力=mấy chục năm nội lực
凶手上面=hung thủ phía trên
前六重=tiền lục trọng
四到六招=bốn đến sáu chiêu
大碑天王拳=Đại Bi Thiên Vương Quyền
天翠掌=Thiên Thúy Chưởng
山河湖泊=sơn hà hồ nước
巅峰的=đỉnh phong
开天前=Khai Thiên trước
开天前的=Khai Thiên trước
斩龙腿=Trảm Long Thối
有无道路=hữu vô đạo lộ
未尝不可能=không phải là không thể
未来之力=tương lai chi lực
林奇=Lâm Kỳ
枪决=thương quyết
江白圭=Giang Bạch Khuê
火之高兴=Hỏa Chi Cao Hưng
秦浩和田冲=Tần Hạo và Điền Xung
第九重=đệ cửu trọng¦tầng thứ chín
翠绿色大手=bàn tay lớn màu xanh ngọc
老人家的名字=lão nhân gia tên
蒙冲=Mông Xung
迎宾小姐=tiếp khách tiểu tỷ