三大帮会=tam đại bang hội
上接天星=thượng tiếp thiên tinh
不亏心=không áy náy
个人的修炼=cá nhân tu luyện
什么叫做恐怖=cái gì gọi là khủng bố
修正能力=tu chính năng lực
公孙乾=Công Tôn Càn
凡人寿命=phàm nhân thọ mệnh
出自大家之手=xuất từ đại gia chi thủ
切的=cắt
切萝卜丝=cắt sợi củ cải
卡车大哥=xe tải đại ca
厉老魔=Lệ lão ma
叶、云二人=Diệp , Vân hai người
嘉元盟=Gia Nguyên Minh
在出兵=tại xuất binh
她宝贝的=nàng bảo bối
如此高妙=như thế cao diệu
寂清=yên lặng
寂清的=yên lặng
寻山使=Tầm Sơn Sứ
小段=đoạn ngắn¦Tiểu Đoàn
小爷=tiểu gia¦ông giời con¦ông trời con
就是自家=chính là nhà mình
山山=Sơn Sơn
左山山=Tả Sơn Sơn
很细微的=rất nhỏ bé
很细微的改变=rất nhỏ sửa đổi
恐怖的地步=kinh khủng trình độ
新剑神=Tân Kiếm Thần
明白自己的=hiểu mình
明白自己的意思=hiểu mình ý tứ
杀伐之意=sát phạt chi ý
柳叶刀=Liễu Diệp đao
武魂殿的魂师=Võ Hồn Điện hồn sư
气法要妙至诀=Khí Pháp Yếu Diệu Chí Quyết
炸裂的=nổ tung
竹子=cây trúc¦gậy trúc¦cây tre¦tre trúc¦Trúc tử¦trúc tử
老神仙一般=giống như lão thần tiên
脸色微动=sắc mặt khẽ động
落落=tự nhiên¦thoải mái¦không hợp¦lạc lạc
落落大方=tự nhiên hào phóng
蛟首=giao đầu
衣衫却是干=y sam lại là khô
褚、古、傅、朱=Chử, Cổ, Phó, Chu
谪仙人的存在=sự tồn tại của trích tiên nhân
赵大人=Triệu đại nhân
赵小友=Triệu tiểu hữu
赵神仙=Triệu Thần Tiên
连亲=liên thân
鳄鱼剪=Ngạc Ngư Tiễn
鹰钩鼻=mũi ưng