一箭中的=một tiễn trúng đích
一箭中的,=một tiễn trúng đích
个人的=cá nhân/cá nhân đích
个人的事情=chuyện cá nhân/cá nhân sự tình
个人的感情=tình cảm cá nhân/cá nhân cảm tình
个很美的=rất đẹp
个悲惨的结果=cái kết quả bi thảm/cái bi thảm kết quả
亲下的命令=đích thân ra lệnh
亲手写的=đích thân viết
亲手绑的=đích thân trói
亲点的=đích thân chọn
亲点的将=đích thân điểm tướng
亲自出马的=tự thân xuất mã/đích thân ra tay
亲身遇到的一天=một ngày đích thân gặp phải
人才说的=người mới nói đến/người mới nói đích
众矢之的=chúng chú mục/chúng thỉ chi/cái đích cho mọi người chỉ trích/mục tiêu công kích/cái đích của trăm mũi tên/đối tượng đả kích/bia ngắm của mọi người
另有目地的=có mục đích khác
各论各的=mỗi người một lý/các luận các đích
各走各的=mỗi người đi mỗi bên/các tẩu các/bỏ qua tất cả/ai đi đường nấy/các tẩu các đích
外面世界的=thế giới bên ngoài/thế giới đích bên ngoài
宗的标志=tông đích tiêu chí
实打实喝下去的=thật đả thật hát hạ khứ đích
客客气气的=khách khí/khách khách khí khí/khách khách khí khí đích
家主的嫡长子=con trai lớn của gia chủ/con trưởng đích tôn của gia chủ
家族的人物=gia tộc nhân vật/gia tộc đích nhân vật
家族的异类=gia tộc dị loại
宽的=chiều rộng/rộng
富贵家的=Phú Quý gia
对我方的=đối ngã phương
对攻的=đối công
对的.=đúng.
寻的=tầm/tìm đấy
尋的=tầm
小口的=miệng nhỏ
就输的=tựu thua
屡试屡灵的=lũ thí lũ linh
左家的事=Tả gia sự
左的=trái
帝的年代=Đế niên đại
平静的心湖=bình tĩnh như nước hồ thu/bình tĩnh tâm hồ
广的=rộng
张常的=trương thường
弱的=yếu
强烈的光芒=quang mang mãnh liệt/cường liệt quang mang
归海的神龙=rồng về biển lớn/quy hải thần long
当时的第一道君=đương thời đệ nhất Đạo Quân
当着天下英雄的面=đối mặt với thiên hạ anh hùng/đương trứ thiên hạ anh hùng diện/ngay trước mặt anh hùng thiên hạ
彩虹帮的=thải hồng bang
很介意的=để bụng
很强的报复目地=mục đích báo thù rất lớn
很老的老桥=cầu rất cũ
微笑的人类脸庞=khuôn mặt mỉm cười nhân loại
心头的=trong lòng
必然的事情=chuyện tất nhiên/chuyện sự tình tất nhiên/tất nhiên sự tình
悬的=treo
惊人的长寿=kinh người trường thọ
慢慢的像=chầm chậm hướng
慢慢的坐下=chậm rãi ngồi xuống/chậm rãi ngồi xuống
慢慢的过去=chầm chậm đi qua/chầm chậm đi qua
成人的=trưởng thành/thành nhân
成长的烦恼=Trưởng Thành Phiền Não
戴的=đeo
手心上亘古的月光=thủ tâm thượng tuyên cổ nguyệt quang
拼的=liều chết/hợp lại/liều/liều mạng
捶脚的=chủy cước
新买的=mới mua
无根的浮萍=lục bình không rễ/lục bình không có rể/không có chỗ dựa/vô căn phù bình
无的放矢=bắn tên không đích/không bẩn thỉu
无知的灵魂=linh hồn vô tri/vô tri linh hồn
旧的=cũ/xưa cũ/xưa
是夜家的=là Dạ gia
是要报的=là phải báo
最为弱小的=nhỏ yếu nhất/bèo bọt nhất/nhược tiểu nhất
最亲的=thân nhất
最广的=rộng nhất
最浓的=nồng nhất
最疼的=đau nhất
最瘦的=gầy nhất
最错的=sai nhất
月的弓箭=Nguyệt cung tiễn
有什么修炼的宝典没有=có bảo điển gì để tu luyện hay không
有成对的=có thành đôi
有的放矢=bắn tên có đích/làm việc có chủ đích/làm việc có mục tiêu rõ ràng
有肉的=có thịt
服的=dùng/trang phục
本神的力量=Bản Thần lực lượng
李月娥的怒意=lý nguyệt nga nộ ý
标的=bia/mục tiêu/mục đích/đối tượng/ngọn
树倒猢狲散的=tan đàn xẻ nghé/cây đổ bầy khỉ tan/xẻ đàn tan nghé/thầy bại thì tớ cụp đuôi/Cây đổ bầy Khỉ tan/thụ đảo hồ tôn tán đích
次的=loại này/lần
死妈的血锋城=Tử mẫu Huyết Phong Thành
气嘟嘟的=khí đô đô
油炸的小食=du tạc tiểu thực
洋文的=dương văn
淡淡的寒气=nhàn nhạt hàn khí
深的一层=sâu một tầng
满嘴硬的=cứng miệng
漏的=lộ
漫无边际的闲聊=tán dóc không mục đích
然的=nhưng
特別的=đặc biệt
王八气质的猪=Vương bát khí chất Trư
玩出的把戏=ngoạn xuất bả hí
玻栗草的=pha lật thảo
田家的事=Điền gia sự
百思不得其解的时候=bách tư bất đắc kỳ giải thì hậu
的=/như thế/đích
的一生=một đời/nhân sinh cuộc sống/đích nhân sinh cuộc sống/khi còn sống
的主,=nhân vật,/nhân vật,
的事物=sự vật/vật
的人很少=rất ít người/xác rất ít người/đích xác rất ít người
的人才可以=người mới có thể
的人才感觉=người mới cảm giác
的人才有=người mới có
的人材=nhân tài
的人格=nhân cách
的人气=nhân khí/độ hot
的人缘=nhân duyên
的刺术=thứ thuật/cây kim
的办法=phương pháp xử lý/phương pháp xử lý
的卡影=tạp ảnh
的卢=đích lô/Đích Lô
的厚爱=hậu ái
的去向=hướng đi
的名为=tên là/danh vi
的名称=danh xưng
的吧台=quầy ba/quầy Bar/quầy bar
的土元素=thổ nguyên tố
的士人=sĩ nhân/kẻ sĩ
的士军=sĩ quân
的士卒=binh lính/sĩ tốt
的士卫=sĩ vệ/vệ sĩ
的士子=sĩ tử
的士子们=đám sĩ tử/đích đám sĩ tử
的士庶=sĩ thứ/đích sĩ thứ
的士气=sĩ khí/tinh thần/đích sĩ khí
的士灵兽=sĩ linh thú/đích sĩ linh thú
的士燮=sĩ tiếp/đích sĩ tiếp
的士石=sĩ thạch/đích sĩ thạch
的天分=thiên phú/đích thiên phú
的天地囚笼=thiên địa lao tù/thiên địa tù lung/đích thiên địa tù lung
的天将=Thiên Tướng/đích Thiên Tướng
的天机星=Thiên Cơ tinh/đích Thiên Cơ tinh
的天火尊者=Thiên Hỏa tôn giả/đích Thiên Hỏa tôn giả
的天生媚骨=trời sinh mị cốt/đích trời sinh mị cốt
的天赋了=thiên phú rồi/đích thiên phú rồi
的好人=hảo nhân/đích hảo nhân
的好坏=tốt xấu/đích tốt xấu
的好手=hảo thủ/đích hảo thủ
的好闻=dễ chịu/đích dễ chịu
的师哥=sư ca/đích sư ca
的师尊=sư tôn/đích sư tôn
的年代=niên đại/đích niên đại
的年薪=lương hàng năm/đích lương hàng năm
的当=hợp lý/làm/đích đáng/thoả đáng/coi là/đương/đích mưu/thích đáng
的当代=đương đại/đích đương đại
的当务=đương vụ/đích đương vụ
的当头=phủ đầu/đích phủ đầu
的当朝=đương triều/đích đương triều
的当然=đương nhiên/đích đương nhiên
的手势=thủ thế/đích thủ thế
的手套=bao tay/đích bao tay/thủ sáo
的手工业=thủ công nghiệp/đích thủ công nghiệp
的手札=viết vào/đích viết vào
的手机号=số điện thoại/đích số điện thoại
的手淫=thủ dâm/đích thủ dâm
的手艺=tay nghề/đích tay nghề
的手雷=lựu đạn/đích lựu đạn
的才能.=tài năng./đích tài năng.
的旅途=đường đi/đích đường đi
的根本=căn bản/đích căn bản
的根本印=căn bản ấn/đích căn bản ấn
的根源=căn nguyên/đích căn nguyên
的根骨=căn cốt/đích căn cốt
的正中=chính giữa/đích chính giữa
的正中央=chính trung ương/đích chính trung ương
的正中心=chính trung tâm/đích chính trung tâm
的死城=tử thành/đích tử thành
的死穴=tử huyệt/đích tử huyệt
的清白=thanh bạch/đích thanh bạch
的的=/hiểu rõ/hiểu biết/đích xác/đích thực
的真=đích thực/đích xác
的真主=Chân Chủ/đích chân chủ
的真性情=đích thực tính tình
的真空=đích Chân Không
的真谛=chân lý/đích chân lý
的確=đích xác
的空洞=chỗ trống/đích chỗ trống
的美丽=mỹ lệ/đích mỹ lệ
的萧秋风=Tiêu Thu Phong/đích Tiêu Thu Phong
的角斗=giác đấu/đích giác đấu
的证=đích chứng/căn cứ chính xác/căn cứ xác thực
的话语=lời nói/chính là lời nói/lời/thoại ngữ/đích thoại ngữ
的走开=bỏ đi/đích bỏ đi
的走运=vận may/đích vận may
的道中=đạo trung/đích đạo trung
的长子=trưởng tử/đích trưởng tử
的雷芒=lôi mang/đích lôi mang
的食物 =thực vật/đích thực vật
盏省油的灯=kẻ tầm thường/cây đèn đã cạn dầu
相信自己的眼睛=tin tưởng con mắt của mình/tin vào hai mắt của mình/tin tưởng vào hai mắt của mình/tương tín tự kỷ đích nhãn tình
相接的=tương tiếp đích/đụng vào nhau
相生的=tương sinh đích
省油的灯=đèn đã cạn dầu/tỉnh du đích đăng/kẻ tầm thường/đèn cạn dầu
眾矢之的=cái đích cho mọi người chỉ trích
瞎的=mù/mù đích
矮人们的=các người lùn/các ải nhân/các ải nhân đích
硬生生的=ngạnh sinh sinh/gắng gượng/cứ thế mà/mạnh mẽ/cứng rắn/ngạnh sanh sanh/ngạnh sinh sinh đích
碧阳宗的=bích dương tông/bích dương tông đích
磕头的=dập đầu/dập đầu đích
神秘的人物=nhân vật thần bí/thần bí đích nhân vật
神骏的宝马=bảo mã thần tuấn/thần tuấn đích bảo mã
神魂丹的=Thần Hồn Đan/thần hồn đan đích
离开的人世=ly khai nhân thế
稀有的=hiếm hoi/hi hữu đích
立下的=lập được/lập hạ đích/lập xuống/lập hạ
端的=quả nhiên/đích xác/quả thực/thực/thực ra/đích thực/rốt cuộc/cuối cùng/đầu đuôi/diễn biến/ quả nhiên
端的是=quả nhiên là/mang chính là/đoan đích thị
米高的台阶=mét cao bậc thang/mét cao đích bậc thang
级别的人物=cấp bậc nhân vật/cấp bậc đích nhân vật/nhân vật có cấp bậc/nhân vật có số má
级别的艺人=Cấp Bậc đích Nghệ Nhân
级别的魔法=cấp bậc đích ma pháp
级别的魔法师=cấp bậc của Ma Pháp sư/cấp bậc đích ma pháp sư
纯真的=hồn nhiên/thuần chân đích
给你的亲笔信=đích thân viết cho ngươi
绝对强大的=tuyệt đối cường đại/tuyệt đối cường đại đích
美兹兹的=mỹ tư tư đích
老柳的根部=vài gốc Liễu già/lão liễu đích căn bộ
老柳的根须=rễ cây liễu già/lão liễu đích căn tu
胆的=mật đích
能治愈的=có thể chữa trị/năng trì dũ đích
能源部的=bộ năng lượng/năng nguyên bộ đích
自好的=tự hảo
自的=mục đích bản thân/mục đích tự nhiên
臭哄哄的=xú hống hống/xú hống hống đích
至大的=rất lớn/rất lớn đích
苍桑的=thương tang đích
荒古的帝=Hoang Cổ đích Đế
萧然的事情=sự tình tẻ nhạt/Tiêu Nhiên đích sự tình
落的=rơi/rơi đích
藏所的=tàng sở đích
蛇发女妖的凝视=xà phát nữ yêu đích ngưng thị
蛮骨城的城主=Man Cốt Thành đích Thành Chủ
蜀山剑宫的掌教=Thục Sơn Kiếm Cung đích Chưởng giáo
衔尾的=ngậm đuôi đích
被打的=bị đánh/bị đánh đích
装着睡着的样子=trang trứ thụy trứ đích dạng tử，
要一击中的=muốn một đòn trúng đích
要处置我们的命=đích mệnh phải xử trí chúng ta
要平心静气的=phải bình tâm tĩnh khí đích
观察的焦点=cái đích quan sát
讲的道=giảng đích đạo
证的道=chứng đích đạo/chứng đạo
识人的=biết người đích
该挺的挺=cai đĩnh đích đĩnh
该收的收=cai thu đích thu
该翘的翘=nên vểnh thì vểnh/cai kiều đích kiều
说的道=thuyết đích đạo
谨记你的姓名是炎黄=cẩn ký nhĩ đích tính danh thị Viêm Hoàng
豪气的=hào khí/hào khí đích
贴的=dán/dán đích
贵村的=quý thôn đích
贵气的=quý khí đích
赌气的=tức giận/giận dỗi đích
跑的倒快=chạy thế mà nhanh/bào đích đảo khoái
身上背的=trên người cõng/gánh trên người đích
辛强的话=tân cường đích thoại
过去的知识=biết về quá khứ/tri thức của quá khứ/quá khứ đích tri thức/quá khứ tri thức
过度的恐惧=sợ hãi quá độ/sợ hãi quá độ đích
过的无比=quá đích vô bỉ
运兵舰的=vận binh hạm/vận binh hạm đích
运气的问题=vận khí đích vấn đề
还行的=còn được/còn được đích
追求的道=theo đuổi đích đạo
适合的人才=thích hợp đích nhân tài
遍的=lần/lần đích
道的巅峰=đạo đỉnh phong/đạo đích đỉnh phong
道的指引=Đạo đích chỉ dẫn
邋遢的胖子少年=Lôi thôi đích béo tử thiếu niên
那么容易修炼的,=dễ dàng tu luyện đích như vậy,
都不会的=cũng sẽ không/cũng không biết/đều không biết/đều không biết đích
酒的=rượu/rượu đích
醉的=say/say đích
长空的=bầu trời mênh mông/bầu trời đích
阮家那位琴心天生的才女=Nguyễn Gia vị cầm tâm thiên sinh đích tài nữ
阳光的白鸽=Dương Quang đích Bạch Cát
雪地的血=Tuyết Địa đích Huyết
零的=không đích
雷公打豆腐拣软的欺=lôi công đả đậu hũ/giản nhuyễn đích khi
雷公打豆腐揀軟的欺=lôi công đả đậu hũ/giản nhuyễn đích khi
霜打的茄子=sương đả đích gia tử
霞幽星碧的夜食国=hà u tinh bích đích dạ thực quốc
须的=phải đích
预期的好=dự kì đích hảo
领导的才能=tài năng lãnh đạo/lãnh đạo đích tài năng
风淡云轻的话=phong đạm vân khinh nói/gió nhạt mây nhẹ/phong đạm vân khinh đích thoại
骨刀的=cốt đao đích
高利债的=cao lợi trái đích
高挑的大美女=cao thiêu đích đại mỹ nữ
魔兽领主的=Ma Thú Lĩnh Chủ/ma thú lĩnh chủ/ma thú lĩnh chủ đích
魔家的=ma gia đích
魔法神的祝福=ma pháp thần chúc phúc/ma pháp thần đích chúc phúc
鹄的=đích/hồng tâm/mục đích
黑暗的事情=hắc ám đích sự tình/chuyện của bóng tối
黑色的巨剑=kiếm lớn màu đen/hắc sắc đích cự kiếm
龙凰丹的=long hoàng đan/long hoàng đan đích
A, 的.=A, đích.
AI 的=trí tuệ đích
N 遍的=nhiều lần/nhiều lần đích
• 淫荡的小穴穴站=• dâm đãng đích tiểu huyệt huyệt trạm
