一箭中的=một tiễn trúng đích
一箭中的,=một tiễn trúng đích
亲下的命令=đích thân ra lệnh
亲手写的=đích thân viết
亲手绑的=đích thân trói
亲点的=đích thân chọn
亲点的将=đích thân điểm tướng
亲身遇到的一天=một ngày đích thân gặp phải
另有目地的=có mục đích khác
宗的标志=tông đích tiêu chí
实打实喝下去的=thật đả thật hát hạ khứ đích
很强的报复目地=mục đích báo thù rất lớn
无的放矢=bắn tên không đích/không bẩn thỉu
有的放矢=bắn tên có đích/làm việc có chủ đích/làm việc có mục tiêu rõ ràng
漫无边际的闲聊=tán dóc không mục đích
的卢=đích lô/Đích Lô
的真=đích thực/đích xác
的真性情=đích thực tính tình
的真空=Chân Không
的確=đích xác
的证=chứng/căn cứ chính xác/căn cứ xác thực
相接的=tương tiếp/đụng vào nhau
相生的=tương sinh
眾矢之的=cái đích cho mọi người chỉ trích
级别的艺人=Cấp Bậc Nghệ Nhân
级别的魔法=cấp bậc ma pháp
给你的亲笔信=đích thân viết cho ngươi
美兹兹的=mỹ tư tư
胆的=mật
自的=mục đích bản thân/mục đích tự nhiên
苍桑的=thương tang đích
荒古的帝=Hoang Cổ Đế
藏所的=tàng sở
蛇发女妖的凝视=xà phát nữ yêu ngưng thị
蛮骨城的城主=Man Cốt Thành Thành Chủ
蜀山剑宫的掌教=Thục Sơn Kiếm Cung Chưởng giáo
衔尾的=ngậm đuôi
装着睡着的样子=trang trứ thụy trứ dạng tử，
要一击中的=muốn một đòn trúng đích
要处置我们的命=mệnh phải xử trí chúng ta
要平心静气的=phải bình tâm tĩnh khí
观察的焦点=cái đích quan sát
讲的道=giảng đạo
证的道=chứng đạo/chứng đạo
识人的=biết người
该挺的挺=cai đĩnh đĩnh
该收的收=cai thu thu
说的道=thuyết đạo
贵村的=quý thôn
贵气的=quý khí
运气的问题=vận khí vấn đề
适合的人才=thích hợp nhân tài
道的指引=Đạo chỉ dẫn
邋遢的胖子少年=Lôi thôi béo tử thiếu niên
那么容易修炼的,=dễ dàng tu luyện như vậy,
阮家那位琴心天生的才女=Nguyễn Gia vị cầm tâm thiên sinh tài nữ
阳光的白鸽=Dương Quang Bạch Cát
零的=không
霜打的茄子=sương đả gia tử
须的=phải
骨刀的=cốt đao
高挑的大美女=cao thiêu đại mỹ nữ
魔家的=ma gia
鹄的=đích/hồng tâm/mục đích
黑暗的事情=hắc ám đích sự tình/chuyện của bóng tối
A, 的.=A, đích.
AI 的=trí tuệ đích
• 淫荡的小穴穴站=• dâm đãng đích tiểu huyệt huyệt trạm
