一个只会用离职作为威胁的人=một người chỉ biết dùng nghỉ việc để uy hiếp
一个身穿蓝色维修工作服的人=một người mặc đồng phục nhân viên sửa chữa màu xanh lá cây
一个永远彻底失去自由的人=một người vĩnh viễn hoàn toàn mất đi tự do
个能够听得进别人意见的人=người có thể lắng nghe ý kiến của người khác
一个比自己更有实力的人=một người có thực lực hơn so với mình
一个没有运气和背景的人=một người không có vận khí và bối cảnh
一个表面看起来很土的人=một người bề ngoài nhìn rất quê mùa
个不能忍受别人欺负的人=một người không thể chịu đựng người khác khi dễ
喜欢我这样喜欢着她的你=ngươi ưa thích nàng như vậy
愿意陪自己傻傻淋雨的人=người nguyện ý cùng mình ngây ngốc dầm mưa
有学问又有厉害身手的人=người có học vấn vừa có thân thủ lợi hại
有没有发现什么可疑的人=có phát hiện người nào khả nghi hay không
能把心里所想说出来的人=người có thể nói ra suy nghĩ trong lòng
一个抱着他腿求救的人=một người ôm chân hắn cầu cứu
一个拥有非凡力量的人=một người có lực lượng phi phàm
不把自己性命看重的人=người không coi trọng tính mạng của mình
两个没有血缘关系的人=hai người không có liên hệ máu mũ
些不在乎世俗眼光的人=người không chút quan tâm ánh mắt thế đời/người không chút quan tâm ánh mắt thế tục
任何一个稍有野心的人=bất cứ người nào có chút dã tâm
唯一知道事情真相的人=người duy nhất biết chân tướng sự tình
喜欢穿黑色内衣裤的人=người thích mặc đồ lót màu đen
心甘情愿跟随于你的人=người cam tâm tình nguyện đi theo ngươi
拥有这么厉害医术的人=người có y thuật lợi hại như vậy
普通得不能再普通的人=người thật bình thường
死板固执不通情理的人=người cứng nhắc cố chấp không thông tình đạt lý
没有一丝特别之处的人=người không có chỗ nào đặc biệt
甚至连打电话报警的人=thậm chí ngay cả người gọi điện thoại báo cảnh sát
稍微懂得天象之法的人=người hơi hiểu phép thiên tượng
稍微有点政治嗅觉的人=người hơi có chút khứu giác chính trị
能够杀死这个少年的人=người có thể giết chết thiếu niên này
能够杀死这个男人的人=người có thể giết chết người đàn ông này
能够杀死这个男子的人=người có thể giết chết người đàn ông này
自小出身高门望族的人=người từ nhỏ xuất thân cao môn vọng tộc
一个不喜欢杀人的人=một người không thích giết người
一个会怜香惜玉的人=một người biết thương hương tiếc ngọc
一个脑子不正常的人=một người đầu óc không bình thường
一些受过我恩义的人=một số người chịu ân nghĩa của ta
不见棺材不掉泪的人=kẻ chưa thấy quan tài chưa đổ lệ/người chưa thấy quan tài chưa đổ lệ
个喜欢多管闲事的人=người thích xen vào việc của người khác
个手无缚鸡之力的人=người tay trói gà không chặt
其它一些不认识的人=một ít người không quen biết khác
几个穿着保安服的人=mấy người mặc đồng phục an ninh
周围被吸引过来的人=người chung quanh bị hấp dẫn tới
唯一能够解救你的人=người duy nhất có thể giải cứu ngươi
喜欢占别人便宜的人=người thích chiếm tiện nghi người khác
多喜欢惹事生非的人=người thích gây chuyện thị phi
家里稍微有点钱的人=người trong nhà hơi có chút tiền
已是同一条船上的人=đã là người trên cùng một thuyền
干了半辈子警察的人=người làm cảnh sát nửa đời
干掉那几个士兵的人=người giết chết mấy tên lính kia
引开那些跟踪你的人=đánh lạc hướng những người theo dõi ngươi
得罪她们及身后的人=đắc tội đến người đứng phía sau các nàng
总是第一个发言的人=luôn là người thứ nhất lên tiếng
招惹了不该招惹的人=trêu chọc phải người không nên trêu chọc
拥有这么好心境的人=người có tấm lòng tốt như vậy
敢跟我这样说话的人=người dám cùng ta nói chuyện như vậy
是第一个这么做的人=người thứ nhất làm như vậy
更相信自己培养的人=tin tưởng người mình bồi dưỡng hơn
曾经要暗杀自己的人=người đã từng muốn ám sát mình
有点地位和见识的人=người có chút địa vị và kiến thức
有这种漂亮的手的人=người có thứ tay xinh đẹp này
正拍着婚纱影像的人=người đang chụp hình đám cưới
每个和他相处过的人=mỗi người ở gần hắn một thời gian
照了照镜子中的自己=nhìn mình trong gương
真正经历过战争的人=người chân chính trải qua chiến tranh
碰上黑胡子海盗的人=người đụng phải hải tặc râu đen
禁地内六千年前的人=người ở bên trong cấm địa từ sáu ngàn năm trước
第一个冲开封印的人=người đầu tiên giải khai phong ấn
第一个喊他医圣的人=người thứ nhất gọi hắn y thánh
第一个当面骂我的人=người thứ nhất mắng ngay mặt ta
第一个打我耳光的人=người thứ nhất bạt tai ta
第一个看出端倪的人=người đầu tiên nhìn ra đầu mối
第一个给他安慰的人=người đầu tiên an ủi hắn
第一个能笑出来的人=người thứ nhất có thể cười được/người thứ nhất có th�新闻网页贴吧知道音乐图片视频地图百科文库
第一个解开封印的人=người đầu tiên cởi bỏ phong ấn
第九个解开封印的人=người thứ chín cởi bỏ phong ấn
等最佳攻击时机的人=chờ thời cơ tốt nhất công kích người
经常逛奢侈品店的人=người thường đi dạo tiệm xa xí phẩm
能做出灵力菜肴的人=người có thể làm ra thức ăn linh lực
能够伤得了的他的人=người có thể làm hắn bị thương
能够开那种跑车的人=người có thể lái loại xe thể thao đó
能够杀死这个人的人=người có thể giết chết người này
能知道这种绝症的人=người có thể biết loại tuyệt chứng này
身为游泳健将的自己=mình thân là kiện tướng bơi lội
还没有我找不到的人=còn không có người ta không tìm được
都没有恋爱经验的人=người đều chưa có kinh nghiệm yêu
食用河豚肉而死的人=người ăn thịt cá nóc chết
一个不同世界的人=người của một thế giới khác
一个不能修炼的人=một người không thể tu luyện
一个全无敌意的人=người hoàn toàn không có địch ý
一个半死不活的人=một người nửa chết nửa sống
一个品行不错的人=một người phẩm hạnh không tệ
一个喜欢杀人的人=một người thích giết người
一个士兵打扮的人=một người mặc đồ lính
一个多么强势的人=một người quyết liệt cỡ nào
一个师爷模样的人=một người bộ dáng sư gia
一个年纪较大的人=một người tuổi tác hơi lớn
一个很重人情的人=một người rất trọng nhân tình
一个怜香惜玉的人=một người thương hương tiếc ngọc
一个惠根深厚的人=một người huệ căn thâm hậu
一个意想不到的人=một người không tưởng được
一个挺乐观派的人=một người trời sinh tính lạc quan
一个智勇双全的人=một người trí dũng song toàn
一个最为普通的人=một người bình thường nhất
一个有大本事的人=người có bản lãnh lớn
一个未曾谋面的人=một người chưa từng gặp mặt
一个极为执着的人=một người cực kỳ cố chấp
一个毫无关系的人=một người không có chút quan hệ nào
一个没有戏份的人=một người không có phần diễn
一个浑身浴血的人=một người toàn thân đẫm máu
一个爱上浪漫的人=một người yêu thích sự lãng mạn
一个穿着西装的人=một người mặc tây trang
一个管家摸样的人=một kẻ ra dáng quản gia
一个绝对可靠的人=một người tuyệt đối có thể tin được
一个胆大心黑的人=một người gan lớn lòng dạ đen tối
一个胸有大志的人=một người trong lòng hoài chí lớn
一个脾气不好的人=một người tính khí không tốt
一个赤手空拳的人=một người tay không tấc sắt
一个身受重伤的人=một người người bị thương nặng
一个身穿机甲的人=một người mặc cơ giáp
一个轻易放弃的人=một người dễ dàng bỏ cuộc
一个这么细心的人=một người cẩn thận như vậy
一个闭着眼睛的人=một người nhắm mắt
一个颇善言辞的人=một người giỏi ăn nói
一个高深莫测的人=một người cao thâm khó lường
一些人认识他的人=một số người nhận biết hắn
一位意志坚定的人=một người ý chí kiên định
一個忘恩負義的人=một người vong ân phụ nghĩa
一帮身穿制服的人=một đám người mặc đồng phục
不喜欢惹事的他们=bọn hắn không thích gây chuyện
不是没有脑子的人=không phải là người không có đầu óc
不是这个世界的人=không phải người của thế giới này
与他有些交情的人=người cùng hắn có chút giao tình
丢失自己哨子的人=người đánh mất còi của mình
个不喜欢张扬的人=người không thích khoe khoang
个洗衣服做饭的人=người nấu cơm giặt quần áo
中央帝国叶家的人=người của Trung Ương Đế Quốc Diệp gia
丰富战斗经验的人=người kinh nghiệm chiến đấu phong phú
什么光明磊落的人=người quang minh lỗi lạc gì
什么出身高贵的人=người xuất thân cao quý gì
什么天赋聪明的人=người thông minh thiên phú gì
什么性格坚强的人=người tính cách kiên cường gì
什么惹事生非的人=người gây chuyện thị phi gì
什麽可以信赖的人=người nào có thể tin cậy
从事这个职业的人=người dấn thân vào nghề nghiệp này
从来留不住话的人=người mà trước giờ không biết giữ lời
任何想要杀我的人=bất kỳ người nào muốn giết ta
位愿意听他谈的人=người nguyện ý nghe hắn nói
体型比较高壮的人=người dáng tương đối cao lớn
值得托付终身的人=người đáng giá phó thác chung thân
像你这么优秀的人=người ưu tú như ngươi vậy
出身高门望族的人=người xuất thân cao môn vọng tộc
创下这部剑诀的人=người chế bộ kiếm quyết này
创造出这剑术的人=người sáng tạo ra kiếm thuật này
创造这门功法的人=người sáng tạo môn công pháp này
别的几个军区的人=người của mấy quân khu khác
到达这个阶段的人=người đạt tới giai đoạn này
受了这么重伤的人=người bị thương nặng như vậy
受到绝大多数的人=được tuyệt đại đa số người
可以托付终身的人=người có thể phó thác chung thân
可有这样想法的人=nhưng người có ý nghĩ như vậy
可能给他答案的人=người có thể cho hắn câu trả lời
听到这个消息的人=người nghe được tin tức này
哪些见死不救的人=những người thấy chết mà không cứu
唯一拥有武器的人=người duy nhất có vũ khí
唯一能接触到的人=người duy nhất có thể tiếp xúc được
唯一露出笑容的人=người duy nhất lộ ra nụ cười
善于把握时机的人=người giỏi về nắm chặt thời cơ
喜欢外国文化的人=người thích văn hóa ngoại quốc
在军队里呆过的人=người từng ở trong quân đội
在场最为惊讶的人=người kinh ngạc nhất tại chỗ
天底下最漂亮的人=người đẹp nhất trên đời này
女强盗珍妮特的人=người của nữ cường đạo Trân Ny Đặc
如此爱药如命的人=người như vậy yêu thuốc như yêu mạng
学识如此渊博的人=người học thức uyên bác như vậy/người học thức uyên bác  như vậy
害死自己儿子的人=người hại chết con trai mình
尚未完全成熟的人=người chưa hoàn toàn trưởng thành
已经注定死亡的人=người đã chú định chết
已经躺进被窝的人=người đã nằm vào chăn
归元宗黑甲军的人=người của Quy Ngyên Tông Hắc Giáp Quân
心思极其慎密的人=người tâm tư cực kỳ cẩn mật
患上这种疾病的人=người mắc loại bệnh này
想对我们不利的人=người muốn gây bất lợi đối với chúng ta
惹到了不该惹的人=chọc phải người không nên chọc
意志极其顽强的人=người ý chí cực kỳ ngoan cường
感应到这张符的人=người cảm ứng được tấm phù này
戴了小丑面具的人=người đeo mặt nạ hề
打着小姐主意的人=người đeo đuổi tiểu thư
拥有精神之力的人=người có tinh thần lực
拥有这种体质的人=người nắm giữ loại thể chất này
提供重要线索的人=người cung cấp đầu mối trọng yếu
救了她们母女的人=người cứu mẹ con các nàng
敢于面对现实的人=người dám đối mặt với thực tế
整个会议室里的人=tất cả mọi người trong phòng họp
昏迷躺在地上的人=người hôn mê nằm dưới đất
是个很有原则的人=là người rất có nguyên tắc
是他最信得过的人=là người hắn tin thưởng nhất
最为出类拔萃的人=người siêu quần bạt tụy nhất
最先来到这里的人=người đầu tiên đến chỗ này
有个躲在厕所的人=có một người núp ở nhà vệ sinh
有贼心没贼胆的人=người có gan mà không dám làm
有身份有地位的人=người có thân phận có địa vị/người có địa vị có danh tiếng
杀死一个无辜的人=giết một người vô tội
极端自私自利的人=người cực đoan vì tự lợi
根本没有关系的人=người căn bản không có quan hệ
死在我们手中的人=người chết ở trong tay chúng ta
比自己低一级的人=người thấp hơn mình một cấp
比自己大一级的人=người lớn hơn mình một cấp
比自己官衔低的人=người quan hàm thấp hơn mình
比较谨慎一类的人=một loại người tương đối cẩn thận
没有任何背景的人=người không có bất kỳ bối gì
没有贵族血统的人=người không có huyết thống quý tộc
没有雄心壮志的人=người không có hùng tâm tráng chí
电影世界之中的人=người trong thế giới điện ảnh
白莲教和明教的人=người của Bạch liên giáo và Minh giáo
相貌丑陋不堪的人=người tướng mạo xấu xí không chịu nổi
看看镜子里的自己=nhìn mình trong gương một chút
看着站在门口的人=nhìn người đứng ở cửa
知道这个秘密的人=người biết cái bí mật này
知道这件事情的人=người biết chuyện này
离开这个世界的人=người rời đi thế giới này
第一个要对付的人=người đầu tiên muốn đối phó
第一个说这话的人=người thứ nhất nói lời này
纯粹的靠运气的人=người chỉ dựa vào vận khí
绝对知道分寸的人=người tuyệt đối biết phân tấc
能够杀死他们的人=người có thể giết chết bọn họ
能够杀死此人的人=người có thể giết chết người nọ
能够杀死老人的人=người có thể giết chết ông lão
能够杀死老者的人=người có thể giết chết ông lão
能够杀死自己的人=người có thể giết chết chính mình
能够杀死自已的人=người có thể giết chết chính mình
能够闯到这里的人=người có thể xông tới chỗ này
蓝电霸王龙宗的人=người của Lam Điện Bá Vương Tông
被包裹在里面的人=người bị bao vây ở trong
被挑选为亲兵的人=người được chọn làm thân binh
被收回指挥权的人=người bị thu hồi quyền chỉ huy
西武帝国叶家的人=người của Tây Võ Đế Quốc Diệp gia
设计这个电路的人=người vẻ mạch điện này
说得出做得到的人=người nói được làm được
走在最为后面的人=người đi ở phía sau nhất
走在最是后面的人=người đi ở phía sau nhất
身处考核之中的他=thân hắn ở trong khảo hạch
身边熟悉自己的人=người quen bên cạnh mình
还有没有生存的人=có còn người nào sống hay không
还有点不相信的人=còn có một số người không tin
进入这大厅中的人=người tiến vào đại sảnh này
进出这个房间的人=người ra vào phòng này
选择这种做法的人=người lựa chọn làm như vậy
遵守游戏规则的人=người tuân thủ quy tắc trò chơi
马车中所坐着的人=người ngồi trong xe ngựa
默默喜欢自己的人=người thầm mến chính mình
ữ多么强大的人=người mạnh cỡ nào
一个不相干的人=một kẻ không quen biết
一个不认识的人=một người không quen biết
一个什么样的人=một hạng người gì
一个圈子里的人=người trong một hội
一个很极端的人=một người rất cực đoan
一个很沉稳的人=một người rất trầm ổn
一个接一个的人=người này tiếp theo người kia
一个有理智的人=một người có lý trí
一个有良知的人=một người có lương tri
一个爱炫耀的人=một người thích khoe khoang
一个直性子的人=một người thẳng tính
一个肯吃亏的人=một người chịu thua thiệt
一个跑得快的人=một người chạy nhanh nhất
一些修为低的人=một ít người tu vi thấp
一些眼睛尖的人=một ít người tinh mắt
一名会英文的人=một người biết tiếng Anh
七宝琉璃宗的人=người của Thất Bảo Lưu Ly Tông
不会是这样的人=không phải là người như vậy
不喜欢惹事的他=hắn không thích gây chuyện
不喜欢杀人的人=người không thích giết người
不太有眼力的人=người không tinh mắt lắm
不理解真相的人=người không hiểu chân tướng
不知道内情的人=người không biết nội tình
不知道细情的人=người không biết rõ ngọn ngành
与自己一样的人=người giống như mình vậy
世界上最强的人=người mạnh nhất trên thế giới
个保镖模样的人=người dáng vẻ hộ vệ
个值得信任的人=người đáng giá tín nhiệm
个值得我帮的人=người đáng giá ta giúp
个即将死去的人=một người sắp chết
个可以说话的人=người có thể nói chuyện
个善于交际的人=một người giỏi về giao tế
个善于言辞的人=người giỏi ăn nói
个宦官模样的人=ngườ ibộ dáng hoạn quan
个已经死去的人=người đã chết
个很好相处的人=người rất dễ thân cận
个很有气魄的人=người rất có khí phách
个很识时务的人=người rất thức thời/người rất thức thời vụ
个心里明亮的人=người tâm lý trong sáng
个懂得收敛的人=người biết thu liễm
个有点气度的人=người có chút khí độ
个来偷袭他的人=người đến đánh lén hắn
个比较冷傲的人=người tương đối lãnh ngạo
个没有戏份的人=người không có phần diễn
个浑身是血的人=người cả người là máu
个要求严格的人=người yêu cầu nghiêm khắc
个雄才大略的人=người hùng tài đại lược
个非常可怕的人=người hết sức đáng sợ
乘坐出租车的人=người ngồi xe taxi
也是别人家的人=cũng là người của người khác
二个不相识的人=hai người không quen biết
什么不开眼的人=người mắt đui mù gì
从车上下来的人=người từ trên xe bước xuống
从里面出来的人=người từ bên trong đi ra ngoài
任何想杀我的人=bất cứ người nào muốn giết ta
任何看到你的人=bất luận người gì nhìn thấy ngươi
任凭什么样的人=bất kỳ hạng người gì
做厨师长的自己=mình làm đầu bếp chính
做这种琐事的人=người làm loại chuyện vặt vảnh này
先出手救的他们=xuất thủ cứu bọn hắn trước
先天性抗体的人=người trời sinh kháng thể
冲击到瓶颈的人=người đánh vào bình cảnh
几个是怕事的人=mấy người sợ chuyện
几个看热闹的人=mấy người xem náo nhiệt
几名围攻他的人=mấy người vây công hắn
出来逛夜市的人=người đi ra ngoài dạo chợ đêm
刚才名单中的人=người trong danh sách mới vừa rồi
刚才打电话的人=người mới vừa gọi điện thoại
功劳最为大的人=người công lao lớn nhất
功劳最是大的人=người công lao lớn nhất
参加追悼会的人=người tham gia lễ truy điệu
另一个世界的人=người của một thế giới khác
可以安慰他的人=người có thể an ủi hắn
同一个时代的人=người cùng một thời đại
同一条船上的人=người trên cùng một thuyền
和他们同样的人=người giống như bọn hắn
和他做生意的人=người làm ăn với hắn
和你有关系的人=người có quan hệ với ngươi
唯一能信任的人=người duy nhất có thể tín nhiệm
喜静不喜动的人=người thích tĩnh không thích động
喝了矿泉水的人=người uống nước suối
四千年不死的人=người bốn ngàn năm không chết
在地上打滚的人=người lăn lộn trên mặt đất
在场最惊讶的人=người tại chỗ kinh ngạc nhất
地面之上的他们=bọn hắn trên mặt đất
坐在最上面的人=người ngồi ở phía trên nhất
够得上资格的人=người có đủ tư cách
大内密探班的人=người của ban mật thám đại nội
天赋差一些的人=người thiên phú kém một chút
失去武功的自己=mình mất đi võ công
她最为亲近的人=người thân cận nàng nhất
她最为痛恨的人=người nàng thống hận nhất
好心又细心的人=người tốt bụng lại cẩn thận
实力最强大的人=người thực lực cường đại nhất
害死了师傅的人=người hại chết sư phó
家境富裕的他们=gia cảnh bọn hắn giàu có
家里赶出来的人=người trong nhà đuổi ra ngoài
容易打交道的人=người dễ dàng giao thiệp
将你变成我的人=biến ngươi thành người của ta
已经被自己的人=đã được người của mình
布这个禁制的人=người bày ra cấm chế này
帮我吃剩饭的人=người giúp ta ăn cơm thừa
干了这件事的人=người làm chuyện này
干过这种事的人=người đã làm chuyện như vậy
年轻时候的自己=mình lúc còn trẻ
年龄比他大的人=người lớn tuổi hơn hắn
很容易满足的人=người rất dễ thỏa mãn
心情愉快的他们=bọn hắn tâm tình khoái trá
忠心于自己的人=người trung thành với mình/người trung thành với chính mình
思维最敏捷的人=người suy nghĩ nhanh nhất
性子高傲的他们=bọn hắn tính tình cao ngạo
患了精神病的人=người có bệnh tâm thần/người bị bệnh tâm thần
想出这办法的人=người nghĩ ra biện pháp này
想对她不利的人=người muốn làm hại nàng
想有些头脑的人=nghĩ người có chút đầu óc
想要捉拿我的人=người muốn bắt ta
想要这本书的人=người muốn quyển sách này
愿意听他谈的人=người nguyện ý nghe hắn nói
所有名单上的人=tất cả người trên danh sách
找不到工作的人=người không tìm được việc làm
抓药的看病的人=người xem bệnh hốt thuốc
拥有心脏病的人=người bị bệnh tim
拥有精神力的人=người có tinh thần lực
拴不住嘴巴的人=người không giữ kín miệng được
拿到领带夹的人=người lấy được cái kẹp cà vạt
数年以前的自己=mình mấy năm trước kia
整个酒吧里的人=toàn bộ người trong quán rượu
施恩不图报的人=người thi ân bất cầu báo
是一条船上的人=là người trên một cái thuyền
是个很仗义的人=là một người rất trọng nghĩa
是个有大才的人=là người đại tài
是朕最信任的人=là người trẫm tín nhiệm nhất
更为有眼力的人=người càng tinh mắt hơn
更多没有枪的人=nhiều người không có súng hơn
最为信得过的人=người tin được nhất
最为有眼力的人=người tinh mắt nhất
最为有能力的人=người có năng lực nhất
最为适合你的人=người thích hợp với ngươi nhất
最早到此处的人=người đến chỗ này sớm nhất
最是信得过的人=người tin được nhất
有一定地位的人=người có địa vị nhất định
有一定身份的人=người có thân phận nhất định
有五行遁术的人=người có ngũ hành độn thuật
有关系密切的人=người có quan hệ mật thiết
有武学天赋的人=người có thiên phú võ học
有特殊天赋的人=người có thiên phú đặc thù
有身份地位的人=người có thân phận địa vị
有这种思想的人=người có loại tư tưởng này
有这种野心的人=người có thứ dã tâm này
服务生打扮的人=người ăn mặc như phục vụ viên
杀人不眨眼的人=người giết người không chớp mắp
来这里交易的人=người tới nơi này giao dịch
正在上楼的他们=bọn hắn đang lên lầu
正方和反方的人=người của phe ủng hộ và phe chống đối
每一个经过的人=mỗi một người đi qua
比自己聪明的人=người thông minh hơn mình
江湖里无数的人=vô số người trong giang hồ
没上过大学的人=người chưa từng học đại học
没什么能力的人=người không có năng lực gì
没有买不动的人=không có người nào mua không được
没有大背景的人=người không có đại bối cảnh
没有露过面的人=người chưa từng lộ diện
派到西鲁城的人=người phái đến Tây Lỗ Thành
特别行动处的人=người của đặc biệt hành động xử
玩保龄球戏的人=người chơi bowling
留守在神殿的人=người lưu thủ tại thần điện
直呼他名字的人=người gọi thẳng tên hắn
省委宣传部的人=người của Tỉnh ủy tuyên truyền bộ
看着镜中的自己=nhìn mình trong kính/nhìn mình trong kiếng
看见这封信的人=người nhìn thấy lá thư này
真心喜欢枪的人=người thật lòng thích súng
真是个奇怪的人=thật là một người kì quái
真正有才能的人=người thực sự có tài năng
知道他名号的人=người biết danh hiệu hắn
知道他用处的人=người biết chỗ dùng của nó
知道它价值的人=người biết rõ giá trị của nó
知道我秘密的人=người biết ta bí mật
知道这件事的人=người biết chuyện này
确定是要找的人=xác định là người muốn tìm
离婚过一次的人=người đã ly dị một lần
稍微聪明点的人=người hơi thông minh một chút
稍有些实力的人=người hơi có chút thực lực
穿橙色衣服的人=người mặc quần áo màu cam
穿着病员服的人=người mặc đồng phục bệnh viện
穿着防护服的人=người mặc phòng hộ phục
第一个提起的人=người thứ nhất nhắc tới
第一次开枪的人=người lần đầu tiên bắn súng
给最为亲密的人=cho người thân thiết nhất
给最是亲密的人=cho người thân thiết nhất
给自己下毒的人=người hạ độc mình
老人不想见的人=người ông lão không muốn gặp
老人所保护的人=người ông lão bảo vệ
老人所嫉妒的人=người ông lão ghen tị
老人所探望的人=người {0] thăm
老人所接待的人=người ông lão tiếp đón
老人所跟踪的人=người ông lão theo dõi
老者不想见的人=người ông lão không muốn gặp
老者所保护的人=người ông lão bảo vệ
老者所嫉妒的人=người ông lão ghen tị
老者所探望的人=người {0] thăm
老者所接待的人=người ông lão tiếp đón
老者所跟踪的人=người ông lão theo dõi
而中了蛇毒的人=người bị trúng nọc rắn độc
能与他为敌的人=người có thể đối địch với hắn
能够信得过的人=người có thể tin được
能够杀死他的人=người có thể giết chết hắn
能够杀死你的人=người có thể giết chết ngươi
能够杀死她的人=người có thể giết chết nàng
能够杀死它的人=người có thể giết chết nó
能够杀死我的人=người có thể giết chết ta
能够超出他的人=người có thể vượt qua hắn
能胜得过你的人=người có thể thắng nổi ngươi
脑子不正常的人=người đầu óc không bình thường
脑子有问题的人=người đầu óc có vấn đề
脸皮这么厚的人=người da mặt dầy như vậy
自已不想见的人=người chính mình không muốn gặp
自已所保护的人=người chính mình bảo vệ
自已所嫉妒的人=người chính mình ghen tị
自已所探望的人=người {0] thăm/người chính mình thăm
自已所接待的人=người chính mình tiếp đón
自已所跟踪的人=người chính mình theo dõi
获得传承的他们=bọn hắn đạt được truyền thừa
蓝电霸王宗的人=người của Lam Điện Bá Vương Tông
虹镰佣兵团的人=người của Hồng Liêm dong binh đoàn
被命运选中的人=người bị vận mệnh chọn trúng
被困在里面的人=người bị nhốt ở bên trong
被布盖起来的人=người bị đậy vải
被称为大哥的人=người được xưng là đại ca
要自己的命的人=người muốn mạng của mình
观察着镜的自己=nhìn mình trong kiếng
认识这东西的人=người biết vật này
说话不算话的人=người nói không giữ lời
象自己这样的人=người giống mình vậy
赤手空拳的他们=bọn họ tay không
走在最后面的人=người đi ở phía sau nhất
身为舰长的他们=bọn hắn thân là Hạm trưởng
躲闪得过去的人=người né tránh được
躺在担架上的人=người nằm trên băng ca
迎娶队伍中的人=người trong đội ngũ rước dâu
还不能修炼的人=người còn không thể tu luyện
还没有出生的你=ngươi còn chưa ra đời
还要有眼力的人=người còn tinh mắt hơn
进我们山庄的人=người vào sơn trang của chúng ta
迟早都是你的人=sớm muộn cũng là người của ngươi
都是打着伞的人=đều là người che dù
都是靠得住的人=đều là người đáng tin cậy
门开了出来的人=người mở cửa ra
闲着没事干的人=người nhàn rỗi không có chuyện làm
阻挡你前进的人=người ngăn trở ngươi tiến tới
随身带着枪的人=người mang súng tùy thân
雕刻这心法的人=người điêu khắc tâm pháp này
非常有权势的人=vô cùng có quyền thế người
首先要感谢的人=người đầu tiên phải cảm tạ
驻守在这里的人=người đóng giữ ở đây
魂灭佣兵团的人=người của Hồn Diệt dong binh đoàn
TIN 的人=người của TIN
一个世界的人=người của một thế giới
一个仁慈的人=một người nhân từ
一个冷酷的人=một kẻ lãnh khốc
一个古老的人=một người cổ xưa
一个可怕的人=một kẻ đáng sợ
一个可怜的人=một kẻ đáng thương
一个善良的人=một người hiền lành
一个垃圾的人=một tên vô dụng
一个多话的人=một người lắm lời
一个孤独的人=một người cô độc
一个安分的人=một người an phận
一个懂枪的人=một người hiểu biết về súng
一个懦弱的人=một người nhu nhược
一个执著的人=một kẻ cố chấp
一个断臂的人=một người cụt tay
一个时代的人=người cùng một thời đại
一个普通的人=một người bình thường
一个村子的人=người của một thôn
一个正常的人=một người bình thường
一个死了的人=một người đã chết
一个现实的人=một người thực tế
一个真正的人=một con người thực sự
一个站着的人=một người đứng
一个简单的人=một người đơn giản
一个聪明的人=một người thông minh
一个自杀的人=một kẻ tự sát
一个过路的人=một người qua đường
一个送信的人=một người đưa tin
一个逃跑的人=một người chạy trốn
一个鲁莽的人=một người lỗ mãng
一千多岁的人=người hơn một ngàn tuổi
一夜未眠的人=người cả đêm không ngủ
一条船上的人=người trên một cái thuyền
一直贫穷的人=người luôn bần cùng
一群无聊的人=một đám người nhàm chán
一群落难的人=một đám người gặp nạn
一般普通的人=người bình thường
一身黑衣的人=người mặc áo đen
万里之外的人=người ngoài ngàn dặm
上面下来的人=người phía trên xuống
不仁不义的人=người bất nhân bất nghĩa
不会武功的人=người không có võ công
不分轻重的人=người không phân biệt nặng nhẹ
不受控制的人=người không bị khống chế
不太不凡的人=người không bất phàm lắm
不太倔强的人=người không quật cường lắm
不太危险的人=kẻ không nguy hiểm lắm
不太可怕的人=kẻ không đáng sợ lắm
不太可怖的人=người không khủng bố lắm
不太可怜的人=kẻ không đáng thương lắm
不太可恶的人=kẻ không đáng ghét lắm
不太可爱的人=người không đáng yêu lắm
不太可疑的人=kẻ không khả nghi lắm
不太吝啬的人=kẻ không keo kiệt lắm
不太善良的人=người không hiền lành lắm
不太好惹的人=người không dễ trêu chọc lắm
不太好色的人=kẻ không háo sắc lắm
不太好运的人=người không may mắn lắm
不太孤独的人=người không cô độc lắm
不太小气的人=kẻ không hẹp hòi lắm
不太干净的人=người không sạch sẽ lắm
不太幸福的人=người không hạnh phúc lắm
不太庸俗的人=kẻ không dung tục lắm
不太弱智的人=kẻ không não tàn lắm
不太强大的人=người không mạnh mẽ lắm
不太强悍的人=người không cường hãn lắm
不太强横的人=người không mạnh mẽ lắm
不太怕死的人=kẻ không sợ chết lắm
不太恐怖的人=người không khủng bố lắm
不太悲观的人=người không bi quan lắm
不太愚蠢的人=kẻ không ngu xuẩn lắm
不太无情的人=kẻ không vô tình lắm
不太普通的人=người không bình thường lắm
不太残忍的人=kẻ không tàn nhẫn lắm
不太熟悉的人=người không quen thuộc lắm
不太特别的人=người không đặc biệt lắm
不太粗鲁的人=kẻ không thô lỗ lắm
不太精明的人=người không sáng suốt lắm
不太聪明的人=người không thông minh lắm
不太胆小的人=kẻ không nhát gan lắm
不太讨厌的人=kẻ không đáng ghét lắm
不太贪婪的人=kẻ không tham lam lắm
不太软弱的人=kẻ không mềm yếu lắm
不太适合的人=người không thích hợp lắm
不太逆天的人=kẻ không nghịch thiên lắm
不太邪恶的人=kẻ không gian ác lắm
不太阴险的人=kẻ không nham hiểm lắm
不太非几的人=người không phi thường lắm
不太非凡的人=người không phi phàm lắm
不太高傲的人=người không kiêu ngạo lắm
不太鲁莽的人=kẻ không lỗ mãng lắm
不怎么样的人=người chẳng ra gì
不想做我的人=không muốn làm người của ta
不懂商业的人=người không biết buôn bán
不懂战斗的人=người không hiểu chiến đấu
不敢比试的人=người không dám tỷ thí
不明来历的人=người không rõ lai lịch
不是一般的人=không phải người bình thường
不是琐细的人=không phải dạng vừa
不是自己的人=không phải người của mình
不是莽撞的人=không phải người lỗ mãng
不是这样的人=không phải là người như thế/không phải là người như vậy
不有眼力的人=người không tinh mắt
不爱自己的人=người không thương mình
不爱说话的人=người không thích nói chuyện
不知内情的人=người không biết nội tình
不算丢你的人=không tính là mất mặt của ngươi
不过他们的人=bất quá người của bọn hắn
不通情理的人=người không thông tình lý
与他为敌的人=kẻ đối địch với hắn
世俗眼光的人=ánh mắt người thế tục/ánh mắt người thế đời
世界之力的人=Thế Giới Chi Lực người
世界各国的人=người của các nước thế giới
两个世界的人=người của hai thế giới
两门一派的人=người của lưỡng môn nhất phái
丧失帝具的你=ngươi mất đi teigu
个不干脆的人=người không kiền thúy
个不幸运的人=một người không may mắn
个不讲理的人=người không nói lý
个什么样的人=hạng người gì
个大肚子的人=người bụng bự
个很不错的人=người rất được
个很危险的人=người rất nguy hiểm
个很小心的人=người rất cẩn thận
个很慈和的人=người rất từ hòa
个很正经的人=người rất đứng đắn
个很特别的人=người rất đặc biệt
个很生猛的人=người rất sinh mãnh/người rất sanh mãnh
个很神奇的人=người rất thần kỳ
个很要强的人=người rất hiếu thắng
个怎么样的人=người như thế nào
个急性子的人=người nóng tính
个更恐怖的人=người càng kinh khủng hơn
个有大才的人=người đại tài
个有野心的人=một người có dã tâm
中央想动的人=người trung ương muốn động
主神军队的人=người thuộc đội quân của Chủ thần
也是你们的人=cũng là người của các ngươi
也是自己的人=cũng là người của mình
京城燕家的人=người của kinh thành Yến gia
人面兽心的人=người mặt người lòng thú
什么奇怪的人=người kỳ quái gì
什么放荡的人=người phóng đãng gì
什么猥琐的人=người bỉ ổi gì
什么认识的人=người quen biết nào
仇视揭发的人=coi người tố giác là kẻ thù
从天而降的人=người từ trên trời hạ xuống
以为安全的人=người cho là an toàn
以力欺人的人=kẻ lấy lực khinh người
任何帮派的人=người của bất kỳ bang phái nào
会议室里的人=người trong phòng họp
伤势不重的人=người thương thế không nặng
但凡有心的人=phàm là người có tim có lòng
位有担当的人=người đảm đương
低调谦逊的人=người đê điều khiêm tốn
住在这里的人=người ở chỗ này/người ở nơi này
何种叫骂的人=loại người mắng chửi nào
何种围观的人=loại người vây xem nào
何种残暴的人=loại kẽ tàn bạo nào
何种贫穷的人=loại người nghèo khó nào
何等眼色的人=người ánh mắt bực nào
何等聪明的人=người thông minh bực nào
佛罗里达的人=người của Phật La Lý Đạt
作恶多端的人=làm nhiều việc ác người
保护自己的人=người bảo vệ mình
信口开河的人=người ăn nói lung tung/người tín khẩu khai hà
修习秘术的人=người tu tập bí thuật
修炼口诀的人=người tu luyện khẩu quyết
修炼成仙的人=người tu luyện thành tiên
值得信任的人=người đáng giá tín nhiệm
做事稳重的人=người làm việc chững chạc
做过母亲的人=người đã làm mẹ
偶尔抽烟的人=người thỉnh thoảng hút thuốc lá
像他这样的人=dạng người như hắn/người giống như hắn/người giống như hắn vậy
像你这样的人=người giống như ngươi
像她这样的人=người như cô ta vậy
先出手救的他=xuất thủ cứu hắn trước
先富起来的人=người giàu trước
光之神域的人=người của Quang Chi Thần Vực
光明教廷的人=người của quang minh giáo
光明磊落的人=người quang minh lỗi lạc
光明神域的人=người của Quang Minh Thần Vực
公司总部的人=người của công ty tổng bộ
公司里面的人=người trong công ty
六千年前的人=người từ sáu ngàn năm trước
关注自己的人=người chú ý mình
其它军团的人=người của những quân đoàn khác
其它国家的人=người của những quốc gia khác
其它所有的人=tất cả những người khác
具有神力的人=người có thần lực
再有眼力的人=người tinh mắt đến đâu
再有耐心的人=người có kiên nhẫn nữa
写这本书的人=người viết quyển sách này
军部里面的人=người trong quân bộ
几个合适的人=mấy người thích hợp
几个跨刀的人=mấy người khóa đao
几个逃跑的人=mấy người chạy trốn
几次接触的人=người tiếp xúc mấy lần
几重破碎的人=người mấy trọng Phá Toái
凶神恶煞的人=người hung dữ
出价最高的人=người ra giá cao nhất
出入这里的人=người ra vào nơi này
出卖国家的人=người bán nước
出卖朋友的人=người bán đứng bằng hữu
出声说话的人=người lên tiếng nói chuyện
出来迎接的人=người ra nghênh đón
出言询问的人=người mở lời hỏi
刚才开枪的人=người mới vừa nổ súng
别有用心的人=người có dụng tâm khác
别的县市的人=người của huyện thị khác
到少林寺的人=người của Thiếu Lâm tự
制服我们的人=chế ngự người của chúng ta
制造赝品的人=người chế tạo hàng giả
刺杀自己的人=người ám sát chính mình
剑法高明的人=người kiếm pháp cao minh
办公室内的人=người trong phòng làm việc
办公室里的人=người trong phòng làm việc
功劳最大的人=người công lao lớn nhất
十分危险的人=người hết sức nguy hiểm
十分可怕的人=người hết sức đáng sợ
十分强大的人=người hết sức mạnh
十分强横的人=người hết sức mạnh mẽ
十分恐怖的人=người hết sức khủng bố
十分特别的人=người hết sức đặc biệt
十分自负的人=người hết sức tự phụ
半个服侍的人=một kẻ hầu hạ
卖友求荣的人=là người bán bạn cầu vinh
占用屋子的人=người chiếm dùng nhà
卡西帝国的人=Tạp Tây đế quốc
去保护她的人=người đi bảo vệ nàng
去找姑娘的人=người đi tìm cô nương
去看桥梁的人=người đi xem cầu
参加会议的人=người tham gia hội nghị
反动组织的人=người của tổ chức phản động
反应迅速的人=người phản ứng nhanh nhẹn
发出信号的人=người phát ra tín hiệu
发明英文的人=người phát minh tiếng Anh
发生车祸的人=người bị tai nạn xe cộ
受了重伤的人=người bị trọng thương
口渴至极的人=người cực kỳ khát nước
可以交往的人=người có thể chơi được
可以依靠的人=người có thể dựa
可以信任的人=người có thể tin được
可以信赖的人=người có thể tin cậy
可以打听的人=nhân có thể hỏi thăm
可以结交的人=người có thể kết giao
可是在场的人=nhưng là người ở đây
可有可无的人=người có cũng như không
各大圣地的人=người của các Đại Thánh địa
各方势力的人=người của các phe thế lực
同一世界的人=người của cùng một thế giới
同样身份的人=người thân phận giống vậy
名有修养的人=một người có trình độ
后面站着的人=người đứng phía sau
听到这话的人=người nghe như vậy
启年小组的人=người của Khải Niên tiểu tổ
告诉天下的人=nói cho người của thiên hạ biết
周围围观的人=người vây xem chung quanh
命运极好的人=người số mệnh cực tốt
命运神域的人=người của Vận Mệnh Thần Vực
和会里面的人=cùng người trong hội
和你飙车的人=người đua xe với ngươi
和我作对的人=người đối nghịch với ta
和我对视的人=người cùng ta đối mắt
品行不错的人=người phẩm hạnh không tệ
哪个家族的人=người của gia tộc nào
哪个门派的人=người của môn phái nào
唯一活着的人=người sống duy nhất
唯二在场的人=hai người duy nhất ở đây
善于拒绝的人=người giỏi cự tuyệt
善于观察的人=người giỏi về quan sát
善于言辞的人=người giỏi về ăn nói
喜欢权谋的人=người thích quyền mưu
喜欢游戏的人=người thích trò chơi
喜欢热闹的人=người thích náo nhiệt
喝酒开车的人=người uống rượu lái xe
喝酒爽快的人=người uống rượu sảng khoái
嚣张已久的他=hắn phách lối đã lâu
四千年前的我=ta của bốn ngàn năm trước
地面之上的他=hắn trên mặt đất
坏事做多的人=người làm nhiều chuyện xấu
坐以待毙的人=người ngồi chờ chết
坐公交车的人=người đi xe buýt
坐在旁边的人=người ngồi bên cạnh
坐在车上的人=người ngồi trên xe
坐在马上的人=người ngồi ở trên ngựa
坐在马车的人=người ngồi ở xe ngựa
复国组织的人=người của tổ chức phục quốc
外表妖异的人=người bề ngoài yêu dị
多么危险的人=người nguy hiểm cỡ nào
多么可怕的人=người đáng sợ cỡ nào
多么强大的人=kẻ mạnh cỡ nào/người mạnh cỡ nào
多么强横的人=người mạnh mẽ cỡ nào
多么恐怖的人=người khủng bố cỡ nào
多么特别的人=người đặc biệt cỡ nào
多懂礼貌的人=người biết lễ độ
大大咧咧的人=người tùy tiện
大有来头的人=người có lai lịch lớn
天威公司的人=người của công ty Thiên Uy
天山剑派的人=người của Thiên Sơn kiếm phái/người của Thiên Sơn  kiếm phái
天斗帝国的人=người của Thiên Đấu Đế Quốc
天生傲骨的他=hắn trời sinh ngạo cốt/hắn trời sanh ngạo cốt
天生异禀的人=người trời sinh dị bẩm/người trời sanh dị bẩm
天赋极高的人=người thiên phú cực cao
太有眼力的人=người quá tinh mắt
太过精明的人=người quá mức khôn khéo
头发鬈曲的人=người tóc xoăn
她不想见的人=người nàng không muốn gặp
她所保护的人=người nàng bảo vệ
她所嫉妒的人=người nàng ghen tị
她所探望的人=người {0] thăm/người nàng thăm
她所接待的人=người nàng tiếp đón
她所跟踪的人=người nàng theo dõi
她手底下的人=người dưới tay nàng
她最亲近的人=người thân cận nhất của nàng
好有眼力的人=người thật là tinh mắt
如果这样的人=nếu như dạng này người/nếu người như vậy
如此凶狠的人=người hung ác như vậy
如此可怕的人=người đáng sợ như vậy
如此强大的人=người cường đại như vậy
如此残忍的人=người tàn nhẫn như vậy
学识不凡的人=người học thức bất phàm
它不想见的人=người nó không muốn gặp
它所保护的人=người nó bảo vệ
它所嫉妒的人=người nó ghen tị
它所探望的人=người {0] thăm/người nó thăm
它所接待的人=người nó tiếp đón
它所跟踪的人=người nó theo dõi
宇宙之中的人=người trong vũ trụ
守口如瓶的人=người thủ khẩu như bình
完全陌生的人=người hoàn toàn xa lạ
宗派界中的人=người trong giới tông phái
实力更强的人=người thực lực mạnh hơn
实力最强的人=người thực lực mạnh nhất
实力稍弱的人=người thực lực hơi yếu
实力较弱的人=người thực lực hơi yếu
客串演出的人=người diễn xuất nghiệp dư
客厅里面的人=người bên trong phòng khách
客栈里面的人=người bên trong khách sạn
害怕死亡的人=người sợ chết
家境富裕的他=gia cảnh hắn giàu có
家境殷实的人=người gia cảnh sung túc
家族里面的人=người trong gia tộc
对不知情的人=đối người không biết chuyện
对我开枪的人=người bắn ta
对面站着的人=người đứng đối diện
射日神山的人=người của Xạ Nhật Thần Sơn
小区里面的人=người trong tiểu khu
小小年纪的他=hắn tuổi nho nhỏ
尖酸刻薄的人=người chua ngoa khắc nghiệt
就不是我的人=liền không phải người của ta
就是这样的人=chính là người như vậy
差点溺水的人=người thiếu chút nữa chết chìm
已经死了的人=người đã chết
已经死亡的人=người đã tử vong
已经逆天的人=người đã nghịch thiên
布雷泽岛的人=người của Bố Lôi Trạch Đảo
师士协会的人=người của Sư Sĩ Hiệp Hội
带太阳镜的人=người đeo kính mác
干这些事的人=người làm những chuyện này
年幼时的自己=mình lúc còn tấm bé
年轻时的他们=bọn hắn lúc tuổi còn trẻ
幸存下来的人=người may mắn còn sống sót
应该习武的人=người nên tập võ
强大无比的人=người vô cùng cường đại
当你对手的人=coi ngươi làm đối thủ người
当成了他的人=trở thành người của hắn
很少拍照的人=người rất ít chụp hình
很少犹豫的人=người rất ít do dự
很有主见的人=người rất có chủ kiến
很有分寸的人=người rất có mực thước
很有心机的人=người rất có tâm cơ
很有意思的人=người rất có ý tứ
很有眼力的人=người rất tinh mắt
很有知识的人=người rất có kiến thức
很有耐心的人=người rất có kiên nhẫn
很讲信誉的人=người nói rất tín nghĩa
很讲礼节的人=người ăn nói rất lễ phép
得了重病的人=người bị trọng bệnh
得住消耗的人=người bị tiêu hao
得罪了他的人=người đắc tội hắn
心中有鬼的人=người trong lòng có quỷ
心地邪恶的人=người có tâm địa tà ác
心怀不轨的人=người trong lòng có quỷ
心怀叵测的人=kẻ có lòng dại khó lường
心思缜密的人=người tâm tư kín đáo
心情愉快的他=hắn tâm tình khoái trá
心智坚定的人=người tâm trí kiên định
心术不正的人=người tâm thuật bất chính/người tâm thuật bất chánh
心浮气躁的人=người tâm phù khí táo
心灵修炼的人=người tu luyện tâm linh
心狠手辣的人=người lòng dạ độc ác
心高气傲的他=hắn tâm cao khí ngạo
志同道合的人=người chung một chí hướng
忘恩负义的人=người vong ân phụ nghĩa
快人快语的人=người khoái nhân khoái ngữ
怜香惜玉的人=người thương hương tiếc ngọc
性子高傲的他=hắn tính tình cao ngạo
性格孤僻的人=người tính tình cô độc
恩怨分明的人=người ân oán phân minh
患上恶疾的人=người mắc bệnh hiểm nghèo
想出这招的人=người nghĩ ra chiêu này
想杀自己的人=kẻ muốn giết mình
想要娶她的人=người muốn cưới nàng
想要我命的人=người muốn mạng ta
想要杀他的人=người muốn giết hắn
意志坚强的人=người ý chí kiên cường
意志薄弱的人=người ý chí yếu ớt
感染瘟疫的人=người bị lây ôn dịch
感触最深的人=người có cảm xúc sâu nhất
慕名而来的人=người mộ danh mà đến
懂得兽语的人=người hiểu được thú ngữ
成为自己的人=trở thành người của mình
战术指挥的人=người chỉ huy chiến thuật
房间里面的人=người trong phòng
才学兼备的人=người tài năng và học vấn vẹn toàn
才智超绝的人=người tài trí siêu tuyệt
打来手机的人=người gọi tới điện thoại di động
扛着门板的人=người khiêng cánh cửa
把照片上的人=đem người trong hình
抢走油画的人=người cướp đi tranh sơn dầu là ai
披着黑袍的人=người khoác hắc bào
拍她脑袋的人=người vỗ đầu nàng
拥有异力的人=người có dị lực
拥有法术的人=người có pháp thuật
拥有热血的人=người có nhiệt huyết
拥有秘密的人=người có bí mật
拥有资本的人=người có vốn
拿号排队的人=người lấy số xếp hàng
指挥作战的人=người chỉ huy tác chiến
挺信得过的人=người rất đáng tin tưởng
挺有眼力的人=người rất tinh mắt
掐着脖颈的人=người bóp cổ
推开旁边的人=đẩy những người bên cạnh ra
推门进入的人=người vừa đẩy cửa tiến vào
搬家公司的人=người của công ty dọn nhà
擅于伪装的人=người giỏi ngụy trang
擅长这个的人=người am hiểu cái này
支持自己的人=người ủng hộ mình
敢杀自己的人=kẻ dám giết mình
敢质疑他的人=người dám nghi ngờ hắn
整个大陆的人=người của cả đại lục
文武兼修的他=hắn văn vũ kiêm toàn
施展秘术的人=người thi triển bí thuật/người triển khai bí thuật
旁边围观的人=người vây xem bên cạnh
无权无势的人=người không quyền không thế
无比危险的人=kẻ vô cùng nguy hiểm
无比可怕的人=kẻ vô cùng đáng sợ
无比强大的人=người vô cùng mạnh mẽ
无法无天的人=người vô pháp vô thiên
时空神域的人=người của Thời Không Thần Vực
时间宝贵的人=người thời gian quý báu
明白事理的人=người hiểu chuyện
是什么样的人=là hạng người gì
是作大事的人=là người làm đại sự
是取你命的人=là người lấy mạng ngươi
是另有目的这=là có mục đích khác
是喜欢我的人=là người yêu thích ta
是最愚蠢的人=người ngu xuẩn nhất
是有功名的人=là người có công danh
是有来路的人=là người có lai lịch
是非一般的人=không phải là người bình thường
暗夜大陆的人=người của Ám dạ đại lục
暗杀我们的人=ám sát người của chúng ta
暗黑神域的人=người của Hắc Ám Thần Vực
更为不凡的人=người càng bất phàm hơn
更为专业的人=người chuyên nghiệp hơn
更为倔强的人=người càng quật cường hơn
更为危险的人=kẻ càng nguy hiểm hơn
更为可怕的人=kẻ càng đáng sợ hơn
更为可怖的人=người càng khủng bố hơn
更为可怜的人=kẻ càng đáng thương hơn
更为可恶的人=kẻ càng đáng ghét hơn
更为可爱的人=người càng đáng yêu hơn
更为可疑的人=kẻ càng khả nghi hơn
更为吝啬的人=kẻ càng keo kiệt hơn
更为善良的人=người càng hiền lành hơn
更为好惹的人=người càng dễ trêu chọc hơn
更为好色的人=kẻ càng háo sắc hơn
更为好运的人=người càng may mắn hơn
更为孤独的人=người càng cô độc hơn
更为小气的人=kẻ càng hẹp hòi hơn
更为干净的人=người càng sạch sẽ hơn
更为幸福的人=người càng hạnh phúc hơn
更为庸俗的人=kẻ càng dung tục hơn
更为弱智的人=kẻ càng não tàn hơn
更为强大的人=người càng mạnh mẽ hơn
更为强悍的人=người càng cường hãn hơn
更为强横的人=người càng mạnh mẽ hơn
更为怕死的人=kẻ càng sợ chết hơn
更为恐怖的人=người càng khủng bố hơn
更为悲观的人=người càng bi quan hơn
更为愚蠢的人=kẻ càng ngu xuẩn hơn
更为无情的人=kẻ càng vô tình hơn
更为普通的人=người càng bình thường hơn
更为残忍的人=kẻ càng tàn nhẫn hơn
更为熟悉的人=người càng quen thuộc hơn
更为特别的人=người càng đặc biệt hơn
更为粗鲁的人=kẻ càng thô lỗ hơn
更为精明的人=người càng sáng suốt hơn
更为聪明的人=người càng thông minh hơn
更为胆小的人=kẻ càng nhát gan hơn
更为讨厌的人=kẻ càng đáng ghét hơn
更为贪婪的人=kẻ càng tham lam hơn
更为软弱的人=kẻ càng mềm yếu hơn
更为适合的人=người càng thích hợp hơn
更为逆天的人=kẻ càng nghịch thiên hơn
更为邪恶的人=kẻ càng gian ác hơn
更为阴险的人=kẻ càng nham hiểm hơn
更为非几的人=người càng phi thường hơn
更为非凡的人=người càng phi phàm hơn
更为高傲的人=người càng kiêu ngạo hơn
更为鲁莽的人=kẻ càng lỗ mãng hơn
更加危险的人=kẻ càng nguy hiểm
更加可怕的人=kẻ càng đáng sợ
更加强大的人=người càng mạnh mẽ
更强修为的人=người tu vi mạnh hơn
更有实力的人=người có thực lực hơn
更有眼力的人=người càng tinh mắt hơn
最为不凡的人=người bất phàm nhất
最为亲近的人=người thân cận nhất/người gần gũi nhất
最为佩服的人=người bội phục nhất
最为倔强的人=người quật cường nhất
最为危险的人=kẻ nguy hiểm nhất
最为厉害的人=người lợi hại nhất
最为可怕的人=kẻ đáng sợ nhất
最为可怖的人=người khủng bố nhất
最为可怜的人=kẻ đáng thương nhất
最为可恶的人=kẻ đáng ghét nhất
最为可爱的人=người đáng yêu nhất
最为可疑的人=kẻ khả nghi nhất
最为吝啬的人=kẻ keo kiệt nhất
最为善良的人=người hiền lành nhất
最为在乎的人=người quan tâm nhất
最为奸猾的人=người gian hoạt nhất
最为好惹的人=người dễ trêu chọc nhất
最为好色的人=kẻ háo sắc nhất
最为好运的人=người may mắn nhất
最为孤独的人=người cô độc nhất
最为富有的人=người giàu có nhất
最为尊敬的人=người tôn kính nhất
最为小气的人=kẻ hẹp hòi nhất
最为干净的人=người sạch sẽ nhất
最为年轻的人=người trẻ tuổi nhất
最为幸福的人=người hạnh phúc nhất
最为庸俗的人=kẻ dung tục nhất
最为弱智的人=kẻ não tàn nhất
最为强大的人=người mạnh mẽ nhất
最为强悍的人=người cường hãn nhất
最为强横的人=người mạnh mẽ nhất
最为心爱的人=người yêu dấu nhất
最为怕死的人=kẻ sợ chết nhất
最为恐怖的人=người khủng bố nhất
最为悲观的人=người bi quan nhất
最为愚蠢的人=kẻ ngu xuẩn nhất
最为敬重的人=người kính trọng nhất
最为文明的人=người văn minh nhất
最为无情的人=kẻ vô tình nhất
最为普通的人=người bình thường nhất
最为棘手的人=người khó giải quyết nhất
最为残忍的人=kẻ tàn nhẫn nhất
最为沉默的人=người trầm mặc nhất
最为没用的人=người vô dụng nhất
最为潇洒的人=người tiêu sái nhất
最为熟悉的人=người quen thuộc nhất
最为特别的人=người đặc biệt nhất
最为睿智的人=người cơ trí nhất
最为粗鲁的人=kẻ thô lỗ nhất
最为精明的人=người sáng suốt nhất
最为聪明的人=người thông minh nhất
最为胆小的人=kẻ nhát gan nhất
最为讨厌的人=kẻ đáng ghét nhất
最为贪婪的人=kẻ tham lam nhất
最为软弱的人=kẻ mềm yếu nhất
最为适合的人=người thích hợp nhất
最为逆天的人=kẻ nghịch thiên nhất
最为邪恶的人=kẻ gian ác nhất
最为重要的人=người trọng yếu nhất
最为阴险的人=kẻ nham hiểm nhất
最为非几的人=người phi thường nhất
最为非凡的人=người phi phàm nhất
最为高傲的人=người kiêu ngạo nhất
最为高兴的人=người cao hứng nhất
最为鲁莽的人=kẻ lỗ mãng nhất
最了解他的人=người hiểu rõ hắn nhất
最信得过的人=người tin được nhất
最先逃跑的人=người chạy trốn trước nhất
最是亲近的人=người thân cận nhất
最是佩服的人=người bội phục nhất/người khâm phục nhất
最是厉害的人=người lợi hại nhất
最是可怜的人=người đáng thương nhất
最是在乎的人=người quan tâm nhất
最是富有的人=người giàu có nhất
最是年轻的人=người trẻ tuổi nhất
最是幸福的人=người hạnh phúc nhất
最是心爱的人=người yêu dấu nhất
最是敬重的人=người kính trọng nhất
最是文明的人=người văn minh nhất
最是棘手的人=người khó giải quyết nhất
最是沉默的人=người trầm mặc nhất
最是没用的人=người vô dụng nhất
最是潇洒的人=người tiêu sái nhất
最是聪明的人=người thông minh nhất
最是高兴的人=người cao hứng nhất
最最幸福的人=người hạnh phúc nhất
最有决心的人=người có quyết tâm nhất
最有学问的人=người có học vấn nhất
最有心机的人=người có tâm cơ nhất
最有权势的人=người có quyền thế nhất
最有眼力的人=người tinh mắt nhất
最有经验的人=người có kinh nghiệm nhất
最有能力的人=người có năng lực nhất/người có năng lực cao nhất
最有见识的人=người có kiến thức nhất
最看不透的人=người nhìn không thấu nhất
最终录取的人=người trúng tuyển cuối cùng
最适合你的人=người thích hợp với ngươi nhất
有些修行的人=có vài người tu hành
有些倒霉的人=có ít người xui xẻo
有些名望的人=người có chút danh vọng
有些胆大的人=có vài người dạn dĩ
有大本事的人=người có bản lãnh lớn
有大气魄的人=người có đại khí phách
有大魄力的人=người có đại phách lực
有头有脸的人=người có mặt mũi
有情有义的人=người có tình nghĩa
有权有势的人=người có quyền thế
有点来头的人=người có chút lai lịch
有点眼光的人=người có chút ánh mắt
有点能力的人=người có chút năng lực
有点脑子的人=người có chút đầu óc
有真本事的人=người có bản lãnh thật sự
有眼无珠的人=người có mắt không tròng
有空来小的这=rảnh rỗi đến chỗ tiểu nhân đây
有精神病的人=người bị bệnh tâm thần
有血有肉的人=người có máu có thịt
有话语权的人=người có quyền phát biểu
有钱有权的人=người có tiền có quyền
权力最大的人=người có quyền lực lớn nhất
权势越高的人=người quyền thế càng cao
村子里面的人=người trong thôn
来不该死的人=người tới không đáng chết
来了又去的人=người đến cùng đi
来到这里的人=người tới nơi này
来办公事的人=người tới làm việc
来历不明的人=người lai lịch không rõ
来学武功的人=người tới học võ công
来帮助你的人=người đến giúp đỡ ngươi
来杀我们的人=đến giết người của chúng ta
来来往往的人=người ta lui tới/người tới lui
来看热闹的人=người tới xem náo nhiệt
来过一次的人=người đã tới một lần
来鄙视我的人=để khinh bỉ người của ta
极为低调的人=người cực kỳ khiêm tốn
极为危险的人=người cực kỳ nguy hiểm/kẻ cực kỳ nguy hiểm
极为可怕的人=người cực kỳ đáng sợ/kẻ cực kỳ đáng sợ
极为强大的人=người cực kỳ mạnh/người cực kỳ mạnh mẽ
极为强横的人=người cực kỳ mạnh mẽ
极为恐怖的人=người cực kỳ khủng bố
极为特别的人=người cực kỳ đặc biệt
极为聪明的人=người cực kỳ thông minh
极为重要的人=là người cực kỳ trọng yếu
极其危险的人=người cực kỳ nguy hiểm/kẻ cực kỳ nguy hiểm
极其可怕的人=người cực kỳ đáng sợ/kẻ cực kỳ đáng sợ
极其强大的人=người cực kỳ mạnh/người cực kỳ mạnh mẽ
极其强悍的人=người cực kỳ cường hãn
极其强横的人=người cực kỳ mạnh mẽ
极其恐怖的人=người cực kỳ khủng bố
极其正直的人=người cực kỳ chính trực
极其特别的人=người cực kỳ đặc biệt
极其理智的人=người cực kỳ lý trí
极其聪明的人=người cực kỳ thông minh
极其逆天的人=người cực kỳ nghịch thiên
极度危险的人=người hết sức nguy hiểm
极度可怕的人=người hết sức đáng sợ
极度强大的人=người hết sức mạnh
极度强横的人=người hết sức mạnh mẽ
极度恐怖的人=người hết sức khủng bố
极度特别的人=người hết sức đặc biệt
极有眼力的人=người cực kỳ tinh mắt
极有身份的人=người có địa vị cực cao
极限武馆的人=người của Cực hạn võ quán
植入木马的人=người cài virus trojan
橙色衣服的人=người quần áo màu cam
正在上楼的他=hắn đang lên lầu
正在排队的人=người đang xếp hàng
正在散去的人=người đang tản đi
正在读书的人=người đang đi học
正在赛车的人=người đang đua xe
正常智商的人=người thông mình bình thường
正正经经的人=người đàng hoàng
步入死亡的人=người bước vào tử vong
武力再高的人=người võ lực cao hơn nữa
死亡神域的人=người của Tử Vong Thần Vực
死在里面的人=người chết ở bên trong
毁灭神域的人=người của Hủy Diệt Thần Vực
比哥还笨的人=kẻ còn ngốc hơn ta
比自己差的人=người kém hơn mình
比较专业的人=người tương đối chuyên nghiệp
比较钟意的人=người tương đối chung ý
气宇轩昂的他=hắn khí vũ hiên ngang
没心没肺的人=người không có tim không có phổi
没有主见的人=người không có chủ kiến
没有举手的我=ta không có giơ tay
没有了心的人=người không có lòng
没有修为的人=người không có tu vi
没有其他的人=không có người nào
没有坐骑的人=người không có cưỡi ngựa/người không có cỡi ngựa
没有权力的人=người không có quyền lực
没有灵根的人=người không có linh căn
没有眼力的人=người không có nhãn lực
没有能力的人=người không có năng lực/kẻ vô dụng
没有落水的人=người không rơi xuống nước
没有身份的人=người không có thân phận
没练过武的人=người chưa từng luyện võ
法力不够的人=người mà pháp lực không đủ
浑身冷汗的他=hắn cả người đổ mồ hôi lạnh
浪荡江湖的人=người giang hồ lãng tử
深度睡眠的人=người ngủ say
混迹赌场的人=người trà trộn sòng bạc
清醒过来的人=người thanh tỉnh lại
渴了许久的人=người khát thật lâu
火云世家的人=người của Hỏa Vân thế gia
火山周围的人=mọi người xung quanh núi lửa
炼制符箓的人=người luyện chế phù lục
爱凑热闹的人=người thích tham gia náo nhiệt
爱多说话的人=người thích nói nhiều
爱好武术的人=người yêu thích võ thuật
爱管闲事的人=người thích xen vào chuyện của người khác
生命神域的人=người của Sinh Mệnh Thần Vực
用钱砸人的人=người dùng tiền đập người
留不住话的人=người không biết giữ lời
留在车上的人=lưu lại trên xe người
皮隆家族的人=người Bì Long gia tộc
监督工作的人=người giám đốc công việc
监视自己的人=người giám thị mình
目光长远的人=người có con mắt lâu dài
目标身边的人=người bên cạnh mục tiêu
相信风水的人=người tin tưởng phong thủy
相当不错的人=người tương đối khá
相当勤奋的人=người tương đối chăm chỉ
看不起我的人=người xem thường ta
看似领头的人=người trông như đầu lãnh
看着对面的人=nhìn người đối diện
看着身边的人=nhìn người bên cạnh
真有眼力的人=người thật là tinh mắt
真正呆过的人=người thực sự từng ở lại
眼前跪着的人=người quỳ trước mắt
知根知底的人=người biết gốc tích
知道内情的人=người biết nội tình
知道后面的人=biết người phía sau
砍出此刀的人=người chém ra đao này
破了案子的人=người phá án
破坏气氛的人=người phá hỏng bầu không khí
砸砖投票的人=người đập gạch bỏ phiếu
神圣联盟的人=người của liên minh thần thánh
神经错乱的人=người thác loạn thần kinh
神通广大的人=người thần thông quảng đại
福缘深厚的人=người có phước lớn
穿着军服的人=người mặc quân phục
穿着警服的人=người mặc cảnh phục
穿着黑衣的人=người mặc áo đen
突兀出现的人=người đột ngột xuất hiện
站在这里的人=người đứng ở chỗ này
站在远处的人=người đứng ở chỗ xa
第一个来的人=người thứ nhất tới
第六兵团的人=người của binh đoàn thứ sáu
精通术法的人=người tinh thông thuật pháp
精通武功的人=người tinh thông võ công
精通种植的人=người tinh thông trồng trọt
素不相识的人=người không quen biết
素来冷面的他=hắn xưa nay mặt lạnh
紫幽山上的人=người trên Tử U Sơn
练出内劲的人=người luyện ra nội kình
经受不起的人=người không chịu nổi
经常喝酒的人=người thường uống rượu
经常开车的人=người thường xuyên lái xe
经理模样的人=người có vẻ là quản lý
结婚之后的人=người sau khi kết hôn
给快死了的人=cho người sắp chết
给最亲密的人=cho người thân thiết nhất
维修公司的人=người của công ty sửa chữa
缉毒总队的人=người của tập độc tổng đội
老人保护的人=người ông lão bảo vệ
老人受恩的人=người ông lão mang ơn
老人嫉妒的人=người ông lão ghen tị
老人心爱的人=người ông lão yêu
老人所找的人=người mà ông lão đang tìm kiếm
老人所杀的人=người ông lão giết
老人所跟的人=người ông lão đi theo
老人探望的人=người {0] thăm
老人接待的人=người ông lão tiếp đón
老人服务的人=người ông lão phục vụ
老人深爱的人=người ông lão yêu sâu đậm
老人要找的人=người ông lão muốn tìm
老人要见的人=người ông lão muốn gặp
老人跟踪的人=người ông lão theo dõi
老人这样的人=người như ông lão
老者保护的人=người ông lão bảo vệ
老者受恩的人=người ông lão mang ơn
老者嫉妒的人=người ông lão ghen tị
老者心爱的人=người ông lão yêu
老者所找的人=người mà ông lão đang tìm kiếm
老者所杀的人=người ông lão giết
老者所跟的人=người ông lão đi theo
老者探望的人=người {0] thăm
老者接待的人=người ông lão tiếp đón
老者服务的人=người ông lão phục vụ
老者深爱的人=người ông lão yêu sâu đậm
老者要找的人=người ông lão muốn tìm
老者要见的人=người ông lão muốn gặp
老者跟踪的人=người ông lão theo dõi
老者这样的人=người như lão giả/người như ông lão
考试通过的人=người thi đậu
聪明至极的人=người cực kỳ thông minh
背叛同伴的人=người phản bội đồng bạn
胸有大志的人=người trong lòng hoài chí lớn
能力更强的人=người năng lực mạnh hơn
能打赢他的人=người có thể đánh thắng hắn
能拯救她的人=người có thể chửng cứu nàng
能杀死他的人=người có thể giết chết hắn
能认出来的人=người có thể nhận ra được
脾气再好的人=người tính khí tốt hơn nữa
脾气火爆的人=người tính tình nóng nảy
自已保护的人=người chính mình bảo vệ
自已受恩的人=người chính mình mang ơn
自已嫉妒的人=người chính mình ghen tị
自已心爱的人=người chính mình yêu
自已所找的人=người mà chính mình đang tìm kiếm
自已所杀的人=người chính mình giết
自已所跟的人=người chính mình đi theo
自已探望的人=người {0] thăm/người chính mình thăm
自已接待的人=người chính mình tiếp đón
自已服务的人=người chính mình phục vụ
自已深爱的人=người chính mình yêu sâu đậm
自已要找的人=người chính mình muốn tìm
自已要见的人=người chính mình muốn gặp
自已跟踪的人=người chính mình theo dõi
自已这样的人=người như chính mình
自认有钱的人=người tự nhận có tiền
苟且偷生的人=người tham sống sợ chết
获得传承的他=hắn đạt được truyền thừa
营帐里面的人=người trong doanh trướng
葬身海底的人=người bỏ mạng dưới đáy biển
虔信神佛的人=người sùng tín thần phật
行将离开的你=ngươi sắp sửa rời đi
被他打死的人=người bị hắn đánh chết
被他拯救的人=người được hắn cứu vớt
被保存着的人=được người bảo tồn
被她欺负的人=người bị nàng ăn hiếp
袭击他们的人=người tập kích bọn họ
装修公司的人=người của công ty sửa chữa
西武叶家的人=người của Tây Võ Diệp gia
要有眼力的人=người còn tinh mắt hơn
要杀很多的人=phải giết rất nhiều người
要说感谢的人=người phải nói cảm tạ
观众席上的人=người trên khán đài
言出必行的人=người nói là làm
言而无信的人=người nói không giữ lời
让他讨厌的人=người để cho hắn ghét
议论纷纷的人=người nghị luận phân phân
设下棋局的人=người bày cuộc cờ
试图进来的人=người cố gắng tiến vào
读了兵书的人=người đọc binh thư
贩卖毒品的人=người buôn bán ma túy
贩卖禁药的人=người buôn bán thuốc cấm
贪图富贵的人=người tham đồ phú quý
贪生怕死的人=người tham sống sợ chết
贪那点钱的人=người tham chút tiền kia
走在前面的人=người đi ở phía trước
越是这样的人=người càng là như vậy
越有眼力的人=người càng tinh mắt hơn
跑车里面的人=người bên trong xe thể thao
踉跄跟着的人=người lảo đảo đi theo
踏踏实实的人=người thành thực
身为舰长的他=hắn thân là Hạm trưởng
身份再高的人=người thân phận cao đi nữa
身份最高的人=người có thân phận cao nhất
身体强健的人=người thân thể tráng kiện
身着黑衣的人=người mặc áo đen
身穿制服的人=người mặc đồng phục
身穿黑衣的人=người mặc áo đen
身边所跟的人=người đi theo bên cạnh
躺在地上的人=người nằm trên đất
躺在床上的人=người nằm trên giường
躺在床上的他=hắn nằm ở trên giường
车上坐着的人=người ngồi trên xe
轻易认输的人=người dễ dàng nhận thua
达到要求的人=người đạt tới yêu cầu
过大世面的人=người thể diện quá lớn
过河拆桥的人=người qua sông rút cầu
运气不佳的人=người vận khí không tốt
还是婴儿的我=ta vẫn còn hài nhi
还要不凡的人=người còn bất phàm hơn
还要倔强的人=người còn quật cường hơn
还要危险的人=kẻ còn nguy hiểm hơn
还要可怕的人=kẻ còn đáng sợ hơn
还要可怖的人=người còn khủng bố hơn
还要可怜的人=kẻ còn đáng thương hơn
还要可恶的人=kẻ còn đáng ghét hơn
还要可爱的人=người còn đáng yêu hơn
还要可疑的人=kẻ còn khả nghi hơn
还要吝啬的人=kẻ còn keo kiệt hơn
还要善良的人=người còn hiền lành hơn
还要好惹的人=người còn dễ trêu chọc hơn
还要好色的人=kẻ còn háo sắc hơn
还要好运的人=người còn may mắn hơn
还要孤独的人=người còn cô độc hơn
还要小气的人=kẻ còn hẹp hòi hơn
还要干净的人=người còn sạch sẽ hơn
还要幸福的人=người còn hạnh phúc hơn
还要庸俗的人=kẻ còn dung tục hơn
还要弱智的人=kẻ còn não tàn hơn
还要强大的人=người còn mạnh mẽ hơn
还要强悍的人=người còn cường hãn hơn
还要强横的人=người còn mạnh mẽ hơn
还要怕死的人=kẻ còn sợ chết hơn
还要恐怖的人=người còn khủng bố hơn
还要悲观的人=người còn bi quan hơn
还要愚蠢的人=kẻ còn ngu xuẩn hơn
还要无情的人=kẻ còn vô tình hơn
还要普通的人=người còn bình thường hơn
还要残忍的人=kẻ còn tàn nhẫn hơn
还要熟悉的人=người còn quen thuộc hơn
还要特别的人=người còn đặc biệt hơn
还要粗鲁的人=kẻ còn thô lỗ hơn
还要精明的人=người còn sáng suốt hơn
还要聪明的人=người còn thông minh hơn
还要胆小的人=kẻ còn nhát gan hơn
还要讨厌的人=kẻ còn đáng ghét hơn
还要贪婪的人=kẻ còn tham lam hơn
还要软弱的人=kẻ còn mềm yếu hơn
还要适合的人=người còn thích hợp hơn
还要逆天的人=kẻ còn nghịch thiên hơn
还要邪恶的人=kẻ còn gian ác hơn
还要阴险的人=kẻ còn nham hiểm hơn
还要非几的人=người còn phi thường hơn
还要非凡的人=người còn phi phàm hơn
还要高傲的人=người còn kiêu ngạo hơn
还要鲁莽的人=kẻ còn lỗ mãng hơn
进入里面的人=người tiến vào bên trong
进出城门的人=người ra vào cửa thành
进出空港的人=người ra vào không cảng
进到那里的人=người đi vào nơi đó
进进出出的人=người ra ra vào vào
远处看到的人=người ở xa nhìn
远征军中的人=người trong quan viễn chinh
远远避开的人=người tránh xa xa
追杀你们的人=người đuổi giết các ngươi
通情达理的人=người thông tình đạt lý
都是乐观的人=đều là người lạc quan
重创后的你们=các người sau khi trọng thương
重情重义的人=người trọng tình trọng nghĩa
重色轻友的人=người trọng sắc khinh bạn
野火镇上的人=người Dã Hỏa trấn
铁石心肠的人=người có tâm địa sắt đá
镜子中的自己=mình trong gương
闯进这里的人=người xông vào nơi này
随着测试的人=người theo khảo sát
需要保护的人=người cần bảo vệ
需要帮助的人=người cần giúp đỡ
需要这样的人=cần người như vậy
非常危险的人=người hết sức nguy hiểm/kẻ phi thường nguy hiểm
非常可怕的人=người hết sức đáng sợ/kẻ phi thường đáng sợ
非常幸运的人=người phi thường may mắn
非常强大的人=người phi thường cường đại/người hết sức mạnh mẽ
非常强横的人=người hết sức mạnh mẽ
非常恐怖的人=người hết sức khủng bố
非常成功的人=người vô cùng thành công
非常熟悉的人=người hết sức quen thuộc
非常特别的人=người hết sức đặc biệt
非常神秘的人=người phi thường thần bí
非常聪明的人=người vô cùng thông minh
非常警觉的人=người phi thường cảnh giác
面带疯狂的人=người mặt điên cuồng
颇有眼力的人=người khá tinh mắt
首先想到的人=người đầu tiên nghĩ tới
骑摩托车的人=người cưỡi xe gắn máy/người cỡi xe gắn máy
骑马进城的人=người cưỡi ngựa vào thành
骚扰她们的人=người quấy rầy các nàng
高高瘦瘦的人=người cao cao gầy gầy
黑色衣服的人=người quần áo màu đen
黑龙会里的人=người trong Hắc long hội
一个个的人=từng người
一屋子的人=người cả phòng
一条船的人=người chung một thuyền
一群群的人=từng đoàn từng đoàn người
三巨头的人=người của tam cự đầu
三王爷的人=người của Tam vương gia
下杀手的人=người hạ sát thủ
下过厨的人=là người chưa từng nấu ă
不一般的人=người không bình thường
不下跪的人=người không quỳ
不不凡的人=người không bất phàm
不倔强的人=người không quật cường
不危险的人=kẻ không nguy hiểm
不可怕的人=kẻ không đáng sợ
不可怖的人=người không khủng bố
不可怜的人=kẻ không đáng thương
不可恶的人=kẻ không đáng ghét
不可爱的人=người không đáng yêu
不可疑的人=kẻ không khả nghi
不吉祥的人=người không may mắn
不吝啬的人=kẻ không keo kiệt
不听话的人=người không nghe lời
不善良的人=người không hiền lành
不太傻的人=kẻ không ngu lắm
不太坏的人=kẻ không xấu lắm
不太好的人=người không tốt lắm
不好惹的人=người không dễ trêu chọc
不好色的人=kẻ không háo sắc
不好运的人=người không may mắn
不孤独的人=người không cô độc
不安分的人=người không an phận
不小气的人=kẻ không hẹp hòi
不干净的人=người không sạch sẽ
不平凡的人=người không tầm thường
不幸福的人=người không hạnh phúc
不庸俗的人=kẻ không dung tục
不弱智的人=kẻ không não tàn
不强大的人=người không mạnh mẽ
不强悍的人=người không cường hãn
不强横的人=người không mạnh mẽ
不心虚的人=người không chột dạ
不怕死的人=người không sợ chết/kẻ không sợ chết
不恐怖的人=người không khủng bố
不悲观的人=người không bi quan
不想见的人=không muốn gặp
不愚蠢的人=kẻ không ngu xuẩn
不成道的人=kẻ không thành đạo
不挑食的人=người không kén ăn
不无情的人=kẻ không vô tình
不是他的人=không phải là người của hắn
不普通的人=người không bình thường
不服输的人=người không chịu thua
不死族的人=người bất tử tộc
不残忍的人=kẻ không tàn nhẫn
不熟悉的人=người không quen thuộc
不爱你的人=kẻ không yêu ngươi
不特别的人=người không đặc biệt
不相干的人=người không liên hệ/người không liên quan
不知情的人=người không biết chuyện/người không biết
不知道的人=người không biết
不简单的人=người không đơn giản
不粗鲁的人=kẻ không thô lỗ
不精明的人=người không sáng suốt
不缺钱的人=người không thiếu tiền
不聪明的人=người không thông minh
不胆小的人=kẻ không nhát gan
不认识的人=kẻ không quen biết
不讨厌的人=kẻ không đáng ghét
不诚信的人=người không thành tín
不该偷的人=người không nên trộm
不该死的人=người không đáng chết
不该爱的人=người không nên yêu
不贪婪的人=kẻ không tham lam
不软弱的人=kẻ không mềm yếu
不适合的人=người không thích hợp
不逆天的人=kẻ không nghịch thiên
不邪恶的人=kẻ không gian ác
不阴险的人=kẻ không nham hiểm
不非几的人=người không phi thường
不非凡的人=người không phi phàm
不靠谱的人=người không đáng tin cậy
不高傲的人=người không kiêu ngạo
不鲁莽的人=kẻ không lỗ mãng
专家组的人=người của tổ chuyên gia
东方家的人=người của Đông Phương gia
个一般的人=người bình thường
个仗义的人=người trượng nghĩa
个厉害的人=một người lợi hại
个善良的人=người thiện lương
个垂死的人=người sắp chết
个奇怪的人=người kỳ quái
个幸运的人=kẻ may mắn
个怎样的人=người thế nào
个懦弱的人=người hèn yếu
个无辜的人=người vô tội
个最强的人=người mạnh nhất
个有用的人=một người hữu dụng
个有趣的人=người thú vị
个果断的人=người quả quyết
个稳重的人=người chững chạc
个简单的人=một người đơn giản
个聪明的人=người thông minh
个胆小的人=người nhát gan
个跟踪的人=người theo dõi
个骄傲的人=người kiêu ngạo
中了招的人=người trúng chiêu
中央军的人=người của quân trung ương
中组部的人=người của Trung tổ bộ
临凤阁的人=người của Lâm Phượng Các
为负伤的人=người bị thương
九刀团的人=người của Cửu Đao Đoàn
也是我的人=cũng là người của ta,
了解他的人=người hiểu hắn
交朋友的人=người kết giao bằng hữu
京城里的人=người ở kinh thành
人世间的人=người của Nhân Thế Gian
人事部的人=người của bộ nhân viên
什么样的人=hạng người gì
今年来的人=năm nay người tới
今早的他们=bọn hắn sáng nay
仙界中的人=người trong tiên giới
以前的他们=bọn họ trước kia
以前的自己=mình trước kia
会做事的人=kẻ biết làm việc
会打架的人=người biết đánh nhau
会看相的人=người biết xem tướng
会花钱的人=người biết tiêu tiền
会魔法的我=Magical Me
传说中的人=người trong truyền thuyết
伤害你的人=người thương tổn ngươi
位公正的人=người công chính
位昏迷的人=người hôn mê
低爵位的人=người tước vị thấp
低身份的人=người có thân phận thấp/người thân phận thấp
体制内的人=người bên trong thể chế
体质强的人=người thể chất mạnh
使用它的人=người sử dụng nó
保护你的人=người bảo vệ ngươi
信任我的人=người tín nhiệm ta
信得过的人=người tin cẩn
信风水的人=người tin phong thủy
修为弱的人=kẻ tu vi yếu
值得交的人=người đáng giá kết giao
做决定的人=người làm quyết định
做厨师的人=người làm đầu bếp
做噩梦的人=người gặp ác mộng
做大事的人=người làm đại sự
做慈善的人=người làm từ thiện
做生意的人=người làm ăn
做错事的人=người làm chuyện sai
偷袭他的人=người đánh lén hắn
偷钱袋的人=người trộm túi tiền
催眠过的人=người bị thôi miên qua
像这样的人=người giống vậy
克制你的人=người khắc chế ngươi
全世界的人=người của toàn thế giới
全京城的人=người của toàn kinh thành
全公司的人=mọi người trong công ty
全天下的人=người trong cả thiên hạ
八扇门的人=người của Bát Phiến môn
公安局的人=người của cục công an
公室里的人=người trong phòng làm việc
其它村的人=người của những thôn khác
其它班的人=người của lớp khác
内务部的人=người của Bộ nội vụ
再不凡的人=người bất phàm đến đâu
再倔强的人=người quật cường đến đâu
再凶恶的人=người dù hung ác đến mức nào
再勇敢的人=người dũng cảm nữa
再危险的人=kẻ nguy hiểm đến đâu
再厉害的人=người lợi hại hơn nữa
再可怕的人=kẻ đáng sợ đến đâu
再可怖的人=người khủng bố đến đâu
再可怜的人=kẻ đáng thương đến đâu
再可恶的人=kẻ đáng ghét đến đâu
再可爱的人=người đáng yêu đến đâu
再可疑的人=kẻ khả nghi đến đâu
再吝啬的人=kẻ keo kiệt đến đâu
再善良的人=người hiền lành đến đâu
再坚强的人=người kiên cường nữa
再好惹的人=người dễ trêu chọc đến đâu
再好色的人=kẻ háo sắc đến đâu
再好运的人=người may mắn đến đâu
再孤独的人=người cô độc đến đâu
再小气的人=kẻ hẹp hòi đến đâu
再干净的人=người sạch sẽ đến đâu
再幸福的人=người hạnh phúc đến đâu
再庸俗的人=kẻ dung tục đến đâu
再弱智的人=kẻ não tàn đến đâu
再强大的人=người cường đại cỡ nào/người mạnh mẽ đến đâu
再强悍的人=người cường hãn đến đâu
再强横的人=người mạnh mẽ đến đâu
再怕死的人=kẻ sợ chết đến đâu
再恐怖的人=người khủng bố đến đâu
再悲观的人=người bi quan đến đâu
再愚笨的人=người ngu dốt đi nữa
再愚蠢的人=kẻ ngu xuẩn đến đâu
再无情的人=kẻ vô tình đến đâu
再普通的人=người bình thường đến đâu
再残忍的人=kẻ tàn nhẫn đến đâu
再熟悉的人=người quen thuộc đến đâu
再牛逼的人=kẻ trâu bò đến đâu
再特别的人=người đặc biệt đến đâu
再睿智的人=người cơ trí đi nữa
再粗鲁的人=kẻ thô lỗ đến đâu
再精明的人=người sáng suốt đến đâu
再老实的人=người đàng hoàng đi nữa
再聪明的人=người thông minh đến đâu
再胆小的人=kẻ nhát gan đến đâu
再自信的人=người tự tin đến đâu
再讨厌的人=kẻ đáng ghét đến đâu
再贪婪的人=kẻ tham lam đến đâu
再软弱的人=kẻ mềm yếu đến đâu
再迟钝的人=kẻ ngu ngốc đến mấy/người có ngốc cỡ nào
再适合的人=người thích hợp đến đâu
再逆天的人=kẻ nghịch thiên đến đâu
再邪恶的人=kẻ gian ác đến đâu
再阴险的人=kẻ nham hiểm đến đâu
再非几的人=người phi thường đến đâu
再非凡的人=người phi phàm đến đâu
再高傲的人=người kiêu ngạo đến đâu
再鲁莽的人=kẻ lỗ mãng đến đâu
军务部的人=người của Quân vụ bộ
军营里的人=người trong quân doanh
击梭上的人=người trên kích toa
分公司的人=người của chi nhánh công ty
刑警队的人=người của hình cảnh đội
划筏子的人=người lái bè
刚过世的人=người vừa qua đời/người vừa tạ thế
别人家的人=người của người khác
别墅里的人=người trong biệt thự
别的村的人=người của những thôn khác
到这里的人=người tới chỗ này
刺杀他的人=người ám sát hắn
前世的自己=mình kiếp trước
力量大的人=người lực lượng lớn
办公室的人=người của phòng làm việc
功劳多的人=người công lao nhiều
劫持你的人=người ép buộc ngươi
劳雷塔的人=người của Lao Lôi Tháp
医院里的人=người trong bệnh viện
华山派的人=người của phái Hoa Sơn
占便宜的人=chiếm tiện nghi của người
卫生局的人=người của cục vệ sinh
去征兵的人=người đi đầu quân
参谋部的人=người của bộ tham mưu
反应慢的人=người phản ứng chậm
取名字的人=người đặt tên
叫大胆的人=người tên đại đảm
可怜的我们=chúng ta đáng thương
可教你的人=người có thể dạy ngươi
台下面的人=người phía dưới đài
吃早饭的人=người ăn điểm tâm
吃独食的人=người ăn một mình
吃过亏的人=người bị thua thiệt
各阶层的人=người của các giai tầng
同境界的人=người cùng cảnh giới
同等级的人=người cùng đẳng cấp
同行业的人=người cùng nghề
同资质的人=người có cùng tư chất
名单上的人=người trong danh sách
名单中的人=người trong danh sách
吹笛子的人=người thổi địch
呼唤他的人=người kêu hắn
咱们班的人=người của lớp chúng ta
咱兄弟的人=người của huynh đệ ta
商船上的人=người trên thương thuyền
喜欢她的人=người thích nàng
喜欢我的人=người yêu thích ta
喜欢枪的人=người thích súng
围攻我的人=người vây công ta
圈子内的人=người của bên trong vòng
在心爱的人=tại người yêu
在这里的人=người ở chỗ này
在里面的人=người ở bên trong
地榜上的人=người trên địa bảng
埃德温的人=người của Ai Đức Ôn
城主府的人=người của phủ thành chủ
堂屋中的人=người trong gian nhà chính
墨先生的人=người của Mặc tiên sinh
声誉高的人=người danh dự cao
多残忍的人=người tàn nhẫn biết bao
大厅中的人=người trong đại sảnh
大厅内的人=người bên trong đại sảnh
大厅里的人=người trong đại sảnh
大家族的人=người của đại gia tộc/đại gia tộc người
大本事的人=người có bản lĩnh lớn
大殿中的人=người trong đại điện
大气运的人=người có đại khí vận/người có vận may lớn
大魔门的人=Đại Ma Môn người
天榜上的人=người trên Thiên bảng
天神宫的人=người của Thiên Thần cung/người của Thiên thần cung
天蛇府的人=người của Thiên Xà phủ
太不凡的人=người quá bất phàm
太倔强的人=người quá quật cường
太危险的人=kẻ quá nguy hiểm
太可怕的人=kẻ quá đáng sợ
太可怖的人=người quá khủng bố
太可怜的人=kẻ quá đáng thương
太可恶的人=kẻ quá đáng ghét
太可爱的人=người quá đáng yêu
太可疑的人=kẻ quá khả nghi
太吝啬的人=kẻ quá keo kiệt
太善良的人=người quá hiền lành
太好惹的人=người quá dễ trêu chọc
太好色的人=kẻ quá háo sắc
太好运的人=người quá may mắn
太孤独的人=người quá cô độc
太小气的人=kẻ quá hẹp hòi
太干净的人=người quá sạch sẽ
太幸福的人=người quá hạnh phúc
太庸俗的人=kẻ quá dung tục
太弱小的人=người quá nhỏ yếu
太弱智的人=kẻ quá não tàn
太强大的人=người quá mạnh mẽ
太强悍的人=người quá cường hãn
太强横的人=người quá mạnh mẽ
太怕死的人=kẻ quá sợ chết
太恐怖的人=người quá khủng bố
太悲观的人=người quá bi quan
太愚蠢的人=kẻ quá ngu xuẩn
太无情的人=kẻ quá vô tình
太普通的人=người quá bình thường
太残忍的人=kẻ quá tàn nhẫn
太熟悉的人=người quá quen thuộc
太特别的人=người quá đặc biệt
太粗鲁的人=kẻ quá thô lỗ
太精明的人=người quá sáng suốt
太聪明的人=người quá thông minh
太胆小的人=kẻ quá nhát gan
太讨厌的人=kẻ quá đáng ghét
太贪婪的人=kẻ quá tham lam
太贪财的人=người quá tham tiền
太软弱的人=kẻ quá mềm yếu
太适合的人=người quá thích hợp
太逆天的人=kẻ quá nghịch thiên
太邪恶的人=kẻ quá gian ác
太阴险的人=kẻ quá nham hiểm
太非几的人=người quá phi thường
太非凡的人=người quá phi phàm
太高傲的人=người quá kiêu ngạo
太鲁莽的人=kẻ quá lỗ mãng
头三名的人=ba người đứng đầu
她介绍的人=người nàng giới thiệu
她保护的人=người nàng bảo vệ
她力挺的人=người nàng ủng hộ
她受恩的人=người nàng mang ơn
她嫉妒的人=người nàng ghen tị
她家族的人=người của dòng họ nàng
她心爱的人=người nàng yêu
她所找的人=người mà nàng đang tìm kiếm
她所杀的人=người nàng giết
她所跟的人=người nàng đi theo
她探望的人=người {0] thăm/người nàng thăm
她接待的人=người nàng tiếp đón
她服务的人=người nàng phục vụ
她母亲的人=của nàng mẫu thân
她深爱的人=người nàng yêu sâu đậm
她要找的人=người nàng muốn tìm
她要见的人=người nàng muốn gặp
她该爱的人=người nàng nên yêu
她跟踪的人=người nàng theo dõi
她身边的人=người bên cạnh nàng
她这样的人=người như nàng
好不凡的人=người thật là bất phàm
好倔强的人=người thật là quật cường
好危险的人=kẻ thật là nguy hiểm
好可怕的人=kẻ thật là đáng sợ
好可怖的人=người thật là khủng bố
好可怜的人=kẻ thật là đáng thương
好可恶的人=kẻ thật là đáng ghét
好可爱的人=người thật là đáng yêu
好可疑的人=kẻ thật là khả nghi
好吝啬的人=kẻ thật là keo kiệt
好善良的人=người thật là hiền lành
好好惹的人=người thật là dễ trêu chọc
好好色的人=kẻ thật là háo sắc
好好运的人=người thật là may mắn
好孤独的人=người thật là cô độc
好对付的人=người dễ đối phó
好小气的人=kẻ thật là hẹp hòi
好干净的人=người thật là sạch sẽ
好幸福的人=người thật là hạnh phúc
好庸俗的人=kẻ thật là dung tục
好弱智的人=kẻ thật là não tàn
好强大的人=người thật là mạnh mẽ
好强悍的人=người thật là cường hãn
好强横的人=người thật là mạnh mẽ
好怕死的人=kẻ thật là sợ chết
好恐怖的人=người thật là khủng bố
好悲观的人=người thật là bi quan
好愚蠢的人=kẻ thật là ngu xuẩn
好无情的人=kẻ thật là vô tình
好普通的人=người thật là bình thường
好残忍的人=kẻ thật là tàn nhẫn
好熟悉的人=người thật là quen thuộc
好特别的人=người thật là đặc biệt
好粗鲁的人=kẻ thật là thô lỗ
好精明的人=người thật là sáng suốt
好聪明的人=người thật là thông minh
好胆小的人=kẻ thật là nhát gan
好讨厌的人=kẻ thật là đáng ghét
好贪婪的人=kẻ thật là tham lam
好软弱的人=kẻ thật là mềm yếu
好适合的人=người thật là thích hợp
好逆天的人=kẻ thật là nghịch thiên
好邪恶的人=kẻ thật là gian ác
好阴险的人=kẻ thật là nham hiểm
好非几的人=người thật là phi thường
好非凡的人=người thật là phi phàm
好高傲的人=người thật là kiêu ngạo
好鲁莽的人=kẻ thật là lỗ mãng
如今的他们=bọn hắn hôm nay
如此多的人=nhiều người như vậy
嫉妒你的人=người đố kị ngươi
学校里的人=người trong trường học
学院外的人=người ngoài học viện
它保护的人=người nó bảo vệ
它受恩的人=người nó mang ơn
它嫉妒的人=người nó ghen tị
它心爱的人=người nó yêu
它所找的人=người mà nó đang tìm kiếm
它所杀的人=người nó giết
它所跟的人=người nó đi theo
它探望的人=người {0] thăm/người nó thăm
它接待的人=người nó tiếp đón
它服务的人=người nó phục vụ
它深爱的人=người nó yêu sâu đậm
它要找的人=người nó muốn tìm
它要见的人=người nó muốn gặp
它跟踪的人=người nó theo dõi
它这样的人=người như nó
安全局的人=người của cục an ninh
宗教局的人=người của tông giáo cục
官场中的人=người trong quan trường
宣传部的人=người của tuyên truyền bộ
宫殿中的人=trong cung điện người
家族中的人=người trong gia tộc
察事厅的人=người của Sát sự thính
对他好的人=người đối tốt với hắn
对付她的人=người muốn đối phó nàng
将晕倒的人=người té xỉu
小家族的人=người của tiểu gia tộc
少林寺的人=người của Thiếu Lâm tự
少话聊的人=người ít nói
就是我的人=liền là người của ta
就这样的人=mà người như vậy/chính là người như vậy
屋子里的人=người trong phòng
山外面的人=người bên ngoài núi
山村里的人=người ở trong sơn thôn
崆峒派的人=người của phái Không Động
崇拜我的人=người sùng bái ta
巨仙族的人=người của Cự Tiên tộc
市钢厂的人=người của xưởng thép thành phố
干大事的人=người làm đại sự
年少的他们=bọn hắn còn trẻ
年纪大的人=người lớn tuổi
年轻时的他=hắn lúc tuổi còn trẻ
年青的自己=tuổi trẻ của mình
广寒宗的人=người của Quảng Hàn Tông/người của Nghiễm Hàn Tông
开玩笑的人=người thích đùa
归元宗的人=người của Quy Nguyên Tông
当下棋的人=làm người đánh cờ
当他们的人=khi người của bọn họ
当初的我们=chúng ta lúc ban đầu
当年的自己=mình năm đó
当时的他们=bọn hắn lúc đó
当警察的人=người làm cảnh sát
当过兵的人=người đã từng đi lính
影毒门的人=người của Ảnh độc môn
很不凡的人=người rất bất phàm
很不错的人=người rất được
很任性的人=kẻ rất thất thường
很倔强的人=người rất quật cường
很危险的人=kẻ rất nguy hiểm
很厉害的人=người rất lợi hại
很可怕的人=kẻ rất đáng sợ
很可怖的人=người rất khủng bố
很可怜的人=kẻ rất đáng thương
很可恶的人=kẻ rất đáng ghét
很可爱的人=người rất đáng yêu
很可疑的人=kẻ rất khả nghi
很吝啬的人=kẻ rất keo kiệt
很善良的人=người rất hiền lành
很奇怪的人=người thật kỳ quái
很好惹的人=người rất dễ trêu chọc
很好色的人=kẻ rất háo sắc
很好运的人=người rất may mắn
很孤独的人=người rất cô độc
很小气的人=kẻ rất hẹp hòi
很干净的人=người rất sạch sẽ
很平常的人=người rất bình thường
很幸福的人=người rất hạnh phúc
很庸俗的人=kẻ rất dung tục
很弱智的人=kẻ rất não tàn
很强大的人=người rất mạnh mẽ
很强悍的人=người rất cường hãn
很强横的人=người rất mạnh mẽ
很念旧的人=người rất nhớ bạn cũ
很怕死的人=kẻ rất sợ chết
很恐怖的人=người rất khủng bố
很悲观的人=người rất bi quan
很愚蠢的人=kẻ rất ngu xuẩn
很慷慨的人=người rất khẳng khái
很执着的人=người rất cố chấp
很无情的人=kẻ rất vô tình
很普通的人=người rất bình thường
很有钱的人=người rất có tiền
很残忍的人=kẻ rất tàn nhẫn
很淡漠的人=người rất đạm mạc
很温和的人=người rất ôn hòa
很熟悉的人=người rất quen thuộc
很特别的人=người rất đặc biệt
很稳重的人=người rất chững chạc
很简单的人=người rất đơn giản
很粗鲁的人=kẻ rất thô lỗ
很精明的人=người rất sáng suốt
很聪明的人=người rất thông minh
很胆小的人=kẻ rất nhát gan
很自信的人=người rất tự tin
很讨厌的人=kẻ rất đáng ghét
很贪婪的人=kẻ rất tham lam
很软弱的人=kẻ rất mềm yếu
很适合的人=người rất thích hợp
很逆天的人=kẻ rất nghịch thiên
很邪恶的人=kẻ rất gian ác
很重要的人=người rất trọng yếu
很阴险的人=kẻ rất nham hiểm
很非几的人=người rất phi thường
很非凡的人=người rất phi phàm
很高傲的人=người rất kiêu ngạo
很高层的人=người rất cao tầng
很鲁莽的人=kẻ rất lỗ mãng
心中的他们=bọn hắn trong lòng
忠于我的人=người trung với ta
怎么样的人=người như thế nào/người như thế nấy
怎么盯的人=canh chừng người nào
怕惹事的人=người sợ gây chuyện
怕打针的人=người sợ chích
怕麻烦的人=người sợ phiền toái
恐水症的人=người có chứng sợ nước
悟性高的人=người có ngộ tính cao
您要找的人=người ngài muốn tìm
悬崖上的人=người trên vách đá
情报处的人=người của phòng tình báo/người của tình báo xử
情报部的人=người của sở tình báo
想杀她的人=những người muốn giết nàng
想杀我的人=kẻ muốn giết ta/người muốn giết ta
想见他的人=người muốn gặp hắn
想说话的人=người muốn nói chuyện
惹得起的人=người chọc nổi
惹恼他的人=người gây chuyện với hắn
懂汉字的人=người biết chữ hán
懂礼貌的人=người biết lễ phép
懂规矩的人=người biết quy củ
成大事的人=người làm đại sự/người thành đại sự
战车内的人=người trong chiến xa
戴口罩的人=người mang đồ chụp miệng mũi
房间里的人=người trong phòng
手中抓的人=trong tay người nắm/người nắm trong tay
扑上来的人=người nhào lên
打主意的人=người để ý
打开水的人=người lấy nước
打扰他的人=người quấy nhiễu hắn
打败我的人=người đánh bại ta
打过我的人=người đánh ta
执行司的人=người của Chấp hành ty
找到它的人=người tìm được nó
技术科的人=người của khoa kỹ thuật
护君营的人=người của hộ quân doanh
报名办的人=người tiếp nhận báo danh
拜魔教的人=người của Bái Ma Giáo
拥有它的人=kẻ có được nó
拯救我的人=người đã cứu ta
拿箱子的人=người cầm cặp
持秘卫的人=người của trì bí vệ
挑战他的人=người khiêu chiến hắn
挺不凡的人=người rất bất phàm
挺倔强的人=người rất quật cường
挺危险的人=kẻ rất nguy hiểm
挺可怕的人=kẻ rất đáng sợ
挺可怖的人=người rất khủng bố
挺可怜的人=kẻ rất đáng thương
挺可恶的人=kẻ rất đáng ghét
挺可爱的人=người rất đáng yêu
挺可疑的人=kẻ rất khả nghi
挺吝啬的人=kẻ rất keo kiệt
挺善良的人=người rất hiền lành
挺好惹的人=người rất dễ trêu chọc
挺好色的人=kẻ rất háo sắc
挺好运的人=người rất may mắn
挺孤独的人=người rất cô độc
挺小气的人=kẻ rất hẹp hòi
挺干净的人=người rất sạch sẽ
挺幸福的人=người rất hạnh phúc
挺庸俗的人=kẻ rất dung tục
挺开明的人=người thật sáng suốt
挺弱智的人=kẻ rất não tàn
挺强大的人=người rất mạnh mẽ
挺强悍的人=người rất cường hãn
挺强横的人=người rất mạnh mẽ
挺怕死的人=kẻ rất sợ chết
挺恐怖的人=người rất khủng bố
挺悲观的人=người rất bi quan
挺愚蠢的人=kẻ rất ngu xuẩn
挺无情的人=kẻ rất vô tình
挺普通的人=người rất bình thường
挺残忍的人=kẻ rất tàn nhẫn
挺熟悉的人=người rất quen thuộc
挺特别的人=người rất đặc biệt
挺粗鲁的人=kẻ rất thô lỗ
挺精明的人=người rất sáng suốt
挺聪明的人=người rất thông minh
挺胆小的人=kẻ rất nhát gan
挺讨厌的人=kẻ rất đáng ghét
挺贪婪的人=kẻ rất tham lam
挺软弱的人=kẻ rất mềm yếu
挺适合的人=người rất thích hợp
挺逆天的人=kẻ rất nghịch thiên
挺邪恶的人=kẻ rất gian ác
挺阴险的人=kẻ rất nham hiểm
挺非几的人=người rất phi thường
挺非凡的人=người rất phi phàm
挺高傲的人=người rất kiêu ngạo
挺鲁莽的人=kẻ rất lỗ mãng
接电话的人=người nghe điện thoại
掳她来的人=người bắt nàng
放了我的人=thả người của ta
救过你的人=người đã cứu ngươi
教室里的人=học sinh trong phòng học
敢动我的人=kẻ dám động ta/dám đụng đến người của ta
敢开枪的人=người dám nổ súng
敢靠近的人=người dám đến gần
新进来的人=người mới tiến vào
无大志的人=người không có chí lớn
无组织的人=người vô tổ chức
日本国的人=người nước Nhật Bản
旧时代的人=người thời đại trước
明事理的人=người hiểu chuyện
星船上的人=người trên tinh thuyền
是哪里的人=là người nơi nào
是自己的人=là người của mình
是这样的人=là người như vậy
是魔教的人=là người của Ma giáo
普通区的人=người của khu phổ thông
暗势力的人=người của thế lực ngầm
暗恋她的人=người thầm mến nàng
暴怒的他们=bọn hắn giận dữ
更不凡的人=người càng bất phàm hơn
更为傻的人=kẻ càng ngu hơn
更为坏的人=kẻ càng xấu hơn
更为好的人=người càng tốt hơn
更倔强的人=người càng quật cường hơn
更危险的人=kẻ càng nguy hiểm hơn/kẻ càng nguy hiểm
更可怕的人=kẻ càng đáng sợ hơn/kẻ càng đáng sợ
更可怖的人=người càng khủng bố hơn
更可怜的人=kẻ càng đáng thương hơn
更可恶的人=kẻ càng đáng ghét hơn
更可爱的人=người càng đáng yêu hơn
更可疑的人=kẻ càng khả nghi hơn
更合适的人=người thích hợp hơn
更吝啬的人=kẻ càng keo kiệt hơn
更善良的人=người càng hiền lành hơn
更好惹的人=người càng dễ trêu chọc hơn
更好色的人=kẻ càng háo sắc hơn
更好运的人=người càng may mắn hơn
更孤独的人=người càng cô độc hơn
更小气的人=kẻ càng hẹp hòi hơn
更干净的人=người càng sạch sẽ hơn
更幸福的人=người càng hạnh phúc hơn
更庸俗的人=kẻ càng dung tục hơn
更弱智的人=kẻ càng não tàn hơn
更强大的人=người cường đại hơn/người càng mạnh mẽ hơn
更强悍的人=người càng cường hãn hơn
更强横的人=người càng mạnh mẽ hơn
更怕死的人=kẻ càng sợ chết hơn
更恐怖的人=người càng kinh khủng hơn/người càng khủng bố hơn
更悲观的人=người càng bi quan hơn
更愚蠢的人=kẻ càng ngu xuẩn hơn
更无情的人=kẻ càng vô tình hơn
更普通的人=người càng bình thường hơn
更残忍的人=kẻ càng tàn nhẫn hơn
更熟悉的人=người càng quen thuộc hơn
更特别的人=người càng đặc biệt hơn
更粗鲁的人=kẻ càng thô lỗ hơn
更精明的人=người càng sáng suốt hơn
更聪明的人=người càng thông minh hơn
更胆小的人=kẻ càng nhát gan hơn
更讨厌的人=kẻ càng đáng ghét hơn
更贪婪的人=kẻ càng tham lam hơn
更软弱的人=kẻ càng mềm yếu hơn
更适合的人=người càng thích hợp hơn
更逆天的人=kẻ càng nghịch thiên hơn
更邪恶的人=kẻ càng gian ác hơn
更阴险的人=kẻ càng nham hiểm hơn
更非几的人=người càng phi thường hơn
更非凡的人=người càng phi phàm hơn
更高傲的人=người càng kiêu ngạo hơn
更鲁莽的人=kẻ càng lỗ mãng hơn
最不凡的人=người bất phàm nhất
最为亲的人=người thân nhất
最为傻的人=kẻ ngu nhất
最为坏的人=người xấu nhất/kẻ xấu nhất
最为好的人=người tốt nhất
最为忙的人=người bận rộn nhất
最为难的人=người khổ sở nhất
最亲密的人=người thân cận nhất
最亲近的人=người thân cận nhất
最佩服的人=người bội phục nhất/người khâm phục nhất
最信任的人=người tín nhiệm nhất/người đáng tin tưởng nhất/người ngươi tín nhiệm nhất
最倔强的人=người quật cường nhất
最危险的人=kẻ nguy hiểm nhất
最厉害的人=người lợi hại nhất
最可怕的人=kẻ đáng sợ nhất/người đáng sợ nhất
最可怖的人=người khủng bố nhất
最可怜的人=người đáng thương nhất/kẻ đáng thương nhất
最可恶的人=kẻ đáng ghét nhất
最可爱的人=người đáng yêu nhất
最可疑的人=kẻ khả nghi nhất
最吝啬的人=kẻ keo kiệt nhất
最善良的人=người hiền lành nhất
最在乎的人=người quan tâm nhất
最奸猾的人=người gian hoạt nhất
最好惹的人=người dễ trêu chọc nhất
最好色的人=kẻ háo sắc nhất
最好运的人=người may mắn nhất
最孤独的人=người cô độc nhất
最富有的人=người giàu có nhất
最尊敬的人=người tôn kính nhất
最尊贵的人=người cao quý nhất
最小气的人=kẻ hẹp hòi nhất
最干净的人=người sạch sẽ nhất
最年轻的人=người trẻ tuổi nhất
最幸福的人=người hạnh phúc nhất
最庸俗的人=kẻ dung tục nhất
最弱智的人=kẻ não tàn nhất
最强大的人=người mạnh mẽ nhất
最强悍的人=người cường hãn nhất
最强横的人=người mạnh mẽ nhất
最心爱的人=người yêu dấu nhất
最怕死的人=kẻ sợ chết nhất
最恐怖的人=người khủng bố nhất
最悲观的人=người bi quan nhất
最愚蠢的人=kẻ ngu xuẩn nhất
最敬重的人=người kính trọng nhất
最文明的人=người văn minh nhất
最无情的人=kẻ vô tình nhất
最普通的人=người bình thường nhất
最有钱的人=có tiền nhất người
最棘手的人=người khó giải quyết nhất
最残忍的人=kẻ tàn nhẫn nhất
最沉默的人=người trầm mặc nhất
最没用的人=người vô dụng nhất
最潇洒的人=người tiêu sái nhất
最熟悉的人=người quen thuộc nhất
最特别的人=người đặc biệt nhất
最看重的人=người được coi trọng nhất
最粗鲁的人=kẻ thô lỗ nhất
最精明的人=người sáng suốt nhất
最聪明的人=người thông minh nhất
最胆小的人=kẻ nhát gan nhất
最自由的人=người tự do nhất
最讨厌的人=ghét nhất người/kẻ đáng ghét nhất/người đáng ghét nhất
最贪婪的人=kẻ tham lam nhất
最软弱的人=kẻ mềm yếu nhất
最适合的人=người thích hợp nhất
最逆天的人=kẻ nghịch thiên nhất
最邪恶的人=kẻ gian ác nhất
最郁闷的人=người buồn nhất
最重要的人=người trọng yếu nhất
最阴险的人=kẻ nham hiểm nhất
最非几的人=người phi thường nhất
最非凡的人=người phi phàm nhất
最靠谱的人=người đáng tin nhất
最高傲的人=người kiêu ngạo nhất
最高兴的人=người cao hứng nhất
最高贵的人=người cao quý nhất
最鲁莽的人=kẻ lỗ mãng nhất
有丈夫的人=người có chồng
有二心的人=người có hai lòng
有仇怨的人=người có thù oán
有份量的人=người có phân lượng
有修为的人=người có tu vi
有修仙的人=có người tu tiên
有修养的人=người có tu dưỡng
有修行的人=người có tu hành
有决断的人=người quyết đoán
有准备的人=người có chuẩn bị
有功劳的人=người có công
有名望的人=người có danh vọng
有品位的人=người có phẩm vị
有喜欢的人=có người thích
有地位的人=người có địa vị
有多少的人=có bao nhiêu người
有天赋的人=người có thiên phú
有威胁的人=người có uy hiếp
有实力的人=người có thực lực
有异心的人=người có dị tâm
有心机的人=người có tâm cơ
有成就的人=người có thành tựu
有才华的人=người có tài hoa
有文化的人=người có văn hóa
有更多的人=có nhiều người hơn
有本事的人=người có bản lãnh
有权势的人=người có quyền thế
有来历的人=người có lai lịch
有武功的人=người có võ công
有涵养的人=người có hàm dưỡng
有潜质的人=người có tiềm chất
有灵智的人=người có linh trí
有灵根的人=người có linh căn
有点胖的人=người hơi mập
有眼力的人=người tinh mắt/người có nhãn lực
有礼貌的人=người có lễ phép
有福气的人=người có phúc khí
有秘密的人=người có bí mật
有素质的人=người có tư cách
有经验的人=người có kinh nghiệm
有耐心的人=người có kiên nhẫn
有背景的人=người có bối cảnh
有能力的人=người có năng lực
有能耐的人=người có khả năng
有能量的人=người có năng lượng
有自尊的人=người có tự trọng/người có tự ái
有见识的人=người có kiến thức
有解药的人=người có giải dược
有诚信的人=người có thành tín
有资质的人=người có tư chất
有身份的人=người có thân phận
有野心的人=người có dã tâm
有骨气的人=người có cốt khí
望乡星的人=người của Vọng Hương Tinh
未来的我们=tương lai của các ngươi
本镇上的人=người ở trong thị trấn
杀你们的人=người giết các ngươi
杀我们的人=giết người của chúng ta
杀掉他的人=giết chết hắn  người
杀死它的人=người giết chết nó
李家村的人=người của Lý gia thôn
村子里的人=người trong thôn
来公园的人=người tới công viên
来参加的人=những người dự
来拜寿的人=người tới chúc thọ
来杀你的人=người đến giết ngươi
来看病的人=người tới xem bệnh
来调查的人=người tới điều tra
来这里的人=người tới nơi này
极不凡的人=người cực kỳ bất phàm
极亲近的人=người cực gần gũi
极倔强的人=người cực kỳ quật cường
极危险的人=kẻ cực kỳ nguy hiểm
极厉害的人=người vô cùng lợi hại
极可怕的人=kẻ cực kỳ đáng sợ
极可怖的人=người cực kỳ khủng bố
极可怜的人=kẻ cực kỳ đáng thương
极可恶的人=kẻ cực kỳ đáng ghét
极可爱的人=người cực kỳ đáng yêu
极可疑的人=kẻ cực kỳ khả nghi
极吝啬的人=kẻ cực kỳ keo kiệt
极善良的人=người cực kỳ hiền lành
极好惹的人=người cực kỳ dễ trêu chọc
极好色的人=kẻ cực kỳ háo sắc
极好运的人=người cực kỳ may mắn
极孤独的人=người cực kỳ cô độc
极小气的人=kẻ cực kỳ hẹp hòi
极干净的人=người cực kỳ sạch sẽ
极幸福的人=người cực kỳ hạnh phúc
极庸俗的人=kẻ cực kỳ dung tục
极弱智的人=kẻ cực kỳ não tàn
极强大的人=người cực kỳ mạnh mẽ
极强悍的人=người cực kỳ cường hãn
极强横的人=người cực kỳ mạnh mẽ
极怕死的人=kẻ cực kỳ sợ chết
极恐怖的人=người cực kỳ khủng bố
极悲观的人=người cực kỳ bi quan
极愚蠢的人=kẻ cực kỳ ngu xuẩn
极无情的人=kẻ cực kỳ vô tình
极普通的人=người cực kỳ bình thường
极残忍的人=kẻ cực kỳ tàn nhẫn
极熟悉的人=người cực kỳ quen thuộc
极特别的人=người cực kỳ đặc biệt
极粗鲁的人=kẻ cực kỳ thô lỗ
极精明的人=người cực kỳ sáng suốt
极聪明的人=người cực kỳ thông minh
极胆小的人=kẻ cực kỳ nhát gan
极讨厌的人=kẻ cực kỳ đáng ghét
极谨慎的人=người rất cẩn thận
极贪婪的人=kẻ cực kỳ tham lam
极软弱的人=kẻ cực kỳ mềm yếu
极适合的人=người cực kỳ thích hợp
极逆天的人=kẻ cực kỳ nghịch thiên
极邪恶的人=kẻ cực kỳ gian ác
极阴险的人=kẻ cực kỳ nham hiểm
极非几的人=người cực kỳ phi thường
极非凡的人=người cực kỳ phi phàm
极高傲的人=người cực kỳ kiêu ngạo
极鲁莽的人=kẻ cực kỳ lỗ mãng
桥上面的人=người phía trên cầu
欺负他的人=người khi dễ hắn
武功高的人=người võ công cao
武当派的人=người của phái Võ Đang/người của phái Võ Đương
武林中的人=người trong võ lâm
武魂殿的人=người của Vũ Hồn Điện
江湖上的人=người trên giang hồ
汽车里的人=người trong ô tô
沙滩上的人=người trên bãi cát
没分寸的人=người không có chừng mực
没品味的人=người không biết thưởng thức
没家底的人=người không có của cải
没有钱的人=người không có tiền
没本事的人=người không có bản lãnh
没经验的人=người không có kinh nghiệm
没脑子的人=người không có đầu óc
法力低的人=người pháp lực thấp
法力高的人=người pháp lực cao
洛京来的人=người tới từ Lạc kinh
活下来的人=người còn sống sót
活生生的人=người sống sờ sờ
派出去的人=người phái đi ra ngoài
派出所的人=người của đồn công an
满单位的人=người của cả đơn vị
满天下的人=tất cả người trong thiên hạ
满屋子的人=người cả phòng
满药店的人=người trong tiệm thuốc
潜艇里的人=người trong tàu lặn
澡堂中的人=người trong phòng tắm
火云家的人=người của Hỏa Vân gia
炼火宗的人=người của Luyện Hỏa Tông
炼药堂的人=người của luyện dược đường
照片里的人=người trong hình
熟悉他的人=người quen biết hắn
爱吃肉的人=người thích ăn thịt
爱炫耀的人=người thích khoe khoang
爱说谎的人=người thích nối dối
爱过你的人=người đã yêu ngươi
特别熟的人=người đặc biệt quen
狗一样的人=cẩu nhất dạng người
狮虎团的人=người của Sư Hổ Đoàn
猎人团的人=người của đoàn thợ săn
王宫外的人=vương cung bên ngoài người
玩电脑的人=người chơi máy vi tính
现在的他们=bọn hắn hiện tại/bọn hắn bây giờ
现在的你们=các ngươi bây giờ
现在的自己=mình bây giờ
珍妮特的人=người của Trân Ny Đặc
理字辈的人=người chữ lót Lý
生是你的人=sống là người của ngươi
生是我的人=sống là người của ta
甬道内的人=người bên trong dũng đạo
画地图的人=người vẽ bản đồ
病房内的人=người bên trong phòng bệnh
痛恨他的人=người thống hận hắn
白莲教的人=người của Bạch liên giáo
皇宫里的人=người trong hoàng cung
皇甫家的人=người của Hoàng Phủ gia
皮最厚的人=người da dầy nhất
盯着他的人=người chú ý hắn
直性子的人=người thẳng tính
直肠子的人=người thẳng thắn
省纪委的人=người của tỉnh kỷ ủy
看热闹的人=người xem náo nhiệt
真不凡的人=người thật là bất phàm
真倔强的人=người thật là quật cường
真危险的人=kẻ thật là nguy hiểm
真可怕的人=kẻ thật là đáng sợ
真可怖的人=người thật là khủng bố
真可怜的人=kẻ thật là đáng thương
真可恶的人=kẻ thật là đáng ghét
真可爱的人=người thật là đáng yêu
真可疑的人=kẻ thật là khả nghi
真吝啬的人=kẻ thật là keo kiệt
真善良的人=người thật là hiền lành
真好惹的人=người thật là dễ trêu chọc
真好色的人=kẻ thật là háo sắc
真好运的人=người thật là may mắn
真孤独的人=người thật là cô độc
真小气的人=kẻ thật là hẹp hòi
真干净的人=người thật là sạch sẽ
真幸福的人=người thật là hạnh phúc
真庸俗的人=kẻ thật là dung tục
真弱智的人=kẻ thật là não tàn
真强大的人=người thật là mạnh mẽ
真强悍的人=người thật là cường hãn
真强横的人=người thật là mạnh mẽ
真怕死的人=kẻ thật là sợ chết
真恐怖的人=người thật là khủng bố
真悲观的人=người thật là bi quan
真愚蠢的人=kẻ thật là ngu xuẩn
真无情的人=kẻ thật là vô tình
真普通的人=người thật là bình thường
真残忍的人=kẻ thật là tàn nhẫn
真熟悉的人=người thật là quen thuộc
真特别的人=người thật là đặc biệt
真粗鲁的人=kẻ thật là thô lỗ
真精明的人=người thật là sáng suốt
真聪明的人=người thật là thông minh
真胆小的人=kẻ thật là nhát gan
真讨厌的人=kẻ thật là đáng ghét
真贪婪的人=kẻ thật là tham lam
真软弱的人=kẻ thật là mềm yếu
真适合的人=người thật là thích hợp
真逆天的人=kẻ thật là nghịch thiên
真邪恶的人=kẻ thật là gian ác
真阴险的人=kẻ thật là nham hiểm
真非几的人=người thật là phi thường
真非凡的人=người thật là phi phàm
真高傲的人=người thật là kiêu ngạo
真鲁莽的人=kẻ thật là lỗ mãng
眼力差的人=người nhãn lực kém
睡着的自己=mình ngủ
知道他的人=người biết hắn
石头上的人=người trên đá
石寨中的人=người trong trại đá
社会上的人=người trong xã hội
神城内的人=người trong thần thành
神组织的人=người của tổ chức Thần
禹皇门的人=người của Vũ hoàng môn
科学院的人=người của viện khoa học
秘会中的人=người trong bí hội
穷怕了的人=người sợ nghèo
穿西装的人=người mặc âu phục
穿黑衣的人=người mặc áo đen
窗户里的人=người trong cửa sổ
站台上的人=người đứng trên đài
竹梯上的人=người trên thang trúc
第二镇的人=người của trấn thứ hai/người của trấn thứ Hai
等待着的人=người đang đợi
等我们的人=chờ người của chúng ta
精英区的人=người của khu tinh anh
精血的他们=tinh huyết của bọn họ
精血的我们=tinh huyết của chúng ta
精血的自己=tinh huyết của mình/tinh huyết của chính mình
紫音宗的人=người của Tử Âm Tông
練國術的人=người luyện quốc thuật
练武功的人=người luyện võ công
经历过的人=người đã trải qua
结过婚的人=người đã kết hôn
缺烟抽的人=người thiếu thuốc hút
罗家庄的人=người của La gia trang
老一辈的人=người đời trước
老叶家的人=người của lão Diệp gia
而别家的人=mà người nhà khác
胆子大的人=người to gan
背叛我的人=người phản bội ta
胜过她的人=người thắng được nàng
能伤他的人=người có thể gây thương tổn hắn
能害她的人=người có thể hại nàng
能想到的人=người có thể nghĩ tới
能杀你的人=người có thể giết được ngươi
苦难中的人=người trong khổ nạn
茶楼中的人=người trong trà lâu
菜刀帮的人=người của Thái đao bang
营地里的人=người trong doanh trại
螳螂里的人=người bên trong bọ ngựa
血瓶帮的人=người của Huyết Bình Bang
行里面的人=người ở trong nghề
街道上的人=người trên đường phố
衡月宗的人=người của Hành Nguyệt Tông
被丑恶的人=người bị bôi nhọ
被倒吊的人=người bị treo ngược
被催眠的人=người bị thôi miên
被击败的人=người bị đánh bại
被吓住的人=người bị kinh sợ
被外边的人=bị người bên ngoài
被带来的人=bị người mang tới
被录取的人=người được trúng tuyển
被指到的人=người bị chỉ đến
被敲诈的人=người bị lường gạt
被淘汰的人=người bị đào thải
被溺死的人=người bị chết chìm
被灭口的人=người bị diệt khẩu
被追杀的人=người bị đuổi giết
袭击你的人=người tập kích ngươi
要不凡的人=người còn bất phàm hơn
要你命的人=người đòi mạng ngươi
要保护的人=người phải bảo vệ
要倔强的人=người còn quật cường hơn
要加入的人=người muốn gia nhập
要危险的人=kẻ còn nguy hiểm hơn
要可怕的人=kẻ còn đáng sợ hơn
要可怖的人=người còn khủng bố hơn
要可怜的人=kẻ còn đáng thương hơn
要可恶的人=kẻ còn đáng ghét hơn
要可爱的人=người còn đáng yêu hơn
要可疑的人=kẻ còn khả nghi hơn
要吝啬的人=kẻ còn keo kiệt hơn
要善良的人=người còn hiền lành hơn
要好惹的人=người còn dễ trêu chọc hơn
要好色的人=kẻ còn háo sắc hơn
要好运的人=người còn may mắn hơn
要孤独的人=người còn cô độc hơn
要小气的人=kẻ còn hẹp hòi hơn
要干净的人=người còn sạch sẽ hơn
要幸福的人=người còn hạnh phúc hơn
要庸俗的人=kẻ còn dung tục hơn
要弱智的人=kẻ còn não tàn hơn
要强大的人=người còn mạnh mẽ hơn
要强悍的人=người còn cường hãn hơn
要强横的人=người còn mạnh mẽ hơn
要怕死的人=kẻ còn sợ chết hơn
要恐怖的人=người còn khủng bố hơn
要悲观的人=người còn bi quan hơn
要愚蠢的人=kẻ còn ngu xuẩn hơn
要找你的人=người muốn tìm ngươi
要无情的人=kẻ còn vô tình hơn
要普通的人=người còn bình thường hơn
要杀他的人=người muốn giết hắn
要杀我的人=người muốn giết ta
要残忍的人=kẻ còn tàn nhẫn hơn
要治疗的人=người muốn trị liệu
要熟悉的人=người còn quen thuộc hơn
要特别的人=người còn đặc biệt hơn
要粗鲁的人=kẻ còn thô lỗ hơn
要精明的人=người còn sáng suốt hơn
要聪明的人=người còn thông minh hơn
要胆小的人=kẻ còn nhát gan hơn
要讨厌的人=kẻ còn đáng ghét hơn
要贪婪的人=kẻ còn tham lam hơn
要软弱的人=kẻ còn mềm yếu hơn
要适合的人=người còn thích hợp hơn
要逆天的人=kẻ còn nghịch thiên hơn
要邪恶的人=kẻ còn gian ác hơn
要阴险的人=kẻ còn nham hiểm hơn
要非几的人=người còn phi thường hơn
要非凡的人=người còn phi phàm hơn
要高傲的人=người còn kiêu ngạo hơn
要鲁莽的人=kẻ còn lỗ mãng hơn
见于家的人=gặp người của Vu gia
觊觎它的人=người ngấp nghé nó
认识他的人=người biết hắn
认识我的人=nhận biết ta người/người nhận biết ta
讲规矩的人=người nói quy củ
设计部的人=người của thiết kế bộ
识时务的人=người thức thời
该通知的人=người nên thông báo
说谎话的人=người nói láo
说这话的人=người nói lời này
诸圣地的人=người của các Thánh địa
读过书的人=người có học
财政部的人=người của Bộ tài chính/người của Bộ tài chánh
走江湖的人=người đi lại giang hồ
走过来的人=người đi tới
赵公子的人=người của Triệu công tử
赵剑炉的人=người Triệu kiếm lô
越不凡的人=người càng bất phàm hơn
越倔强的人=người càng quật cường hơn
越南帮的人=người của bang Việt Nam
越危险的人=kẻ càng nguy hiểm hơn
越可怕的人=kẻ càng đáng sợ hơn
越可怖的人=người càng khủng bố hơn
越可怜的人=kẻ càng đáng thương hơn
越可恶的人=kẻ càng đáng ghét hơn
越可爱的人=người càng đáng yêu hơn
越可疑的人=kẻ càng khả nghi hơn
越吝啬的人=kẻ càng keo kiệt hơn
越善良的人=người càng hiền lành hơn
越好惹的人=người càng dễ trêu chọc hơn
越好色的人=kẻ càng háo sắc hơn
越好运的人=người càng may mắn hơn
越孤独的人=người càng cô độc hơn
越小气的人=kẻ càng hẹp hòi hơn
越干净的人=người càng sạch sẽ hơn
越幸福的人=người càng hạnh phúc hơn
越庸俗的人=kẻ càng dung tục hơn
越弱智的人=kẻ càng não tàn hơn
越强大的人=người càng mạnh mẽ hơn
越强悍的人=người càng cường hãn hơn
越强横的人=người càng mạnh mẽ hơn
越怕死的人=kẻ càng sợ chết hơn
越恐怖的人=người càng khủng bố hơn
越悲观的人=người càng bi quan hơn
越愚蠢的人=kẻ càng ngu xuẩn hơn
越无情的人=kẻ càng vô tình hơn
越普通的人=người càng bình thường hơn
越残忍的人=kẻ càng tàn nhẫn hơn
越熟悉的人=người càng quen thuộc hơn
越特别的人=người càng đặc biệt hơn
越粗鲁的人=kẻ càng thô lỗ hơn
越精明的人=người càng sáng suốt hơn
越聪明的人=người càng thông minh hơn
越胆小的人=kẻ càng nhát gan hơn
越讨厌的人=kẻ càng đáng ghét hơn
越贪婪的人=kẻ càng tham lam hơn
越软弱的人=kẻ càng mềm yếu hơn
越这样的人=người càng như vậy
越适合的人=người càng thích hợp hơn
越逆天的人=kẻ càng nghịch thiên hơn
越邪恶的人=kẻ càng gian ác hơn
越阴险的人=kẻ càng nham hiểm hơn
越非几的人=người càng phi thường hơn
越非凡的人=người càng phi phàm hơn
越高傲的人=người càng kiêu ngạo hơn
越鲁莽的人=kẻ càng lỗ mãng hơn
跑不动的人=người không chạy nổi
跑出来的人=người chạy ra
跑车里的人=người trong xe thể thao
车子里的人=người trong xe
车里面的人=người bên trong xe
轿子里的人=người trong kiệu
辈分高的人=người bối phận cao
输不起的人=người thua không trả tiền/người thua không chung
过不去的人=người không qua được
过去的自己=quá khứ chính mình
运尸体的人=người vận chuyển thi thể
还是我的人=vẫn là người của ta
还活着的人=người còn sống
还要傻的人=kẻ còn ngu hơn
还要坏的人=kẻ còn xấu hơn
还要好的人=người còn tốt hơn
进来的他们=bọn hắn tiến vào
连其他的人=đến ngay những người khác
追杀你的人=truy sát ngươi người
逍遥宫的人=người của Tiêu Diêu Cung
通情理的人=kẻ thấu tình đạt lý
道玄门的人=người của Đạo Huyền môn
酒吧里的人=người trong quán rượu
酒店里的人=người trong quán rượu
酒量好的人=người tửu lượng cao
银片门的人=người của ngân phiến môn/người của Ngân Phiến môn/người của Ngân phiến môn
锦衣卫的人=người của Cẩm y vệ
镖局中的人=người trong tiêu cục
镖局子的人=người của tiêu cục
镜中的自己=mình trong kính
镜子里的人=người trong gương
长老会的人=người của trưởng lão hội
阴阳教的人=người của Âm Dương giáo
院子里的人=người trong viện
院落里的人=người trong sân
陷害他的人=người hãm hại hắn
隐魔门的人=người của Ẩn Ma Môn
雪橇上的人=người trên xe trượt tuyết
雪鹰教的人=người của Tuyết Ưng Giáo
青城派的人=người của phái Thanh Thành
青帮里的人=người trong Thanh bang
青湖岛的人=người của Thanh Hồ Đảo
静海宗的人=người của Tĩnh Hải Tông
靠近他的人=người đến gần hắn
靠近你的人=người đến gần ngươi
靠近她的人=người đến gần nàng
领导班的人=người của Lãnh đạo ban
颇不凡的人=người khá bất phàm
颇倔强的人=người khá quật cường
颇危险的人=kẻ khá nguy hiểm
颇可怕的人=kẻ khá đáng sợ
颇可怖的人=người khá khủng bố
颇可怜的人=kẻ khá đáng thương
颇可恶的人=kẻ khá đáng ghét
颇可爱的人=người khá đáng yêu
颇可疑的人=kẻ khá khả nghi
颇吝啬的人=kẻ khá keo kiệt
颇善良的人=người khá hiền lành
颇好惹的人=người khá dễ trêu chọc
颇好色的人=kẻ khá háo sắc
颇好运的人=người khá may mắn
颇孤独的人=người khá cô độc
颇小气的人=kẻ khá hẹp hòi
颇干净的人=người khá sạch sẽ
颇幸福的人=người khá hạnh phúc
颇庸俗的人=kẻ khá dung tục
颇弱智的人=kẻ khá não tàn
颇强大的人=người khá mạnh mẽ
颇强悍的人=người khá cường hãn
颇强横的人=người khá mạnh mẽ
颇怕死的人=kẻ khá sợ chết
颇恐怖的人=người khá khủng bố
颇悲观的人=người khá bi quan
颇愚蠢的人=kẻ khá ngu xuẩn
颇无情的人=kẻ khá vô tình
颇普通的人=người khá bình thường
颇残忍的人=kẻ khá tàn nhẫn
颇熟悉的人=người khá quen thuộc
颇特别的人=người khá đặc biệt
颇粗鲁的人=kẻ khá thô lỗ
颇精明的人=người khá sáng suốt
颇聪明的人=người khá thông minh
颇胆小的人=kẻ khá nhát gan
颇讨厌的人=kẻ khá đáng ghét
颇贪婪的人=kẻ khá tham lam
颇软弱的人=kẻ khá mềm yếu
颇适合的人=người khá thích hợp
颇逆天的人=kẻ khá nghịch thiên
颇邪恶的人=kẻ khá gian ác
颇阴险的人=kẻ khá nham hiểm
颇非几的人=người khá phi thường
颇非凡的人=người khá phi phàm
颇高傲的人=người khá kiêu ngạo
颇鲁莽的人=kẻ khá lỗ mãng
风满楼的人=người của Phong Mãn Lâu
飞船上的人=người trên phi thuyền
饿极了的人=người cực đói
马虎眼的人=người qua loa
马车里的人=người trong xe ngựa
骑白马的人=người cưỡi ngựa trắng
高身份的人=người thân phận cao
鬼音宗的人=người Quỷ Âm Tông
黄山派的人=người của phái Hoàng Sơn
黑暗中的人=người trong bóng tối
黑社会的人=người của xã hội đen
黑道上的人=người trong hắc đạo
黑龙会的人=người của Hắc long hội
龙魔宫的人=người của Long Ma Cung
"我的人="Người của ta
一关的人=người của một cửa
一样的人=người giống vậy
一般的人=người bình thường
一路的人=người đi chung đường
丁家的人=người của Đinh gia
上当的人=người mắc lừa
上船的人=người lên thuyền
上面的人=người ở phía trên/người cấp trên/người ra mặt/người của phía trên
下手的人=hạ thủ người/người hạ thủ
下方的人=người phía dưới
下棋的人=người đánh cờ
下边的人=người bên dưới
下面的人=người phía dưới
不傻的人=kẻ không ngu
不同的人=người khác nhau
不坏的人=kẻ không xấu
不好的人=người không tốt
不少的人=không ít người
不详的人=người không thể nhắc tới/người không rõ/người bí ẩn
不错的人=người tốt
丐帮的人=người của Cái Bang/người của Cái bang
专业的人=người chuyên nghiệp
专门的人=người đặc biệt/người chuyên biệt
东厂的人=người của Đông xưởng
两府的人=người của hai phủ
两边的人=người của hai bên
两队的人=người của hai đội
严厉的人=người nghiêm nghị
严家的人=người của Nghiêm gia
中枪的人=người trúng thương
中毒的人=người trúng độc
临死的人=người trước khi chết
为首的人=người cầm đầu
主上的人=người của chủ thượng
主刀的人=người chủ đao
主队的人=người của chủ đội
举手的人=người giơ tay
乐观的人=người lạc quan
乐队的人=người của ban nhạc
乘坐的人=người ngồi/thừa tọa đích nhân
亲爱的人=người yêu dấu
亲近的人=người thân cận
仁慈的人=người nhân từ
仇家的人=người của Cừu gia
今早的他=hắn sáng nay
任何的人=bất cứ người nào
任性的人=người thất thường
企业的人=người của xí nghiệp
优秀的人=người ưu tú
伟大的人=người vĩ đại/vĩ đại nhân
传出的人=người truyền ra
低调的人=người khiêm tốn
低贱的人=người đê tiện
余下的人=những người còn lại
保护的人=người bảo vệ
信任的人=người tín nhiệm
修习的人=người tu tập
修仙的人=người tu tiên
修养的人=tu dưỡng người
修炼的人=người tu luyện
修真的人=người tu chân
修行的人=người tu hành
倒下的人=người ngã xuống
倔强的人=người quật cường
做主的人=người làm chủ
做事的人=người làm việc
做你的人=làm người của ngươi
做到的人=người làm được
做官的人=người làm quan
做我的人=làm người của ta
健康的人=người khỏe mạnh
偷听的人=người nghe trộm
偷车的人=người trộm xe
催眠的人=người bị thôi miên
傻瓜的我=Ta là đứa ngốc - What a fool I am
先生的人=người của tiên sinh
入京的人=người đến kinh thành
入住的人=vào ở người
入定的人=người nhập định
入局的人=người nhập cuộc
全村的人=người của toàn thôn
全部的人=tất cả mọi người
公司的人=người của công ty
关注的人=người chú ý
关联的人=người liên hệ
兵部的人=người của binh bộ
其余的人=người còn lại
其它的人=những người khác/các người khác
养鸡的人=người nuôi gà
再傻的人=người ngu đi nữa/kẻ ngu đến đâu
再坏的人=kẻ xấu đến đâu
再多的人=nhiều người hơn nữa
再好的人=người tốt đến đâu
再穷的人=người nghèo đến đâu
冒险的人=mạo hiểm giả
写书的人=người viết sách
军部的人=người của quân bộ/người của quân đội
军队的人=người của quân đội
农家的人=người nhà nông
农村的人=người nông thôn
冷血的人=người có máu lạnh
凤家的人=người của Phượng gia
凶狠的人=người hung ác
出剑的人=người xuất kiếm
出动的人=người xuất động
出口的人=người đi ra cửa/người mở miệng
出名的人=người nổi danh
出城的人=người ra thành
出局的人=người bị loại
出手的人=xuất thủ người/người xuất thủ
出来的人=người đi ra ngoài
出现的人=xuất hiện người
出色的人=người xuất sắc
刘家的人=người của Lưu gia
别人的人=người của người khác
别村的人=Biệt thôn người
别的的人=những người khác
前世的他=đời trước của hắn
前方的人=người phía trước
前面的人=người phía trước/người trước mặt
剑村的人=người của kiếm thôn
剩下的人=những người còn lại
剰下的人=còn lại người
卑鄙的我=Despicable Me/despicable me
单纯的人=người đơn thuần
卖车的人=người bán xe
卧着的人=người đang nằm
卫队的人=vệ đội người/người của vệ đội
危险的人=kẻ nguy hiểm/nguy hiểm nhân/người nguy hiểm
厅中的人=người trong sảnh
厉害的人=người lợi hại
厚道的人=người phúc hậu
县城的人=người của huyện thành
参加的人=người tham gia
双方的人=người của song phương
反对的人=người phản đối
反抗的人=người phản kháng
发现的人=người phát hiện
受伤的人=người bị thương
受恩的人=người chịu ân
叛乱的人=người nổi loạn
另外的人=người khác
叫他的人=người gọi hắn
可怕的人=kẻ đáng sợ/người đáng sợ
可怜的人=người đáng thương/kẻ đáng thương
可怜的我=ta đáng thương
可敬的人=người có thể tôn kính
可疑的人=người khả nghi/kẻ khả nghi
可靠的人=người có thể tin được
台下的人=người ở dưới đài
右边的人=người bên phải
叶家的人=Diệp gia người/người của Diệp gia
吃了的人=người ăn
吃多的人=người ăn nhiều
吃饭的人=người ăn cơm
吃龙的人=kẻ ăn thịt rồng
合适的人=người thích hợp
同代的人=người cùng thời
同族的人=người đồng tộc
同派的人=người cùng phái
后世的人=người đời sau/người của đời sau
后方的人=người phía sau
后来的人=người đến sau
后面的人=người phía sau
吝啬的人=người keo kiệt/keo kiệt người
听见的人=người nghe
吴家的人=người của Ngô gia
吹牛的人=người khoác lác
周围的人=người chung quanh
周家的人=người của Chu gia
周府的人=người của Chu phủ
周遭的人=người quanh mình
咱们的人=người của chúng ta
唐家的人=người của Đường gia
唐门的人=người của Đường môn
唱歌的人=người đang hát
商会的人=thương hội người
商铺的人=người của cửa hàng
啥样的人=người ra sao
善良的人=người thiện lương/người hiền lành
喝酒的人=uống rượu người/người uống rượu
四周的人=người xung quanh
四派的人=người của bốn phái
回复的人=người trả lời
围观的人=người vây xem
国外的人=người nước ngoài
国安的人=người của quốc an
圈里的人=người trong vòng
圣教的人=người của thánh giáo
在场的人=người ở chỗ này
在座的人=người đang ngồi
场中的人=người trong sân
场内的人=người trong sân
坏话的人=người nói xấu
坐庄的人=người làm nhà cái
坐着的人=người đang ngồi
垃圾的人=đồ vứt đi người/tên vô dụng
城下的人=người dưới thành
城内的人=người bên trong thành
城外的人=người ngoài thành
城里的人=người trong thành
墨家的人=Mặc gia người
复仇的人=người báo thù
夏家的人=người của Hạ gia
外围的人=người bên ngoài
外边的人=người bên ngoài
外面的人=người bên ngoài/người ở phía ngoài
多事的人=người nhiều chuyện
多余的人=người sót lại
多嘴的人=người hay lắm miệng
多忙的人=người bận rộn
多话的人=người nói nhiều
夜行的人=người dạ hành
大少的人=người của đại thiếu
大把的人=rất nhiều người
大明的人=người của Đại Minh
大量的人=rất nhiều người
天下的人=người trong thiên hạ
天域的人=người của Thiên Vực
天庭的人=người của thiên đình
天界的人=người của thiên giới
太傻的人=kẻ quá ngu
太坏的人=kẻ quá xấu
太多的人=người quá nhiều
太好的人=người quá tốt
夫家的人=người của bên nhà chồng
失信的人=người thất tín
失恋的人=người thất tình
失踪的人=người mất tích
奇怪的人=người kỳ quái
奇特的人=người kỳ lạ
奸猾的人=người gian hoạt
她们的人=các nàng người/người của các nàng
她爱的人=người nàng yêu
好傻的人=kẻ thật là ngu
好坏的人=kẻ thật là xấu
好奇的人=người tò mò
好好的人=người thật là tốt
好惹的人=người dễ trêu chọc
好色的人=người háo sắc/kẻ háo sắc
好运的人=người may mắn/kẻ may mắn
如今的他=hắn hôm nay
妒忌的人=người đố kỵ
妥当的人=người thích hợp
姓费的人=người họ Phí
姜家的人=người của Khương gia
姬家的人=người Cơ gia/người của nhà họ Cơ
嫉妒的人=người ghen tỵ
孙子的人=người cháu
孤独的人=người cô độc/kẻ cô độc
学医的人=người học y
学武的人=người học võ
学过的人=người học qua/người từng học
它们的人=bọn chúng người/người của bọn chúng/người của bọn nó/bọn nó người
守夜的人=người gác đêm
守门的人=người giữ cửa
宋家的人=người của Tống gia
完美的你=bạn hoàn mỹ
宫外的人=người ở ngoài cung
害我的人=người hại ta
家族的人=gia tộc người/người của gia tộc
家里的人=người trong nhà
寂寞的人=người tịch mịch/người cô quạnh
寒家的人=người của Hàn gia
对付的人=người đối phó
对我的人=đối người của ta
对方的人=người của đối phương
对面的人=người đối diện
射箭的人=người bắn tên
将我的人=đem người của ta
小心的人=người cẩn thận
小气的人=người hẹp hòi/kẻ hẹp hòi
少数的人=số ít người
局里的人=người trong cục/người trong chuyện
屋内的人=người trong nhà/có người trong nhà
屋里的人=người trong phòng
山上的人=người trên núi
岛上的人=người trên đảo
岸边的人=người bên bờ
左右的人=người hai bên
布局的人=người bố trí
布阵的人=người bài trận
师门的人=người của sư môn
帝国的人=người của đế quốc
带兵的人=người cầm binh
带来的人=người mang tới
带路的人=người dẫn đường
帮他的人=người mà giúp đỡ hắn
帮佣的人=người giúp việc
帮里的人=người trong bang
干净的人=người sạch sẽ
干活的人=người làm việc
平凡的人=người tầm thường/người bình thường
平常的人=người bình thường
年少的他=hắn còn trẻ
年老的人=người già nua
年轻的他=hắn còn trẻ
幸存的人=người còn sống sót/người may mắn còn sống sót
幸福的人=người hạnh phúc
幸运的人=người may mắn
庄里的人=người trong trang
床上的人=người trên giường
应试的人=người dự thi
底下的人=người phía dưới
底舱的人=người khoang đáy
府中的人=người trong phủ
府里的人=người trong phủ
庸俗的人=người tục tằng/kẻ dung tục
廖家的人=người của Liêu gia
开朗的人=người cởi mở
开枪的人=người nổ súng
开车的人=người lái xe
开门的人=người mở cửa
张家的人=Trương gia người/người của Trương gia
弱智的人=kẻ não tàn
弹琴的人=người đánh đàn
强大的人=người cường đại/cường đại người/người mạnh mẽ
强悍的人=người cường hãn
强横的人=người mạnh mẽ
当初的他=hắn của ban đầu
当初的我=ta lúc ban đầu
当地的人=người địa phương
当场的人=người tại chỗ
当官的人=người làm quan
当年的我=ta của năm đó
当时的他=hắn lúc đó
很傻的人=kẻ rất ngu
很坏的人=kẻ rất xấu
很好的人=người rất tốt
徐家的人=người của Từ gia
得鼎的人=người chiếm được đỉnh
微胖的人=người hơi mập
心中的他=hắn trong lòng
心爱的人=người yêu
忍耐的人=người nhẫn nại
快乐的人=người vui sướng
怀里的人=người trong ngực
怎样的人=người thế nào
怕事的人=người sợ chuyện
怕死的人=người sợ chết/kẻ sợ chết
怯懦的人=người hèn nhát
总部的人=người của tổng bộ
恐怖的人=người khủng bố
恨他的人=người hận hắn
您要的人=người của ngài muốn
悲观的人=người bi quan
想死的人=người muốn chết
想象的人=người giống như
惹事的人=người gây chuyện
愚笨的人=người ngu dốt
愚蠢的人=người ngu xuẩn/kẻ ngu xuẩn
感冒的人=người bị cảm
慈祥的人=Kindly Man
成亲的人=thành thân người
成功的人=người thành công
'我的人='Người của ta
战死的人=người chết trận
所有的人=hết thảy mọi người/mọi người
所杀的人=người giết
所跟的人=người đi theo
扑倒的人=người bị đụng ngã
打井的人=người đào giếng
打你的人=người đánh ngươi
打擂的人=người đánh lôi đài/người thi đấu
执法的人=người chấp pháp
扮我的人=đóng vai ta người
找他的人=người tìm hắn
找我的人=người tìm ta
承受的人=người nhận
抓他的人=người bắt hắn
抗议的人=người kháng nghị
报价的人=người báo giá/người ra giá
报信的人=người báo tin
报到的人=người báo danh
报名的人=người báo danh
报告的人=người báo cáo
报警的人=người báo cảnh sát
报讯的人=người báo tin
抬轿的人=người nâng kiệu/người khiêng kiệu
抽烟的人=người hút thuốc lá
拍照的人=người chụp hình
拿刀的人=người cầm đao
拿枪的人=người cầm súng
指路的人=người chỉ đường
挖井的人=người đào giếng
挺傻的人=kẻ rất ngu
挺坏的人=kẻ rất xấu
挺好的人=người rất tốt
捣乱的人=người quấy rối
掌管的人=người chưởng quản
探望的人=người thăm
接你的人=người đón ngươi
接岗的人=người tiếp ca
接待的人=người tiếp đãi
接我的人=người đón ta
接手的人=người sang tay
接班的人=người thay ca
握劍的人=người cầm kiếm
揭发的人=người tố giác
搞事的人=người gây sự
擁有的人=ủng hữu đích nhân
操练的人=người thao luyện
收信的人=người nhận thư/người nhận thơ
收债的人=người đòi nợ
放哨的人=người tuần tra
政府的人=người của chính phủ
敌人的人=người của địch nhân
敌对的人=người đối địch
敏感的人=người nhạy cảm
救他的人=người cứu hắn/người cứu nàng
救她的人=người cứu nàng
救援的人=người cứu viện
教廷的人=người của giáo đình
敲钟的人=người gõ chuông
斯文的人=người có văn hoá/người có giáo dục/người thuộc tầng lớp tri thức/người lịch sự
新来的人=người mới tới
方家的人=người của Phương gia
施工的人=thợ xây cất
旁系的人=người của hệ thứ
旁边的人=người bên cạnh/những người bên cạnh
族中的人=người trong tộc
无关的人=người không liên quan
无德的人=người vô đức
无情的人=người vô tình/kẻ vô tình
无理的人=người vô lý
无知的人=người dốt nát
无耻的人=người vô sỉ/người vô liêm sỉ
无聊的人=người nhàm chán
无辜的人=người vô tội
明眼的人=người có ánh mắt độc đáo
是他的人=là người của hắn
是谁的人=là người nào
晨练的人=người luyện thần
普通的人=người bình thường
暗中的人=người trong bóng tối
暗幕的人=người của Ám Mạc
暴富的人=người giàu đột ngột
暴怒的他=hắn giận dữ/hắn giận dử
更傻的人=kẻ càng ngu hơn
更坏的人=kẻ càng xấu hơn
更多的人=người nhiều hơn
更好的人=người càng tốt hơn
曾经的他=hắn đã từng
最亲的人=người thân nhất
最傻的人=kẻ ngu nhất
最后的人=người cuối cùng
最坏的人=người xấu nhất/kẻ xấu nhất
最好的人=người tốt nhất
最差的人=người kém cỏi nhất/người kém cõi nhất
最弱的人=người yếu nhất
最强的人=người mạnh nhất
最忙的人=người bận rộn nhất
有势的人=người có thế
有活的人=có người sống
有趣的人=người thú vị
有钱的人=người có tiền
服侍的人=người hầu hạ
服务的人=người phục vụ
服用的人=người được phục dụng
朝廷的人=người của triều đình
未来的我=ta của tương lai
本事的人=người có bản lĩnh/người có bản lãnh
本少的人=người của bổn thiếu
本族的人=người của bổn tộc
朱家的人=người của Chu gia
机会的人=cơ hội người
机灵的人=người cơ linh
杀人的人=người giết người
杀他的人=người giết hắn
杀你的人=người giết ngươi
杀我的人=giết ta người/giết người của ta
李家的人=người của Lý gia
村里的人=người trong thôn
杜家的人=người của Đỗ gia
来往的人=người lui tới
来犯的人=những kẻ xâm phạm
杨家的人=Dương gia người/người của Dương gia
极傻的人=kẻ cực kỳ ngu
极坏的人=kẻ cực kỳ xấu
极好的人=người tốt vô cùng/người cực kỳ tốt
林家的人=người của Lâm gia
柳家的人=người của Liễu gia
桌上的人=người trên bàn
桑老的人=người của Tang lão
梦里的人=người trong mộng
检票的人=người soát vé
楼中的人=người trong lầu
榜上的人=người trên bảng
欠钱的人=người thiếu tiền
正常的人=người bình thường
正派的人=người chính phái
正直的人=người chính trực/người chánh trực
正经的人=người đứng đắn
武功的人=người có võ công
死了的人=người đã chết
死去的人=người bị chết/người đã chết
死神的人=tử thần đích nhân
残忍的人=người tàn nhẫn/kẻ tàn nhẫn
殷家的人=người của Ân gia
殿中的人=người trong điện
母亲的人=người của mẫu thân
毒门的人=người của Độc môn
求教的人=người thỉnh giáo
江家的人=người của Giang gia
江湖的人=người của giang hồ
沈家的人=người của Thẩm gia/người của Trầm gia/người của nhà họ Thẩm
沉默的人=người trầm mặc
没家的人=người không nhà
没用的人=người vô dụng
没病的人=người không có bệnh
没脸的人=người không mặt mũi/người không biết xấu hổ
沿路的人=người dọc theo đường/người ven đường
活命的人=người còn sống
活着的人=người sống
活著的人=người đang sống
海上的人=người đi biển
海外的人=hải ngoại người
淫荡的人=người dâm đãng
深爱的人=người yêu sâu đậm
清醒的人=người sáng suốt
满舱的人=người đầy thương tích
潜伏的人=người nằm vùng
炼制的人=người luyện chế
炼器的人=người luyện khí
照看的人=người trông nom
熊样的人=người y như gấu
熟悉的人=quen thuộc người/người quen/người quen thuộc
熟识的人=người quen biết
燕家的人=người của Yến gia
爱你的人=người yêu của ngươi/người yêu ngươi
父亲的人=người của phụ thân
特别的人=người đặc biệt
特勤的人=người của đặc cần
犯罪的人=người phạm tội
狂妄的人=người cuồng vọng
狈村的人=người của Bái thôn
狩猎的人=người săn thú
玄门的人=người của huyền môn
王宫的人=người của vương cung
王家的人=người của Vương gia
现在的他=hắn hiện tại/hắn bây giờ
现在的你=ngươi bây giờ
班上的人=người trong lớp
理智的人=người có lý trí
琢磨的人=gọt giũa người
生死的人=người sống chết
生气的人=người tức giận
生病的人=người ngã bệnh
用它的人=người dùng nó
用餐的人=người dùng cơm
留下的人=người được ở lại/người được giữ lại
留恋的人=người lưu luyến
疯狂的人=người điên cuồng
白家的人=người của Bạch gia
皇上的人=người của hoàng thượng
皇室的人=người của hoàng thất
监视的人=người giám thị/người giám sát
直爽的人=người thẳng thắn
相投的人=người tương đắc
相近的人=người ở gần
看书的人=người đọc sách
看守的人=người trông coi
看戏的人=người xem kịch
看牌的人=người xem bài
看病的人=người xem bệnh
真傻的人=kẻ thật là ngu
真坏的人=kẻ thật là xấu
真好的人=người thật là tốt
真实的人=người chân thật
眼前的人=người trước mắt
眼馋的人=người thèm thuồng
睡觉的人=người ngủ
知己的人=người tri kỷ
知情的人=người biết
知道的人=người biết
矫情的人=loại người bụng đang đói có người mời ăn thì kêu no rồi/loại người bụng đang đói có người mời ăn thì kêu no rồi mà từ chối
石家的人=người của Thạch gia
矿上的人=người trong mỏ
硬气的人=người cứng rắn
碰瓷的人=người giả bộ bị đụng
神域的人=người của Thần Vực
神宫的人=người của Thần cung
神殿的人=người của thần điện
神盟的人=người của thần minh
神秘的人=người thần bí
离婚的人=người ly dị
离开的人=người rời đi
种植的人=người trồng trọt
秘会的人=người của bí hội
秘密的人=người bí mật
稳健的人=người vững vàng
站着的人=người đứng
童家的人=người của Đồng gia
笨死的人=người đần
简单的人=người đơn giản
管事的人=người quản sự
管家的人=người của Quản gia
粗鲁的人=người thô lỗ/kẻ thô lỗ
精明的人=người tinh minh/người sáng suốt
精血的他=tinh huyết của hắn
精血的你=tinh huyết của ngươi
精血的我=tinh huyết của ta
系铃的人=người buộc chương
纪委的人=người của kỷ ủy
练武的人=người luyện võ
组织的人=người của tổ chức/tổ chức người
经过的人=người đi qua
缺钱的人=người thiếu tiền
罗家的人=người của La gia
老娘的人=người của lão nương
老子的人=lão tử người/người của lão tử
老实的人=người trung thực
联盟的人=người trong liên minh
联邦的人=người của liên bang
聪明的人=người thông minh
肖家的人=người của Tiếu gia
胆大的人=người dạn dĩ
胆小的人=người nhát gan/kẻ nhát gan
背后的人=người sau lưng
能飞的人=người có thể bay
脱困的人=người thoát khốn
脸红的人=người mặt đỏ
脾气的人=người có tính khí/người nóng tính
自卑的人=người tự ti
自恋的人=người tự luyến/người hay tự kỷ tự yêu chính mình
自我的人=tự ngã đích nhân
自爱的人=tự ái đích nhân
自私的人=người ích kỷ
至亲的人=người chí thân
舰上的人=người trên hạm
船上的人=người trên thuyền
船里的人=người trong thuyền
苏家的人=người của Tô gia
苏沉的人=người của Tô Trầm
萧家的人=người của Tiêu gia
落水的人=người rơi xuống nước
虎哥的人=người của Hổ ca
虎家的人=người của Hổ gia
虚伪的人=người dối trá
蠢笨的人=người ngu xuẩn
街上的人=người trên đường phố
被抓的人=người bị bắt
被杀的人=người bị giết
装傻的人=trang kẻ ngu
西厂的人=người của tây Hán
要傻的人=kẻ còn ngu hơn
要坏的人=kẻ còn xấu hơn
要好的人=người còn tốt hơn
要强的人=người hiếu thắng
要找的人=muốn tìm người/người muốn tìm
要护的人=muốn bảo vệ người
要死的人=phải chết người/người phải chết/phải người đã chết
要见的人=người muốn gặp
见不的人=xem có người không
见到的人=người nhìn thấy
观战的人=người quan chiến/người xem cuộc chiến
观棋的人=người xem cờ
观看的人=người quan sát
解救的人=người giải cứu
言家的人=người của Ngôn gia
认识的人=người quen biết/người biết
认输的人=nhận thua người/người nhận thua
讨厌的人=chán ghét người/người đáng ghét/kẻ đáng ghét
记恨的人=người ghi hận
讲究的人=người ý tứ
识得的人=người nhận biết
识货的人=người biết nhìn hàng/người biết nhìn hàng xịn/người biết hàng
识趣的人=người thức thời
诚实的人=người thành thật
话多的人=người nói nhiều
该死的人=người đáng chết
说媒的人=người làm mối
说话的人=người nói chuyện
说话的他=hắn nói chuyện
说谎的人=người nói láo
请他的人=người mời hắn
谢家的人=người của Tạ gia
谦逊的人=người khiêm tốn
谨慎的人=người cẩn thận
豁达的人=người rộng lượng/loại người rộng lượng
豪爽的人=người hào sảng
贪婪的人=người tham lam/kẻ tham lam
贪钱的人=người tham tiền
贫穷的人=người nghèo khó bần cùng
费家的人=người của Phí gia
赌局的人=người đánh cuộc
赌车的人=người đánh cuộc xe
走动的人=người đi đi lại lại
赵家的人=người của Triệu gia
赵村的人=người của Triệu thôn
赶车的人=người đánh xe
越傻的人=kẻ càng ngu hơn
越坏的人=kẻ càng xấu hơn
越好的人=người càng tốt hơn
跌倒的人=người ngã nhào
跟踪的人=người theo dõi
路边的人=người bên ven đường
踩人的人=người giẫm lên người
身后的人=người phía sau/người đứng phía sau
身旁的人=người bên cạnh
身边的人=người bên cạnh/người ở bên cạnh
车上的人=người trên xe
车内的人=người bên trong xe
车里的人=người trong xe
车队的人=người của đoàn xe
软弱的人=kẻ mềm yếu
输了的人=người thua
输家的人=người của nhà thua
边上的人=người bên trên
迂腐的人=loại người cổ hủ/người vu hủ
过去的人=người trong quá khứ/quá khứ nhân
过去的你=ngươi của quá khứ/ngươi đi qua/quá khứ ngươi/ngươi ngày xưa/của ngươi quá khứ
过去的我=ta của quá khứ
还有的人=còn có người
进入的人=người tiến vào
进出的人=người ra vào
进来的人=người tiến vào
进来的他=hắn tiến vào
远处的人=người ở ngoài xa
远方的人=người phương xa
追她的人=người theo đuổi nàng
追杀的人=người truy sát
适合的人=người thích hợp
逆天的人=người nghịch thiên
选中的人=chọn trúng người/người được chọn
通学的人=người ở ngoại trú
道歉的人=người nói xin lỗi
遭劫的人=người gặp nạn
邀请的人=người mời
邪恶的人=người tà ác/kẻ gian ác
邮电的人=người của bưu điện
部族的人=người của bộ tộc
部队的人=người của bộ đội
酒店的人=người của quán rượu
醉了的人=người say
醉酒的他=hắn say rượu
醒着的人=người tỉnh
里面的人=người ở bên trong
重要的人=người trọng yếu
铁家的人=người của Thiết gia
错误的人=người sai lầm
镇上的人=người của trấn trên
镖局的人=người của tiêu cục
镜中的人=người trong kính
门外的人=người ngoài cửa
门里的人=người trong cửa
闭关的人=người bế quan
问话的人=người hỏi
问路的人=người hỏi đường
闹事的人=người gây chuyện
闻过的人=người ngửi qua/người từng ngửi
阙家的人=khuyết gia nhân
队里的人=người trong đội
阴险的人=người âm hiểm/kẻ nham hiểm
附近的人=người lân cận
陆家的人=người của Lục gia
陌家的人=người của Mạch gia
随便的人=người tùy tiện
集团的人=người của tập đoàn
雷家的人=người của Lôi gia
青帮的人=người của Thanh bang
面前的人=người trước mặt
韩家的人=người của Hàn gia
领头的人=đầu lĩnh/người cầm đầu
颇傻的人=kẻ khá ngu
颇坏的人=kẻ khá xấu
颇好的人=người khá tốt
风族的人=người của Phong tộc
餐厅的人=người của phòng ăn
马上的人=người cưỡi ngựa
马爷的人=người của Mã gia
驾驶的人=người lái xe
验票的人=người soát vé
骑马的人=người cưỡi ngựa
骗的我们=lừa gạt chúng ta
高傲的人=người cao ngạo/người kiêu ngạo
高家的人=người của Cao gia
高贵的人=người cao quý
高雅的人=người cao nhã/người tao nhã
魏家的人=người của Ngụy gia
魔域的人=người của Ma Vực
魔宫的人=người của Ma cung
魔教的人=người của Ma giáo
魔族的人=người của ma tộc
魔门的人=người của Ma môn
鲁莽的人=người lỗ mãng/kẻ lỗ mãng
黑帮的人=người của xã hội đen
黑道的人=người của hắc đạo
龙家的人=người của Long gia
龙息的人=người của long tức
上的人=người trên
买的人=người mua
亲的人=thân nhân
会的人=người biết
住的人=người ở/người đang ở
傲的人=ngạo nhân
傻的人=kẻ ngu
养的人=người nuôi
别的人=những người khác
叫的人=người gọi
哪的人=người ở đâu
喊的人=người kêu
坏的人=người xấu
外的人=người bên ngoài
多的人=nhiều người
她的人=người của nàng/nàng người
好的人=người tốt
它的人=người của nó/nó người
对的人=người thích hợp
少的人=ít/vắng người/ít,vắng người
带的人=mang người
座的人=người ngồi
怕的人=người sợ
您的人=người của ngài
懂的人=người biết
找的人=tìm người
数的人=số người
有的人=có người
杀的人=giết người
来的人=người tới/tới nhân
样的人=người như vậy
死的人=người chết
烫的他=hắn nóng
瞎的人=người mù
矮的人=người lùn
神的人=thần nhân
笑的人=người cười
约的他=hẹn hắn
罩的人=bảo vệ người/bảo vệ - người
美的你=đẹp mặt ngươi
老的人=lão nhân/người của lão
赢的人=người thắng
趣的人=người thú vị
软的人=người hèn nhát
输的人=người thua
送的人=người đưa
里的人=người bên trong
