一书=quyển sách này
世爵=Spyker
乔丹=Jordan
人类=nhân loại
以太=ether/Aether
伊顿=Eaton
伦尼=Lenny
保罗=Paul
傲罗=Auror
光轮=Nimbus
冈特=Gaunt
刚特=Gaunt
制杖=chế trượng
加隆=Galleon
华生=Watson
博科=Burkes
卡玛=Kama
卢平=Lupin
厉火=lệ hỏa
哈利=Harry
嘉玛=Gemma
地图=địa đồ
塞耶=Sayre
夜游=dạ du
大卫=David
失控=mất khống chế
奇洛=Quirrell
奎妮=Queenie
奥美=Ogilvy
如尼=Rune
媚娃=Veela
安东=Aron
家族=gia tộc
宾斯=Binns
尼可=Nick
巴罗=Baron
巴蒂=Barty
布特=Abbott
带嘤=England
席勒=Schiller
弗利=Farley
张秋=Cho Chang
彼得=Peter
戴丽=Doly
才能=tài năng
摩金=Malkin
敖罗=Auror
教师=giảng viên
文达=Vinda
斑斑=Scabbers
断掉=gãy mất
普塞=Puse
杰克=Jack
杰玛=Gemma
校长=hiệu trưởng
格雷=Grey
梅林=Merlin
梅森=Mason
横扫=Cleansweep
欧宝=Opel
欧洲=Châu Âu
汤姆=Tom
沃森=Watson
油灯=đèn dầu
法利=Farley
波特=Potter
洛奇=Quirrell
洛肯=Lorcan
海格=Hagrid
炉石=Hearthstone
牙牙=Fang
狼人=Người Sói
珀莉=Polly
甘普=Gamp
白鲜=Bạch tiên
破特=Potter
破解=phá giải
祭司=tế tự
福奇=Fudge
科亚=Coya
穆迪=Moody
级长=cấp trưởng
纽特=Newt
纽约=New York
维莉=Willie
罗恩=Ron
老伏=lão Vol
老斯=Snape
老格=Grindelwald
艾玛=Emma
艾登=Aiden
芙蓉=Fleur
苏珊=Susan
莉莉=Lily
莫格=Mogg
莫芬=Morfin
莫莉=Molly
莱恩=Ryan
莱福=Trevor
萨博=Saab
蔓蒂=Mandy
蛇怪=xà quái
行礼=hành lý
褔吉=Fudge
西撒=Cesar
要点=nội dung chủ yếu
解开=giải khai
詹姆=James
诺厄=Noah
谎话=nói vớ vấn/lời nói dối
费农=Vernon
赫敏=Hermione
路威=Fluffy
迈伦=Myron
邢泽=Damon
里奇=Richie
钠特=Knut
铂西=Percy
闪闪=Winky
雪莉=Shirley
雷诺=Renault
飞路=Floo
马修=Mã Tu/Matthew
马琳=Marlene
高尔=Goyle
魅娃=Veela
魔文=ma văn
魔药=ma dược
鸟蛇=Occamy
万宝龙=Montblanc
乔安娜=Johanna
乔昆达=Jorkunda
云备份=cloud backup data
伊万斯=Evans
伊戈尔=Igor
伏地魔=Voldemort
伯恩斯=Burns
佐科的=Jokos
佩内诺=Penelope
兄弟会=Huynh đệ hội
克劳奇=Crouch
克里维=Creevey
内里达=Nerida
凯瑞迪=Charity
分裂咒=Bùa cắt(Diffindo)
博恩斯=Bones
博恩施=Bones
博格特=Ông kẹ(Boggart)
卡休斯=Cassius
卡修斯=Cassius
卢修斯=Lucius
卢埃林=Llewellyn
厉火咒=Lệ Hỏa Chú
反咒的=Phản Chú
变形咒=Bùa biến hình(Transfiguration)
古灵阁=Gringotts
史代西=Stacy
吉莉安=Gillian
味美思=Vermouth
咒立停=Finite Incantatem
哈洛特=Lockhart
啃大瓜=Avada
图赛尔=Tussel
圣芒戈=St. Mungo
地波特=Potter
塔里诺=Tarino
塞克斯=Psykox
塞德里=Cedric
多利安=Dorian
大宇车=Daewoo
大家族=đại gia tộc
大粪弹=Dungbomb
太妃糖=Toffee (kẹo bơ cứng)
奥利姆=Olympe
奥塔林=Ottaline
奥特里=Autry
好干净=thật sạch sẽ
如尼文=Rune
守护神=thủ hộ thần
安东尼=Anthony
安德罗=Andrew
对角巷=Hẻm Xéo
小天狼=Sirius
小矮星=Pettigrew
尹戈尔=Igor/Igo
巫师棋=Vu sư cờ
巴伯鲁=Barberu
巴博恩=Barebone
巴布林=Babbling
巴恩斯=Barnes
巴步林=Baburin
巴沙特=Bagshot
巴隆顿=Longbottom
布加迪=Bugatti
布来克=Black
布洛瓦=Blois
布莱克=Black
布雷尔=Brel
帕特奇=Potage
库尔坎=Kurkan
弗利维=Flitwick
弗立维=Flitwick
弗雷德=Fred
徳思礼=Dursley
德怀特=Dwight
德思礼=Dursley
德拉科=Draco
德斯礼=Dursley
德里安=Drian
恶咒的=Ác Chú
戴丽丝=Dilys
戴安娜=Diana
戴尔菲=Delphini
扎比尼=Zabini
找球手=Seeker
拉瑞娜=Larina
拜尔本=Barebone
摩尔根=Morgan
斑地芒=Bundimun
断裂处=chỗ gãy
斯内普=Snape
斯塔基=Skeeter
斯莱特=Slytherin
昏迷咒=Bùa choáng
普威特=Prewett
暴风雨=bão tố
朱维尔=Jewell
来姆斯=Remus
杰克逊=Jackson
柬埔寨=Campuchia
柯维斯=Corvus
校董会=trường học chủ tịch hội
格兰芬=Gryffindor
格拉布=Crabbe
格林德=Grindelwald
桃丽丝=Doris
桑帕克=Parker
汤姆森=Thompson
沃尔顿=Walton
沃森特=Watson
沙克尔=Shacklebolt
波莫娜=Pomona
泥巴种=Mudblood
洛丽丝=Norris
洛丽思=Noris
洛里丝=Norris
海尔波=Herpo
海德薇=Hedwig
海薇德=Hedwig
潘多拉=Pandora
火焰杯=Cốc Lửa
特里洛=Trelawny
狄安娜=Diana
甘波尔=Gambol
白灯戒=white lantern
白魔王=Bạch ma vương
皮皮鬼=Peeves
盖洛特=Gellert
神之躯=thần chi khu
福克斯=Fawkes
福洛林=Florean
福灵剂=Phúc Linh Tề
福西特=Fawcett
笔记本=bút ký bản
米兰达=Miranda
类魔法=loại ma pháp
纳罗利=Raleigh
纳西沙=Narcissa
纳西莎=Narcissa
缄默人=Unspeakable
罗伯特=Robert
罗威娜=Rowena
罗宾斯=Robbins
罗瑞娜=Laurena
罗齐尔=Rozier
翻倒巷=Hẻm Knockturn
翻到巷=Hẻm Knockturn
艾克莫=Akmo
芭布玲=Babbling
莫拉蒂=Moratti
莫泊桑=Maupassant
莫茨坦=Morstan
菲留斯=Filius
蒲绒绒=Puffskein
薇薇安=Vivian
蛇佬腔=Parselmouth
被打断=bị đánh gãy
詹姆斯=James
賓利车=Bentley
贝特西=Betsy
贝芙丽=Beverly
费因斯=Fiennes
费比安=Fabian
贾斯廷=Justin
赛蒂娜=Celestina
赫尔奇=Helga
赫恩斯=Hearns
迪佩特=Dippet
追球手=Chaser
邓不利=Dumbledore
邓布利=Dumbledore
都要断=đều phải đánh gãy
里弗斯=Rivers
里德尔=Riddle
金加隆=Galleon
金斯来=Kingsley
金斯莱=Kingsley
金飞侠=SNIDGET
钻心咒=Lời nguyền tra tấn(Crucio)
铃木车=Suzuki
银西可=Sickle
阿万达=Avada
阿不斯=Albus
阿克列=Akre
阿拉尼=Alani
阿瑪尼=Armani
阿瓦达=Avada
隆巴隆=Longbottom
雅典娜=Athena
霍拉斯=Horace
韦斯来=Weasley
韦斯莱=Weasley
飞路嘭=Floo-Pow
飞路网=Floo Network
香奈兒=Chanel
马福尔=Malfoy
魔法石=Hòn đá phù thuỷ
麻瓜界=Muggle thế giới
黑魔法=hắc ma pháp
万咒皆终=Vạn chú giai chung
乌姆里奇=Umbridge
乌龙出洞=Serpensortia
亚德里恩=Adrian
佛蒙特州=Vermont
俄勒冈州=Oregon
克里瓦尔=Clearwater
八眼巨蛛=Acromantula
兰尼斯特=Lannister
冷静下来=tỉnh táo lại
凯特伯恩=Kettleburn
力松劲泄=Relashio (Bùa giải thoát)
卓尔精灵=Drow tinh linh
卡思伯特=Cuthbert
卡斯曼德=Scamander
卡特里娜=Katrina
卢克伍德=Rookwood
厄恩普兰=Ernie Prang
厚礼蟹特=Holy sh***
古代魔文=cổ đại ma văn
哈利波特=Harry Potter
哈瑞破特=Harry Potter
四分五裂=Diffindo
圣玛利亚=St. Maria
坚不可摧=không thể phá vỡ
埃尔隆德=Elrond
塞巴格曼=Sebagman
塞德里克=Cedric
多洛霍夫=Dolohov
大蒜恶整=tỏi ác chỉnh
奈杰勒斯=Nigellus
奥利安娜=Orianna
奥林匹亚=Olympia
如尼纹蛇=Runespoor
姓韦斯莱=họ Weasley
威克尔多=Victor
威尔米娜=Wilhelmina
威森加摩=Wizengamot
安多米达=Andromeda
安格娜拉=Angara
富豪夫妻=phú hào vợ chồng
小天狼星=Sirius
尼克梅勒=Nicolas Flamel
巴拿巴斯=Barnabas
巴雷洛斯=Barrelos
希亚伯恩=Sheaburn
帕西瓦尔=Parcival
平克斯顿=Pinkston
幻影移形=Apparition
弯角鼾兽=Crumple-Horned Snorkack
徳思礼家=Dursley gia
急急现形=Aparecium
恢复如初=Reparo (bùa sửa chữa)
愈合如初=Episkey
戈德里克=Godric
护树罗锅=Bowtruckle
拉巴斯坦=Labastan
拉文克拉=Ravenclaw
拉文卡劳=Ravenclaw
摄魂取念=Legilimency
断了一只=gãy một cái
斯卡曼德=Scamander
斯卡曼特=Scamander
斯普劳特=Sprout
斯普特劳=Sprout
斯来特林=Slytherin
斯芬克司=Nhân sư(Sphinx)
无仗施法=vô trượng thi pháp
无声息地=không một tiếng động
无声施法=im lặng thi pháp
易容马格=Metamorphmagus
杜嘉班纳=Dolce
格兰芬多=Gryffindor
格拉普兰=Grubbly-Plank
格林德沃=Grindelwald
格林迪洛=Grindylow
格雷伯克=Greyback
格雷戈里=Gregory
格雷维斯=Graves
汝拉山脉=Jura sơn mạch
沃卡诺娃=Vokanova
沸啦唯杜=Vera Verto
波佩图阿=Perpetua
洛夫古德=Lovegood
清洁一新=Scourgify
温彻斯特=Winchester
火焰熊熊=Incendio (Bùa tạo lửa)
特里劳尼=Trelawney
瑟拉菲娜=Seraphina
皮克科瑞=Picquery
盔甲护身=Protego (Bùa che chắn)
研究中心=nghiên cứu trung tâm
神奇动物=thần kỳ động vật
神锋无影=Thần Phong Vô Ảnh(Sectumsempra)
科罗纳尔=Coronal
穆斯塔发=Mostafa
纳尔拉克=Gnarlak
纽蒙嘉德=Nurmengard
统统石化=Petrificus Totalus
维克多尔=Victor
维泽埃克=Wiseacres
罗道夫斯=Rodolphs
芭丝谢达=Bathsheda
芭斯谢达=Bassheda
苏珊彭斯=Susan Bones
莫德丝蒂=Modesty
莫蒂西雅=Morticia
莫非斯托=Mephisto
菲力乌斯=Filius
菲尼克斯=Phoenix/Phenex
蒙顿格斯=Mundungus
蜘蛛退散=Arania Exumai (Bùa đuổi nhện)
西弗利斯=Severus
西弗雷斯=Severus
训练中心=huấn luyện trung tâm
诺夫古德=Lovegood
赛拉菲娜=Seraphina
赫奇帕卡=Hufflepuff
赫普兹巴=Hepzibah
辛尼斯塔=Sinistra
达芙妮格=Daphne
速速变大=Engorgio (Bùa phóng to)
速速变小=Reducio (Bùa thu nhỏ)
邪恶力量=Supernatural
郝奇帕奇=Hufflepuff
阿不思福=Aberforth
阿不福思=Aberforth
阿丽安娜=Ariana
阿利安娜=Arianna
阿拉托斯=Aratos
阿斯托利=Astoria
阿米库斯=Amycus
阿美利卡=America
阿莉安娜=Ariana
阿莱克斯=Alex
阿金巴德=Akingbade
雷古洛斯=Regulus
霍格沃些=Hogwarts
霍格沃德=Hogwart
霍格沃滋=Hogwarts
霍格沃茨=Hogwarts
霍格莫得=Hogsmeade
霹雳爆炸=Confringo (Lời nguyền nổ tung)
飞鸟群群=Avis (Bùa gọi chim)
马克西姆=Maxime
魔法学校=trường học ma pháp
麦克拉根=McLaggen
麦克西姆=Maxime
伊尔维莫尼=Ilvermorny
伊格纳提娅=Ignatia
八眼巨蛛的=Acromantula
凯特尔伯恩=Kettleburn
古卜莱仙火=Gubraithian fire
埃尔芬斯通=Elphinstone
塔朗泰拉舞=Tarantallegra (Lời nguyền nhảy nhót)
塞法罗伯斯=Cephalopos
大脑封闭术=Occlumency
奥尔德里奇=Aldridge
奥瑞利乌斯=Aurelius
姓邓布利多=họ Dumbledore
弗洛伯黏虫=Flobber sâu lông
强大的心灵=cường đại tâm linh
强烈的电流=cường liệt điện lưu/dòng điện mãnh liệt
德姆斯特朗=Durmstrang
拉文克劳德=Ravenclaw
挪威脊背龙=Norwegian Ridgeback
无痕伸展咒=Bùa Mở Rộng
日不落帝国=United Kingdom
有求必应屋=Hữu Cầu Tất Ứng Phòng
来斯特兰奇=Lestrange
格林格兰斯=Greengrass
格林格拉斯=Greengrass
清泉如水的=Aguamenti
漂浮了起来=lơ lửng
火烤热辣辣=Furnunculus (Lời nguyền nổi mụn)
科瓦尔斯基=Kowalski
老邓布利多=lão Dumbledore
脱凡成衣店=Twilfitt and Tattings
自由工作者=Freelancer
艾尔弗丽达=Elfrida
苏门答腊岛=Sumatra
西尔瓦努斯=Silvanus
谢诺菲留斯=Xenophilius
迈克尔科纳=Michael Corner
门牙赛大棒=Densaugeo (Bùa mọc răng)
阿斯托利亚=Astoria
阿斯托莉娅=Astoria
阿格玛尼斯=Animagus
韦斯莱夫妇=Weasley vợ chồng
依玛戈马格斯=magicagus
卡拉克塔库斯=Caractacus
国王十字车站=Kings Cross nhà ga
威尔德史密斯= Wildsmith
布罗塞利昂德=Broceliande
怀尔德史密斯=Wild Smith
戴丽丝德文特=Dilys Derwent
贝拉克利特斯=Bellatrix
阿尼玛阿格斯=Animagus
阿芒多迪佩特=Armando Dippet
安东尼戈德斯坦=Anthony Goldstein
潘多拉洛夫古德=Pandora Lovegood
神奇动物在哪里=Fantastic Beasts and Where to Find Them
罗伯特希利亚德=Robert Hilliard
马库斯麦克拉根=Marcus McLagen
九又四分之三站台=Sân ga 9 3/4
伊万杰琳 · 奥平顿=Evangeline Orpington
温迪克 · 温瑞迪安=Vindictus Viridian
万科=Vanko
上传=Upload
上帝=God
丧钟=Deathstroke
中庭=Midgard
丹恩=Dane
丹特=Dent
主教=chủ giáo
主神=Chủ thần
之神=God
乌鲁=Uru
乔迁=dời đến chỗ ở tốt
亚卡=Yaka
亨利=Hank
人品=nhân phẩm
人格=nhân cách
人间=nhân gian
伊万=Ivan
伊戈=Ego
伊述=Isu
伍德=Woodrue
伙计=Buddy
传授=truyền thụ
传送=truyền tống
伽莉=Gali
位格=vị cách
佐徳=Zod
作业=bài tập
佩吉=Peggy
佩姬=Peggy
佩波=Pepper
佩珀=Pepper
信仰=tín ngưỡng
信玄=Shingen
克劳=Klaw
全断=gãy hết
兰利=Langley
内德=Ned
冥想=Calm Mind
凑齐=góp đủ
凯伦=Karen
刀锋=Blade
刻尔=Keres
加州=California
加里=Gary
加马=Gama
劳森=Lawson
劳非=Laufey
劳顿=Lawton
勒达=Leda
勾八=Baka
卡尔=Kal
卡戎=Charon
卡拉=Kara
卡特=Carter
卢恩=Rune
古一=Ancient One
古巴=Cuba
史丹=Stan
史登=Stern
后劲=hậu kình
后宫=hậu cung
吞叔=Galan thúc
员工=nhân viên
周旋=lượn vòng
咪咪=Mimi
哀尔=Il
哈代=Hardy
哈皮=Happy
哈维=Harvey
哥谭=Gotham
嘉颖=Gia Dĩnh
嘿呦=Hail
图灵=Turing
地点=địa điểm
地球=Địa cầu
埃尔=El
基因=gen
墨瑟=Mercer
夜枭=Owl
夜魔=Daredevil
大群=Legion
大超=Superman
天主=God
天使=thiên sứ
天后=Thiên hậu
天父=thiên phụ
天竺=Ấn Độ
天马=Pegasus
奈姬=Nike
奎斯=Quested
奎西=Quincy
奥妹=Olsen
奥措=Otso
奥氏=Osborn
女人=nữ nhân
妇联=Avengers
妞约=New York
妮尔=Niel
妮莎=Nyssa
姜戈=Django
娇德=Jorde
婊子=Bitch
孔苏=Khonsu
孟邦=Bang Mon
宙斯=Zeus
宝马=BMW
将军=tướng quân
小丑=Joker
尤瑞=Yuri
尼克=Nick
山姆=Sam
岛国=Nhật Bản
左德=Zod
巴特=Bart
巴顿=Barton
布利=Buri
布朗=Brown
布来=Brad
希芙=Sif
帕克=Parker
幻视=Vision
库瑞=Curry
弗瑞=Fury
得州=Texas
德军=Đức quân
心灵=tâm linh
忍者=Ninja
忒拜=Thebes
快抖=FFs
总部=tổng bộ
恶魔=ác ma
惊队=Captian Marvel
戈登=Gordon
戴因=Dyne
戴蒙=Daimon
手机=điện thoại
托尼=Tony
托德=Todd
托法=Torfa
扩张=khuếch trương
披萨=Pizza
拉普=Rapu
拉顿=Rodan
拳头=nắm đấm
拿铁=Latte
振金=Vibranium
捏断=bóp gãy
掸国=Myanmar
提柯=Tikor
提琴=Violin
撞断=đụng gãy
支点=điểm tựa*(Fulcrum)
敏锐=nhạy cảm
教堂=giáo đường
教子=Godson
教父=Godfather
文森=Vince
断裂=đứt gãy
日报=Daily
旧神=Cựu thần
旺达=Wanda
明白=minh bạch
星云=Nebula
星城=Star City
晨星=MorningStar
智人=Homo sapiens
智商=IQ
暹罗=Thái Lan
曼迪=Mandy
机甲=Armor
林肯=Lincoln
柴达=Nova
格尔=Gorr
格温=Gwen
梅婶=Aunt May
梅黛=Mayday
棍叟=Stick
棱堡=Bastion
欧阿=Oa
正联=Justice League
死侍=Deadpool
死神=Tử thần
毒液=Venom
比利=Billy
毛子=nước Nga
氪星=Krypton/krypton
氪石=Kryptonite
汉克=Hank
汉默=Hammer
沙朗=Sharon
沙赞=Shazam
波兹=Potts
泰坦=Titan
泰奇=Tetch
洛基=Loki
派对=Party
浩克=Hulk
海拉=Hella
海滨=Coast
海滩=bãi biển
渣康=Constantine
漂浮=trôi nổi
漫威=Marvel
激流=Riptide
火种=hỏa chủng
灭霸=Thanos
灵界=Linh giới
灵蝶=Psylocke
炸断=nổ gãy
烧断=đốt gãy
牛顿=Newton
狂攻=Onslaught
狗屎=Shit
狼獾=Wolverine
猎鹰=Falcon
王水=Acid đặc
玛姬=Maggie
玻瓦=Bolivar
珍玛=Jemma
班纳=Banner
瑜伽=Yoga
瑞克=Rick
瑞安=Ryan
瑞德=Rhett
甜心=Sweetheart
电系=Hệ Điện
电索=Cable
疯帽=Jervis Tetch
皮卡=xe bán tải
皮姆=Pym
盖亚=Gaia
真神=Chân thần
矛刃=mũi mâu
短命=đoản mệnh
碧亚=Bia
碧压=Bia
祖利=Zuri
神性=thần tính
神格=thần cách
神王=thần vương
福吉=Foggy
福柏=Phoebe
秘客=Magik
秘密=bí mật
秘能=bí năng
穆托=Muto
米奇=Mickey
紐约=New York
紫人=Purple Man
红房=Red Room
级别=cấp bậc
纳尔=Knull
纳布=Nebo
纳米=Nano
纳翠=Nazi
纽約=New York
维度=chiều không gian
维恩=Wayne
维森=Wesson
绿魔=Green Goblin
罗宾=Robin
罗根=Logan
罗比=Robbie
罗维=Lowe
美刀=USD
美女=mỹ nữ
老墨=lão Mep
能力=năng lực
能量=năng lượng
船长=thuyền trưởng
艾尔=El
艾崔=Eitri
苏国=Liên Xô
苏打=Soda
苏芮=Shuri
苏里=Shuri
茉莉=Jasmine
草莓=dâu tây
荣兹=JOnzz
莎伦=Sharon
莫度=Mordo
莫拉=Moira
莫森=Mawson
莫都=Mordo
莱夫=Leif
莱蒂=Letty
菲兹=Fitz
菲力=Philly
萨卡=Sakaar
萨总=Sargeras
葛蕾=Grey
蒂凡=Tivan
薄饼=Bánh kếp
蝰蛇=Viper
血脉=huyết mạch
西芙=Sif
詹米=Jamie
诺恩=Noen
诺林=Norrin
谢顿=Seldon
贝恩=Bane
费城=Philadelphia thành phố
费斯=Frost
资本=tư bản
赖德=Rider
赫夫=Huff
赫曼=Hermann
超人=Superman
超凡=siêu phàm
超英=Superhero
超霸=Ultraman
跑酷=Parkour
达蒙=Damon
远征=viễn chinh
迭加=điệp gia
邦德=Bond
酒保=Bartender
里克=Rick
里昂=Lyon
金尼=Kinney
金并=Kingpin
钢骨=xương thép*(Cyborg)
银护=Guardians of the Galaxy
银滑=Silver Surfer
阔佬=Rich-guy
阿三=Ấn Độ
阿福=Alfred
院长=viện trưởng
隆中=Ryū-chū
雅典=Athens
雅威=Yahweh
雪绪=Yukio
雷尼=Rainey
雷神=Thần Sấm
霍尔=Hall
霓虹=Nhật Bản
露丝=Ruth
非裔=gốc Phi
鞭索=Whiplash
韦伦=Waylon
韦德=Wade
韦恩=Wayne
顶篷=Canopy
飞机=máy bay
首富=Richest
马克=Mark
马特=Matt
马龙=Malone
高丽=Hàn quốc
高桌=High Table
高达=Gundam
魔力=ma lực
魔神=Majin
鹈鹕=Pelican
鹰眼=Hawk Eye
黄印=Kijirushi
黑帮=Gangster
黑格=Hale
黑洞=Black Hole
黑皇=Black King
黑空=Elektra
黑豹=Black Panther
黛娜=Dinah
黛比=Debbie
万力王=Graviton
万达格=Wundagore
三飞翼=Triskelion
上帝啊=Jesus
不老泉=bất lão tuyền
丰颂府=Tỉnh Mae Hong Son
丹吉尔=Tangier
丹弗斯=Danvers
丽亚娜=Illyana
乔丹尼=Jordani
乔纳森=Jonathan
乔艾尔=Jor El
五面怪=Quintessons
亚克莱=Alkali
亚图姆=Atum
亚天父=Á thiên phụ
交换下=trao đổi
人造人=người nhân tạo
企鹅人=The Penguin
伊万卡=Ivanka
伊文斯=Evans
伊特里=Eitri
伊莫顿=Imhotep
伽娜塔=Galacta
住吉会=Sumiyoshi-kai
保护伞=Umbrella
光照会=Illuminati
克拉科=Krakoa
克来因=Crane
克林特=Clint
克莱恩=Klein
克里斯=Chris/Crius
克里特=Crete
兔子国=Tàu hủ quốc
共济会=Hội tam điểm
共生体=Symbiote
冈萨斯=Venganza
写作业=làm bài tập
冲云霄=Predaking
几十亿=mấy tỷ
凡冈撒=Venganza
凤凰女=Phoenix
凯尹拉=Caiera
凯撒宫=Caesars Palace
凯瑟琳=Catherine
功能卡=công năng tạp
加拿大=Canada
加米尔=Gamiel
加里奥=Galio
加里森=Garrison
加麻大=Canada
包尔森=Borson
匝瑳市=Sōsa thành phố
十环帮=Ten Rings
千里眼=Clairvoyant
半位面=bán vị diện
华盛顿=Washington
博尔森=Borson
博德利=Bodleian
卡列班=Caliban
卡利文=Calvin
卡斯柏=Casper
卡珊卓=Cassandra
卡罗尔=Carol
卡迈恩=Carmine
卡魔拉=Gamora
印杜洋=Ấn Độ dương
双面人=Two-Face
变种人=Mutant
史丹顿=Stanten
史密斯=Smith
史来姆=slime
史蒂芬=Stephen
吸收人=Absorbing Man
吸血鬼=Vampire
哈密尔=Hamir
哈斯塔=Hastur
哈米尔=Hamil
嘉布拉=Gabriela
因特尔=Intel
圣达菲=Santa Fe
坐忘道=tọa vong đạo
坦利亚=Tanya
埃和星=Morag tinh
埃米尔=Emil
基诺沙=Kenosha
塔利娅=Talia
塔尔图=Tartu
塔希堤=Tahiti
塔希提=T.A.H.I.T.I
塞勒尔=Serrure
塞维格=Selvig
复仇者=Avengers
多玛姆=Dormammu
多角体=The Many Angled Ones
多角者=The Many Angled Ones
夜莺队=Nightingales
夜魔侠=Daredevil
大主教=đại chủ giáo
大伊万=Big Ivan
大天使=Đại thiên sứ
大头目=Leader
大富豪=nhà giàu
大祭司=Đại tế ti
大钢牙=Sabretooth
大魔女=đại ma nữ
天使长=thiên sứ trưởng
天堂山=thiên đường sơn
天神族=Celestials
天神组=Celestial
太平洋=Thái Bình dương
奇塔瑞=Chitauri
奥丁森=Odinson
奥巴达=Obadiah
奥斯汀=Austin
奥术师=áo thuật sư
奥淑图=Oshutu
奥莉薇=Olivia
奥菲拉=Faora
威尔逊=Wilson
威震天=Megatron
安德洛=Androm
安戴尔=Andel
安苏娜=Ancksunamun
小丑女=Harley Quinn
小淘气=Rogue
小辣椒=Pepper
尤里卡=JAEGER
尼克斯=Nyx
尼克森=Nickerson
尾立鼠=Otachi
山达尔=Xandar
崔斯克=Trask
工程师=công trình sư
巫心魔=Blackheart
巴克希=Bakshi
巴沙尔=Bashar
布利克=Bleecker
布朗查=Bron-Char
布洛克=Brock
布里克=Bleecker
布鲁斯=Bruce
帕提斯=Pallas
帝王城=Imperial City
席恩娜=Sinthia
平克曼=Pinkman
康纳斯=Connors
开拓者=khai thác giả
弗丽嘉=Frigga
弗莉嘉=Frigga
弗莱肯=Flerken
弗里斯=Fries
彼得森=Peterson
德拉姆=Drumm
急冻人=Freeze
悠悠球=yo-yo
惠特斯=Whitsler
意大利=Italy
慧星帮=Comet Gang
戴克斯=Dax
手合会=The Hand
手和会=The Hand
托尔顿=Thor
托马雷=Tomar · Re
拉娜蓝=Lana Lang
拉斐特=Lafayette
振金矿=vibranium khoáng
提华纳=Tijuana
摩尔斯=Morse
擎天圣=Optimus Primal
擎天柱=Optimus Prime
收藏家=Collector
收集者=Collector
文森特=Vincent
斯克鲁=Skrull
斯卡尔=Skaar
斯坦尼=Stane
斯塔克=Stark
斯库鲁=Skrull
斯特拉=Strucker
斯特鲁=Skrull
斯莱德=Slade
施拉德=Schrader
无畏舰=Dreadnought hạm
昆塔莎=Quintessa
暴风女=Storm
曼提斯=Mantis
月光石=MoonStone
朗姆罗=Rumlow
本叔叔=Uncle Ben
杀人脑=MODOK
来克斯=Lex
来福枪=Rifle
杰罗麦=Jerome
枯木喉=Ebony Maw
柏拉图=Plato
查尔斯=Charles
查维兹=Chavez
格列佛=Gulliver
格温侍=Gwenpool
格蕾尔=Grail
格雷尔=Grail
格雷森=Grayson
格鲁特=Groot
梅丽娜=Melina
梅帕克=May Parker
梅特工=May agent
梅琳达=Melinda May
梅莱利=May Riley
梦蒂法=Montifa
森信郎=Noburo Mori
欧罗巴=Europa
死亡女=Lady Deathstrike
比邻星=Proxima
毛淡棉=Mawlamyine
永久卡=vĩnh cửu tạp
永恒族=Eternals
汤普森=Thompson
沃密尔=Vormir
沃辛顿=Worthington
法尔曾=Falzone
法师王=pháp sư Wong
法温德=Fairwind
波尔森=Borson
波震女=Quake
泰瑞根=Terrigen
泰诺斯=Thanos
派斯克=Paiske
浮空塔=phù không tháp
海扁王=Kick-Ass
涅迦尔=Nergal
清迈府=Tỉnh Chiang Mai
漂亮国=Mỹ quốc
火风暴=Firestorm
灯塔国=Hoa Kỳ
炸鸡叔=Gus
爱丽丝=Alice
爱德华=Edward
特卡查=TChaka
特弥斯=Themis
特查卡=TChaka
猕猴桃=kiwi
玛丽简=Mary Jane
珍宝女=Jewel
理工男=kỹ thuật trạch nam
理查兹=Richards
琴格雷=Jean Gray
琴葛蕾=Jean Grey
瑟蕾莎=Cereza
瓦图姆=Watoomb
瓦尔托=Valtorr
电磁学=điện từ học
疯帽匠=Jervis Tetch
白皇后=White Queen
皮卡丘=Pikachu
皮尔斯=Pierce
盖兹勒=Geiszler
真纯会=Chân Thuần hội
眼球人=The Orb
硝化人=Nitro
祖国人=Homelander
神秘客=Mysterio
福斯特=Foster
科勒曼=Kellerman
科拉斯=Korath
科莫多=Komodo
科萨语=Xhosa ngữ
科里昂=Corleone
科鲁兹=Cruze
稻草人=Scarecrow
简小姐=Jane tiểu thư
简泰克=Gentek
简福斯=Jane · Foster
米涅瓦=Minn-Erva
类人体=Man-Thing
红坦克=Juggernaut
红头罩=Red Hood
红房子=Red Room
红浩克=Red Hulk
红蜘蛛=Starscream
红魔鬼=Azazel
纳塔鲁=Natalu
纳琪丝=Natchios
维克多=Victor
维山帝=Vishanti
维山蒂=Vishanti
维达尔=Vidal
绿灯戒=green lantern
罗德尼=Rodney
罗琳娜=Lorena
美宣宗=Tổng thống Mỹ
肖尔斯=Shales
腹语人=Ventriloquist
腹语者=Ventriloquist
自由国=Hoa Kỳ
艾丽卡=Elektra
艾克恩=Ikonn
艾斯丽=Isley
艾曼德=Adamantium
艾米克=Amick
艾贾克=Ajak
苏克雷=Sucre
苏尔特=Surtur
苏尼尔=Sunil
苗瓦迪=Myawaddy
荒原狼=Steppenwolf
莫拉格=Morag
莫格星=Morag tinh
莫高雷=Mogore
菊花国=Nhật Bản
菲奥娜=Fiona
萨姆恩=Sameen
萨洛蒙=Solomon
萨缪尔=Samuel
萨诺斯=Thanos
落锤市=thành phố Hammerfall
蒂亚姆=Tiamut
蒂尔顿=Tilton
蒙巴顿=Mountbatten
蔓蒂丝=Mantis
蜥蜴人=Lizardman
蝙蝠侠=Batman
蝙蝠灯=Batlight
蝙蝠镖=Batarang
西恩娜=Sinthia
西格德=Sigurd
西索恩=Chthon
西索文=Chthon
西索斯=Chthon
西蒙斯=Simmons
警探局=Detective Bureau
请冷静=xin tỉnh táo
诺夫曼=Norfman
豪利特=Howlett
贝里克=Bellick
贾尔森=Jarlson
贾维斯=Jarvis
赛丽娜=Selena
赛博格=cyborg
赫莫斯=Hermes
赫莲娜=Helena
超巨星=Supergiant
路易斯=Lewis
路西法=Lucifer
达尼尔=Daniel
迅猛龙=Velociraptor
迈阿密=Miami
郎姆洛=Rumlow
里查兹=Richard
重力鎓=Gravitonium
金字塔=Pyramid
钢铁侠=Iron Man
钷金属=promethium metal
银影侠=Silver Surfer
银武士=Silver Samurai
阿加莎=Agatha
阿南斯=Ananke
阿尔宁=Arnim
阿戈摩=Agamotto
阿拉冈=Aragon
阿拉科=Arakko
阿摩戈=Amogotto
阿斯加=Asgard
阿波罗=Apollo
阿滨苏=Abin · Sur
阿莎加=Agatha
阿萨佐=Azazel
阿萨姆=Arnim
阿贾克=Ajak
隐型女=Invisible Woman
雷耶斯=Reyes
霍利斯=Hollis
霍华德=Howard
霍尔斯=Hvolsvöllur
霍格斯=Hoggoth
霍比特=Hobbit
霍瓦斯=Horvath
霸天虎=Decepticon
风筝人=Kite Man
风速侠=Whizzer
马克思=Marx
马利克=Malick
马律师=Matt luật sư
马罗尼=Maroney
马苏卡=Masoka
骨裂的=gãy xương
魔斯拉=Mothra
鲨卷风=Sharknado
黄灯戒=yellow lantern
黑亚当=Black Adam
黑凤凰=Dark Phoenix
黑塔帮=Black Tower Gang
黑奇异=Dark Strange
黑寡妇=Black Widow
黑手党=Mafia
黑死剑=Black Death Sword
黑皇后=Black Queen
黑皇帝=Black King
黑矮星=Black Dwarf
黑蝠王=Black Bolt
黛布拉=Debra
龙卷风=Tornado
一脸笑容=nở nụ cười
万格达山=Wundagore núi
万物之下=One Below All
万达格山=Wundagore núi
三大圣殿=tam đại thánh điện
不朽之城=bất hủ chi thành
中城高中=Midtown High School
丹内阿人=Achaeans người
为他脱罪=gỡ tội cho hắn
乌克萨斯=Uxas
乔卡斯塔=Jocasta
亚历山大=Alexander
亚肯尼亚=Kenya
亲手打造=tự tay chế tạo
伊丽亚娜=Illyana
伊凡万科=Ivan Vanko
伊瓦诺拉=Evanora
伦斯蕾尔=Renslayer
佛罗斯特=Frost
佩罗普斯=Pelops
光明骑士=Bright Knight
克拉格林=Kraglin
克拉科亚=Krakoa
克波帕特=Cobblepot
克洛罗斯=Cronos
克洛诺斯=Khronos
克莉丝汀=Christine
克里厄斯=Crius
克里特岛=đảo Crete
兰博基尼=Lamborghini
兰塔洛斯=Rantalos
冈萨雷斯=Gonzalez
军情五处=MI5
冥界海姆=Helheim
凡尔科内=Falcone
刺客联盟=The Fraternity/thích khách liên minh
加尔满都=Kathmandu
加芙列拉=Gabriela
劳斯来斯=Rolls Royce
劳斯莱斯=Rolls-Royce
劳顿先生=Lawton tiên sinh
午夜之子=Midnight Sons
华纳海姆=Vanaheimr
华纳神族=Vanir thần tộc
单体宇宙=đơn thể vũ trụ
卡尔哀尔=Kal-Il
卡尔尼拉=Karnilla
卡尔科萨=Carcosa
卡尔耐克=Karnak
卡拉索芬=Karla Sofen
卡泰玛姬=Kamar Taj
卡玛泰姬=Kamar-Taj
卡米达尔=Camidal
印第安那=Indiana
厄勒梯亚=Eileithyia
厄瑞珀斯=Erebus
受害人类=thụ hại nhân loại
各类魔法=các loại ma pháp
吸收人类=hấp thu nhân loại
命运长河=mệnh vận trường hà
和风一号=Zephyr One
哈克尼斯=Harkness
哈姆达尔=Heimdall
哈密奎特=Hamiquet
哥谭大学=Gotham University
唐克雷蒂=Tancredi
啦啦舞团=Cheerleaders
圣冈萨斯=San Venganza
圣凡冈萨=San Venganza
在理查德=tại Richard
地狱厨房=Hells Kitchen
坦普润斯=Temperance
埃博拉罕=Abraham
埃塞克斯=Essex
埃德蒙德=Edmonton
埃阿涅斯=Aeneas
塔尔洛斯=Tartarus
塞尔维德=Selvig
塞托拉克=Cyttorak
墨西哥裔=gốc Mexico
多米尼克=Dominic
夜空之剑=Necroswords
大动干戈=làm to chuyện
大挨阿斯=Ajax
大陆酒店=Continental Hotel
天空航母=Thiên không mẫu hạm
天谴博士=Doctor Nemesis
奇异博士=Doctor Strange
奥什图尔=Oshtur
奥巴代亚=Obadiah
奥比迪亚=Obadiah
女绿巨人=She-Hulk
好几百万=hơn mấy triệu
威切斯特=Westchester
威尔希尔=Wilshire
宇宙大帝=Unicron
宇宙灵球=Cosmic Orb
宇宙神族=vũ trụ thần tộc
宇宙神明=vũ trụ thần minh
安东万科=Anton Vanko
安图苏尔=Antusur
完美国度=hoàn mỹ quốc độ
密瑟能核=Mystryl thạch
小克拉克=tiểu Clark
小卡拉米=phế vật
小麦克尔=tiểu Michael
尹卡瑞斯=Ikaris
尼古拉斯=Nicholas
尼姑拉丝=Nicholas
尼达维勒=Nidavellir
岛津浩二=Shimazu Koji
州立大学=state university
巫毒医生=Doctor Voodoo
巴尔萨扎=Balthazar
巴尔萨泽=Balthazar
巴格威尔=Bagwell
巴里艾伦=Barry Allen
布拉多克=Braddock
布拉斯基=Bronsky
布朗斯基=Bronsky
布朗普顿=Brompton
布鲁斯李=Bruce Lee
希尔特工=Hill đặc công
席尔维格=Selvig
幸运妈妈=Mama Fortuna
廷达瑞斯=Tyndareus
弗兰克林=Franklin
强大超凡=cường đại siêu phàm
强烈反对=cường liệt phản đối
彼奥提亚=Boeotia
征服者康=Kang the Conqueror
微笑装甲=Sentinel armor
德拉克斯=Drax
德雷科夫=Dreykov
心灵感应=Telepathy
心脏支架=Heart Stent
怀特霍尔=Whitehall
急冻先生=Mister Freeze
恐惧毒气=Fear Gas
恶灵骑士=Ghost Rider
悬浮汽车=Suspension Car
惊奇女士=Ms. Marvel
惊奇队长=Captain Marvel
意式浓缩=Espresso
战争机器=War Machine
扎坦诺斯=Zarathos
扎斯先生=Mister Zsasz
拉斯加德=Asgard
拉瑟福德=Rutherford
提亚马特=Tiamat
撒坦尼什=Satannish
斯万维克=Swanwick
斯佩克特=Spector
斯塔克拉=Strucker
斯塔兰奇=Strange
斯特兰奇=Strange
斯科尔奇=Skurge
斯莫威尔=Smallville
斯蒂芬妮=Stephanie
新星军团=Nova Corps
新泽西州=New Jersey
无尽之刃=Vô Cực kiếm
无限宝石=Infinity Stones
时间小姐=Miss Minute
星战前传=Star Wars
星球大战=Star Wars
月光骑士=MoonKnight
杰森托德=Jason Todd
柯洛诺斯=Chronos
格斗技能=Fighting Skills
格林医生=Dr. Green
格温多林=Gwendolyn
格雷玛金=Graymalkin
梅瑞狄斯=Meredith
梵天神系=Phạn Thiên thần hệ
梵格尔夫=Vingólf
植物大师=Floronic Man
正义联盟=Justice League
死亡女神=Tử Vong nữ thần
死亡风暴=Deathstorm
氪星之子=Krypton chi tử
永恒一族=Eternals
汉默工业=Hammer Industries
没人回应=không ai trả lời
没人回答=không ai hồi đáp
法尔克内=Falkene
法尔科内=Falcone
法斯托斯=Phastos
波托马克=Potomac
泽侯贝里=Zen-Whoberi
洞察计划=Project Insight
海姆冥界=Helheim
海尔海姆=Helheim
涨潮组织=tổ chức Rising Tide
深渊之主=Lord of the Abyss
火箭浣熊=Rocket gấu mèo
然德基尔=Zadkiel
牛津大学=Oxford university
犯罪之都=Crime Capital
犯罪集团=Criminal Gang
狂笑之蝠=The Batman Who Laughs
玛丽大街=Mary Street
玛士撒拉=Methuselah
环球日报=Global Daily
瓦尔哈尔=Valhalla
生物质能=sinh vật chất năng
疯狂攻击=điên cuồng công kích
白宫沦陷=Nhà Trắng thất thủ
矢岛正男=Masao Yajima
知无领域=Knowhere
神奇四侠=Fantastic Four
神恩大街=Grace Street
福尔图娜=Fortūna
科波帕特=Cobblepot
穆斯贝尔=Musbel
章鱼博士=Dr. Octopus
米尔加德=Midgard
米德加德=Midgard
索科菲亚=Sokovia
红桃妈妈=Mama Hearts
红色守卫=Red Guardian
纳摩瑞塔=Namorita
纳米机甲=Nano Armor
细思极恐=tế tư cực khủng
绝境计划=Desperate Project
绯红女巫=Scarlet Witch
绿灯军团=Green Lantern Corps
绿灯戒指=Green Lantern Ring
罗曼诺夫=Romanoff
罗森桥的=Rosen Bridge
罗马诺夫=Romanoff
美国队长=Captain America
美式咖啡=Americano
老史塔克=lão Stark
耶梦加德=Jörmungandr
自杀小队=Suicide Squad
至尊太君=Primacron
艾森哈特=Eisenhardt
艾萨克斯=Isaacs
艾里奥斯=Alioth
苏尔特尔=Surtur
苯基乙氨=Phenylethylamine
莱特切斯=Littletrees
菲波纳奇=Fibonacci
萨格拉斯=Sargeras
蓝纹奶酪=Blue Cheese
虚无之地=Knowhere
蜘蛛小子=Spider-Boy
蜘蛛感应=Spider Sense
蜘蛛战衣=Spider-suit
许配里翁=Hyperion
诸天神灵=chư thiên Thần Linh
诺曼诺夫=Romanoff
谍影重重=The Bourne
贝优妮提=Bayonetta
贝拉斯特=Bellas
贝提斯塔=Batista
费斯托斯=Phastos
赛博朋克=Cyberpunk
赛尼斯托=Sinestro
赛拉托克=Cyttorak
赛蒙托斯=Ségur
赫尔姆特=Helmut
赫里俄斯=Helios
超级小子=Superboy
超级战士=Super Soldier
超级英雄=Super Hero
达克赛德=Darkseid
达那都斯=Thanatos
远超人类=viễn siêu nhân loại
遗留之人=He Who Remains
里斯托克=Strucker
金属人型=hình người kim loại
金杯酒吧=Gold Cup Bar
钢铁战衣=Iron Suit
铃木娜美=Suzuki Nami
铱星系统=Iridium
门捷列夫=Mendeleev
阿列克谢=Aleksei
阿勒德斯=Allerdyce
阿卡摩托=Agamotto
阿尔卡利=Alkali
阿布里奇=Abruzzi
阿戈摩多=Agamotto
阿扎赛尔=Azazel
阿托莫斯=Agamotto
阿拉斯加=Alaska
阿撒托斯=Azathoth
阿斯卡德=Asgard
阿美丽卡=America
阿耳戈斯=Arges
阿萨托斯=Asatos
阿里克斯=Alex
阿里瑟姆=Arishem
雷欧帕顿=Leopardon
雷霄奥古=Ras al Ghul
霍斯金斯=Hoskins
非常冷静=vô cùng tỉnh táo
面部识别=bộ mặt phân biệt
韦恩庄园=Wayne Manor
飞马计划=Project Pegasus
马克塔格=MacTaggert
马克战甲=Mark chiến giáp
马克系列=Mark series
马勒基斯=Malekith
马卡鲁峰=núi Makalu
马尔巴克=Marbas
马尔萨泽=Balthazar
马斯拉尼=Masrani
驯龙高手=How to Train Your Dragon
魅影陌客=Phantom Stranger
鲁格手枪=Luger súng ngắn
鸥诺弥亚=Eunomia
麋鹿大街=Elk Street
黑暗之城=Dark City
黑暗神书=Book of Darkness
黑暗英雄=Dark Hero
黑曜五将=Black Oders
黑皇帝肖=Black King Shaw
黑色太阳=Black Sun
三曲翼总部=Triskelion tổng bộ
乔沃诺维奇=Jovonovich
伊皮米修斯=Epimetheus
伊阿伯托斯=Labertus
侏罗纪世界=Jurassic World
俄克阿诺斯=Oceanus
克拉特鲁斯=Craterus
刺客兄弟会=The Assassin Brotherhood
加维奥塔斯=Gaviota
博格利亚斯=BomGaliath
卡斯柏管家=Casper quản gia
卡西利亚斯=Casillas
卡西里奥斯=Kaecilius
卡里西亚斯=Calisias
吉恩马利克=Gideon Malick
嚎叫突击队=Howling Commandos
国土安全局=DHS
圣母玛利亚=Virgin Mary
埃尔夫海姆=Alfheim
塞边尼图斯=Sebenetus
墨涅拉奥斯=Menelaus
多德卡尼斯=Dodekanisa
宇宙第一因=《○》
安全理事会=UNSC
安德洛玛克=Andromache
安格尔伯达=Angrboda
安菲特里同=Amphitrite
小辣椒佩珀=Pepper Potts
尼德维阿尔=Nidavellir
山姆威尔逊=Sam Wilson
布拉德多福=Bradford
布拉德皮特=Brad Pitt
布鲁德海文=Bludhaven
希尔德加德=Hildegard
托尼斯塔克=Tony Stark
拉托维尼亚=Latovina
拉格伽多尔=Raggardor
摩涅摩绪涅=Mnemosyne
斯塔克大厦=Stark Building
斯考菲尔德=Scofield
斯莱普尼斯=Sleipnir
方舟反应炉=Arc Reactor
普利阿莫斯=Priam
暗黑比邻星=Proxima Midnight
暴虐迅猛龙=Indoraptor
树人格鲁特=thụ nhân Groot
格兰德沃特=Grand Ward
格温史黛西=Gwen Stacy
梅内赫莫斯=Menehmos
死去的战士=chiến sĩ đã chết
海豹突击队=SEALs
消灭霸天虎=tiêu diệt Decepticon
玛利亚希尔=Maria Hill
瓜达拉哈拉=Guadalajara
矢志田信玄=Yashida Shingen
知识的诅咒=The Curse of Knowledge
米尔科维奇=Milkovich
粒子对撞机=máy gia tốc hạt
维里甘之拳=Fist of Verrigan
至尊小超人=Superboy-Prime
艾尔登法环=Elden Ring
荷蒙库鲁斯=Homunculus
莱克斯卢瑟=Lex Luthor
要塞恩加莱=NGarai
贾巴里山脉=Jabari sơn mạch
贾斯汀汉默=Justin Hammer
达伦克劳斯=Darren Cross
速度与激情=Fast and Furious
里德理查兹=Reed Richards
钢铁爱国者=Iron Patriot
银河滑翔者=Silver Surfer
银色冲浪者=Silver Surfer
银色滑翔者=Silver Surfer
长老会医院=Presbyterian Hospital
阿尔弗雷德=Alfred
阿斯莫德斯=Asmodeus
阿玛尔忒亚=Amalthea
阿芙罗狄特=Aphrodite
阿里瑟什么=Arishem
雷克雅未克=Reykjavík
非裔女朋友=gốc Phi bạn gái
飞雷神之术=Hiraishin no Jutsu
马克西姆斯=Maximoff
马克西莫夫=Maximoff
马西克莫夫=Maximoff
黑袍纠察队=The Boys
乔 · 艾尔=Jor · El
俄刻阿儀诺斯=Oceanus
克拉伯姆公地=Clapham Common
勇 · 罗格=Yon Rogg
卡里奥斯托罗=Cagliostro
哥伦比亚大学=Columbia University
地狱火俱乐部=Hellfire Club
奥托克塔维斯=Octavius
好邻居蜘蛛侠=Good Neighbor Spider-Man
安拉胡阿克巴=Allāhu Akbar
小胡子的军队=Nazi quân đội
恩 - 加莱=Flickering
托马 · 雷=Tomar · Re
拉娜 · 蓝=Lana · Lang
斯瓦泰夫海姆=Svartalfheim
朗基努斯之枪=Lance of Longinus
玛 · 威尔=Mar-Vell
玛丽 · 简=Mary · Jane
琴 · 葛蕾=Jean Grey
瓦特阿尔海姆=Svartalfheim
穆斯贝尔海姆=Muspelheim
简 · 福斯=Jane Foster
芝加哥大剧院=Chicago Theater
赫尔斯特罗姆=Hellström
阿卡姆疯人院=Arkham Asylum
阿尔忒忒弥斯=Artemis
阿德剌斯忒亚=Amalthea
阿滨 · 苏=Abin · Sur
韦斯特莫兰德=Westmoreland
凯伦 · 佩吉=Karen Page
布拉卡格伏特加=Blackagar Boltagon
斯科特 · 朗=Scott · Lang
梅琳达 · 梅=Melinda May
简 · 福斯特=Jane · Foster
霍华德汽车公司=Howard Motor Company
春田 1903 =《Springfield 1903》
阿卡姆精神病医院=Arkham Psychiatric Hospital
Thank you=Thank you
塞巴斯蒂安 · 肖=Sebastian Shaw
尤利西斯 · 克劳=Ulysses · Klaw
泽维尔天才少年学校=Xavier School for Gifted Boys
绍沙 M1915 =《Chauchat M1915》
珍妮特 · 凡 · 黛因=Janet · Van · Dyne
塔利娅 · 艾尔 · 古尔=Talia al Ghul
拉尔斯 · 艾尔 · 古尔=Ras al Ghul
