Truyện được đăng tại https://sangtacviet.app/truyen/69shu/1/43009/28803931/
吾=ngô
市=thành phố
怼=đỗi
简=Jane
道=nói
一扇=một phiến
七级=Thất cấp
三级=Tam cấp
上天=thượng thiên
上帝=Thượng Đế
下令=hạ lệnh
严令=nghiêm lệnh
中二=trung nhị
丽娜=Lena
之道=chi đạo
乌鲁=Uru
二级=Nhị cấp
五级=Ngũ cấp
人类=Nhân Loại
仙宫=Tiên Cung
令牌=lệnh bài
以太=Aether
伍德=Wood
传令=truyền lệnh
佩珀=Pepper
僵尸=Cương Thi
克里=Kree
公道=công đạo
六道=Lục Đạo
几道=mấy đạo
出道=xuất đạo
制杖=chế trượng
力道=lực đạo
匠魂=Tượng Hồn
卢恩=Rune
口令=khẩu lệnh
号令=hiệu lệnh
同道=đồng đạo
吐槽=nhả rãnh
君主=Quân Chủ
命令=mệnh lệnh
哈皮=Happy
喝道=quát lên
喵喵=miêu miêu
嘴毒=miệng độc
国王=Quốc Vương
土豆=khoai tây
圣母=Thánh Mẫu
地狱=Địa Ngục
地道=địa đạo
基因=gien
多比=Dobby
大卫=David
天使=Thiên Sứ
天王=Thiên Vương
天神=Thiên Thần
天道=Thiên Đạo
奎妮=Queenie
女王=Nữ Vương
如尼=Rune
威特=Witt
孙龙=Tôn Long
导弹=đạn đạo
小丑=Joker
巨头=Cự Đầu
巨龙=Cự Long
巫师=vu sư
巴顿=Barton
市区=nội thành
市场=thị trường
市民=thị dân
市面=thị trường
希尔=Hill
幽灵=U Linh
弯道=đường rẽ
影龙=Ảnh Long
律令=pháp lệnh
恶魔=Ác Ma
懂事=hiểu chuyện
成道=thành đạo
报道=đưa tin
拱道=củng đạo
指令=chỉ lệnh
振金=Vibranium
攻略=công lược
教授=giáo thụ
数道=mấy đạo
星云=Nebula
有令=có lệnh
杰玛=Gemma
校董=giáo đổng
梅林=Merlin
模组=Mod
欧克=Ok
武道=võ đạo
死神=Tử Thần
沙人=Sandman
波兹=Potts
海拉=Hela
渠道=con đường
火龙=Hỏa Long
猜测=suy đoán
王者=Vương Giả
王道=vương đạo
理想=lý tưởng
甬道=hành lang
画片=tranh nhỏ
知道=biết
祂们=các Thần
神器=Thần Khí
神明=Thần Minh
神童=thần đồng
禁令=lệnh cấm
禁林=Rừng Cấm
穆迪=Moody
突变=đột biến
简直=đơn giản
精灵=Tinh Linh
纳威=Neville
纳特=Knot
纽特=Newt
绿魔=Green Goblin
罗德=Rhodes
罗斯=Ross
老道=lão đạo
艾莎=Erza
萨里=Surrey
蛇怪=Xà Quái
西瓜=dưa hấu
课本=sách giáo khoa
贝丽=Belle
赤道=xích đạo
超人=Superman
跑道=đường chạy
轨道=quỹ đạo
这道=đạo này
远道=đường xa
通道=thông đạo
道人=đạo nhân
道具=đạo cụ
道别=tạm biệt
道坎=đạo khảm
道士=đạo sĩ
道家=Đạo gia
道弯=bước ngoặt
道德=đạo đức
道教=Đạo giáo
道理=đạo lý
道统=đạo thống
道谢=cảm tạ
道路=con đường
道长=đạo trưởng
道门=Đạo môn
道馆=đạo quán
那道=đạo kia
邪道=tà đạo
金刚=Kim Cương
金并=Kingpin
长门=Nagato
门道=môn đạo
难道=chẳng lẽ
霍根=Hogan
霸道=bá đạo
面板=bảng
频道=kênh
马拉=Mara
魂器=Hồn Khí
魔金=Malkin
鹰眼=Hawkeye
黄道=hoàng đạo
黄金=Hoàng Kim
黑市=chợ đen
黑湖=Hắc Hồ
黑豹=Black Panther
龙珠=Long Châu
一条道=một con đường
一道道=từng đạo
三头犬=Tam Đầu Khuyển
下命令=hạ mệnh lệnh
下地狱=xuống Địa Ngục
下水道=cống thoát nước
不知道=không biết
世纪末=thế kỷ cuối
丹弗斯=Danvers
二年级=năm hai
五年级=năm năm
从犯罪=Từ phạm tội
从魔杖=từ ma trượng
便说道=liền nói
俄罗斯=Russia
僵尸王=Cương Thi Vương
克林特=Clint
六年级=năm sáu
其深奥=hắn thâm ảo
再还清=lại trả hết nợ
击球手=Tấn Thủ
十四道=mười bốn đạo
华国人=người Hoa
卡魔拉=Gamora
去推理=đi suy luận
又问道=lại hỏi
变形咒=biến hình chú
变形者=biến hình giả
变形课=Biến hình khóa
合成表=hợp thành biểu
呜呜呜=ô ô ô
命令道=ra lệnh
和议论=cùng nghị luận
唐装的=đường trang
在教授=tại giáo thụ
复仇者=Avenger
大城市=thành phố lớn
大神器=Đại Thần Khí
大金刚=Đại Kim Cương
大铁鸟=Đại Thiết Điểu
太尽力=quá tận lực
如尼文=Rune
守门员=Thủ Môn
将死神=đem Tử Thần
小太阳=Tiểu Thái Dương
小女巫=tiểu nữ vu
小巨人=Tiểu Cự Nhân
小恶魔=Tiểu Ác Ma
小火焰=tiểu hỏa diễm
小精灵=Tiểu Tinh Linh
小红星=tiểu hồng tinh
小超市=tiểu siêu thị
布雷司=Blaise
帕特奇=Potage
带班纳=mang Banner
幻身咒=huyễn thân chú
庞雷弗=Pomfrey
彩虹桥=Bifrost
心形草=Tâm Hình Thảo
快到站=nhanh đến trạm
截拳道=Tiệt Quyền Đạo
所爱戴=sở kính yêu
才问道=mới hỏi
打交道=giao tiếp
找球手=Tầm Thủ
把死神=đem Tử Thần
掌控者=Chưởng Khống Giả
提问道=đặt câu hỏi
救世主=Chúa Cứu Thế
斯塔克=Stark
斯莱特=Slytherin
旧桥镇=Old Bridge trấn
明知道=biết rõ
是人类=là Nhân Loại
暗物质=ám vật chất
木叶村=Konoha
柯尔沃=Culver
核导弹=đạn hạt nhân
毁灭者=Destroyer
沃夫林=Waffling
沃弥尔=Vormir
沙维格=Selvig
洛丽丝=Norris
温尔顿=Winton
漂浮咒=phiêu phù chú
火焰咒=hỏa diễm chú
灾害司=tai hại ti
的卢平=Lupin
皮皮鬼=Peeves
直白道=ngay thẳng nói
矮人王=Người Lùn Vương
神盾局=S.H.I.E.L.D
福灵剂=Phúc Linh Tề
笔记本=notebook
索命咒=lấy mạng chú
红骷髅=Red Skull
翻倒巷=Hẻm Knockturn
老玩家=người chơi cũ
老魔杖=Lão Ma Trượng
而以太=mà Aether
而死神=mà Tử Thần
菜市场=chợ bán thức ăn
蛇盾局=Xà Thuẫn Cục
被子民=bị con dân
被道德=bị đạo đức
要知道=phải biết
询问道=dò hỏi
谜语人=câu đố người
质问道=chất vấn
这种有=loại này có
追求手=Truy Thủ
追问道=truy vấn
道德经=Đạo Đức Kinh
那种在=loại kia tại
金加隆=Vàng Galleon
金苹果=Quả Táo Vàng
钢铁侠=Iron Man
铁甲咒=thiết giáp chú
铜纳特=Đồng Knot
银西可=Bạc Sickle
阿迪特=Adit
隆巴顿=Longbottom
霍格斯=Horvath
霍瓦斯=Horvath
霜巨人=Sương Cự Nhân
飞路粉=Bột Floo
马奎尔=Maguire
魔咒课=Ma chú khóa
魔法史=ma pháp sử
魔法石=Ma Pháp Thạch
魔法部=Ma Pháp Bộ
魔药课=Ma dược khóa
黑巫师=hắc vu sư
黑魔王=Hắc Ma Vương
一个月亮=một cái Mặt Trăng
一二年级=năm nhất năm hai
下地下室=xuống tầng hầm
中学生活=trung học sinh hoạt
也不知道=cũng không biết
五六年级=năm năm năm sáu
人道毁灭=nhân đạo hủy diệt
他们球队=bọn hắn đội bóng
他的家务=hắn việc nhà
令行禁止=kỷ luật nghiêm minh
众神之父=Chúng Thần Chi Phụ
众神之王=Chúng Thần Chi Vương
伦敦市区=London nội thành
作为人类=làm Nhân Loại
你的特工=ngươi đặc công
你的魔法=ngươi ma pháp
全身束缚=toàn thân gò bó
八眼巨蛛=Bát Nhãn Cự Chu
八眼蜘蛛=Bát Nhãn Tri Chu
再次问道=lần nữa hỏi
冰雪女王=Băng Tuyết Nữ Vương
冰霜巨人=Băng Sương Cự Nhân
分析能力=phân tích năng lực
分道扬镳=mỗi người đi một ngả
力量宝石=Power Gem
卡思伯特=Cuthbert
四五年级=năm bốn năm năm
圣殿上空=Thánh Điện bầu trời
地狱厨房=Hells Kitchen
塞德里克=Cedric
复方汤剂=Thuốc Đa Dịch
大逆不道=đại nghịch bất đạo
天碍震星=Thiên Ngại Chấn Tinh
奥巴迪亚=Obadiah
她的魔法=nàng ma pháp
好想知道=thật muốn biết
如此问道=như thế hỏi
威森加摩=Wizengamot
它的背包=nó ba lô
宇宙天神=Vũ Trụ Thiên Thần
宇宙魔方=Tesseract
尊师重道=tôn sư trọng đạo
小天狼星=Sirius
小马儿福=tiểu Malfoy
就是人类=chính là Nhân Loại
巨人之锤=Cự Nhân Chi Chùy
巴鲁费奥=Baruffio
布朗基斯=Blonsky
应该能够=nên có thể
开口问道=mở miệng hỏi
微不足道=không có ý nghĩa
志同道合=cùng chung chí hướng
忽然问道=đột nhiên hỏi
恶魔果实=Trái Ác Quỷ
我的上帝=ta Thượng Đế
我的特工=ta đặc công
战斗天赋=chiến đấu thiên phú
所以作为=cho nên làm
抽卡游戏=rút thẻ trò chơi
接着问道=hỏi tiếp
斯莱特林=Slytherin
无尽之锤=Vô Tận Chi Chùy
无限宝石=Infinity Gem
无限手套=Infinity Gauntlet
普通区域=phổ thông khu vực
暴风战斧=Stormbreaker
有价无市=có tiền mà không mua được
来对角巷=tới Hẻm Xéo
格林沃德=Grindelwald
格雷伯恩=Grayburn
死亡之神=Tử Vong Chi Thần
死亡女神=Tử Vong Nữ Thần
死神之掌=Tử Thần Chi Chưởng
没有人类=không có Nhân Loại
混血王子=Hỗn Huyết Vương Tử
火焰巨人=Hỏa Diễm Cự Nhân
爽地问道=sảng khoái hỏi
瓦雷利亚=Valyria
神盾局长=S.H.I.E.L.D cục trưởng
神锋无影=Thần Phong Vô Ảnh
空间宝石=Space Gem
约顿海姆=Jotunheim
美国队长=Captain America
职场女性=chức trường nữ tính
胡说八道=nói hươu nói vượn
至尊法师=Chí Tôn Pháp Sư
诧异问道=kinh ngạc hỏi
身为人类=thân là Nhân Loại
还不如放=còn không bằng phóng
还是人类=vẫn là Nhân Loại
这些魔法=những này ma pháp
这才觉醒=cái này mới thức tỉnh
远古冬棺=Viễn Cổ Đông Quan
连忙问道=vội vàng hỏi
那是人类=đó là Nhân Loại
镜像空间=kính tượng không gian
防御中心=phòng ngự trung tâm
预言之子=Dự Ngôn Chi Tử
高深地步=cao thâm tình cảnh
魔力波动=ma lực ba động
魔法学院=ma pháp học viện
魔虫之王=Ma Trùng Chi Vương
黑魔法师=hắc ma pháp sư
下了逐客令=hạ lệnh trục khách
不解的问道=không hiểu hỏi
严肃地问道=nghiêm túc hỏi
也应该能够=cũng cần phải có thể
你们的包厢=các ngươi bao sương
关切地问道=ân cần hỏi
兴奋的问道=hưng phấn hỏi
十分的大条=hết sức đại điều
卡西利亚斯=Kaecilius
古怪地问道=cổ quái hỏi
吃惊的问道=giật mình hỏi
各自回房间=trở về phòng của mình
后怕地问道=nghĩ mà sợ hỏi
在飞天扫帚=tại chổi bay
埃尔芬斯通=Elphinstone
奇怪地问道=kỳ quái hỏi
好奇的问道=hiếu kỳ hỏi
嫌弃地问道=ghét bỏ hỏi
家养小精灵=Gia Tinh
小辣椒波茨=Pepper Potts
幽幽地问道=sâu kín hỏi
急切地问道=vội vàng hỏi
急切的问道=vội vàng hỏi
愕然地问道=ngạc nhiên hỏi
慎重的问道=thận trọng hỏi
我们的伤害=chúng ta tổn thương
才开口问道=mới mở miệng hỏi
担忧地问道=lo âu hỏi
整个一年级=toàn bộ năm nhất
斯莱特特林=Slytherin
方舟反应炉=Arc Reactor
无聊的问道=nhàm chán hỏi
是一个人类=là một cái Nhân Loại
是在对角巷=là tại Hẻm Xéo
期盼的问道=mong đợi hỏi
格兰芬所多=Gryffindor
比比多味豆=Bertie Bott nhiều vị đậu
淡定地问道=bình tĩnh hỏi
激动地问道=kích động hỏi
狐疑地问道=nghi ngờ hỏi
疑惑地问道=nghi ngờ hỏi
疲惫的问道=mệt mỏi hỏi
的死亡女神=Tử Vong Nữ Thần
真的是人类=thật là Nhân Loại
神奇的魔法=thần kỳ ma pháp
究竟是人类=đến tột cùng là Nhân Loại
签字的条子=ký tên giấy
紧张的问道=khẩn trương hỏi
而活点地图=mà Hoạt Điểm Địa Đồ
艰难的问道=chật vật hỏi
见到的人类=thấy Nhân Loại
诧异地问道=kinh ngạc hỏi
躺在地板上=nằm ở trên sàn nhà
还有的人类=còn có Nhân Loại
还算是人类=còn tính là Nhân Loại
迟疑地问道=chần chờ hỏi
那个反应堆=cái kia lò phản ứng
郑重地问道=trịnh trọng hỏi
阴沉的问道=âm trầm hỏi
阿拉霍洞开=Alohomora
随意的问道=tùy ý hỏi
震惊的问道=khiếp sợ hỏi
飞天扫帚课=chổi bay khóa
不死心的问道=chưa từ bỏ ý định hỏi
冰霜巨人之王=Băng Sương Cự Nhân Chi Vương
孤儿院的院长=cô nhi viện viện trưởng
就是在对角巷=chính là tại Hẻm Xéo
恶狠狠的问道=hung tợn hỏi
洛夫克拉夫特=Lovecraft
用神锋无影咒=dùng Thần Phong Vô Ảnh chú
试探性的问道=hỏi dò
还是一个人类=còn là một cái Nhân Loại
迫及待地问道=vội vã hỏi
鼻涕虫俱乐部=Con Sên câu lạc bộ
一脸认真地问道=vẻ mặt thành thật hỏi
他们的头顶上空=trên đỉnh đầu bọn họ
学校的风云人物=trường học nhân vật phong vân
意味深长地问道=ý vị thâm trường hỏi
有点紧张的问道=có chút khẩn trương mà hỏi
脸色难看的问道=sắc mặt khó coi hỏi
面无表情地说道=mặt không thay đổi nói