乔=Joe
万科=Vanko
丽娜=Lena
乌帕=Upa
伊戈=Ego
佩珀=Pepper
侑子=Yūko
傲罗=Auror
克里=Kree
全露=Moro
勃拉=Bra
勇度=Yondu
卡尔=Kal
卡林=Karin
古一=Ancient One
圣娜=Thena 
多比=Dobby
夜骐=Thestral
天启=Apocalypse
奇洛=Quirrel
奎尔=Quill
如尼=Rune
孙龙=Tôn Long
小可=Kero
小狼=Tiểu Lang
巧断=Takumidan
巫师=Phù Thuỷ
巴布=Bab
巴里=Barry
希芙=Sif
希顿=Heaton
库洛=Clow
影牌=ảnh bài
悟空=Goku
悟饭=Gohan
憎恶=Abomination
振金=Vibranium
斑斑=Scabbers
星云=Nebula
星爵=Star Lord
曙光=Aurora
杰瑞=Jerry
格温=Gwen
格雷=Gray
武天=Roshi
比克=Piccolo
氪石=Kryptonite
汉克=Hank
汉默=Hammer
法伊=Fai
波波=Popo
火箭=Rocket
猎鹰=Falcon
珍玛=Jema
瑞文=Raven
界王=Kaiō
知世=Tomoyo
神现=Emergence
科尔=Coulson
空汰=Sorata
约翰=John
纳尔=Knull
美灵=Mei Ling
翔牌=The Fly
老邓=Lão Dum
艾伦=Allen
艾尔=El
艾琳=Irene
莉莉=Lily
莫拉=Mora
莱福=Life
菲兹=Fitz
蚁人=Ant-man
蜂巢=Hive
诺莎=Noza
贝丽=Belle
超人=Superman
路威=Fluffy
野兽=Beast
金并=Kingpin
钢骨=Cyborg
阿福=Afo
陋居=Hang sóc
雪兔=Yukito
飞王= Fei Wang 
饺子=Chiaotzu
魂器=Trường Sinh Linh Giá
黑炭=Hắc Thán
黑皇=Black King
黑钢=Kurogane
丹巴林=Dambalin
修复咒=Bùa Sữa Chữa
光照会=Illuminati
克利切=Kreacher
冰冻咒=Bùa Đông Cứng
劳蕾尔=Laurel
北界王=Bắc Kaiō
十戒帮=Hội Ten Rings
卡拉森=Karason
卡林塔=Tháp Karin
厉火咒=Bùa lửa quỷ
变形咒=Bùa Biến Hình
变形女=Mystique
召唤咒=Bùa Triệu Tập
圣芒戈=St. Mungo
复苏咒=Bùa thức tỉnh
大圣所=Đại Thánh Sở
天启星=Apokolips
天津饭=Tenshinhan
天狼岛=Đảo Tenrou
天神族=Celestial
天神组=Celestial
孙悟饭=Son Gohan
小辣椒=Pepper
布加尔=Bougal
布雷司=Daphne
幻身咒=Bủa Ẩn
庞雷弗=Pomfrey
开锁咒=Bùa Mở Khóa
异人族=Inhuman
悄声咒=Bùa Im Lặng
戈弗雷=Godfrey
摄魂怪=Dementors
擎天柱=Optimus Prime
斯克鲁=Skrull
斯特克=Stark
斯莱特=Slytherin
昏睡咒=Bùa Choáng
昏迷咒=Bùa Choáng
曼蒂斯=Mantis
曼达林=Mandarin
束缚咒=Bùa Trói
查尔斯=Charles
格鲁特=Groot
桃白白=Tao Pai Pai
桃金娘=Myrtle
永恒族=Eternals
洛丽丝=Norris
游走球=Bludges
狄萨德=DeSaad
玖楼国=Vương quốc Clow
白皇后=White Queen
皮萨罗=Pizarro
破坏神=Thần Hủy Diệt
科尔森=Coulson
移物咒=Bùa Di Chuyển
绝音鸟=Jobberknoll
绳索咒=Bùa Trói
缴械咒=Bùa Giải Giới
荒原狼=Steppenwolf
菲柏丝=Patience
菲莉亚=Philia
蒂亚穆=Tiamut
超巨星=Supergiant
追球手=Chaser
钯元素=Nguyên Tố Palladium
钻心咒=Lời Nguyền Tra Tấn
铁甲咒=Bùa Bảo Vệ
长生诀=Trường Sinh Quyết
阿尔吉=Algie
阿贾克=Ajak
隆巴顿=Longbottom
霍瓦斯=Horvath
飞行咒=Bùa Phi Hành
马克利=Markley
马利克=Malik
马奎尔=Maguire
鬼飞球=Quaffle
魔法石=Hòn Đá Phù Thủy
黑巫师=Phù Thủy Hắc Ám
黑死剑=Necrosword
黑蝠王=Black Bolt
龟仙流=Quy Tiên Lưu
丽痕书店=Flourish and Blotts
乌呼拉呼=Uhrahu
乌鲁缇雅=Ultear
伊卡瑞斯=Ikaris
伊法魔尼=Ilvermorny
修复如初=Reparo (Bùa sửa chữa)
假记忆咒=Bủa Giả Ký Ức
全部定身=Immobulus (Bùa đông cứng)
凤凰之力=Phoenix Force
古代天神=cổ đại thiên thần
四分五裂=Diffindo (Bùa cắt)
四月一日=Kimihiro
地狱厨房=Hell's Kitchen
壹原侑子=Ichihara Yūko
复仇联盟=Avenger
复方药剂=Thuốc Đa Dịch
多多少少=hoặc nhiều hoặc ít
天神组的=Celestial
天神至尊=August Celestial
妖精之力=Goblin Force
妖精心脏=Fairy Heart
守护神咒=Bùa Hộ Mệnh
安得罗斯=Andros
小天狼星=Sirius
尹卡瑞斯=Ikaris
巴布鲁斯=Baburusu
巴斯苔特=Bastet
布朗基斯=Blonsky
希尔特工=Hill Đặc Công
库洛里多=Clow Reed
弗拉维度=Varies
德克赛德=Darkseid
德拉克斯=Drax
快快复苏=Rennervate (Bùa thức tỉnh)
快速变软=Spongify
战争机器=War Machine
摄神取念=Legilimency
斯来特林=Slytherin
斯莫威尔=Smallville
新星军团=Quân đoàn Nova
无影无踪=Disillusionment
无限宝石=Đá Vô Cực
普雷希特=Precht
普雷希顿=Precht
暗黑之书=Darkhold
暗黑神书=Darkhold
月城雪兔=Tsukishiro Yukito
横扫三星=Cleensweep 3
水火不侵=Impervius
流泗不止=Mucus ad Nauseam Tria
混沌之力=Chaos Force
火神开道=Bùa Bão Lửa
生命法庭=Living Tribunal
神奇先生=Mister Fantastic
神经法师=Balthazar pháp sư
神锋无影=Sectumsempra
统统石化=Petrificus Totalus (Lời nguyền tê liệt)
苏特尔特=Surtur
虚无之地=Knowhere
蛇召唤咒=Bùa Triệu Hồi Rắn
速速愈合=Vulnera Sanentur
钻心剜骨=Crucio (Lời nguyền tra tấn)
阿尼马格=Animagus
阿里瑟姆=Arishem
雷霆战斧=Stormbreaker
麻将少女=Mahjong Girl
伊尔弗莫尼=Ilvermony
倒挂金钟咒=Bùa Treo Giò
全身束缚咒=Lời Nguyền Tê Liệt
南达可他州=Nam Dakota 
南达科他州=Nam Dakota 
卡西利亚斯=Kaecilius
可鲁贝洛斯=Cerberus
复仇者联盟=The Avengers
大脑封闭术=Occlumency
库洛里多的=Clow Reed
復仇者联盟=The Avengers
恶魔的心脏=Grimiore Heart
护圣十二盾=Spriggan 12
摄神取念者=Legilimens
斯拉格霍恩=Slughorn
易容马格斯=Metamorphmagus
有求必应屋=Phòng Yêu cầu 
柊泽艾利欧=Hiiragizawa Eriol
格兰芬所多=Gryffindor
比比多味豆=Đậu Bertie Bott's Every Flavor 
水火不侵咒=Bùa Chống Thấm Nước
沃尔斯塔格=Volstag
玛格诺利亚=Magnolia
神奇格瑞丝=Amazing Grace
荣耀戈弗雷=Glorious Godfrey
速速愈合咒=Bùa cầm máu
金钟落地咒=Giải Bùa Treo Giò
银河护卫队=Vệ binh dải Ngân Hà
阿尼马格斯=Animagus
魔导精灵力=Etherion
琴 · 格蕾=Jean Gray
脚指甲生长咒=Bùa mọc móng chân
亚瑟 · 库瑞=Arthur Curry
安东 · 万科=Anton Vanke
流明 · 星辉=Lumen Histoire
百变小樱魔术卡=Cardcaptor Sakura
飞王 · 里多=Fei Wang Reed
玛丽亚 · 希尔=Maria Hill
卡思伯特 · 宾斯=Cuthbert Binns
菲柏丝 · 普利斯=Patience Phillips
萨缪尔 · 斯特恩=Samuel Stern