乌帕=Upa
乐平=Yamcha
伊旺=Iwan
全王=Zenō
兰琪=Launch
内鲁=Neil
凯琳=Karin
凯茵=Kai
加克=Jaco
原王=Nguyên Vương
吉连=Jiren
基纽=Ginyu
夏亚=Char 
夏亚=Hạ Á
夏清=Natsumi
天津=Tien
姬内=Gine
宇王=Vũ Vương
小亚=Tiểu Char
小芳=Pan
尚波=Zarbon
巴特=Burter 
布钦=Bujin
库尔=Kuru
德雷=Dore
悟天=Goten
悟饭=Gohan
托娃=Towa
托破=Toppo
时王=Thời Vương
杜克=Duke
欧布=Uub
武天=Roshi
沙索=Sasol
波波=Popo
洁琳=Kierin
牧萤=Muyin
琪琪=Chi chi
界王=Kaiō
白王=Bạch Vương
祖诺=Zuno
福瓦=Fuwa
穆利=Mully
穆萨=Musa
米拉=Mira
纱兰=Saran
维斯=Whis
艾洛=Aiello
苏诺=Suno
莉泽=Lise
萝吉=Roger
蒂亚=Tia
象帕=Champa
赞佳=Zangya
超蓝=Super Blue
达尔=Ca-đích
邱夷=Cui
阿古=Agu
阿波=Aka
阿辛=Shin
饺子=Chiaotzu
东银河=Đông Ngân Hà
亚拉克=Arak
克维拉=Cooler
兰修斯=Lancius
兹夫尔=Tuffles 
凯琳塔=Tháp Karin
利吉尔=Liquiir
利库姆=Recoom
北界王=Bắc Kaiō
南银河=Nam Ngân Hà
卡娜沙=Kanasa
卡拉梅=Carame
卡艾梅=Kayme
卡里克=Garlic
卡鲁克=Karuk
史古德=Sgoode
史拉古=Slug
坡塔拉=Potara
堪培利=Campahri
塔布尔=Tabour
塔皮恩=Tapion
多克拉=Dokra
多克沙=Doksha
多林寺=Đa Lâm Tự
大天官=Daisenkan
大界王=Dai Kaio
大神官=Daishinkan
大魔界=Đại Ma Giới
天津饭=Tien Shinhan
奎特拉= Quitela
奥洛斯=Olos
孙悟天=Son Goten
孙悟空=Son Goku
孙悟饭=Son Gohan
巴库夫=Bakow
巴赫德=Bahid
巴达克=Bardock
巴隆赫=Ballonch
布尔玛=Bulma
希蕾丝=Helles 
帕蕾丝=Paris
库尔德=Cold
弗利萨=Frieza
拉克鲁=Lacru
拉彼斯=Lapis
拉芙莉=Lovely
排骨饭=Pikkon
提奥斯=Tios
时之界=Thời Gian Giới
普塔尔=Putar
曼纽尔=Manuel
柯尼克=Cognac
格库亚=Gokua
格瓦斯=Govas
梅尔斯=Merus
梅珊人=Người Meishan
梅维丝=Mavis
武泰斗=Mutaito
比索亚=Bissoia
比鲁斯=Beerus
沙克达=Shakda
沙维扎=Salza
波杰克=Bojack
波萨伦=Posalon
界王拳=Kaio-Ken
界王神=Kaiōshin
界芯人=Shinling
破坏神=Thần Hủy Diệt
科纳兹=Konats
精神树=Tinh Thần Thụ
索尔贝=Solbe
缪博士=Tiến sĩ Myuu
芭朵斯=Vados
莫斯可=Mosco 
萨拉玛=Zalama
西之都=Tây Đô
西多拉=Sidra
西萨米=Shisami
贝利特=Berito
贝鲁克=Beruk
路德尔=Ruddell
达达儿=Dadar
邪念波=Janemba
郝思琪=Hasky
金大人=Giin đại nhân
阿特利=Atley
阿莉斯=Alice
魔封波=Ma Phong Ba
齐尔德=Chirudo
万能胶囊=Capsule
上神境界=Thượng Thần cảnh giới
亚奇洛贝=Yajirobe
亚德兰特=Yardrat 
冰冻恶魔=Frost Demon
力之大会=Giải Đấu Sức Mạnh
卡莉芙尔=Kefla
卡莉芙拉=Caulifla
四星龙神=Tứ Tinh Long Thần
多多利亚=Dodoria
多达利亚=Daglia
大界王神=Dai Kaiōshin
大魔神的=Đại Ma Thần
太上老君=Taijōrōkun
奥莉西娅=Olyssia
巴布鲁斯=Baburusu
布里夫斯=Brief
希尔德刚=Hirudegarn
库卡特尔=Cukatail
德米古拉=Demigra
时之天神=Thiên Thần Thời Gian
波蒙勒斯=Beaumont Reus
玛卡丽塔=Marcarita
玛斯鲁塔=Tháp Muscle
第一宇宙=Đệ Nhất Vũ Trụ
第七宇宙=Đệ Thất Vũ Trụ
第五宇宙=Đệ Ngũ Vũ Trụ
第六宇宙=Đệ Lục Vũ Trụ
美达摩尔=Metamore
贝鲁摩德=Belmod
超级神龙=Siêu Cấp Thần Long
超级龙珠=Super Dragon Ball
达维多王=Davido King
阿塔西亚=Atashia
阿波卡特=Avocado
魔神之境=Ma Thần Cảnh
黑暗天使=Hắc Ám Thiên Sứ
传超赛亚人=Legendary Super Saiyan
卡里克二世=Garlic Jr
大自在意境=Ultra Instinct
时之秩序者=Tuần Tra Thời Gian
超级赛亚人=Super Saiyan
超级赛亚人之神=Super Saiyan God
超级赛亚人蓝色=Super Saiyan Blue
传说中的超级赛亚人=Legendary Super Saiyan