乌帕=Upa
乐平=Yamcha
伊旺=Iwan
全王=Zenō
兰琪=Launch
内鲁=Neil
凯琳=Karin
凯茵=Kai/Chronoa
加克=Jaco
原王=Nguyên Vương
吉连=Jiren
基纽=Ginyu
夏亚=Char/Hạ Á
夏清=Natsumi
天津=Tien/Tenshin
姬内=Gine
宇王=Vũ Vương
小亚=Tiểu Char
小芳=Pan
尚波=Zarbon
巴特=Burter
布钦=Bujin/Bido
库尔=Kuru
德雷=Dore
悟天=Goten
悟饭=Gohan
托娃=Towa
托破=Toppo
时王=Thời Vương
杜克=Duke
欧布=Uub
武天=Roshi/Muten
沙索=Sasol
波波=Popo
洁琳=Kierin
牧萤=Muyin
琪琪=Chi chi
界王=Kaiō
白王=Bạch Vương
祖诺=Zuno
福瓦=Fuwa
穆利=Mully
穆萨=Musa
米拉=Mira
纱兰=Saran
维斯=Whis
艾洛=Aiello
苏诺=Suno
莉泽=Lise
萝吉=Roger/Roasie
蒂亚=Tia
象帕=Champa
赞佳=Zangya
超蓝=Super Blue/Super Saiyan Blue
达尔=Ca-đích
邱夷=Cui/Kiwi
阿古=Agu
阿波=Aka/Abo
阿辛=Shin
饺子=Chiaotzu
东银河=Đông Ngân Hà
亚拉克=Arak
克维拉=Cooler
兰修斯=Lancius
兹夫尔=Tuffles/Zvr
凯琳塔=Tháp Karin
利吉尔=Liquiir
利库姆=Recoom/Recoome
北界王=Bắc Kaiō
南银河=Nam Ngân Hà/South Area
卡娜沙=Kanasa
卡拉梅=Carame
卡艾梅=Kayme
卡里克=Garlic
卡鲁克=Karuk
史古德=Sgoode
史拉古=Slug
坡塔拉=Potara
堪培利=Campahri
塔布尔=Tabour
塔皮恩=Tapion
多克拉=Dokra
多克沙=Doksha
多林寺=Đa Lâm Tự
大天官=Daisenkan
大界王=Dai Kaio
大神官=Daishinkan/Grand Minister
大魔界=Đại Ma Giới
天津饭=Tien Shinhan
奎特拉= Quitela/Quitela
奥洛斯=Olos
孙悟天=Son Goten
孙悟空=Son Goku
孙悟饭=Son Gohan
巴库夫=Bakow
巴赫德=Bahid
巴达克=Bardock
巴隆赫=Ballonch
布尔玛=Bulma
希蕾丝=Helles
帕蕾丝=Paris
库尔德=Cold/Frost Demon
弗利萨=Frieza
拉克鲁=Lacru
拉彼斯=Lapis
拉芙莉=Lovely
排骨饭=Pikkon
提奥斯=Tios
时之界=Thời Gian Giới
普塔尔=Putar
曼纽尔=Manuel
柯尼克=Cognac/Conic
格库亚=Gokua/Zangya
格瓦斯=Govas/Gowasu
梅尔斯=Merus
梅珊人=Người Meishan
梅维丝=Mavis
武泰斗=Mutaito
比索亚=Bissoia
比鲁斯=Beerus
沙克达=Shakda
沙维扎=Salza
波杰克=Bojack
波萨伦=Posalon
界王拳=Kaio-Ken/Kaiō-ken
界王神=Kaiōshin
界芯人=Shinling
破坏神=Thần Hủy Diệt
科纳兹=Konats
精神树=Tinh Thần Thụ/Shinseiju
索尔贝=Solbe
缪博士=Tiến sĩ Myuu
芭朵斯=Vados
莫斯可=Mosco/Mule
萨拉玛=Zalama
西之都=Tây Đô/West City
西多拉=Sidra
西萨米=Shisami
贝利特=Berito
贝鲁克=Beruk
路德尔=Ruddell
达达儿=Dadar
邪念波=Janemba
郝思琪=Hasky
金大人=Giin đại nhân
阿特利=Atley
阿莉斯=Alice
魔封波=Ma Phong Ba/Mafūba
齐尔德=Chirudo
万能胶囊=Capsule/Capsules
上神境界=Thượng Thần cảnh giới
亚奇洛贝=Yajirobe
亚德兰特=Yardrat
冰冻恶魔=Frost Demon
力之大会=Giải Đấu Sức Mạnh
卡莉芙尔=Kefla
卡莉芙拉=Caulifla
四星龙神=Tứ Tinh Long Thần
多多利亚=Dodoria
多达利亚=Daglia
大界王神=Dai Kaiōshin/Dai-Kaiōshin
大魔神的=Đại Ma Thần
太上老君=Taijōrōkun/Taijō-Rōkun
奥莉西娅=Olyssia
巴布鲁斯=Baburusu/Bubbles
布里夫斯=Brief
希尔德刚=Hirudegarn/Hirudegran
库卡特尔=Cukatail
德米古拉=Demigra
时之天神=Thiên Thần Thời Gian
波蒙勒斯=Beaumont Reus
玛卡丽塔=Marcarita
玛斯鲁塔=Tháp Muscle
第一宇宙=Đệ Nhất Vũ Trụ/Vũ Trụ 1
第七宇宙=Đệ Thất Vũ Trụ/Vũ Trụ 7
第五宇宙=Đệ Ngũ Vũ Trụ
第六宇宙=Đệ Lục Vũ Trụ/Vũ Trụ 6
美达摩尔=Metamore
贝鲁摩德=Belmod
超级神龙=Siêu Cấp Thần Long/Super Shenron
超级龙珠=Super Dragon Ball
达维多王=Davido King
阿塔西亚=Atashia
阿波卡特=Avocado
魔神之境=Ma Thần Cảnh
黑暗天使=Hắc Ám Thiên Sứ
传超赛亚人=Legendary Super Saiyan
卡里克二世=Garlic Jr
大自在意境=Ultra Instinct
时之秩序者=Tuần Tra Thời Gian
超级赛亚人=Super Saiyan
超级赛亚人之神=Super Saiyan God
超级赛亚人蓝色=Super Saiyan Blue
传说中的超级赛亚人=Legendary Super Saiyan
万帕=Vampa
下级=Hạ cấp
东都=East Town
丝诺=Suno
中都=Central City
丹迪=Dende
乌龙=Oolong
五万=50 ngàn
亚天=Yaten
亚木=Yamu
亚隆=Yaron
亞姆=Yamcha
人间=Nhân Gian
仙人=Sennin
传超=Legendary Super Saiyan
伪神=False-God
佩兒=Puaru
佳斯=Gas
偶像=Idol
傲娇=Tsundere
元气=Genki
克林=Krillin
內魯=Neiru
八号=Số 8
八戒=Uron
兰普=Ranpu
兰芳=Lanfan
兽人=Beast-Man
内兹=Neiz
凯伊=Kai
凯尔=Kale
加林=Karin
加贝=Cabba
动漫=Anime
南无=Nam
南都=South City
卡多=Cado
卡敏=Kamin
卡林=Karin
变成=Biến thành
古拉=Cooler
古魯=Gurudo
吉斯=Jeice
后宫=Harem
呸呸=Pui Pui
哈兹=Heart
啊嘞=Are
圣地=Holy Place
地狱=Địa Ngục
地球=Trái Đất
基因=Gene
基朗=Grian
塔皮=Tapi
外挂=Plug-in
大姐=Aneki
大特=Trunks Lớn
天堂=Thiên Đường
天迪=Dende
契士=Jiisu
奥连=Oren
妖怪=Yōkai
孙君=Son-kun
孙子=Cháu trai
孙贝=Son-Ve
宗师=Grandmaster
导师=Tutor
寿司=Sushi
小林=Krilin
小舞=Mai
尼爾=Neiru
尼路=Neiru
巨猿=Ozaru
巫婆=Witch
布利=Broly
布恩=Vuon
布拉=Bulla
布玛=Bulma
希恩=Shin
希特=Hit
幽灵=Ghost
庫林=Krilin
开尔=Kale
弗瓦=Fuwa
彼德=Bido
忍者=Ninja
怪人=Kaijin
悟空=Goku
战力=CP
托比=Toby
托瓦=Towa
托马=Toma
拉色=Sadla
拟态=Mimic
拳法=Kenpō
拿帕=Nappa
捷斯=Jiisu
教授=Giáo sư
时空=Jikū
昆西=Kunshi
普依=Pui Pui
普娜=Bra
普洱=Puaru
普爾=Puaru
智商=IQ
格罗=Gero
桑卡=Sanka Ku
棒子=Cây gậy
樂平=Yamcha
次元=Dimension
正太=Shota
死神=Shinigami
比克=Piccolo
比達=Vegeta
气场=Aura
沙浦=Sharpner
沙鲁=Cell
洛而=Rou
津饭=Shinhan
海贼=Hải Tặc
潘达=Punta
火影=Hokage
烏巴=Upa
無限=Krillin
玛伦=Maron
瑜伽=Yoga
瑪蘿=Marron
病毒=Virus
真神=True-God
瞬移=Teleport
短笛=Piccolo
碧兒=Biden
神仆=Attendant
神力=God Force
神饭=Mystic Gohan
神龙=Shenron
科伦=Korn
科尼=Kony
究极=Kyūkyoku
立巴=Nappa
精英=Elite
索尼=Zeni
组诺=Zuno
终极=Ultimate
维思=Whis
绿茶=Yamcha
罗丽=Lali
罗吉=Rogi
罗格=Roger
美娅=Meiya
老孙=Son
肖萨=Shosa
胖次=Pantsu
至高=Supreme
艾尔=Ea
艾泽=Ize
艾纪=Age
芝芝=Chichi
芳芳=Fanfan
苏白=Sivar
莊子=Bulma
莫斯=Mosco
莱基=Myū
菇力=Gure
萨博=Zarbon
薩博=Zarbon
蛇姬=Hebihime
蛇道=Snake Way
西克=Sik
西塔=Heeter
西魯=Cell
视频=Video
貝比=Baby
贝利=Berry
贝王=King Vegeta
贝空=Veku
负向=Negative
超一=Super Saiyan 1
超二=Super Saiyan 2
超五=Super Saiyan 5
超四=Super Saiyan 4
超赛=Super Saiyan
辛恩=Shin
达蒙=Damon
道馆=Dōjō
那姆=Namu
那巴=Nappa
邪神=Jashin
野神=Wild-God
金电=Golden
长老=Elder
阎王=Yama
阿全=Zeno
阿博=Abo
阿樂=Yamcha
雷德=Dore
霍伊=Hoi
霸主=Overlord
霸气=Haki
面食=Pasta
飲茶=Yamcha
饮茶=Yamcha
马吉=Maji
魔人=Majin
魔凶=Makyō
魔化=Demonize
魔族=Demon Clan
魔神=Mashin
黄泉=Yomi
黑心=Black Smoke
龙国=Dragon League
龙族=Dragon Clan
龙珠=Dragon Ball
龙界=Dragon World
龙神=Dragon God
一万八=18,000
一千万=10 triệu
一天天=Từng ngày
一星球=Ngọc 1 ⭐️(sao)
一星龙=Syn Shenron
七星球=Ngọc 7 ⭐️(sao)
七龙珠=Dragon Ball
三星球=Ngọc 3 ⭐️(sao)
三百万=3 triệu
不死水=Bất Tử Thủy
东界王=Đông Kaio
两千万=20 triệu
中二病=Chūnibyō
丹巴林=Dambalin
为基纽=là Ginyu
二十万=200 ngàn
二星球=Ngọc 2 ⭐️(sao)
五十万=500 ngàn
五星龙=Rage Shenron
亚莫西=Yamoshi
伊巴纳=Ipana
伊巴那=Ibana
伊莉莎=Erasa
伯达摩=Botamo
佛利萨=Frieza
保温仓=Khoang giữ ấm
傑比特=Kibito
克纳兹=Konats
全功率=Full Power
六星球=Ngọc 6 ⭐️(sao)
六星龙=Oceanus Shenron
兹尔夫=Plant
兹布尔=Plant
冥想法=Meisōpō
凯夫拉=Kefla
凯芙拉=Kefla
利克姆=Rikumu
利庫姆=Rikumu
剧场版=Bản Movie
加帕王=King Choppa
包子山=Núi Paozu
十七号=Số 17
十九号=Số 19
十五号=Số 15
十六号=Số 16
千里眼=Clairvoyant
卡利克=Garlic
卡林塔=Tháp Karin
卡洛特=Kakalot
卡答兹=Katas
卡芙拉=Caulifla
变身术=Transformation
古爾多=Gurudo
可可特=Cocotte
史拉格=Lord Slug
合体扎=Fused Zamasu
吉米斯=Jimeze
味美得=Vermoud
嘎诺斯=Ganos
四星球=Ngọc 4 ⭐️(sao)
四星龙=Nuova Shenron
培植人=Saibamen
塔伊丝=Tights
塔依斯=Tights
塔古玛=Taguma
塔格玛=Tagoma
塔洛特=Tallot
外星人=Alien
大全王=Daizeno
大姐姐=Onee-chan
大布欧=Big Buu
大爆炸=Big Bang
大魔王=Daimaō
天津飯=Tien Shinhan
太阳拳=Taiyō-ken
太阳系=Hệ Mặt Trời
奥勒冈=Oregano
如意棒=Nyoibō
娜美克=Namek
孫悟天=Son Goten
孫悟飯=Son Gohan
小布拉=Bulla-chan
小悟空=Goku Jr
小沙鲁=Cell Jr
巴布特=Pomput
巴比迪=Babidi
巴菲迪=Babidi
巴达拉=Bardock
布尔兹=Blutz
布罗利=Broly
布里夫=Brief
希比特=Hibito
帕布津=Pabuzu
帝破斯=Dyspo
开夫拉=Kefla
异次元=I-Jigen
弗利札=Frieza
弗利沙=Frieza
弗利薩=Frieza
弗德拉=Fudra
彌太郎=Yajirobe
心脏病=Bệnh Tim
恰比拉=Chabilla
悟吉塔=Gogeta
悟空桑=Goku-san
扎布多=Zarbuto
扎马斯=Zamasu
拉凡达=Lavender
拉古丝=Lagss
拉帝兹=Raditz
拉蒂茨=Raditz
拉蒂茲=Raditz
拉邦拉=Rabanra
拿迪斯=Raditz
探寻器=Finder
探测器=Detector
撒旦市=Satan City
无之界=Null Realm
时光机=Time Machine
时间线=Timeline
普亞路=Puaru
普朗特=Plant
普雅鲁=Pujaru
朗姆西=Rumoosh
朗密西=Rumoosh
木瓜岛=Papaya Island
杂烩饭=Pilaf
杜利安=Dodoria
杰比特=Kibito
某小鸟=Boutori
查克拉=Chakra
格古洛=Kakalot
桃白白=Tao Pai Pai
正太控=Shotacon
比努斯=Beerus
比比克=so Piccolo
比比迪=Bibidi
比迪麗=Biden
气元斩=Kienzan
气功炮=Kikōhō
气圆斩=Kienzan
沙拉达=Salada
沦仑伽=Porunga
波仑伽=Porunga
波仑迦=Porunga
波伦伽=Porunga
波塔拉=Portara
洞洞波=Dodonpa
潘启阿=Koichiarator
牛魔王=Gyūmaō
狗头人=Kobold
玆夫尔=Plant
畢拉夫=Pilaf
皮拉夫=Pilaf
破坏弹=Hakai-dan
碧基尼=Bikini
碧姬妮=Bikini
神之力=God Power
神之血=Blood of God
神力量=God Power
神蓝色=God Blue
第一阶=Level 1
第七阶=Level 7
第三阶=Level 3
第二阶=Level 2
第六阶=Level 6
第四阶=Level 4
筋斗云=Kinto’un
米斯特=Hercule
精神力=Mental Strength
紫罗兰=Violet
繆博士=Dr. Myū
红假面=Crimson-Masked
红军团=Red-Ribbon Army
红缎带=Red-Ribbon
纳兹星=Planet Nutts
维生素=Vitamin
胖布欧=Buu Mập
能量球=Energy Ball
舞空术=Bukū Jutsu
苏帕理=Peppra
莫奈特=Monaito
萝莉控=Lolicon
蓝将军=General Blue
融合术=Fusion
西界王=Tây Kaiō
西达拉=Sidra
西里尔=Cereal
西银河=West Area
貝吉塔=Vegeta
貝吉特=Vegetto
贝吉塔=Vegeta
赛亚人=Người Saiyan
赛拉瑞=Salary
赛莉巴=Celiba
超悟空=Super Goku
超时空=Chōjikū
超赛一=Super Saiyan 1
超赛二=Super Saiyan 2
超赛红=Super Saiyan God
超赛蓝=Super Saiyan Blue
达普拉=Dabura
達布拉=Dabura
達洛特=Vegetto
達爾特=Vegetto
重力室=Gravity Room
野比饭=Nobihan
金手指=Golden Finger
银河王=Galactic King
閻羅王=Diêm Vương
闪时功=Time-Skip
阎魔王=King Yemma
阿瓦莫=Awamo
阿纳特=Anato
陶白白=Tao Baibai
雅木茶=Yamcha
雜燴飯=Pilaf
霹雳纳=Pilina
马吉拉=Majora
魔凶星=Makyō Star
魔神城=Majin-jō
鶴仙人=Tsuru Sennin
鹤仙人=Tsuru Sennin
鹤仙流=Tsurusen-ryū
黑悟空=Black Goku
黑魔法=Dark Magic
龙珠超=Dragon Ball Super
龟仙人=Kame Sennin
龟仙岛=Đảo Rùa
一星龙珠=Ngọc rồng 1 ⭐️(sao)
七星龙珠=Ngọc rồng 7 ⭐️(sao)
三十九号=Số 39
世界冠军=World Champion
二十一号=Số 21
二星龙珠=Ngọc rồng 2 ⭐️(sao)
五万五千=55 ngàn
亚德特拉=Yardrats
亞奇洛貝=Yajirobe
伽力克炮=Garrick Cannon
佛罗斯特=Frost
兔子军团=Rabbit Mob
全王大人=Zeno-sama
冰冻一族=Frost Demon Clan
力量大会=Tournament of Power
加林仙人=Thần Mèo Karin
十二宇宙=12 Universes
南界王神=Nam Kaiōshin
卡卡罗特=Kakalot
卡卡羅特=Kakalot
卡塞拉尔=Casserale
卡娜莎星=Kanassa
卡林仙人=Karin Sennin
卡里芙拉=Caulifla
可羅博士=Dr. Gero
啵啦雷哒=Bollarator
四万五千=45 ngàn
基洛博士=Dr. Gero
天使之力=Angel Power
娜美克星=Planet Namek
家庭主妇=Housewife
巴拉卡斯=Paragus
帕帕罗尼=Paparoni
帕拉加斯=Paragus
库尔德王=King Cold
弗罗斯特=Frost
总指挥长=Tổng chỉ huy trưởng
悟天克斯=Gotenks
悟空先生=Goku-san
悟饭先生=Gohan-san
扎普利超=Za Priccio
撒旦先生=Mr. Satan
斯布里奇=Spopovitch
斯波比奇=Spopovitch
时之卷轴=Time Scrolls
时光戒指=Time Ring
时间机器=Time Machine
暗黑龙珠=Dark Dragon Ball
暴热电磁=Overheat Magnetron
最终闪光=Final Flash
机甲战队=Armored Squadron
杰比特神=Kibito Kai
极致升华=Ultra Rise
格兰诺拉=Granolah
格罗博士=Dr. Gero
橙色比克=Orange Piccolo
橙色短笛=Orange Piccolo
武天老师=Muten Rōshi
死亡射线=Death Beam
比克魔王=Piccolo Ma Vương
气的力量=Lực Lượng Ki
汉娜西亚=Gine
波波先生=Mr. Popo
深蓝进化=Blue Evolved
灰色吉连=Jiren the Gray
特南克斯=Trunks
特蘭克斯=Trunks
生命层次=Level of Life
界王神剑=Z-Sword
界王神辛=Kaiōshin Shin
界限突破= Limit Breaker
盖洛博士=Dr. Gero
瞬间移动=Teleport
破坏之力=Destruction Power
破坏神界=Hakaishin-kai
破坏能量=Destroy Energy
神之境界=God Realm
神之次元=Dimension of God
神之气息=God’s Ki
神之状态=God Form
神之领域=Realm of Gods
神秘形态=Mystic Form
神秘状态=Mystic Form
第三宇宙=Vũ Trụ 3
第二宇宙=Vũ Trụ 2
第八宇宙=Vũ Trụ 8
第十宇宙=Vũ Trụ 10
第四宇宙=Vũ Trụ 4
红缎带军=Red-Ribon Army
终极闪光=Final Flash
老界王神=Old Kai
自在极意=Ultra Instinct
自极意功=Ultra Instinct
至高天使=Thiên Sứ Tối Cao
草莓巴菲=Strawberry Buffy
萨欧内尔=Saonel
蓋洛博士=Dr. Gero
融合战士=Fusion Warrior
西塔组织=Heeter Force
西界王神=Tây Kaiōshin
西里尔星=Cereal
贝吉塔星=Planet Vegeta
贝尔盖莫=Bergamo
贝比鲁斯=Beerus
超一星龙=Super Syn Shenron
超破坏神=Siêu Thần Hủy Diệt
超级布欧=Super Buu
超级沙鲁=Super Cell
超级赛亚=Super Saiyan
那美克星=Namek
邪恶力量=Evil Power
邪恶布欧=Evil Buu
里布里安=Ribrianne
银河巡警=Galactic Patrol
银河战士=Galaxy Soldiers
阿尼拉扎=Anilaza
雅奇洛貝=Yajirobe
骄傲战队=Pride Troopers
魔人布欧=Majin Buu
魔人普烏=Majin Buu
黄金巨猿=Golden Ōzaru
黑弗利萨=Black Frieza
黑心龙珠=Black Dragon Ball
黑暗悟空=Black Goku
龙珠英雄=Dragon Ball Heros
龟派气功=Kamehameha
万国惊天掌=Bankoku Bikkuri-shō
亚库亚之雾=Black Water Mist
人造人九号=Android 9
伽米萨拉斯=Gamisaras
假面黑悟空=Masked Goku
卡利克二世=Garlic II
卡多贝斯勒=Katopesla
合体扎马斯=Fused Zamasu
坡塔拉耳环=Bông tai Potara
大爆炸攻击=Big Bang Attack
大特南克斯=Trunks Lớn
孙悟空先生=Son Goku-san
小特兰克斯=Little Trunks
布莱克副官=Staff Officer Black
布里夫博士=Dr. Brief
弥次郎兵卫=Yajirobe
彌次郎兵衛=Yajirobe
时之界王神=Time Kaiōshin
时间的监狱=Thời Gian Ngục Giam
比拉夫大王=Pilaf
比鲁斯大人=Beerus-sama
界王神大人=Kaiōshin-sama
皮拉夫大王=King Pilaf
破坏能量球=Destroy Ball
第十七宇宙=Vũ Trụ 17
第十二宇宙=Vũ Trụ 12
第十八宇宙=Vũ Trụ 18
第十六宇宙=Vũ Trụ 16
米斯特撒旦=Santa
精神时光屋=Spiritual Time Room
紫罗兰上校=Colonel Violet
红缎带军团=Red-Ribbon Army
终极闪光炮=Final Flash
自在极意功=Ultra Instinct
自在极易功=Ultra Instinct
自在级意功=Ultra Instinct
贝吉塔先生=Vegeta-san
赛亚人之王=King of Saiyans
超一全功率=Super Saiyan 1 Full Power
超级十七号=Super 17
超级十八号=Super 18
超级撒亚人=Super Saiyan
超级贝吉特=Super Vegetto
超赛神红色=Super Saiyan God
超赛神蓝色=Super Saiyan Blue/Super Saiyan God Blue
魔贯光杀炮=Makankōsappō
黄金弗利萨=Golden Frieza
黑金弗利萨=BlackGold Frieza
龟派气功波=Kamehameha
人造人二十号=Android 20
人造人十七号=Android 17
人造人十九号=Android 19
人造人十五号=Android 15
人造人十八号=Android 18
人造人十四号=Android 14
值钱的东西都=thứ đáng giá đều
布里夫斯博士=Dr. Brief
最终龟派气功=Final Kamehameha
沃太•马盖塔=Auta Magetta
红假面黑悟空=Crimson-Masked Goku
美达摩尔星人=Tộc Metamorans
赛亚蒙面超人=Saiyan-man
超级悟天克斯=Super Gotenks
超级赛亚之神=Super Saiyan God
超级赛亚人七=Super Saiyan 7
超级赛亚人二=Super Saiyan 2
超级赛亚人六=Super Saiyan 6
超级赛亚人白=Super Saiyan White
超级赛亚人绿=Super Saiyan Green
人造人七十六号=Android 76
人造人三十三号=Android 33
人造人二十一号=Android 21
人造人五十五号=Android 55
传说超级赛亚人=Legendary Super Saiyan
超级龟派气功波=Super Kamehameha
超赛神第一形态=Super Saiyan God 1
超赛神第二形态=Super Saiyan God 2
人造人 17 号=Android 17
人造人 18 号=Android 18
超级赛亚人第一阶=Super Saiyan 1
超级赛亚人第三阶=Super Saiyan 3
超级赛亚人第五阶=Super Saiyan 5
超级赛亚人第四阶=Super Saiyan 4
斯啤利托强制分离术=Forced Spirit Fission
超级赛亚人一第一段=Super Saiyan 1 Stage 1
超级赛亚人一第二段=Super Saiyan 1 Stage 2
超级赛亚人之神蓝色=Super Saiyan God Blue
超级赛亚人桃红第三阶=Super Saiyan Rosé 3
超级赛亚人蓝色第三阶=Super Saiyan Blue 3
超级赛亚人蓝色第四阶=Super Saiyan Blue 4
超级赛亚人一第三段全功率=Super Saiyan 1 Stage 3 Full Power
