士=Tsukasa
煜=Helmet
瑠=Gon 
空=Không
茜=Akane
雷=Ikazuchi
一彰=Akira
一海=Sawatari
三岛=Mishima
三蛋=OOO
不破=Isamu
两足=hai chân
中岛=Nakajima
临多=Linto
丽奈=Rena 
久永=Hisanaga  
乌尔=Heure
乾巧=Inui Takumi
五代=Godai
井坂=Isaka
亚克=Ark
京水=Kyōsui
亮二=Ryoji
仁藤=Nitoh 
仓田=Kurata
令野=Reino
伊兹=Izu
伊达=Date
佐伯=Saeki
佐鲁=Zol
侑斗=Yuto
依兹=Izu
信吾=Shingo
信彦=Nobuhiko
修一=Shuichi
修一=Shuichi 
修骑=Repair 
假面=Kamen
光实=Mitsuzane 
光生=Kōsei
光秀=Mitsuhide
克己=Katsumi
兔子=Rabbit 
兜中=trong túi
八代=Yashiro
兽爷=Beast
兽骑=Beast
冰儿=Băng Nhi
冰室=Himuro
冴子=Saeko
凛子=Rinko
凤莲=Oren 
凯撒=Kaixa
凰莲=Oren 
创骑=Build
剑崎=Kenzaki
剑崎=Kenzaki 
剑蝎=Sasword
剑蝎=Sasword 
剿灭=tiêu diệt
加头=Kazu
加护=gia hộ
勇治=Yūji
勇者=Brave
北冈=Kitaoka
千惠=Chie
升龙=Dragon Rise
卌骑=Fourze
南宫=Minamiya
博士=bác sĩ
卡带= Gashat
卡带=Gashat
卡盒=Ride Booker 
历练=lịch luyện
原虫=Native
友美=Tomomi
双骑=W
变身=Henshin
吉格=Giger
后藤=Goto
吴岛=Kureshima
呀嘞=Yare
呦西=Yosha
和泉=Izumi
哉亚=ZAIA
唯阿=Yua
啫喱=Sclashjellies
团灭=đoàn diệt
园咲=Sonozaki
圆咲=Sonozaki
圣刃=Saber
地空=Foggu
地龙=Groundain
坦克=Tank
城户=Kido
士兵=sĩ binh
夏国=Trung Quốc
夏陵=Natsuki
外传=ngoại truyện
夜哥=Raito nii
大介=Daisuke
大牙=Tiger
大衫=Ōsugi
天哥=Zen-nii
天宇=Kakizaki 
天津=Amatsu 
天道=Tendou
天音=Amane
太鼓=Taiko 
奥拉=Ora
奥特=Ultra
如月=Kisaragi
妹空=muội khống 
安库=Ankh
宝生=Houjou 
宫徒=Zodiarts
寂灭=tịch diệt
小历=Koyomi
小姬=Kohime
小弦=Gen-chan
小明=Tsukasa 
小泉=Izumi-chan
小澄=Kosumi
小煦=Hiyori
小翔=Shō-chan
小舞=Mai-chan
小言=Gon
山村=Yamamura
山野=Yamano
崇皇=Grand
崩灭=băng diệt
巫骑=Wizard
巴旦=Badan
希德=Sid
常盘=Tokiwa
平成=Heisei
幻德=Gentoku
幻梦=Gemn
幻梦=Genm
幽怜=Yuzare
庄吉=Sokichi 
庄吾=Sougo
庄吾=Sōgo
庄悟=SOUGO
库恩=Kuehneo
库恩=Kuehneo 
异类=Another
弟切=Otogiri
影山=Kageyama
御堂=Mido  
德加=Dogga
忍者=Shinobi
志叶=Shiba
总司=Souji
恶霸=Rogue
惣一=Souichi
慎吾=Shingo
或人=Aruto
战兔=Sento
战士=chiến sĩ
战队=Sentai
户田=Kohta
护士=hộ sĩ
拳皇=PunchHopper
拳蝗=Punch Hopper
挂王=quải vương
提德=Tid
插槽=Memory Slot
操真=Sōma
整骑=Zentai
文音=Fumine
斗真=Teos
斩月=Zangetsu
斩灭=chém chết
斩鬼=Zanki 
新富=Shintomi
方舟=Ark
日元=¥
早赖=Hayase
时停=ngưng đọng thời gian
时王=ZI-O
时王=Zi-O
时表=Watch
明海=Narumi
春奈=Haruna
昭和=Showa
晴人=Haruto
晴商=tình thương
暴龙=T-Rex
月读=Tsukuyomi
月骑=Kiva
木下=Kinoshita
木崎=Kizaki
木野=Kino
机车=Moto
杀青=sát thanh
来历=lai lịch
松井=Matsui
松果=Matsubokkuri
柔道=Judo
柳橙=Orange
树花=Juka
格连=Garren
桃井=Momoi
桐生=Kiryū
梦幻=Genm
榴莲=Durian
槐里=trong tay
樱林=Sakurabayashi
橙子=Orange
次狼=Jiro 
欧兹=OOO
欧布=Orb
正宗=Masamune
正邦= Masakuni
殴兹=OOO
比奈=Hina
永梦=Emu
永骑=Eternal
江户=Edo
江草=Egusa
沃兹=Woz
沟口=Mizoguchi
沢芽=Zawame 
泯灭=phai mờ
泰罗=Taro
泷川=Takigawa 
泽芽=Zawame 
津上=Tsugami
流忙=lưu manh
浅仓=Asakura
海东=Kaito
海东=Kaitō
海帕=Hyper
海鳐=Raia
消灭=tiêu diệt
深晴=thâm tình
清人=Kiyoto
湮灭=chôn vùi
满瓶=Fullbottle
灭亡=diệt vong
灭口=diệt khẩu
灭杀=diệt sát
灵骑=Ghost 
照井=Terui
牙兰=Kivala
牙王=Gaoh
特摄=Tokusatsu
狮堂=Shidō
狮子=Lion 
玉望=dục vọng
王蛇=Ohja
王阳=Vương Dương
琴弦=dây đàn
田所=Tadokoro
由衣=Yui
电王=Den-O
疾风=Cyclone
病毒=Virus
白神=OverLord of Light
百濑=Hyose
盖亚=Gaia
相乐=Sagara
真仓=Mankura
真吾=Sougo
真夜=Maya
真影=Makage 
真理=Mari
真红=Demushu
矢车=Yaguruma
石棍=Thạch Côn
石棺=Thạch Quan
神藏=Kagura
秋月=Akitsuki
空我=Kuuga
空间=không gian
竹宫=Takemiya
笔格=bức cách
笔王=bức vương
笠原=Kasahara
箭石=Neohi 
米克=Mick
米娜=Mina
红渡=Kurenei Wataru
纮汰=Kōuta
纯一=Junichi
纱羽=Sawa
纳尼=Nani
绅士=thân sĩ
经历=kinh lịch
结花=Juka
结花=Yuka
统马=Touma
网野=Amino
罗念=Rozen
美咲=Misaki
美沙=Misa
美空=Misora
翔一=Shōichi
翠绿=Redyue
翡翠=Redyue
联组=Combo
胜哄=Kachidoki
舞姐=Mai-nee
芦原=Ashiwara
芦河=Ashikawa
若菜=Wakana
苦无=Kunai
草莓=Ichigo
莫西=moshi
葛叶=Kazuraba
葛成=Katsuragi
藤宫=Fujimiya
蚁兵=ZECTrooper
蜜桃=Peach 
蜜瓜=Melon
蝗女=Inago no Onna
血族=Blood tộc
表盘=Watch
裕也=Yuya
西都=Seito
要往=muốn hướng
诞骑=Birth
诺玛=Noruma
豪快=Gokai
贤吾=Kengo
贵虎=Takatora
赛沙=Sazer
赤羽=Akaba
踢蝗=Kick Hopper
轰鬼=Todoroki 
迅速=nhanh chóng
逢魔=Ohma
里克=Riku
里香=Riko
野狼=Vulcan
金斗=Caucasus
金龙=Goludora
铁兵=Zolda
铠武=Gaim
银河=Ginga
镰田=Kamata
长田=Osada
闪点=Flashpoint
阪东=Bando
阳介=Yōsuke
阿历=Koyomi
阿夜=Raito
阿实=Mitsu
陆敏=Rozen
陈辰=Kogami
难波=Namba
雏鸟=Hina
雪芝=Yukishiba
零二=Zero-Two
零日=Zero Day
雷光=lôi quang
雷声=tiếng sấm
雷蜓=Drake
雷霆=Drake
雷鸣=lôi minh
雾彦=Kirihiko
青城=Aoishiro
青羽=Aoba
顾桑=Ebisu-san
顾肖=Cố Tiêu
风花=Kazahana
风都=Fūto
风面=Fūmen
飞彩=Hiiro
飞电=Hiden
马丸=Mã Hoàn
马俐=Mari 
驱纹=Kumon
高司=Takatsukasa 
魅影=Phantom
鳄霸=Rogue
鸣海=Narumi
鹫尾=Washio
黄蜂=The Bee
黑影=Kurokage
齐格=Sieg
龍牙=Ryuga
龙我=Ryuga
龙我=Ryuuga
龙牙=Ryuga
龙珠=Dragon Ball
龙骑=Ryuki
$森下=Morishita
W装甲=W Armor
一海神=Sawatari  thần
三十下=30 lần
三角龙=Triceratops
三途川=sông Sanzu
上杉城=Makoto Uesugi
上村葵=Uemura Aoi
不死者=NEVER
不破谏=Isamu Fuwa
世界树=Yggdrasil
世纪王=Seiki Ō
久永当=Hisanaga Ataru
九朗岳=Kurodake
九条绫=Kujō Aya
九郎岳=Gurongi
乾巧的=Inui Takumi
五代桑=Godai-san
亚克一=Ark One
亚克零=Ark Zero
亚古鲁=Arcle
亚树子=Akiko
伊能贤=Inō Kengo
伊达明=Date Akira
佐原家=Sawara  gia
佩戴着=đeo vào
光之力=Force of Light
光之森=Hikarigamori 
光夏海=Hikari Natsumi 
光太郎=Kōtarō
克洛诺=Cronos
全能瓶=Almighty Fullbottle
全能踢=Mighty Kick
八代蓝=Yashiro Ai
冰川城=Hikawa Makoto
冰川诚=Hikawa Makoto
冰河期=Băng Hà Kỳ
冲入到=nhảy vào đến
凑耀子=Minato Yoko
刀唯阿=Yaiba Yua 
刃唯阿=Yaiba Yua 
创世纪=Genesis
初濑亮=Hatsuse Ryo
初生踢=Growing  Kick
剑形态=Sword Mode
加古川=Kakogawa 
加头顺=Kazu Jun
加梅尔=Gamel
加艾鲁=Gaeru
加贺美=Kagami
加鲁鲁=Garulu
加鲁鲁=Garuru
千世子=Chiyoko
千树怜=Ren Senjyu
南宫夜=Minamiya Sayo
卡利斯=Chalice
卡扎力=Kazari
卡片匣=Card Deck
卡盒枪=Ride Booker Gun
历世事=việc đời
参杂体=Dopant
变!身=Hen! Shin
变身者=nguời biến thân
古利咚=Gridon
古郎基=Gurongi
史变机=Máy Thay Đổi Lịch Sử
后藤君=Goto-kun
和平星=Star Piece
咔嚓嚓=Gachacha
园咲家=nhà Sonozaki
城之内=Jonouchi 
城岛泪=Jojima Rui
复活者=Revive
夏蜜柑=Natsumikan 
夏蜜桔=Natsumikan 
外传的=ngoại truyện
大切断=Violent Slash
大天使=El Lord
大橙刀=Daidaimaru
天之石=Sky Stone
天才瓶=Genius Bottle
天津四=Deneb
天道君=Tendou-kun
天马弩=Pegasus Bowgun
太棒了=Subarashī
契约卡=Contract Card
奥特曼=Ultraman
女武神=Valkyrie
姬香绫=Cơ Hương Lăng
婕丝塔=Shesta
学生会=Hội Học Sinh 
安库酱=Ankh-chan
对火野=đối với Hino
将门矢=cùng Kadoya
小叶奈=Nao-chan
小夏海=Natsumi-chan
小春奈=Haruna-chan
小月读=Tsukuyomi
小野寺=Onodera
尾藤勇=Bitō Isamu
居间惠=Iruma Megumi
山野遥=Yamano Haruka
岩浆龙=Cross-Z Magma
崛之内=Horinouchi
巴尔坎=Vulcan
布拉弗=Bravo
帝王石=King Stone
帝皇剑=King Blade
常磐庄=Tokiwa Sougo
幸太郎=Kotaro
幻影队=Shadow
库里姆=Krim 
异魔神=Imagin
弦太朗=Gentarō
弦太郎=Gentarō
影视剧=Movies
德尔塔=Delta
忍表了=Shinobi Watch
恭太郎=Kyotaro
我开动=Itadakimatsu
戒斗了=Kaito
所变身=biến thân thành
拉集团=Ra Group
搭载器=Combie
斩月真=Zangetsu Shin
旋影剑=Revolcane 
无双龍=Dragreder
无限魂=Mugen Damashii
既视感=ký thị cảm
早濑繁=Hayase Fukaza
昆虫仪=Zecter
明光院=Myokoin
明日梦=Asumu 
是之助=Yunosuke
暗之力=Force of Darkness
暗星云=Dark Nebula
木下优=Kinoshita Subarashi
木怜治=Nogi Reiji
木野薰=Kaoru Kino
木雕熊=Mộc Điêu Hùng
本愿寺=Honganji
杰斯塔=Shesta
极武装=Kiwami Arms
极限W=Xtreme W
极限斗=GiriGiriChambara
果冻龙=Cross-ZCharge
柔道部=câu lạc bộ Jūdō
格里斯=Grease
梅兹儿=Mezool
梅兹尔=Mezūru
棒球部=câu lạc bộ bóng chày
樱井乡=Sakurai Gō
樱花国=Nhật Bản
橘真伍=Tachibana Shingo
橙子刀=Daidaimaru
檀樱子=Dan Sakurako
檀黎斗=Dan Kuroto
次元踢=Dimension Kick 
欧尼科=Onycho
欧尼酱=Onii-chan
欲望史=Greeed
毒蛇王=Venosnaker 
比奈酱=Hina-chan
水泽悠=Mizusawa Yu
永梦了=Emu
江南的=Kanna
江草茜=Egusa Akane
泉信吾=Izumi Shingo
泊警官=cảnh sát Tomari
波斯得=Birthday
泥娃娃=Claydoll
泷川空=Takikawa Sora
海帕虫=Hyper Zecter
渡渡鸟=Dodo
渡渡鸟=Dodo 
满撞瓶=Fullbottle
满装瓶=Fullbottle
烟雾枪=Steam Gun
照井龙=Terui Ryū
爆裂器=Blaster
爱利迦=Lovrica
牙吠红=Gao Red
牙吠黄=Gao Yellow
牙蝙蝠=Fangbat
牙血鬼=Fangire
特莱多=Tridoron 
猛击者=Smash 
王小明=Kadoya Tsukasa
琉兵卫=Ryūbē
瓦尔坎=Vulcan
田幸雄=Điền Hạnh Hùng
田所修=Tadokoro Shuichi
白沃兹=Shiro Woz
的真木=Maki
盖斯特=Geist
相乐的=Sagara
相川始=Aikawa Hajime
真剑红=Shinken Red
真纪那=Makina
矢车想=Yaguruma Sōu 
石像鬼=Gargoyle
石田键=Ishida Ken
破晓者=Dawnbreaker
神代剑=Kamishiro Tsurugi
神敬介=Keisuke Jin
神速爱=God Speed Love
福添准=Fukuzoe Jun
秀一闻=Shuichi nghe
空我瓶=Kuuga Fullbottle
笛木历=Fueki Koyomi
笛木奏=Fueki Sō
笛木奏=Fueki Sōu
索尔提=Salty
索尔提=Salty 
索尔缇=Salty 
红蜘蛛=Red Spider
纱羽姐=Sawa nee
纳斯卡=Nazca
绘里香=Erika
编年史=Chronicle
美智子=Michiko
美空站=Misora
翔太郎=Shotaro
老流忙=lão lưu manh
能量瓶=Fullbottle
艾卡尔=Ekal
艾姆斯=A.I.M.S
艾尔卡=Elka
芦原贤=Ashiwara Ken
芦原贤=Ken Ashiwara
芭路芭=Baruba
苏天宇=Kakizaki Satoshi
草加的=Kusaka  
荒木町=Araki-cho
菲尼斯=Finis
葛叶晶=Kazuraba Akira
葛城巧=Katsuragi Takumi
葛城肖=Katsuragi Ebisu
蓝花楹=Jacaranda
蛋黄酱=Mayonnaise
蝎子瓶=Scorpion Fullbottle
西马妮=Saiba Nico
警视厅=sở cảnh sát
诸星团=Moroboshi Dan
谢斯塔=Shesta
贝罗萨=Berotha
贝罗萨=Berotha 
财团X=Foundation X
贵利矢=Kiriya
超星神=Chōseishin
超速化=Clock Up
跆拳道=Taekwondo
辛太郎=Shintaro
达罗姆=Darom
进之介=Shinnosuke
进化龙=Evol-Dragon
遥控器=Remocon Bros
重加速=Jūkasoku
金苹果=Golden Fruit
银河骑=Ginga 
银河龙=Cross-Z Evol
镜世界=Mirror World
镜飞彩=Kagami Hiiro
镜飞彩=Kagami Hiiro 
门矢士=Kadoya Tsukasa
阴暗使=Yummy
阿方索=Alfonso
零终结=Zero End
霸王龙=T-Rex
霸王龙=Tyrannosaurus
音击棒=Ongekibou
顺一郎=Junichiro
顺一郎=Junichirō
顾晓然=Ebisu Souzen
顾肖然=Ebisu Souzen
食尸鬼=Ghoul
马萨卡=Masaka
驱动器=Driver
骑士拳=Rider Punch
高原寺=Kōenji
魔化魍= Makamou 
魔机偶=Magia
魔机偶=Maiga
魔皇剑=Zanvat Sword
魔神机=Time Mazine
鸟井坂=Toriisaka
鹫尾雷=Washio Rai
鹰山仁=Takayama Jin
鹰虎蝗=Tatoba
黑山莲= Haguro Ren 
黑炎刀=Drag Saber
黑甲斗=Dark Kabuto
黑神尽=Hắc Thần Tẫn
鼓屋勉=Tsuzumiya Tsutomu
龙形态=Dragon Form
龙骑士=Dragon Knight
龙骑瓶=Ryuki Fullbottle
O扫描器=O Scanner
万丈龙我=Banjou Ryuuga
万丈龙我=Banjō Ryūga
三岛正人=Masato Mishima
中绘里香=Satonaka Erika
乡原光臣=Gōbara Mitsuomi
井泽博司=Izawa Tsukasa
亚玛达姆=Amadam
仁藤攻介=Nitō Kōsuke
伊达先生=Date-san
传通院洸=Dentsuin Akira
佐伯素子=Saeki Motoko
佐原俊吉=Sawara Toshiyoshi
使用时间=sử dụng thời gian
修卡硬币=Shocker Medal
修玛吉亚=Humagear
修码吉亚=Humagear
假面驾驭=Kamen Ride
假面骑士=Kamen Rider
光子血液=Photon Blood
光照相馆=Hikari Studio 
光荣次郎=Eijirō
光荣次郎=Hikari Eijiro 
克洛诺斯=Cronus
克罗诺斯=Kronos
兔坦形态=Rabbit Tank Form
兔子坦克=Rabbit Tank
全能形态=Mighty Form
全能跳跃=Mighty Jump
全能飞踢=Mighty Kick
八分光轮=Dismembering Halo
冰冻极熊=Freezing Bear
冰室幻德=Himuro Gentoku
冰室泰山=Himuro Taizan
冰晶凤凰=Ice Phoenix
冴……子=Sae…… ko
冻结降临=Freeze Vent
凯撒系统=Kasier System
刀剑降临=Sword Vent
刃野千夫=Jinno Mikio
刃野干夫=Jinno Mikio
切尔伊姆=Sheimu
刚烈形态= Goretsu Form
初生形态=Growing Form
剑蝎的剑=Sasword
加贺美亮=Kagami Ryo
加贺美新=Kagami Arata 
加速形态=Accel Form
北都三羽=Hokuto Sanbagarasu
十年号的=Decader
升华全能=Rising Mighty 
升华泰坦=Rising  Titan
升华青龙=Rising Dragon  
升级密钥=Progrisekey
升级秘钥=Progrisekey
南光太郎=Minami Kōtarō
博物馆的=Museum
危险兔坦=Hazard  Rabbit Tank
危险启动=Hazard On
危险模式=Hazard Mode
危险装置=Hazard Trigger
危险黑暗=Hazard Dark
双子赛沙=Sazer Remls
古斯古西=Cous Coussier 
吴岛贵虎=Kureshima Takatora
哉驱动器=Zaia Driver
园咲来人=Sonozaki Raito
圣剑形态=Sword Form
圣枪形态=Gun Form
圣竿形态=Rod Form
地狱大使=Ambassador Hell
城岛悠木=Jojima Yuki
城岛悠木=Jōjima Yūki
堂安主水=Douan Mondo
堂本刚三=Dōmoto Gōzō
复制降临=Copy Vent
大地形态=Ground Form
大文字隼=Daimonji Shun
大道美树=Daidō Maria
大门凛子=Daimon Rinko
大门凛子=Daimon Rinko 
大魔神机=Dai Mazine
天十郎的=Tenjuro
天地双龙= Kyodain
天才形态=Genius Form
天文开关=Astroswitch
天秤赛沙=Sazer Dail
天空寺尊=Tenkuuji Takeru
天马形态=Pegasus Form
奈欧西魔=Naomi
奈良瞬平=Nara Shunpei
契约降临=Advent
奥菲以诺=Orphnoch
奥菲因子=Orphnoch Gen
始之男的=Hajimari no Otoko
完美调和=Kanzen Chōwa
宝生永梦=Houjou Emu
对门矢士=đối Kadoya Tsukasa
射击之狼=Shooting Wolf
将门矢士=đem Kadoya Tsukasa
小夜妹妹=Sayo-chan
尖刺毒蝎=Sting Scorpion
尖刺蝎子=Sting Scorpion
山本昌宏=Yamamoto Masahiro
山森美沙=Yamamori Misa
崩源体了=Bugster
左翔太郎=Hidari Shotaro
巨力金刚=Punching Kong
巫师枪剑=WizarSwordGun
巴拉欧姆=Baraom
巴拿长枪=Bana Spear
巴罗欧姆=Baraom
帝王形态=King Form
帝诺佐鲁=Dinozaur
常…常磐=To… Tokiwa
幻梦公司=Genm Corp
幻梦集团=Gemn Corp
开关打开=Switch On
异类帝骑=Another Decade
异类骑士=Another Rider
引擎战士=EngineBro’s
影月信彦=Nobuhiko Tsukikage
德兰城堡=Castle Doran
德加形态=Dogga Form
德迦形态=Dogga Form
忍者装甲=Shinobi Armor
性格鲁莽=tính cách lỗ mãng
恐龙战队=Kyōryū Sentai
恐龙联组=Putotyra Combo
恶路程序=Roidmude
惊异天马=Amazing Pegasus
惊异泰坦=Amazing Titan
惊异青龙=Amazing Dragon
我回来了=Tadaima
战马博士=Ryoma bác sĩ
才……能=Tài…… Năng
才贺凉香=Saiga Ryoka
扫描充能=Scanning Charge
拳击金刚=Punching Kong
掘井正美=Tango Yūji
操真晴人=Sohma Haruto
攻击驾驭=Attack  Ride
攻击驾驭=Attack Ride
斯巴拉西=Subarashī
斯沃鲁次=Swartz
新牙血鬼=Neo Fangire
旋影剑的=Revolcane 
旋转光剑=Kōshi Ken Riborukien
无坚不破=vô kiên bất phá
无敌玩家=Hyper Muteki
无物不破=không có gì không phá
无限指环=Infinity Wizard Ring
日高仁志=Hidaka Hitoshi
时光魔神=Time Machine
时间停止=Time-Skip
时间充能=Time Charge
时间爆破=Time Break
时间的王=vua của thời gian
时间读取=Time Vent
时间长兵=Zikan DeSpear
时间魔神=Time Machine
星火燎原=Burning Falcon
暗杀弟弟=Ansatsu-chan
暗黑帝骑=Dark Decade
暴风战戟=Storm Halberd
最终形态=Final Form
最终读取=Final Vent
月弦太朗=Kisaragi Gentarō
有时劫者=có Time Jacker
朔田流星=Sakuta Ryūsei
本乡猛的=Hongō Takeshi
机械形态=Kikai Form
机械表盘=Kikai Watch
极致形态=Xtreme Form
极致驱动=Maximum Drive
极限形态=Xtreme Form
极限驱动=Maximum Drive
柳橙武装=Orange Arms
格拉菲特=Graphite 
桃塔罗斯=Momotaros
桐生战兔=Kiryu Sento
梦比优斯=Mebius
榴莲武装=Durian Arms
橘朔也的=Tachibana Sakuya 
檀!黎斗=Dan Kuroto
檀正宗的=Dan Masamune
檀氏集团=Dan Foundation
檀黎斗王=Dan Kuroto Oh
次元之扉=Dimensional Wall
欧尼…酱=Onii… chan
欲望使的=Greeed
歌星贤吾=Utahoshi Kengo
死亡野虎=Destwilder
比卡利亚=Vicarya
水流龍卷=Aqua Tornado
水系联组=Shauta Combo
永梦的话=Emu
泊进之介=Tomari Shinnosuke
泷川纱羽=Sawa Takigawa
泷川纱羽=Takigawa Sawa
泽渡樱子=Sawado Sakurako
津上翔一=Tsugami Shouichi
浅矢一广=Asahihiro
海堂直也=Kaidō Naoya
海棠直也=Kaido Naoya
深红电钻=Crimson Smash
温斯凯尔=Winskell
游戏之神=Gamedeus
游戏卡带=Game Gashat
满装瓶罐=Fullbottle
激情形态=Violent Emotion
激清形态=Violent Emotion Form
火焰军刀=Flame Saber
火焰魔龙=Flame Dragon
灰飞烟灭=hôi phi yên diệt
炽热钢铁=Heat Metal
烈焰军刀=Flame Saber
烈焰老虎=Flaming Tiger
燃烧形态=Burning Form
燃焰猛虎=Flaming Tiger
爆龙战队=Bakuryū Sentai
牙吠连者=Gaoranger
牡羊赛沙=Sazer Mithras
狗道供界=Kudō Kugai
狮堂未加=Shidō Mika
猩猩形态=GorillaMond Form
猩猩钻石=Gorilla Diamond
猫系联组=Latorartar Combo
猿渡一海=Kazumi Sawatari
獠牙肩刃=Shoulder Fang
玛贝拉斯=Marvelous
生化骑士=Bio Rider
生存无限=Survive Mugen
田所修一=Tadokoro Shuichi
田泽莉娜=Tentrina
电王列车=Den-Liner
疾风王牌=Cyclone Joker  
疾驰猎豹=Rushing Cheetah
百分十二=12%
的手里剑=Shuriken
盖尔修卡=Gel Shocker
真影壮一=Makage Soichi 
真木博士=Dr. Maki
真角大古=Madoka Daigo
眼枪军刀=Gan Gun Saber
石动惣一=Isurugi Soichi
石动美空=Isurugi Misora
破晓之翼=Dawn Wings
神代剑的=Kamishiro Tsurugi
神威形态=Divine Form
神崎士郎=Kanzaki Shiro
秋月信言=Nobuhiko Akizuki
稳坐泰山=ngồi vững Thái Sơn
究极升华=Rising Ultimate
突击握柄=Assault Grip
突击野狼=Assault Wolf
竹宫弓子=Takemiya Yumiko
粒子之刃=Particle Feather
红蜘蛛的=Red Spider
细胞硬币=Cell Medal
终极读取=Final Vent
终结时刻=Finish Time
绯红电钻=Crimson Smash
罐头机器=Candroids
罐头机械=Candroids
翼角暴龙=Pu-To-Tyrannosaurus$
至仁至善=Chí Nhân Chí Thiện
艾伯鲁特=Evolto
艾克赛德=Ex-Aid
草加雅人=Kusaka Masato
莱欧骑兵=Riotrooper
葛叶纮汰=Kazuraba Kouta
葛城巧了=Katsuragi Takumi
葛城忍的=Katsuragi Shinobu
藤慎太郎=Gotō Shintarō
虫系联组=Gatakiriba Combo
蜻蜓队长=Captain Tomborg
蝎狮魅影=Manticore Phantom
蟑螂恶霸=Cobrander
袁渡一海=Kazumi Sawatari
装甲时刻=Armor Time
西马妮可=Saiba Nico
贝露娜玖=Vernage
超级战队=Super Sentai
超越形态=Hyper Form
超越甲斗=Hyper Kabuto 
达斯马达=Dasmader
进化扳机=Evol-Trigger
进化龙瓶=Evol-Dragon Fullbottle
逢魔之力=Ohma Force
逢魔时王=Ohma Zi-O
邪恶矩阵=Oni Dōkutsu Matorikkusu
重力引擎=Core Driviars
野间航平=Noma Hankei
金兔银龙=Cross-Z Build
金属烙印=Metal Branding
金龟次郎=Kuwajīro
铁拳模式=Knuckle Mode
银河龙瓶=Cross-ZEvol Bottle
错觉读取=Trick Vent
镜中世界=Mirror World
长枪突刺=Yarisugi
长田结花=Osada Yuka
门矢士了=Kadoya Tsukasa
闪耀形态=Shining Form
闪耀突击=Shining Assault 
闪耀飞蝗=Shining Hopper
防御读取=Guard Vent
阴暗使了=Yummy
难波重工=Nanbajūkō
零一七年=2017
雷云之中=trong lôi vân
雾岛美穗=Kirishima Miho
音速弓弩=Sonic Arrow
音速弓箭=Sonic Arrow
须藤雾彦=Sudō Kirihiko
风城美羽=Kazashiro Miu
风暴战戟=Storm Halberd
风谷真鱼=Kazaya Mana
飞电智能=Hiden Intelligent
飞翔猎鹰=Flying Falcon
飞鹰獠牙=Falcon Fang
飞龙杰克=Dragon Jackun
香蕉武装=Banana Arms
马渕由衣=Mabuchi Yui
驰骑装甲=Drive Armor  
驾驭卡牌=Ride Card
驾驭表头=Rider Watch
骑士卡牌=Rider Card
骑士射击=Rider Shooting
骑士手环=Rider Brace
骑士斩击=Rider Slash
骑士时表=Rider Watch
骑士系统=Rider System
骑士踢的=Rider Kick
骑士铠甲=Rider Armor
骑士飞踢=Rider Kick
骰子军刀=Dice Saber
高跃飞蝗=Rising Hopper
魔法枪剑=WizarSwordGun
魔皇形态=Emperor Form
鸟掺杂体=Bird Dopant
鸟记忆体=Bird Memory
鸣海庄吉=Narumi Sokichi
鸿上光生=Kōgami Kōsei
黄金果实=Forbidden Fruit
黎明小镇=Dawn Town
黎明小镇=Deibureikutaun
黏土人偶=Clay Doll
黏土玩偶=Claydoll
黑崎怜志=Kurosaki Reishi
黑暗帝骑=Dark Decade
黑暗甲斗=Dark Kabuto  
黑暗甲虫=Dark Kabuto Zecter
黑暗骑士=Dark Rider
黑洞扳机=Evol-Trigger
齿轮兄弟=Engine Bros
龙召唤机=Dragvisor 
龙深红者=Dragreder
2009年=năm 2009
三角追踪者= TRCS-2000
中田吉米的=Jimmy Nakata
二一二一年=2121
二零一七年=2017
井坂深红郎=Isaka Shinkurō
以极光帷幕=lấy Aurora Curtain
假野明日那=Karino Asuna
假面骑士剑=Kamen Rider Blade
假面骑士迅=Kamen Rider Jin
假面骑士铠=Kamen Rider Gai
光子破坏炮=Photon Buster
光子破碎剑=Photon·Breaker
光子血液的=Photon Blood
公文包大刀=Attache Calibur
公文箱王剑=Attache Calibur
冰室泰山的=Himuro Taizan
凤凰形态了=Phoenix Form
剑刃公文包=Attache Caliber
加古川飞流=Kakogawa Hiryuu
北都三羽鸦=Hokuto Sanbagarasu
千世子小姐=Chiyoko-san
千位驱动器=Thousand Driver
升华究极踢=Rising Ultimate Kick
双重破坏者=Twin Breaker
变身烟雾枪=TranSteam Gun
和平星之神=God Star Piece
喷雾变身器=TranSteam Gun
圣徽暴咬龙=Medagabryu
地之帝王的=Orga  
城乃内秀保=Jonouchi Hideyasu
城堡德兰龙=Castle Doran 
基因灭绝者=Genocider
复活者暴风=Revive Shippu
多治见喜子=Tajimi Yoshiko
大杉忠太老=Tadashi Osugi
天之川高校=Amanogawa High School 
天之帝王的=Psyga
天才能量瓶=Genius Fullbottle
奇虾掺杂体=Anomalocaris Dopant
如月弦太朗=Kisaragi Gentarō
嬉笑梦乐园=Laughing Dream Paradise
宇宙编年史=Space Chronicle
安达明日梦=Asumu Adachi
完美昆虫剑=Perfect Zecter
射击升华器=A.I.M.S. ShotRiser
小泽百合子=Ozawa Yuriko
山森美智子=Yamamori Michiko
岩浆龙形态=Magma Dragon Form
岩浆龙拳套=Magma Knuckle
崩源病毒体=Bugster Virus
常磐顺一郎=Tokiwa Junichiro
幸运四叶草=Lucky Clover
幻影激光剑=Kōshi Ken Riborukien
异类极限W=Another Xtreme W
弥诺陶诺斯=Minotaur
强力升级器=Force Riser 
恐惧掺杂体=Terror Dopant
惊异全能踢=Amazing Mighty Kick
战极驱动器=Sengoku Driver
扳机掺杂体=Trigger Dopant
掘口一郎的=Horiguchi Ichirō
斯沃鲁兹君=Swartz-kun
无双深红龙=Dragreder 
无敌的玩家=Hyper Muteki
时光魔神机=Time Mazine
时空管理局=Quarzter
时空驱动器=Ziku-Driver
时间管理局=Quarzter
明光园盖茨=Myōkōin Geiz
明光院盖茨=Myoukouin Geiz
明光院盖茨=Myōkōin Geiz
昨日记忆体=Yesterday Memory
月神掺杂体=Luna Dopant
朝九晚五堂=9 5 DO
机械创造者=Machine Builder
机械变异体=Roidmude
极限记忆体=Xtreme Memory
果冻龙形态=Cross-Z Charge Form
梅嘉赫克斯=Megahax
檀黎斗神王=Dan Kuroto Shin-oh
欲望的天秤=Libra of Desire
武器掺杂体=Arms Dopant
永恒记忆体=Eternal Memory
消失的天堂=Paradise Lost
潘多拉之盒=Pandora Box
潘多拉石板=Pandora Box
激突机器人=GektotsuRobots
火炎十字斩=Kaen Jujizan
火焰凤凰拳=Flame Phoenix Punch
灭绝升华器=ZetsumeRiser
熔岩记忆体=Magma Memory
片平真纪子=Katahira Makiko
狂暴加特林=Rampage Gatling
独角仙甲虫=Kabuto Zecter
王Sama=Ō-sama
玩家驱动器=Gamer Driver
疾风记忆体=Cyclone Memory
白色魔法师=White Wizard
的死神博士=Doctor Death
的毒岛冴子=Busujima Saeko
禁忌掺杂体=Taboo Dopant
程式升华匙=Progrisekey
究极之暗的=Ultimate Darkness
空间掺杂体=Zone Dopant
突袭升级器=RaidRiser
绝灭升华匙=Zetsumerisekey
绝灭升华器=ZetsumeRiser
罐头机器人=Candroids
羽翼长矛者=Wing Lancer
蒸汽喷雾枪=Steam Gun
虚拟掺杂体=Dummy Dopant
蜘蛛满装瓶=Spider Fullbottle
行李箱模式=Trunkbox 
财前美智彦=Zaimae Michihiko
超级鹰虎蝗=Super Tatoba
超越昆虫仪=Hyper Zecter
超越驱动器=Beyond Driver
进化驱动器=Evol Driver
迷失能量瓶=Lost-Bottle
迷失驱动器=Lost Driver
透明记忆体=Invisible Memory
里中绘里香=Satonaka Erika
重量系联组=Sagohzo Combo
野座间友子=Nozama Tomoko
金属掺杂体=Metal Dopant
金属簇飞蝗=Metal Cluster Hopper
金钱掺杂体=Money Dopant
金钱记忆体=Money Memory
银河龙形态=Cross Z Evol Form
锤形破坏者=Gashacon Breaker
闪电哥莱姆=Lightning Gōram
闪耀究极踢=Shining Ultimate Kick
音奏终结者=Beat Closer
驾驭卡盒剑=Ride Booker
驾驭卡盒枪=Ride Booker Gun
高见泽逸郎=Takamizawa Itsurō
魔法师剑枪=Wizar Sword Gun
鸿上基金会=Kōgami Foundation
黄金不死鸟=Goldphoenix
黄金的骑士=Golden Rider
黑暗独角仙=Dark Kabuto Zecter
黑色闪电号=Black Lightning
龙挤压啫喱=Dragon Sclashjellies
龙骑士猎人=Dragon Knight Hunter
555 爆裂=555 Blaster
井板深红郎的=Isaka Shinkurō
假面骑士一号=Kamen Rider Ichigo
假面骑士二号=Kamen Rider Nigo
假面骑士剑蝎=Kamen Rider Sasword
假面骑士昨日=Kamen Rider Yesterday
假面骑士毒蝎=Kamen Rider Scorpion
假面骑士流星=Kamen Rider Meteor
假面骑士白鸟=Kamen Rider Femme
假面骑士铠武=Kamen Rider Gaim
假面骑士银河=Kamen Rider Ginga
八乙女纱衣子=Yaotome Saiko
冰河期记忆体=IceAge Memory
剑的骑士卡片=Blade Rider card
剑齿虎掺杂体=Smilodon Dopant
升华天马形态=Rising Pegasus Form
升华究极形态=Rising Ultimate Form
危险启动装置=Hazard Trigger
变成细胞硬币=biến thành Cell Medal
天才满装瓶罐=Genius Fullbottle
宇宙刑事加班=Uchuu Keiji Gavan
异类骑士手表=Another Rider Watch
忍者漫画形态=NinninComic Form
您的骑士表盘=ngài Rider Watch
户田山登巳蔵=Todayama Tomizo
扫描时间爆破=Scaning Time Burst
拳击金刚形态=Punching Kong Form
操偶师记忆体=Puppeteer Memory
斩月 · 真=Zangetsu Shin
昨日极致驱动=Yesterday Maximum Drive
普罗斯派克特= Prospect
普罗派克斯特=Prospect
暴击时间粉碎=Strike Time Break
最终假面驾驭=Final Kamen Ride
最终形态驾驭=Final·Form Ride
月神金属形态=Luna Metal Form
朔田……流星=Sakuta…… Ryūsei
权杖的驱动器=Leangle Driver
棱镜极致驱动=Prism Maximum Drive
满装瓶破坏者=Fullbottle Buster
满装能量瓶罐=Fullbottle
灭亡迅雷站的=MetsubouJinrai.net
爆裂最终形态=Blaster Final Form
疾风极致驱动=Cyclone Maximum Drive
疾风王牌形态=Cyclone Joker Form
疾驰猎豹形态=Rushing Cheetah Form
神极限的卡带=God Maximum Gashat
程式升华密钥=Progrisekey
终极攻击驾驭=Final Attack Ride
终极武装时刻=Final Form Time
绝灭升华密钥=Zetsumerisekey
腹肌撕裂太郎=Fukkinhoukai Taro
蜘蛛满装瓶罐=Spider Fullbottle
谎言者掺杂体=Liar Dopant
超级核心硬币=Super Core Medal
闪耀蝗虫形态=Shining Hopper Form
飞鹰加特林枪=HawkGatlinger
飞鹰加特林者=HawkGatlinger
飞鹰满装瓶罐=Taka  Fullbottle
飞龙杰克形态=Dragon Jackun Form
高跃蝗虫形态=Rising Hopper Form
黄金苹果锁种=Golden Fruit Lock Seed
大......=Taiga
大猩猩钻石形态=Gorilla Diamond Form
强制绝灭升华器=MetsubouJinrai Forceriser
挤压机器人形态=Grease Form
无双龙龙深红者=Dragreder
暗黑龙龙漆黑者=Dragblacker
极限时间粉碎）=Limit Time Break
火龙果能量锁种=Dragon Fruit Energy Lock Seed
烈车战队特急者=Ressha Sentai ToQger
狂暴加特林形态=Rampage Vulcan Form
空......=Kuuga
能量定锁种子的=Energy Lock Seed
超级鹰虎蝗联组=Super Tatoba Combo
郁金香定锁载具=Tulip Hopper Lock Vehicle
魔王侦探事务所=văn phòng trinh thám Maō
黑暗独角仙甲虫=Dark Kabuto Zecter 
龙......=Ryuga
Ex-Aid装甲=Ex-aid Armor
升级密匙null=Progrisekeys
圣都大学附属医院=Bệnh viện Đại Học Seito
异类Ex-Aid=Another Ex-aid
普罗斯派克特博士=Doctor Prospect
空......的=Kuuga
超越 · 超高速=Hyper Clock Up
超越獠牙极致驱动=Fang-Xtreme Maximum Drive
万丈龙......=Banjou Ryuga
勇气飞龙奇幻驾驭书=Wonder Ride Book
火绳大橙 DJ 枪=Hinawadaidai-DJ-Ju
花家大......=Hanaya Taiga
跟失了智的野兽一样=giống như một con dã thú mất đi lý trí
金兔银龙的创越形态=Cross-Z  Build Form
齐鲁巴斯 · 蜘蛛=Killbus Spider
......源之男的=Hajimari no Otoko
Zodiarts开关=Zodiarts Switch
万丈龙......的=Banjou Ryuga
宝生永梦......=Houjou Emu tới