南=Minami
响=Hibiki
士=Tsukasa
爱=Ai
紬=Tsumugi
花=Hana
蕾=Tsubomi
遥=Haruka
·列=· Re
·基=· Gi
·巴=· Ba
·蝶=· De
“恩=“N
一海=Kazumi
一直=một mực
一花=Ichika
七森=Nanamori
七濑=Nanase
万代=Bandai
三岛=Mishima
三玖=Miku
上城=Kamijō 
东西=đồ vật
东都=Touto 
个兹=cái Zu
中森=Nakamori
临多=Rinto 
主水=Mondo 
丽奈=Rena
乃木=Nogi 
么西=moshi 
义彦=Yoshihiko
乌尔=Heure 
乾,=Inui,
乾.=Inui.
乾巧=Inui Takumi
乾桑=Inui-san
二乃=Nino
五代=Yusuke
五岛=Gotō
五月=Itsuki 
井坂=Isaka
井手=Mitsuhiro
亚修=Ash
亚兹=Azu
亚子=Ako
亚纪=Aki
亮二=Ryoji
人类=nhân loại
仁志=Hitoshi
仁藤=Nitoh 
从者=Servant
令和=Reiwa
伊拉=Ira
优衣=Yui
伸幸=Nobuyuki 
佐山=Sayama 
佐藤=Satōu 
佑子=Yūko
侑斗=Yuto
信吾=Shingo
修罗=Shura
傲娇=tsundere
傻橙=ngốc cam (Kazuraba)
光实=Mitsuzane
光金=Golden 
克彦=Katsuhiko
六花=Rikka
其雄=Soreo
内海=Utsumi
冠位=Grand
冬木=Fuyuki
冰室=Himuro
冰川=Hikawa
凉香=Ryoka
凛的=Rin
凯撒=Kaixa
凰莲=Oren 
创骑=Build
初濑=Hase
前川=Maekawa
剑吾=Kengo
剑士=kiếm sĩ
剑玉=Kendama
剑蝎=Sasword
加辰=Kasshine
勇治=Yuji
北崎=Kitazaki
北斗=Hokuto
北琦=Kitazaki
北都=Hokuto
千骑=Thouser
卌骑=Fourze
华夏=Trung Quốc
南雅=Nanya
卡勒=Caller
卫宫=Emiya
双骑=W
可爱=đáng yêu
可隆=Cologne
叶奈=Hana
吉格=Giger
启介=Keisuke 
吴岛=Kureshima
呀勒=yare
味增=miso
咪碳=Mii-tan
哈桑=Hassan
响指=búng tay
响鬼=Hibiki
哲也=Tetsuya
喀戎=Chiron
喜子=Yoshiko
嘎次=Guts
噶次=Guts
四叶=Yotsuba
四郎=Shirou
园咲=Sonozaki
圆谷=Tsuburaya
圣刃=Saber
圣辉=Sacred 
地之=địa chi
坂上=Sakagami
坦克=Tank
型月=Type-Moon
城户=Kido
基因=Gene
基德=Kid
士,=Tsukasa,
士桑=Tsukasa-san
士郎=Shirou
声音=âm thanh
夏海=Natsumi
夏特=Shut
夏龙=Haron
大二=Daiji 
大介= Daisuke
大和=Yamato
大森=Omori
大河=Taiga
大贝=Oogai
大雄=Nobita
天津=Amatsu 
天道=Tendo
天音= Amane 
太牙= Taiga 
太郎=Tarōu
奥丁=Odin
奥特=Ultra
女士=nữ sĩ
妖翠=Verde
妮可=Nico
娅秀=Aishu
安达=Adachi 
宝生=Houjou
密钥=mật thược
小唯=Yui
小夜=Sayo
小川=Ogawa
小幸=tiểu Sachi
小明=Tsukasa
小樱=Sakura
小泽=Ozawa 
小煦=Hiyori
小稔=Midori
小言=Gon
小鸟=Kotori
山吹=Yamabuki
岬姐=Misaki tỷ
崩源=Bugster
巧爷=Takumi
巴丹=Badan
巴夏=Basshaa 
希德=Sid
常磐=Tokiwa
幸子=Sachiko
幸实=Yukimi 
广见=Hiromi
庄吾=Sougo
库噜=~kuru
库撒=Kutha
庞墩=Pandon
异虫=Worm
弥生=Yayoi
强鬼=Kyoki
强魔=Goma
彩夏=Ayaka
影山=Kageyama
影月=Shadow Moon
彼方=Kanata
御堂=Midō
德加=Dogga
志叶=Shiba
快子=hạt tachyon
怜治=Reiji 
总司=Sōji
恩·=N ·
恩奇=Enkidu
悠子=Yuko
悠悠=Yunyun
惊异=Amazing
惣一=Sōichi
成彰=Nariaki
戒斗=Kaito
战兔=Sento
战士=chiến sĩ
战队=Sentai
手冢=Tezuka 
才能=tài năng
才贺=Saiga 
扎基=Zagi
托马=Touma
拉·=Ra ·
拳蝗=Punch Hopper
捷德=Geed
提德=Tid 
操真=Souma
文音=Fumie
斗真=Touma
斩月=Zangetsu
无惨=Muzan
无月=Mutsuki
日高=Hidaka 
旦那=Danna
时停=thời gian đình chỉ
时贞=Tokisada
星司=Seiji 
春丽=Chun-Li
春春=HaruHaru
昭和=Showa
昭和=Shōwa
最上=Mogami 
月读=Tsukuyomi
有栖=Alice
木大=Muda
杉田=Sugita
李飞=Lý Phi
村上=Murakami
杜维=Devi
来海=Kurumi
杰顿=Zetton
松仓=Matsukura
林枫=Rinho 
树花=Juka
根岸=Negishi
桃园=Momozono
桃子=Momoko
桐乃=Kirino 
桐矢=Kiriya 
梅林=Merlin
梨沙=Risa
榎田=Enokida
樱子=Sakurako
樱花=Sakura
欧拉=Euler
正人=Masato
正弘= Masahiro
正邦=Masakuni
武田=Takeda
死徒=Dead Apostles
比婪=Biran
水岛=Kitajima 
永梦=Emu
沃兹=Woz
沙羽=Sawa
泡芙=Pafu
泰伽=Taiga
泰山=Taizan 
泷川=Takigawa
泽木=Sawaki 
泽田=Sawada
泽芽=Zawame
洛林=Lorraine
津村=Tsumura
流苏=Tassel
浅仓=Asakura
海东=Kaito
海之=Miyuki
海帕=Hyper
涉谷=Shibuya
添野=Sono
渊骑=Abyss
滋·=Zu ·
火花=hỏa hoa
火野=Hino
熏子=Kaoruko
爱姆=Ahim
爱莲=Ellen
爱酱=Ai-chan
牙王=Gaoh
特摄=Tokusatsu
狂霸=Mad Rogue
狩奇=Karizaki
猿渡=Sawatari
王剑=Vương Kiếm
王蛇=Ouja 
玛娜=Mana
玲奈=Rena
琦玉=Saitama
瓦兹=Wazu 
瓶子=Bottle
田口=Taguchi
甲斗=Kabuto
电王=Den-O
病毒=Virus
白亚=Rosyuo 
百特=Bat
盖茨=Geiz
直到=thẳng đến
直是=quả thực là
直球=bóng thẳng
直视=nhìn thẳng
直面=đối mặt
相良=Sagara 
真司=Shinji
真琴=Makoto
真由=Mayu
真锅=Manabe
睦月=Mutsuki
矢车=Yaguruma
石动=Isurugi 
石動=Isurugi
石田=Ishida
神威=Kamui
神山=Kamiyama
神崎=Kanzaki
福添=Fukuzoe 
秀一=Shuichi
秀保=Hideyasu
秀成=Hidenari 
秋月=Akitsuki
究极=Ultimate
空我=Kuuga
笹山=Sasayama
简直=quả thực
红渡=Kurenai Wataru
红羽=Akaba
纮汰=Kouta 
纱绫=Saaya
纱羽=Sawa
织原=Orihara
统汰=Kouta 
绫川=Ayakawa
绮罗=Kirara
绿川=Midorikawa
罗玛=Roma
美幸=Miyuki
美江=Mie
美真=Mima
美穗=Miho
美空=Misora
羚皇=Imperer
翔一=Shouichi
育代=Ikuyo
胜哄=Kachidoki 
舞姐=Mai-nee
艾斯=Ace
芙芙=Fou
芬恩=Fionn
花家=Hanaya 
花瓣=cánh hoa
花蕾=nụ hoa
苍乃=Aono
若林=Wakabayashi 
苦无=kunai
草加=Kusaka
草茄=Kusaka
莫西=moshi
莱特=Wright
菊池=Kikuchi
葛·=Go ·
葛城=Katsuragi
葛的=Go
蓝羽=Aoba
蕾蒂=Laeti
藤村=Fujimura
蚁兵=Trooper
蛮野=Banno 
血族=Blood tộc
血橙=Blood Daidaimaru 
表头=Watch
西内=Shinee
西都=Saito
言峰=Tokiomi
诚司=Seiji
调边=Shirabe
贝鲁=Bel
贞德=Jeanne dArc
贤刚=Kengo
败北=bại trận
贵虎=Takatora 
赛罗=Zero
越前=Echizen
踢蝗=Kick Hopper
辰路=Tatsuji
达比=Dabyi
达比=Darby
达达=Dada
远坂=Tohsaka
远藤=Endo
逢魔=Ohma
那坦=Natarn
醒剑=Blay Rouzer
里昂=Lyon
野乃=Nono
金棒=Kim Bổng
铁兵=Zolda
铜斗=Ketaros 
银三=Ginzo
银斗=Hercus
锅岛=Nabeshima
长野=Nagano
门田=Kadota 
门矢=Kadoya
问骑=Quiz
间宫=Mamiya
间桐=Matou
阵羽=Jimber 
阿守=Mamoru 
阿登=Ardennes
难波=Namba
雅人=Masato
雪菜=Yukina
零一=Zero-One
雷德=Red 
雷霆=Lôi Đình
雾岛=Kirishima
霓虹=Nhật Bản
露卡=Luka
青叶=Aoba
青龙=Dragon
音也= Otoya
须藤=Sudō
风谷=Kazaya 
风都=Futo
飞彩= Hiiro
飞流=Hiryu
香川=Kagawa
香恋=Karen
香澄=Kasumi
香菜=Kana
马农=Manon
马口=Mako
驱纹=Kumon 
骏河=Suruga
高坂=Kosaka
高斯=Cosmos
魁利=Kairi
魁星=Kaisei
魅影=Phantom
魔机=Magia
鲭鱼=cá thu
鳄霸=Night Rogue 
鸣泷=Narutaki
鸣海=Narumi
鹫尾=Washio
黄濑=Kise
黄羽= Kiba 
黎斗=Kuruto
黑日=Black Sun
黑牙=Black Fang
黑翼=Darkwing
齐格=Sieg
龙仁=Ryuujin
龙我=Ryuga
龙牙=Ryuga
龙玄=Ryugen
龙锁=KeyDragon 
龙骑=Ryuki
E 总=Evol 
一个恩=một cái N
一个葛=một cái Go
一条:=Ichijo:
一条也=Ichijo cũng
一条桑=Ichijo-san
一条熏=Kaoru Ichijo
一条薰=Ichijo Kaoru
一条读=Ichijo đọc
七濑唯=Nanase Yui
三叶虫=Trilobite
三枪手=Three Musketeers
三色堇=Sumireko 
不死者=Undead
不死鸟=Phoenix  
不破桑=Fuwa-san
不破谏=Fuwa Isamu
与多垣=Yotogaki 
东大妈=Toei bác gái
两个魅=hai cái Me
乌托邦=Utopia
九条光=Kujou Hikari
九郎岳=Kurogatake
亚久里=Aguri
亚古鲁=Arcle 
亚极陀=Agito
亚极陀=AgitΩ
亚瑟王=King Arthur
亡命众=Deadman
从小夜=từ Sayo
伊藤诚=Itou Makoto
伦太郎=Rintaro
伽多拉=Gadora
伽美戈=Gamego
伽雅泽=Jaaza
佐惠子=Saeko
修罗场=Shuraba
做的面=làm mì
僵格拉=Gangler
光之丘=Pikarigaoka
光夏海=Hikari Natsumi
克鲁德=Crude
兔形态=Rabbit Form
全能踢=Mighty Kick
八代蓝=Yashiro Ai
兰斯酱=Lance-chan 
兹集团=Zu tập đoàn
兽王猩=Zyuoh Gorilla
兽王鹰=Zyuoh Eagle
兽连者=Zyuranger
凑耀子=Minato Yoko
凯瑟利=Kesselley
刃小姐=Yaiba tiểu thư
切扑克=cắt bài poker
刚大木=Gundam
创世王=Century Kings
创世纪=Genesis
剑天使=Cure Sword
加利玛=Garima
加头顺=Kazu Jun
加艾鲁=Gaeru
加迪亚=Gadia
加迪森=Gatezone
勃垦地=Bourgogne
北条透=Hōjō Tōru 
十五秒=mười lăm giây
千界树=Yggdmillennia
升华器=Riser
升华踢=Rising Kick
南瓜头=bí đỏ đầu
南雅彦=Shogo Higashi 
卡利斯=Chalice
反正人=ngược lại người
古力咚=Gridon 
古朗基=Gurongi
合气道=Aikido
同为魅=đều là Me
和一条=cùng Ichijo
哥莱姆=Gouram
哦罗列=Onore
喷射人=Jetman
嘎嘎米=Kagami
土下座=dogeza
圭一郎=Keiichiro
坏恶兽=Saiarks
坦克瓶=Tank Bottle
基基鲁=Gegeru
基拉斯= Giras
堂安保= Douan  Tamotsu 
复活者=Revive 
夏慕尔=Shamour
夏木玲=Natsuki Rin
夏蜜柑=Natsumikan
夏露露=Carla
夏露露=Sharuru
夏龙桑=Haron-san
多尔多=Dordo
多得隆=Doctor
多见治=Tajimi
多雷米=Doremi
大修卡=Dai-Shocker
大兽神=Daizyurin
大橙丸=Daidaimaru
大秦寺=Daishinji
天之川=Tennogawa 
天十郎=Tenjūrō
天才瓶=Genius  Bottle
天津四=Deneb
天津垓=Amatsu Gai
天马弩=Pegasus Bowgun
奇幻书=Wonder  Book 
契约兽=Contract Monster
奥尔加=Olga
奥杜因=Alduin
姬娜佳=Ginoga
婕斯塔=Shesta 
子母像=Tử Mẫu tượng
孙悟空=Son Goku
宇佐美=Usami
安东拉=Antlar
对天道=đối Tendo
射击体=Shooting Form
小花招=tiểu hoa chiêu
小野寺=Onodera
尤次郎=Yujiro 
尼比鲁=Nibiru
尾上亮=Ryo Ogami
岩浆龙=Dragon Magma 
岬佑月=Misaki Yuzuki
崩源体=Bugster
巴修姆=Bašmu
巴尔坦=Baltan 
巴贝鲁=Baberu
布拉朵=Brado
希芙蕾=Chypre
帕拉德=Parado
帕鲁格=Palug
帝蒙斯=Demons
幻想乡=Gensokyo
异域者=Inves
异魔神=Imagin
异魔神=Imajin
弗里欧=Furio 
弦太郎=Gentarō
影山瞬=Kageyama Shun
德拉斯=Banderas
忍者瓶=Ninjya Bottle
总一天=cuối cùng sẽ có ngày
恩奇都=Enkidu
惠美瑠=Emiru
惠美馏=Emiru
感恩魂=Grateful Damashii
戈尔贡=Gorgon
手里剑=shuriken
扑克牌=bài poker
找平行=tìm Bình Hành
抓根宝=Dragonborn
抹布希=Mabushii
拉比斯=Lapis
拉结尔=Raquel
拉赫姆=Lahmu
拉集团=Go tập đoàn
指风间=chỉ Kazama
掺杂体=Dopant
斯塔克=Stark
新谷圭=Shinya Kei
无限魂=Mugen Damashii 
日下部=Kusakabe
日向咲=Hyuuga Saki
日野茜=Akane Hino
时劫者=Time Jacker
时管局=Quartzer
明光院=Myoukouin
明日梦=Asumu
春野遥=Haruno Haruka
是之助=Korenosuke
木野熏=Kino Kaoru
杉田守=Sugita Mamoru
村雨良=Ryo Murasame
果冻龙=Dragon Sclashjelly 
柊身上=Shu trên người
查理加=Charija
柯尔特=Colt
桃~子=Momo ~ ko
梅特龙=Metron
梦原望=Yumehara Nozomi
椿先生=Tsubaki tiên sinh
楚子航=Chu Zihang
樱前线=Cherry blossom front
橘朔也=Tachibana Sakuya
檀正宗=Dan Masamune
次元壁=Dimension Wall
欧尼科=Onycho 
每一条=mỗi một điều
水岛宏=Mizushima Hiro
水无月=Minazuki
沙奈子=Shanako
泉正宗=Masamune Izumi
波普莉=Potpourri
波罗斯=Boros
泰坦瓶=Titan Bottle
浮士德=Faust
海之石=Stone of Ocean
海帕踢=Hyper Kick
海德拉=Hydra
海藤南=Kaido Minami
深红郎= Shinkurō
满装瓶=Fullbottle
满装罐=Fullbottle
激情态=Violent Emotion 
灵神心=Linh Thần Tâm
烟雾剑=Steam Blade
照井龙=Terui Ryu 
爱乃惠=Aino Megumi
牙血鬼=Fangire
牛顿魂=Newton Damashii
特摄剧=Tokusatsu
特里休=Trish 
独角仙=bọ hung sừng chữ Y
猛击者=Smash
王哈桑=King Hassan
王律键=Kings Law To Enshrine
玛尔达=Martha
琉兵卫=Ryūbē
瓶挤压=Sclashjellies 
生命人=Liveman
电击体=Shocker Form
登太牙=Nobori Taiga 
百慕拉=Bemular
百虫剑=Perfect Zecter
的假面=gương mặt giả
的真司=Shinji
皮耶罗=Pierrot
直白了=trực bạch
相川始=Aikawa Hajime 
相田爱=Aida Mana
看天道=xem Tendo
真剑者=Shinkenger
真理奈=Marina
真由美=Mayumi 
眼镜蛇=Cobra
矢车想=Yaguruma Sou 
石中剑=Caliburn
礼堂光=Raidō Hikaru
神极限=God Maximum 
秋山莲=Akiyama Ren
科特队=SSSP
穆罗洛=Murolo
究极踢=Ultimate Kick
穿越龙=Cross-Z Dragon
章鱼瓶=Octopus Bottle
红正夫=Kurenai Masao
纳斯卡=Nasca
终结怪=Oshimaida
绘梨衣=Erii
绘里香=Erika
绯道莲=Ren Akamichi
绿翡翠=lục phỉ thuý
美奈子= Minako
美翔舞=Mishou Mai
翔太郎=Shotarou
老滚五=The Elder Scrolls V
聊天群=Chat Group
自私怪=Jikochuu (ích kỷ quái)
艾卡尔=Ekal
艾姆斯=A.I.M.S
芭璐芭=Baruba
花不了=không hao phí
花多久=tốn bao lâu
苇原凉=Ashihara Ryō
苏美尔=Sumer
苦无斧=Kunai Gun
苦无枪=Kunaigun
药师寺=Yakushiji
莱诺尔=Lainur
菲尼斯=Finis
葛叶晶=Kazuraba Akira
葛城忍=Katsuragi Shinobu
葛成巧=Takumi Katsuragi 
蒂蒙斯=Demons
蓬巴杜=Pompadour
虎太郎=Kotaro
蛇尾剑=Venosaber 
蛹形态=Masked Form
蝙蝠瓶=Bat Bottle
血月表=Dracula Watch
被里克=bị Riku
见泷原=Mitakihara
诗岛刚=Shijima Go 
诸星弹=Moroboshi Dan
诺德人=Nord
豪快王=GokaiOh
贝利亚=Belial
贝集团=Be tập đoàn
赛克斯=Psykos
超一号=Super1
超变身=super hensin
路明非=Ricardo·M·Lu
辉木誉=Kagayaki Homare
达尼克=Darnic
过天马=qua Pegasus
进化瓶=Evol-Bottle
迦尔纳=Karna
迷失瓶=Lost Bottle
遥远的=xa xôi
那天道=kia Tendō
邪念能=tà niệm năng
重三郎=Jūzaburō
重醒剑=King Rouzer
野乃花=Nono Hana
金苹果= Golden Fruit
银河龙=Cross-Z Evol
镜怪物=Mirror Monster
长谷川=Hasegawa
门矢士=Kadoya Tsukasa
间桐樱=Matou Sakura
阿库娅=Aqua
阿方索= Alfonzo
阿罗玛=Aroma
阿达多=Adad
雅美罗=yamero
零诺斯=Zeronos
雷米娅=Remia
霸凯撒=Bikaiser 
青龙溅= Splash Dragon
音奏剑=Beat Closer
顺一郎=Junichiro
香里奈=Karina
马格马=Magma
驱动器=Driver
骑士人=Riderman
骨傲天=Overlord
高司舞=Takatsukasa Mai
魅集团=Me tập đoàn
魔偶机=Maiga
魔化魍=Makamou
魔机偶=Magia
魔皇剑=Zanvat Sword
鲁西尔=Rugir 
鲁邦红=Lupin Red
鳄鱼瓶=Crocodile Crack Bottle
鹫尾风=Washio Fū
麦金利=McKinley
黄泉丸=Yomimaru
黑沃兹=Kuro Woz 
黑洞踢=Black Hole Kick
鼓屋勉=Tsuzumiya Tsutomu
龙先生=Haron tiên sinh
龙军刀=Dragsaber
龙召机=Dragvisor
龙召机=Dragvisor 
龙果冻=Dragon Sclashjelly 
龙瓶子=Dragon Bottle
一拳超人=One punch man
一条亲自=Ichijo tự mình
一条先生=Ichijo tiên sinh
一条比较=Ichijo tương đối
一条激动=Ichijo kích động
一条脸色=Ichijo sắc mặt
三只小猪=Kobuta 3 Kyoudai 
下级基夫=Giff Junior
不声不响=vô thanh vô tức
世间真理=chân lý thế gian
丢人雷蜓=Drake
中野一花=Nakano Ichika
乌龟手表=TurtleWatch 
九郎岳山=núi Kurogatake
五十岚樱=Igarashi Sakura
伟大之眼=Great Eyezer
佛劳洛斯=Flauros
假面驾驭=Kamen Ride
假面骑士=Kamen Rider
光子血管=Photon Stream
光照相馆=Hikari Studio
光荣次郎=Hikari Eijiro
兔兔坦坦=FullFull RabbitTank
全能形态=Mighty Form
八分光轮=Dismembering Halo
公主天使=Cure Princess
六导玲霞=Rikudō Reika
冠位指定=Grand Order
冻结降临=Freeze Vent
凯撒系统=Kaiser System
分身降临=Trick Vent 
刚烈形态=Goretsu Form
剑崎一真=Kenzaki Kazuma
加贺美新=Kagami Arata
加速降临=Accel Vent 
动作玩家=Action Gamer 
勇气之龙=Brave Dragon 
北暴雪瓶=North Blizzard Bottle
升华全能=Rising Mighty
升华形态=Rising Form
升华空我=Rising Kuuga
升华黑洞=Rising Black Hole
卑弥呼魂=Himiko Damashii
危险僵尸=Dangerous Zombies
危险形态=Hazard Form
危险空我=Hazard Kuuga
双子玩家=Double Gamer 
取消降临=Confine Vent
叫门矢士=kêu Kadoya Tsukasa
叹息之墙=Nageki no Kabe
和城乃内=cùng Jonouchi 
圆亚久里=Madoka Aguri
圣斧形态=Ax Form 
圣枪形态=Gun Form 
圣竿形态=Rod Form 
圣辉终结=Sacred Finish 
坦克瓶子=Tank Bottle
埃尔梅罗=El-Melloi
城户真司=Kido Shinji
增子美代=Masuko Miyo
大地形态=Ground Form
大森悠子=Omori Yuko
大浦龙宇=Ohura Ryuichi
大王乌贼=Daiouika 
大部分葛=đại bộ phận Go
天元突破=Tengen Toppa Gurren Lagann
天才形态=Genius Form
天才瓶子=Genius  Bottle
天空之壁=Sky Wall
天空寺尊=Tenkūji Takeru
天空飞马=Tenkuu no Pegasus
天草四郎=Amakusa Shirō
天道总司=Tendou Souji 
天道树花=Tendō Juka
天魔失坠=Felling of the Sky Demon
契约降临=Advent 
奥菲以诺=Orphnoch
宇宙形态=Cosmicstates
定锁种子=Lock Seed
小恩小惠=ân huệ nhỏ
尖刺刺猬=Needle Hedgehog 
就是真理=chính là chân lý
岩浆拳套=Magma Knuckle
左翔太郎=Hidari Shotaro  
巨人之剑=Titan chi kiếm
巴拉克斯=Barlckxs 
巴鲁姆克=Balmung
布莱克王=Black King
帝王形态=King Form
平成骑士=Heisei Rider
幸福澡堂=Happy Spa
幻影女王=Mirage Queen
幻影女皇=Queen Mirage
幻影帝国=Phantom Empire
幻想大剑=Phantasmal Greatsword
幻梦集团=Genm Corp
异类帝骑=Another Decade
异类时王=Another  ZI-O 
异类问骑=Another Quiz 
异类龙牙=Another Ryuga 
异类龙骑=Another Ryuki
强袭降临=Strike Vent
形态驾驭=Form Ride 
德兰城堡=Castle Doran
德加巴基=DoGaBaKi 
德加雷震=Dogga Thunder Slap
恶之女王=Queen Bee 
恶路程式=Roidmude
恶魔石板=Demons Slate 
悲剧王国=Bad End Kingdom
惊雷黄蜂=Lightning Hornet
我门矢士=ta Kadoya Tsukasa
战队连者=Super Sentai 
戶川阳介=Togawa Yosuke
扑克王国=Trump Kingdom
把门矢士=đem Kadoya Tsukasa
抢劫降临=Steal Vent
拆毁一号=Demolition One
挤压果冻=Sclashjellies 
提亚马特=Tiamat
撕咬狂鲨=Biting Shark
攻击驾驭=Attack Ride 
斯派修姆=Spacium 
无敌卡带=Muteki Gashat 
无敌玩家=Muteki Gamer
无限风格=Infinity Style 
无限飞蝗=Infinite Hopper
日神金属=Sol Metal
时空魔神=Time Mazine
时间降临=Time Vent
明堂院树=Myoudouin Itsuki
星云气体=Nebula Gas
星间飞行=Seikan Hikou
春日野丽=Kasugano Urara
昭和骑士=Shōwa Rider
普罗米斯=Promise
暴雪拳套=Blizzard Knuckle
暴风猎鹰=Storm Eagle
最上无惨=Mogami Muzan
最终降临=Final Vent
月影英明=Tsukikage Hideki
月神扳机=Luna Trigger
有多治见=có Tajimi 
朱月藤果=Touka Akatsuki 
机界战队=Kikai Sentai
极致形态=Xtreme Form
极限斩籍=GiriGiriSlash
柠檬阵羽=Lemon Jimber  
核心硬币=Core Medal
桐谷和人=Kirigaya Kazuto
樱...=Sakura...
欧布圆环=Orb Ring
欧鲁特加=Olteca
武器印章=Ohinstamp 
比卡利亚=Vicarya 
气泡兔坦=Rabbit Tank Sparkling 
水岛嘉宏=Mizushima Hiro
泊进之介=Tomari Shinnosuke
泰坦形态=Titan Form
泰坦瓶子=Titan Bottle 
泰莱斯通=Telesdon
泽渡樱子=Sawatari Sakurako
浦塔罗斯=Urataros
海姆冥界=Helheim
海尔兄弟=Haier Brothers
海贼电车=Kaizoku Ressya  
深红电钻=Crimson Smash
温斯凯尔=Winskell
游戏天神=Gamedeus
灭亡迅雷=MetsubouJinrai
烈焰军刀= Flame Saber
烈焰猛虎=Flaming Tiger
烟雾步枪=Steam Rifle
热流模式=Fever Flow
熔岩拳套=Magma Knuckle
燃烧猎隼=Burning Falcon
犀牛风扇=SaiDryer 
狮子战记=Lion Senki 
獠牙王牌=Fang Joker
理直气壮=lẽ thẳng khí hùng
生化骑士=Biorider 
生存形态=Survive Form
田所修一=Tadokoro Shuichi
疾风天马=Blast Pegasus
疾风王牌=Cyclone Joker
白金太太=Shirogane-san
直冲天际=xông thẳng tới chân trời
真理圣主=Master Logos 
破晓之翼=Twilight Wings
秋山莉奈=Akiyama Rina 
科亚特尔=Coatl
究极全能=Ultimate Mighty
空我全能=Kuuga Mighty
突击猎豹=Rushing Cheetah
突击野狼=Assault Wolf
童话王国=Märchenland
红色警戒=Red Alert
纳萨里克=Nazarick
绯红之龙=Crimson Dragon
美弗拉斯=Mefilas 
美菲拉斯=Mefilas
自古朗基=từ Gurongi
自私之王=Kingu Jikochū
至尊鳄霸=Prime Rogue
艾达希克=Adacic
花咲熏子=Hanasaki Kaoruko
莱欧骑兵=RioTrooper
菲姆辛姆=Femushinmu 
菲尼克斯=Fenix
蔷薇天使=Cure Rosetta
蝎子丽娜=Sasorina
蝗虫兄弟=Hopper huynh đệ
蝙蝠引擎=Bat Engine
融合降临=Unite Vent
西游飞龙=Saiyuu Dragon
豪快帆船=Gokai Galleon
贝尔纳姬= Vernage 
走马观花=cưỡi ngựa xem hoa
起源之男=Hajimari no Otoko
超级战队=Super Sentai
轩辕十四=Regulus
辉煌棱晶=Shinning Prism
进化瓶罐=Evol-Bottle 
进化龙瓶=Dragon Evol Bottle
迪丝比娅=Dyspear
迪卢木多=Diarmuid
迪斯比娅=Dyspear
迪斯特隆=Destron
迪斯达克=Dys Dark
迷失瓶子= Lost Bottle 
逢魔之力=Ohma Force
遗产玩家=Legacy Gamer 
避矢加护=Protection from Arrows
邪恶飞龙=Jaaku Dragon
邪王飞龙=Jaou Dragon
重击降临=Strike Vent
重拳金刚=Punching Kong
金塔罗斯=Kintaros
钻石天使=Cure Diamond
镜中世界=Mirror World
闪亮天使=Cure Twinkle
闪耀形态=Shining Form
闪耀突击=Shining Assault  
闪耀飞蝗=Shining Hopper
防御降临=Guard Vent
防护降临=Guard Vent
阿基蕾拉=Aguilera
阿尔匹娜=Alpina 
阿里阿多=Arigato
附在一条=bám vào Ichijo
限制降临=Confine Vent 
雪崩斩击=Avalanche Break
青龙瓶子=Dragon Bottle
音速箭矢=Sonic Arrow
风切大和=Kazakiri Yamato
风暴形态=Storm Form
风暴战戟= Storm Halberd
风暴降临=Blust Vent 
风间大介=Kazama Daisuke
飓风风格=Hurricane Style
飞翔猎隼=Flying Falcon
飞鹰瓶子=Taka Bottle
香川英行=Hideyuki Kagawa 
驾驭表头=Ride Watch
骑士形态=Rider Form
高村沙耶=Saya Takamura
高跃飞蝗=Rising Hopper
高达尼姆=Gundanium
魔女丽娜=Majorina
鲁邦连者=Keisatsu Sentai
鲁邦连者=Lupinranger
鳄鱼裂痕=Crocodile
鸟记忆体=Bird Memory
黄金军刀=Goldsaber
黄金时段=hoàng kim thời điểm
黄金果实=Forbidden Fruit 
黎明小镇=Daybreak Town
黑暗回响=Dark Echoes
黑暗方阵=Dark Phalanx
黑暗领域=Dark Field 
黑洞扳机=Evol-Trigger
黑洞热流=Black Hole Fever Flow 
黑色嵌板=Black Panel
龙塔洛斯=Ryutaros
龙塔罗斯=Ryutaros
龙皇凯撒=Dragon King Caesar
龙进化瓶=Dragon Evol Bottle
Ixa圣剑=Ixa Calibur
Ixa拳套=Ixa Knuckle
sougo=SOUGO
一块地之石=một khối Stone of Earth 
一条下意识=Ichijo theo bản năng
三角追踪者=Trychaser
假面骑士剑=Kamen Rider Blade
光之美少女=Precure
光夏照相馆=Hikari Studio
兔子满装瓶=Rabbit Fullbottle 
全能满装瓶=Mighty Fullbottle
全能的强大=Mighty cường đại
公文箱弩弓=Attach Arrow
公文箱王剑=Attache Calibur
凯西帕鲁格=Cath Palug
创世纪腰带=Genesis Driver
千位劫持者=Thousand Jacker
升华究极态=Rising Ultimate Form
升华究极踢=Rising Ultimate Kick
双重破坏者=Twin Breaker
另类驾驭书=Alter Ride Books
哈米吉多顿=Armageddon 
哉亚处理器=ZAIA Spec
图坦卡门魂=Tutankhamun Damashii
土豪剑激土=Dogouken Gekido
圣剑驱动器=Seiken Swordriver
坦克满装瓶=Tank Fullbottle 
基因生存者=Genocider
基里艾洛德=Kyrieloid
堕天使之锤= Lucifers Hammer
复活者盖茨=Geiz Revive 
天马行空了=thiên mã hành không
失落驱动器=Lost Driver
奇幻驾驭书=Wonder Ride Books
奥特断头刀=Ultra Guillotine
安哥拉曼纽=Angra·Mainyu
富加宫贤人=Fukamiya Kento
封闭齿轮枪=Geartozinger
小野寺雄介=Yusuke Onodera
岩浆龙瓶子=Dragon Magma Bottle
巴比伦尼亚=Babylon
平成驾驭剑=RideHeiSaber
平成骑士踢=Heisei Rider Kick
幸运四叶草=Lucky Clover
幻影帝国的=Phantom Empire
弗拉德三世=Vlad III
强袭驾驭者=RideWatch Holder
战极驱动器=Sengoku Driver
挤压驱动器=Sclash Driver
故障驱动器=Buggle Driver 
斩击驱动器=Slashriser
旋风驱动器=Cycloneriser 
时国剑界时=Jikokuken Kaiji
时空管理局=Quartzer 
时空驱动器=Ziku Driver
时间极限剑=Zikan Girade
时间管理局=Quartzer
星团评议会=Universal Alliance Council
暗黑剑月暗=Ankokuken Kurayami
暴雪机器人=Grease Blizzard
月神记忆体=Luna Memory
机器人瓶子=Robot Bottle
机械创造者=Machine Builder 
桃...子=Momo... Ko
残虐帝国的=Zangyack Empire
水势剑水流=Suiseiken Nagare
水势剑流水=Suiseiken Nagare 
泰罗奥特曼=Ultraman Taro
泽塔奥特曼=Ultraman Z
深红的电钻=Crimson Smash
漆黑无双龙=Dragblacker
漆黑龙召机=Blackdragvisor
潘多拉盒子=Pandora  Box
火炎剑烈火=Kaenken Rekka
火焰剑烈火=Kaenken Rekka
炎门守护者=Thermopylae Enomotia
熔岩掺杂体=Magma Dopant
特里姆玛乌=Trimmau
狂暴加特林=Rampage Gatling 
狂野卡利斯=Wild Chalice
猿飞忍者伝=Sarutobi Ninjaden 
王牌掺杂体=Joker Dopant 
玩家驱动器=Gamer Driver
疾风记忆体=Cyclone Memory 
百万翻转机=Mega Reversal Machine
的假面骑士=Kamen Rider
盖章破坏器=Ohin Buster
石森章太郎=Ishinomori Shotaro
神山飞羽真=Kamiyama Touma
程式升华钥=Progrisekey
穿越龙形态=Great Dragon Form
突袭驱动器=Raid Riser
红舞鞋系统=Red Shoes System
纳马凯鲁达=Namakelder
绝灭升华器=ZetsumeRiser 
编年史卡带=Chronicle Gashat 
菠萝菠萝嗒=boro boro da
赛米拉米斯=Semiramis
超越驱动器=Beyond  Driver
进化满装瓶=Evol Fullbottle
迷失满装瓶=Lost Fullbottle
迷失眼镜蛇=Lost Cobra 
迷失驱动器=Lost Driver
钻头粉碎者=Drill Crusher
阿奇佐尔缇=Archisorte
阿维斯布隆=Solomon
雪城穗乃香=Yukishiro Honoka
零一驱动器=Zero-One Driver
霸王龙连者=TyrannoRanger
风双剑翠风=Fuusouken Hayate
飞鹰加特林=Hawk Gatlinger
驾驭飞射号=Ride Shooter
驾驭飞射号=Rideshooter
高能昆虫仪=Hyper Zecter 
鲁纳蒂克斯=Lunaticks
鸿上基金会=Kougami Foundation
黄金极限W=Gold Xtreme W
黑暗无双龙=Dragblacker 
黑暗进化者=Darkevolver
黑暗进化者=Darkevolver 
齿轮封闭枪=Geartozinger 
《警察与小偷=《 Cops and Robbers
一条点了点头=Ichijo gật gật đầu
万疵必应修补=Pain Breaker
假面骑士十五=Kamen Rider Fifteen
假面骑士电王=Kamen Rider Den-O
假面骑士银河=Kamen Rider Ginga
假面骑士零一=Kamen Rider Zero One
兔子兔子形态=Rabbit Rabbit Form
全知全能之书=Wonder Almighty Wonder Ride Book 
全能坦克形态=Mighty Tank Form
创世纪驱动器=Genesis Driver
卡布里的月光=Moonlight of Capri
地帝Orga=Masked Rider Orga
埃尔梅罗二世=Lord El-Melloi II
忍者漫画形态=NinninComic Form
无敌玩家卡带=Muteki Gamer
暴龙罪恶印章=Rex Vistamp
最终攻击驾驭=Final Attack Ride
月神王牌形态=Luna Joker Form
机器人进化瓶=Robot Evol-Bottle
泰坦坦克形态=Titan Tank Form
究极的骑士态=Ultimate Rider Form
进化起动装置=Evol-Trigger 
野狼罪恶印章=Wolf Vistamps 
钢铁坦克满瓶=Metal Tank Fullbottle
闪耀突击蝗虫=Shining Assault Hopper
闪耀突击飞蝗=Shining Assault Hopper
驾驭加特林号=Ride Gatriker 
魔幻书屋神山=Fantastic Bookstore Kamiyama
黑暗转移波动=Dark Shift Wave
Build手机=Build Phone
evol驱动器=Evol Diver
nAscitA=Nascita
五星战队大连者=Gosei Sentai Dairanger
兔兔坦坦碎冰冰=FullFull RabbitTank 
兽电战队强龙者=Zyuden Sentai Kyoryuger
创世纪能量核心=Genesis Core
南无加特林菩萨=Nam Mô Gatling Bồ Tát
心跳光之美少女=DokiDoki! PreCure
恐龙战队兽连者=Kyōryū Sentai Zyuranger
新世纪福音战士=Shin Seiki Evangelion
水边的阿狄丽娜=Ballade pour Adeline
王 EX 王剑=Kingexcalibur
破灭驱动器带扣=Dooms Driver Buckle
藤↑丸↓立↑香=Fujimaru ↓ Ritsuka
蝙蝠迷失满装瓶=Bat Lost Fullbottle 
轰轰战队冒险者=GoGo Sentai Boukenger
飞鹰加特林形态=HawkGatling Form
黄金Drive=Gold Drive
DrakKiva=Dark Kiva
Evolto黑洞=Evolto Black Hole
Faiz加速形态=Faiz Axel Form
杰克君与土豆之树=Jackun to Domamenoki 
猛犸原型罪恶印章=Mammoth Proto Vistamp
疾驰速度型号医生=Drive Type Speed Doctor
魁扎尔·科亚特尔=Quetzalcoatl
Bugstar病毒=Bugster Virus 
EvolDiver=Evol Diver
星云Bugster=Nebula Bugster
Decadriver=Decade Driver
Gashacon破坏者=Gashacon Breaker
KabutoZecter=Kabuto Zecter 
戈尔德·穆吉克·尤格多米雷尼亚=Gordes Musik Yggdmillennia
	“You are over.”="You are over."
からっぽの星时代をゼロから始めよう=Karappo no hoshi Jidai wo zero kara hajimeyou