三湘=Tam Tương
丘独=Khâu Độc
乌鞘=Ô Sao
云州=Vân châu
关中=Quan Trung
凌空=Lăng Không
古龙=Cổ Long
叶开=Diệp Khai
叶飞=Diệp Phi
唐兄=Đường huynh
天禽=Thiên Cầm
妖娆=yêu nhiêu
孙奎=Tôn Khuê
封万=Phong Vạn
少英=Thiếu Anh
嵩阳=Tung Dương
庄主=trang chủ
张菁=Trương Tinh
彭岳=Bành Nhạc
彭烈=Bành Liệt
心慧=Tâm Tuệ
心树=Tâm Thụ
心灯=Tâm Đăng
心烛=Tâm Chúc
心鉴=Tâm Giám
怜星=Liên Tinh
战帖=chiến thiếp
整改=chỉnh cải
易容=dịch dung
曾伦=Tằng Luân
机灵=cơ linh
杜杀=Đỗ Sát
杜武=Đỗ Vũ
杨大=Dương Đại
杨某=Dương mỗ
段千=Đoạn Thiên
江兄=Giang huynh
江家=Giang gia
江枫=Giang Phong
江贵=Giang Quý
江郎=Giang Lang
沈洋=Thẩm Dương
渣女=tra nữ
温泉=ôn tuyền
游兄=Du huynh
游某=Du mỗ
游腾=Du Đằng
王府=vương phủ/Vương Phủ
田七=Điền Thất
眉州=Mi châu
秦重=Tần Trọng
秦雷=Tần Lôi
程节=Trình Tiết
美誉=mỹ dự
花蜂=Hoa Phong
苏樱=Tô Anh
萧家=Tiêu gia
萧氏=Tiêu thị
萧风=Tiêu Phong
薛冰=Tiết Băng
薛可=Tiết Khả
藏边=Tàng Biên
血剑=Huyết Kiếm
裴云=Bùi Vân
软木=nhuyễn mộc
边浩=Biên Hạo
邓开=Đặng Khai
郭威=Quách Uy
铁姑=Thiết Cô
铁战=Thiết Chiến
镖局=tiêu cục
陇西=Lũng Tây
陈景=Trần Cảnh
雪盈=Tuyết Doanh
霍休=Hoắc Hưu
顾家=Cố gia
黄鸡=Hoàng Kê
丁乘风=Đinh Thừa Phong
丁公子=Đinh công tử
丁灵中=Đinh Linh Trung
丁白云=Đinh Bạch Vân
七妙人=Thất Diệu Nhân
万春流=Vạn Xuân Lưu
万马堂=Vạn Mã đường
上官木=Thượng Quan Mộc
上官飞=Thượng Quan Phi
东亭阁=Đông Đình các
严立本=Nghiêm Lập Bản
九华山=Cửu Hoa sơn
五台山=Ngũ Đài sơn
仙子香=Tiên Tử Hương
伊夜哭=Y Dạ Khốc
保定府=Bảo Định phủ
公子羽=Công Tử Vũ
公孙兰=Công Tôn Lan
公孙断=Công Tôn Đoạn
公孙雨=Công Tôn Vũ
兰花阁=Lan Hoa các
兴云庄=Hưng Vân trang/Hưng Vân Trang
冯天雨=Phùng Thiên Vũ
南宫倩=Nam Cung Thiến
南宫奇=Nam Cung Kỳ
南宫岳=Nam Cung Nhạc
卫满涯=Vệ Mãn Nhai
史夫人=Sử phu nhân
史扬天=Sử Dương Thiên
史明廷=Sử Minh Đình
叶孤城=Diệp Cô Thành
叶秀珠=Diệp Tú Châu
司晨客=Ti Thần Khách
司马烟=Tư Mã Yên
吕凤先=Lữ Phụng Tiên
哈哈儿=Cáp Cáp Nhi
唐天仪=Đường Thiên Nghi
唐天容=Đường Thiên Dung
唐天纵=Đường Thiên Tung
喝花酒=uống hoa tửu
回云子=Hồi Vân Tử
夏侯星=Hạ Hầu Tinh
天青骓=Thiên Thanh Chuy
女菩萨=Nữ Bồ Tát
好汉庄=Hảo Hán trang
孙秀青=Tôn Tú Thanh
孙驼子=Tôn Đà Tử/Tôn đà tử
宋大川=Tống Đại Xuyên
小还丹=Tiểu Hoàn Đan
小鱼儿=Tiểu Ngư Nhi
山西雁=Sơn Tây Nhạn
岳阳府=Nhạc Dương phủ
平独鹤=Bình Độc Hạc
庞飞侠=Bàng Phi Hiệp
张三娘=Trương tam nương
张凤武=Trương Phượng Vũ
张凤汐=Trương Phượng Tịch
弧形剑=Hồ Hình kiếm
彭大鹏=Bành Đại Bằng
徐玄真=Từ Huyền Chân
怜红楼=Liên Hồng lâu
慕容九=Mộ Dung Cửu
慕容永=Mộ Dung Vĩnh
慕容菡=Mộ Dung Hạm
断魂钩=Đoạn Hồn Câu
方玉飞=Phương Ngọc Phi
明玉功=Minh Ngọc Công
易大经=Dịch Đại Kinh
星辰贴=tinh thần thiếp
月下狐=Nguyệt Hạ Hồ
木一半=Mộc Nhất Bán
木道人=Mộc đạo nhân
朱腾云=Chu Đằng Vân
李大叔=Lý đại thúc
李寻欢=Lý Tầm Hoan
李探花=Lý thám hoa
李燕北=Lý Yến Bắc
杜医师=Đỗ Y Sư
杨帮主=Dương bang chủ
杨承祖=Dương Thừa Tổ
极乐峒=Cực Nhạc động
林仙儿=Lâm Tiên Nhi
林诗音=Lâm Thi Âm
林铃铃=Lâm Linh Linh
柳东来=Liễu Đông Lai
柳残心=Liễu Tàn Tâm
梅花庵=Mai Hoa am
梅花盗=Mai Hoa Đạo
楚平渊=Sở Bình Uyên
欧阳丁=Âu Dương Đinh
欧阳亭=Âu Dương Đình
欧阳情=Âu Dương Tình
段师傅=Đoạn sư phó
江公子=Giang công tử
江别鹤=Giang Biệt Hạc
江直下=Giang Trực Hạ
沈三娘=Thẩm Tam Nương
活霸王=Hoạt Bá Vương
游公子=Du công tử/Du Công Tử
游大哥=Du đại ca
游少侠=Du thiếu hiệp
游老弟=Du lão đệ
游荃蕙=Du Thuyên Huệ
游贤侄=Du hiền điệt
游龙生=Du Long Sinh
潘大少=Phan đại thiếu
潘少安=Phan Thiếu An
燕十三=Yến Thập Tam
燕双飞=Yến Song Phi
独孤枭=Độc Cô Kiêu
玉娘子=Ngọc Nương Tử
玉罗刹=Ngọc La Sát
王一抓=Vương Nhất Trảo
王怜花=Vương Liên Hoa
王总管=Vương Tổng Quản
登云楼=Đăng Vân lâu
白二侠=Bạch nhị hiệp
白云庄=Bạch Vân trang
白天羽=Bạch Thiên Vũ
白开心=Bạch Khai Tâm
百花院=Bách Hoa viện
石秀雪=Thạch Tú Tuyết
秦三哥=Tần tam ca
秦三爷=Tần tam gia
秦公子=Tần công tử
秦孝仪=Tần Hiếu Nghi
移花宫=Di Hoa cung
笑弥陀=Tiếu Di Đà
红鞋子=Hồng Hài Tử
绣玉谷=Tú Ngọc cốc
翁天杰=Ông Thiên Kiệt
翁家庄=Ông gia trang
翻江龙=Phiên Giang Long
胡不归=Hồ Bất Quy
胡道人=Hồ đạo nhân
花无涯=Hoa Vô Nhai
花月奴=Hoa Nguyệt Nô
花满楼=Hoa Mãn Lâu
花白凤=Hoa Bạch Phượng
苏二侠=Tô nhị hiệp
苏少英=Tô Thiếu Anh
荆无命=Kinh Vô Mệnh
萧咪咪=Tiêu Mị Mị
萧四无=Tiêu Tứ Vô
蓝月怡=Lam Nguyệt Di
袁秋云=Viên Thu Vân
裴万君=Bùi Vạn Quân
西门玉=Tây Môn Ngọc
观梅山=Quan Mai Sơn
谢天灵=Tạ Thiên Linh
谢晓峰=Tạ Hiểu Phong
赏花会=thưởng hoa hội
赛华佗=Tái Hoa Đà
赤罗刹=Xích La Sát
赵全海=Triệu Toàn Hải
赵正义=Triệu Chính Nghĩa
路菲菲=Lộ Phỉ Phỉ
追月鞭=Truy Nguyệt tiên
追风剑=Truy Phong kiếm
郭嵩阳=Quách Tung Dương
金九龄=Kim Cửu Linh
金老总=Kim Lão tổng
金钱帮=Kim Tiền bang
金风白=Kim Phong Bạch
铁传甲=Thiết Truyền Giáp
铁开诚=Thiết Khai Thành
铁无双=Thiết Vô Song
阎老板=Diêm lão bản
阎铁珊=Diêm Thiết San
阳澄湖=Dương Trừng hồ
阴九幽=Âm Cửu U
阴无极=Âm Vô Cực
陆小凤=Lục Tiểu Phụng
降魔棍=Hàng Ma Côn
霍天青=Hoắc Thiên Thanh
青竹剑=Thanh Trúc kiếm
青衣楼=Thanh Y lâu
青风观=Thanh Phong quan
韦东奇=Vi Đông Kỳ
顾道人=Cố Đạo Nhân
风啸雨=Phong Khiếu Vũ
飒露紫=Táp Lộ Tử
飞花掌=Phi Hoa Chưởng
飞雁门=Phi Nhạn môn
飞鲸帮=Phi Kình bang
马亦云=Mã Diệc Vân
马秀真=Mã Tú Chân
马空群=Mã Không Quần
骆方涯=Lạc Phương Nhai
高长枫=Cao Trường Phong
魏无牙=Ngụy Vô Nha
魏明凡=Ngụy Minh Phàm
鱼肠剑=Ngư Tràng kiếm
黑面君=Hắc Diện Quân
龙四海=Long Tứ Hải
龙小云=Long Tiểu Vân
龙神庙=Long Thần Miếu
一剑飞花=Nhất Kiếm Phi Hoa
一双儿女=một đôi nhi nữ
七巧书生=Thất Xảo Thư Sinh
上官丹凤=Thượng Quan Đan Phượng
上官金虹=Thượng Quan Kim Hồng
上官飞燕=Thượng Quan Phi Yến
东海玉箫=Đông Hải Ngọc Tiêu
中原八义=Trung Nguyên Bát Nghĩa
乌云踏雪=Ô Vân Đạp Tuyết
九折九转=cửu chiết cửu chuyển
云雾茶庄=Vân Vụ trà trang
五毒天水=Ngũ Độc Thiên Thủy
五绝神功=Ngũ Tuyệt Thần Công
公孙摩云=Công Tôn Ma Vân
冷香小筑=Lãnh Hương tiểu trúc
千手罗刹=Thiên Thủ La Sát
南天大侠=Nam Thiên đại hiệp
又来生意=lại có sinh ý
听风小院=Thính Phong tiểu viện
大移穴法=Đại Di Huyệt Pháp
大紫阳手=Đại Tử Dương Thủ
天外飞仙=Thiên Ngoại Phi Tiên
天禽老人=Thiên Cầm lão nhân
天移地转=Thiên Di Địa Chuyển
天龙八部=Thiên Long Bát Bộ
夺命金钱=đoạt mệnh kim tiền
嫁衣神功=Giá Y Thần Công
小李飞刀=Tiểu Lý Phi Đao
少林神拳=Thiếu Lâm Thần Quyền
嵩阳铁剑=Tung Dương Thiết Kiếm
张大善人=Trương đại thiện nhân
彩云追月=Thải Vân Truy Nguyệt
心树大师=Tâm Thụ đại sư
心眉大师=Tâm Mi đại sư
慕容夫妇=Mộ Dung phu phụ
摄魂大法=Nhiếp Hồn Đại Pháp
晋北双秀=Tấn Bắc song tú
普意大师=Phổ Ý đại sư
杨大胡子=Dương đại hồ tử
极乐峒主=Cực Nhạc động chủ
梅二先生=Mai nhị tiên sinh
梅大先生=Mai đại tiên sinh
欢喜菩萨=Hoan Hỉ Bồ Tát
流云飞袖=Lưu Vân Phi Tụ
游龙剑客=Du Long kiếm khách
满天花雨=Mãn Thiên Hoa Vũ
潇湘剑客=Tiêu Tương kiếm khách
灵犀一指=Linh Tê Nhất Chỉ
灵虚道长=Linh Hư đạo trưởng
爱欲天王=Ái Dục Thiên Vương
献果神君=Hiến Quả Thần Quân
玉箫前辈=Ngọc Tiêu tiền bối
班察巴那=Ban Sát Ba Na
生死判官=Sinh Tử Phán Quan
百川归海=Bách Xuyên Quy Hải
百年好合=bách niên hảo hợp
百花芳怡=Bách Hoa Phương Di
碧血双蛇=Bích Huyết Song Xà
神龙九折=Thần Long Cửu Chiết
移花穿玉=Di Hoa Xuyên Ngọc
简二先生=Giản nhị tiên sinh
紫面二郎=Tử Diện nhị lang
细柳生姿=tế liễu sinh tư
落地无声=lạc địa vô thanh
蔷薇夫人=Sắc Vi phu nhân
血手杜杀=Huyết Thủ Đỗ Sát
西门吹雪=Tây Môn Xuy Tuyết
观梅山庄=Quan Mai sơn trang
边城浪子=Biên Thành Lãng Tử
追风剑客=Truy Phong kiếm khách
金鹏王朝=Kim Bằng vương triều
铁手君子=Thiết Thủ Quân Tử
铁笛先生=Thiết Địch tiên sinh
长袖善舞=trường tụ thiện vũ
青楼女子=thanh lâu nữ tử
青衣楼主=Thanh Y lâu chủ
风云剑客=Phong Vân kiếm khách
飞索横空=Phi Tác Hoành Không
鱼肠短剑=Ngư Trường đoản kiếm
黄鸡大师=Hoàng Kê đại sư
五虎断门刀=Ngũ Hổ Đoạn Môn Đao
回风舞柳剑=Hồi Phong Vũ Liễu Kiếm
天涯明月刀=Thiên Nhai Minh Nguyệt Đao
天王斩鬼刀=Thiên Vương Trảm Quỷ đao
射雕英雄传=Xạ Điêu Anh Hùng Truyện
摩云十四式=Ma Vân Thập Tứ Thức
珠光宝气阁=Châu Quang Bảo Khí các
达摩易筋经=Đạt Ma Dịch Cân Kinh
阴风搜魂手=Âm Phong Sưu Hồn Thủ
鞭神西门柔=Tiên Thần Tây Môn Nhu
勾魂摄心大法=Câu Hồn Nhiếp Tâm Đại Pháp
玉面神拳秦重=Ngọc Diện Thần Quyền Tần Trọng
神龙九折剑法=Thần Long Cửu Chiết Kiếm Pháp
风雪七十二式=Phong Tuyết Thất Thập Nhị Thức
多情剑客无情剑=Đa Tình Kiếm Khách Vô Tình Kiếm
天翻地覆大挪移身=Thiên Phiên Địa Phúc Đại Na Di Thân
乐厚=Nhạc Hậu
剑圣=Kiếm Thánh
剑神=Kiếm Thần
加文=Garvin
勇度=Yondu
勇气=Dũng Khí
吕义=Lữ Nghĩa
圣姑=Thánh Cô
塔南=Tarnum
天书=Thiên Thư
女娲=Nữ Oa
孙晨=Tôn Thần
孙逵=Tôn Quỳ
孟晋=Mạnh Tấn
小黑=Tiểu Hắc
左亭=Tả Đình
巫王=Vu Vương
张唐=Trương Đường
心经=Tâm Kinh
拜月=Bái Nguyệt
掌门=Chưởng môn
文化=Văn Hóa
方生=Phương Sinh
无名=Vô Danh
星爵=Star Lord
李沐=Lý Mộc
河阳=Hà Dương
法师=Pháp sư
灭霸=thanos
牧师=Mục sư
玉天=Ngọc Thiên
秦霜=Tần Sương
老苗=Lão Miêu
苏汤=Tô Thang
苗壮=Miêu Tráng
菊豆=Cúc Đậu
虞二=Ngu Nhị
虱蛊=Sắt Cổ
蛊术=Cổ thuật
蜀山=Thục Sơn
赵桐=Triệu Đồng
达蒙=Damon
道家=Đạo gia
钟眉=Chung Mi
陆柏=Lục Bách
陈哥=Trần ca
青儿=Thanh Nhi
麒麟=Kỳ Lân
一线牵=Nhất Tuyến Khiên
万剑诀=Vạn Kiếm Quyết
万大平=Vạn Đại Bình
仙学院=Tiên viện
仙灵岛=Tiên Linh Đảo
令师妹=Lệnh Sư Muội
令狐冲=Lệnh Hồ Xung
任教主=Nhậm giáo chủ
余杭镇=Dư Hàng Trấn
克里根=Kreegans
凤舞箭=Phượng Vũ Tiễn
刘晋元=Lưu Tấn Nguyên
南诏国=Nam Chiếu Quốc
唐若悠=Đường Nhược Du
圣心诀=Thánh Tâm Quyết
大老爸=Đại Lão Ba
天音寺=Thiên Âm Tự
太极剑=Thái Cực Kiếm
孙小红=Tôn Tiểu Hồng
张小凡=Trương Tiểu Phàm
张金鰲=Trương Kim Ngao
拉瑟尔=Russell
易筋经=Dịch Cân Kinh
李二侠=Lý Nhị Hiệp
李大婶=Lý Đại Thẩm
李少爷=Lý Thiếu Gia
李逍遥=Lý Tiêu Dao
林天南=Lâm Thiên Nam
桑三娘=Tang Tam Nương
江湖客=Giang Hồ Khách
汤陈义=Thang Trần Nghĩa
活血散=Hoạt Huyết Tán
火灵珠=Hỏa Linh Châu
王小虎=Vương Tiểu Hổ
田伯光=Điền Bá Quang
白石城=Bạch Thạch Thành
皮卡丘=Pikachu
祝君豪=Chúc Quân Hào
程先生=Trình tiên sinh
紫金丹=Tử Kim Đan
胡晓彤=Hồ Hiểu Đồng
草上飞=Thảo Thượng Phi
莫一兮=Mạc Nhất Hề
蜀山派=Thục Sơn Phái
血剑堂=Huyết Kiếm Đường
血菩提=Huyết Bồ Đề
诸葛刚=Gia Cát Cương
诸葛雷=Gia Cát Lôi
越女剑=Việt Nữ Kiếm
道德经=Đạo Đức Kinh
酒剑仙=Tửu Kiếm Tiên
防御术=Defense
阿维利=Arvil
青云门=Thanh Vân Môn
青魔手=Thanh Ma Thủ
领导术=Leadership
风神腿=Phong Thần Thối
魔法书=Magic book
鲍大楚=Bảo Đại Sở
龙四爷=Long tứ gia
上善若水=Thượng Thiện Nhược Thủy
九天玄经=Cửu Thiên Huyền Kinh
亚历山大=Alexander
倩女幽魂=Thiến Nữ U Hồn
傲寒六诀=Ngạo Hàn Lục Quyết
先天道体=Tiên Thiên Đạo Thể
千叶禅师=Thiên Diệp Thiền Sư
吸星大法=Hấp Tinh Đại Pháp
地狱骑士=Địa Ngục Kỵ Sĩ
多情剑客=Đa Tình Kiếm Khách
大雄宝殿=Đại Hùng Bảo Điện
小无相功=Tiểu Vô Tương Công
巫术启蒙=Vu Thuật Khải Mông
开山剑法=Khai Sơn Kiếm Pháp
御剑飞行=Ngự Kiếm Phi Hành
恩格塔瑞=Engtari
护体神盾=Body Shield
掠夺之王=Tước Đoạt Chi Vương
攻击加速=Attack Acceleration
明镜姥姥=Minh Kính Mỗ Mỗ
暮光之城=Mộ Quang Chi Thành
清净心经=Thanh Tịnh Tâm Kinh
爱乐之城=Ái Nhạc Chi Thành
玛格努斯=Magnus
生化危机=Sinh Hóa Nguy Cơ
神行百变=Thần Hành Bách Biến
莫大掌门=Mạc Đại Chưởng Môn
蚀日剑法=Thực Nhật Kiếm Pháp
轩辕飞剑=Hiên Viên Phi Kiếm
迟缓大法=Slow Dafa
金翅凤凰=Kim Sí Phượng Hoàng
魔力源泉=Source of Magic
魔法神箭=Magic Arrow
太极玄清道=Thái Cực Huyền Thanh Đạo
异次元之门=The Gate of Another Dimension
易经锻骨篇=Dịch Kinh Đoán Cốt Thiên
法师终结者=Pháp Sư Chung Kết Giả
蜀山仙学院=Thục Sơn Tiên Viện
飞龙探云手=Phi Long Tham Vân Thủ
安迪卡普恩特=Andy Capuente
仈 Jiǔ 不离十了=tám chín phần mười
卢大大水克可达路利达皮=Luda Dasu Keda Luli Dapi
Tả Chưởng Môn=Tả Chưởng Môn
