2012=2012
FY1=FY1
Hoa sư huynh=Hoa sư huynh
qinggong=Qinggong
qingong=qingong
《剑上报应经》=《Kiếm Thượng Báo Ứng Kinh》
《地藏因报禅》=《Địa Tạng Nhân Báo Thiền》
《天击穿透文明大法》=《Thiên Kích Xuyên Thấu Văn Minh Đại Pháp》
《太上果报经》=《Thái Thượng Quả Báo Kinh》
《小千世界残破大荒剑卷》=《Tiểu Thiên Thế Giới Tàn Phá Đại Hoang Kiếm Quyển》
《药道真经》=《Dược Đạo Chân Kinh》
一之文明=Nhất Chi Văn Minh
一之文明之主=Nhất Chi Văn Minh Chi Chủ
一剑出世=Nhất Kiếm Xuất Thế
一剑寂寞=Nhất Kiếm Tịch Mịch
一剑无敌=Nhất Kiếm Vô Địch
一剑灭天=Nhất Kiếm Diệt Thiên
一号=Đệ Nhất Hào
一品悟道之地=Nhất Phẩm Ngộ Đạo Chi Địa
一字电剑=Nhất Tự Điện Kiếm
一弓万箭=Nhất Cung Vạn Tiễn
一杯愁绪，几年离索。错！错！错！=Nhất bôi sầu tự, kỷ niên ly tác. Thác! Thác! Thác!
一气风火辟地棍=Nhất Khí Phong Hỏa Bích Địa Côn
一百一十一种剑意=Một trăm mười một loại kiếm ý
一百零一帝子=Nhất Bách Linh Nhất Đế Tử
一百零八美=Một trăm lẻ tám vẻ đẹp
一箭平天下心法=Nhất Tiễn Bình Thiên Hạ Tâm Pháp
一粟阴阳=Nhất Túc Âm Dương
一线电剑=Nhất Tuyến Điện Kiếm
一败屠地=Nhất Bại Đồ Địa
丁三=Đinh Tam
七十二黄金神魂洪荒生灵=Bảy mươi hai sinh linh Hồng Hoang Thần Hồn Vàng
七号=Thất Hào
七大使者=Thất Đại Sứ Giả
七女=Thất Nữ
七彩星=Thất Thải Tinh
七情=Thất Tình
七情之剑=Thất Tình Chi Kiếm
七情之火=Thất Tình Chi Hỏa
七情剑=Thất Tình Kiếm
七情魔火=Thất Tình Ma Hỏa
七方石=Thất Phương Thạch
七星大阵=Thất Tinh Đại Trận
七杀星=Thất Sát Tinh
七气合一=Thất Khí Hợp Nhất
七纪元=Thất Kỷ Nguyên
七色之尘=Thất Sắc Chi Trần
七色彩虹果=Thất Sắc Thải Hồng Quả
七色虹霞=Thất Sắc Hồng Hà
七荒动=Thất Hoang Động
七荒图=Thất Hoang Đồ
七荒始=Thất Hoang Thủy
七荒战=Thất Hoang Chiến
七荒集=Thất Hoang Tập
七铁则剑圣=Thất Thiết Tắc Kiếm Thánh
万世剑师=Vạn Thế Kiếm Sư
万仙=Vạn Tiên
万众雷之君王劫=Vạn Chúng Lôi Chi Quân Vương Kiếp
万佛=Vạn Phật
万俟寂寞=Vạn Hầu Tịch Mịch
万兵之刃=Vạn Binh Chi Nhận
万剑之山=Vạn Kiếm Chi Sơn
万剑同悲=Vạn Kiếm Đồng Bi
万剑大阵=Vạn Kiếm Đại Trận
万剑山庄=Vạn Kiếm Sơn Trang
万剑归一=Vạn Kiếm Quy Nhất
万剑归宗=Vạn Kiếm Quy Tông
万剑归宗大法=Vạn Kiếm Quy Tông Đại Pháp
万剑灵石=Vạn Kiếm Linh Thạch
万剑轮回=Vạn Kiếm Luân Hồi
万剑震动=Vạn Kiếm Chấn Động
万劫不灭的永恒之主=Vạn Kiếp Bất Diệt Vĩnh Hằng Chi Chủ
万变步法=Vạn Biến Bộ Pháp
万叶齐发=Vạn Diệp Tề Phát
万善之源=Vạn Thiện Chi Nguyên
万均之势=Vạn Quân Chi Thế
万妖=Vạn Yêu
万字文=Vạn Tự Văn
万宝琉璃落=Vạn Bảo Lưu Ly Lạc
万家生佛碑=Vạn Gia Sinh Phật Bi
万年醉酒=Vạn Niên Túy Tửu
万恶之源=Vạn Ác Chi Nguyên
万恶乌云=Vạn Ác Ô Vân
万斩鸟=Vạn Trảm Điểu
万智=Vạn Trí
万有引力=Vạn Hữu Dẫn Lực
万毒之蛊=Vạn Độc Chi Cổ
万水归宗=Vạn Thủy Quy Tông
万水真一功=Vạn Thủy Chân Nhất Công
万法之火=Vạn Pháp Chi Hỏa
万法地火=Vạn Pháp Địa Hỏa
万法旋生=Vạn Pháp Toàn Sinh
万法瀑布=Vạn Pháp thác nước
万法门=Vạn Pháp Môn
万清王=Vạn Thanh Vương
万湖门=Vạn Hồ Môn
万物回春=Vạn Vật Hồi Xuân
万磁王剑=Vạn Từ Vương Kiếm
万神=Vạn Thần
万蛇山庄=Vạn Xà Sơn Trang
万象森罗=Vạn Tượng Sâm La
万象森罗剑道=Vạn Tượng Sâm La Kiếm Đạo
万败真经=Vạn Bại Chân Kinh
万道修罗=Vạn Đạo Tu La
万酸之剑=Vạn Toan Chi Kiếm
万魔=Vạn Ma
万魔灭元阵=Vạn Ma Diệt Nguyên Trận
万魔灭生大阵=Vạn Ma Diệt Sinh Đại Trận
万魔祖=Vạn Ma Tổ
万鹰文明杀法=Vạn Ưng Văn Minh Sát Pháp
万龙帝拳=Vạn Long Đế Quyền
万！物！归！本！=Vạn! Vật! Quy! Bản!
三七七七大阵=Đại trận tam thất thất thất
三书师叔=Tam Thư sư thúc
三书文明=Tam thư văn minh
三书文明副主=Phó Chủ Văn Minh Tam Thư
三书文明境副主=Tam Thư Văn Minh Cảnh Phó Chủ
三剑圣=Tam Kiếm Thánh
三十三天=Ba Mươi Ba Thiên
三十五君子=Ba mươi lăm vị quân tử
三号=Tam Hào
三品悟道之地=Địa ngộ đạo tam phẩm
三国=Tam Quốc
三国主卓凌云=Tam quốc chủ Trác Lăng Vân
三大圣地密教=Tam Đại Thánh Địa Mật Giáo
三头六臂=Tam Đầu Lục Tý
三头狮子古古兽=Cổ Cổ thú sư ba đầu
三头穿地龙=Tam Đầu Xuyên Địa Long
三字经=Tam Tự Kinh
三师姐=Tam sư tỷ
三帝子=Tam Đế Tử
三昧天雷=Tam Muội Thiên Lôi
三昧真火=Tam Muội Chân Hỏa
三昧神风=Tam Muội Thần Phong
三月杨柳=Liễu Dương tháng ba
三极归一剑=Tam Cực Quy Nhất Kiếm
三极归一式=Tam Cực Quy Nhất Thức
三派联盟=Liên minh Tam phái
三灵元圣=Tam Linh Nguyên Thánh
三生之石=Tam Sinh Chi Thạch
三生之阵=Tam Sinh Chi Trận
三百五十位=Ba trăm năm mươi vị
三纪元=Tam Kỷ Nguyên
三纲五常=Tam cương Ngũ thường
三花酒=Tam Hoa Tửu
三败草庐=Tam Bại Thảo Lư
三辰酒=Tam Thần Tửu
三重天=Tam Trọng Thiên
三铁纪=Tam Thiết Kỷ
三附马=Tam Phụ Mã
上之剑意=Thượng Chi Kiếm Ý
上古=Thượng Cổ
上古剑者=Thượng Cổ Kiếm Giả
上古剑者令=Lệnh Kiếm Giả Thượng Cổ
上古剑者墓=Thượng Cổ Kiếm Giả Mộ
上古剑道=Thượng Cổ Kiếm Đạo
上古神级=Cấp Thượng Cổ Thần
上古神龙剑气=Thượng Cổ Thần Long Kiếm Khí
上古神龙诀=Thượng Cổ Thần Long Quyết
上古符咒=Thượng Cổ Phù Chú
上古鹰魔神=Thượng Cổ Ưng Ma Thần
上古龙神诀=Thượng Cổ Long Thần Quyết
上品灵石=Thượng phẩm linh thạch
上官=Thượng Quan
上官右轩=Thượng Quan Hữu Hiên
上官夜=Thượng Quan Dạ
上官家=Thượng Quan Gia
上官左轩=Thượng Quan Tả Hiên
上官春=Thượng Quan Xuân
上官煞=Thượng Quan Sát
上官至尊=Thượng Quan chí tôn
上官读=Thượng Quan Độc
上官青=Thượng Quan Thanh
上官骇=Thượng Quan Hãi
上官鹤=Thượng Quan Hạc
上官鼎=Thượng Quan Đỉnh
上帝=Thượng Đế
上洞八仙=Thượng Động Bát Tiên
上清灵宝天尊=Thượng Thanh Linh Bảo Thiên Tôn
上灭剑法=Thượng Diệt Kiếm Pháp
上等仙门=Thượng Đẳng Tiên Môn
不动如山=Bất Động Như Sơn
不动明王=Bất Động Minh Vương
不屈=Bất Khuất
不屈之流光=Bất Khuất Chi Lưu Quang
不死=Bất Tử
不死之城=Bất Tử Chi Thành
不死传奇=Bất Tử Truyền Kỳ
不死城=Bất Tử Thành
不死文明之主=Bất Tử Văn Minh Chi Chủ
不死那一派=Bất Tử Nhất Phái
与世同君=Dữ Thế Đồng Quân
世界=Thế giới
世界之光=Thế Giới Chi Quang
世界之力=Thế Giới Chi Lực
世界之木=Thế Giới Chi Mộc
世界唯我=Thế Giới Duy Ngã
世界境=Thế Giới Cảnh
世界境八重天真界境=Thế Giới Cảnh Bát Trọng Thiên Chân Giới Cảnh
世界天劫=Thiên kiếp thế giới
世界火山=Thế Giới Hỏa Sơn
世界级法术=Pháp Thuật Cấp Thế Giới
业之剑意=Nghiệp Chi Kiếm Ý
业力=Nghiệp Lực
业力之火=Nghiệp Lực Chi Hỏa
业火=Nghiệp Hỏa
业魔=Nghiệp Ma
东之剑意=Đông Chi Kiếm Ý
东南西北上中下=Đông Nam Tây Bắc Thượng Trung Hạ
东南角=Góc Đông Nam
东开鸿濛之先=Đông Khai Hồng Mông Chi Tiên
东方大易国=Đông Phương Đại Dịch Quốc
东方妖=Đông Phương Yêu
东方玄幻=Đông Phương Huyền Huyễn
东方鬼帝=Đông Phương Quỷ Đế
东方鬼帝郁垒=Đông Phương Quỷ Đế Úy Lũy
东极仙翁=Đông Cực Tiên Ông
东极龙宫=Đông Cực Long Cung
东邪=Đông Tà
东邪西毒=Đông Tà Tây Độc
东野=Đông Dã
东野至尊=Đông Dã Chí Tôn
东野良=Đông Dã Lương
东野苍=Đông Dã Thương
两柱香=Hai nén nhang
两铁则剑圣=Lưỡng Thiết Tắc Kiếm Thánh
两面剑者令=Lệnh Kiếm Giả Hai Mặt
严千法=Nghiêm Thiên Pháp
严子兴=Nghiêm Tử Hưng
严子法=Nghiêm Tử Pháp
严子灭=Nghiêm Tử Diệt
严家=Nghiêm Gia
严敢当=Nghiêm Cảm Đương
严敢笑=Nghiêm Cảm Tiếu
严鹤=Nghiêm Hạc
丧魂灭魄罡风=Tang Hồn Diệt Phách Cương Phong
个人中央令=Cá Nhân Trung Ương Lệnh
中品灵石=trung phẩm linh thạch
中央之层=Trung Ương Chi Tầng
中央之鼎=Trung Ương Chi Đỉnh
中央天朝=Trung Ương Thiên Triều
中央鼎=Trung Ương Đỉnh
中宫=Trung Cung
中年书生=Trung niên thư sinh
中庸=Trung Dung
中庸圣经=Trung Dung Thánh Kinh
中极之剑=Trung Cực Chi Kiếm
中极后土心经=Trung Cực Hậu Thổ Tâm Kinh
中极神拳=Trung Cực Thần Quyền
中极门=Trung Cực Môn
中法=Trung Pháp
中法王法道=Trung Pháp Vương Pháp Đạo
中阶神物=Trung Giai Thần Vật
丹奴=Đan Nô
丹火之毒=Đan Hỏa Chi Độc
丹眼=Đan Nhãn
丹药文明=Văn Minh Đan Dược
丹顶仙鹤=Đan Đỉnh Tiên Hạc
为恶僧人=Vi Ác Tăng Nhân
主之牢=Chủ chi lao
主之终极锁链=Chủ Chi Chung Cực Tỏa Liên
主之终极锁链天劫=Thiên kiếp Chuỗi khóa tối thượng của Chủ
主之锁链=Chủ Chi Tỏa Liên
乌云文明副主=Ô Vân Văn Minh Phó Chủ
乐霜=Nhạc Sương
乔飞渡=Kiều Phi Độ
九个半纪元=Chín cái bán Kỷ Nguyên
九九文明之主=Cửu Cửu Văn Minh Chi Chủ
九十九仙剑=Cửu Thập Cửu Tiên Kiếm
九华仙门=Cửu Hoa Tiên Môn
九华山=Cửu Hoa Sơn
九华心法=Cửu Hoa Tâm Pháp
九号=Cửu Hào
九命猫妖=Cửu Mệnh Miêu Yêu
九天台=Đài Cửu Thiên
九天急风术=Cửu Thiên Cấp Phong Thuật
九天玄女=Cửu Thiên Huyền Nữ
九天羽纱=Cửu Thiên Vũ Sa
九天风隐术=Cửu Thiên Phong Ẩn Thuật
九天风雪兔=Cửu Thiên Phong Tuyết Thỏ
九头火麒麟=Cửu Đầu Hỏa Kỳ Lân
九头狮子=Cửu Đầu Sư Tử
九尾猫妖=Cửu Vĩ Miêu Yêu
九星连环剑法=Cửu Tinh Liên Hoàn Kiếm Pháp
九曲邪蛇=Cửu Khúc Tà Xà
九条天晶鱼=Cửu Điều Thiên Tinh Ngư
九极文明之主=Cửu Cực Văn Minh Chi Chủ
九纪元=Cửu Kỷ Nguyên
九荒极=Cửu Hoang Cực
九荒胎=Cửu Hoang Thai
九荒追=Cửu Hoang Truy
九荒霸=Cửu Hoang Bá
九转金龙大法=Cửu Chuyển Kim Long Đại Pháp
九阳=Cửu Dương
九阴九阳=Cửu Âm Cửu Dương
九霄环佩=Cửu Tiêu Hoàn Bội
九龙帝拳=Cửu Long Đế Quyền
九龙帝袍=Cửu Long Đế Bào
书写乾坤=Thư Tả Càn Khôn
书籍一线天=Thư Tịch Nhất Tuyến Thiên
乱之剑意=Loạn Chi Kiếm Ý
乱党=Loạn Đảng
乱剑披麻=Loạn Kiếm Phi Ma
乱情斩=Loạn Tình Trảm
乾坤宫=Càn Khôn Cung
乾坤殿=Càn Khôn Điện
乾坤醉酒一剑=Càn Khôn Túy Tửu Nhất Kiếm
乾天星=Càn Thiên Tinh
乾宫=Càn Cung
二十一层计划=Kế hoạch Hai Mươi Mốt
二十四节气指法=Nhị Thập Tứ Tiết Khí Chỉ Pháp
二十纪元=Hai mươi Kỷ Nguyên
二号=Đệ Nhị Hào
二四=Nhị Tứ
二国主纳兰德=Nhị quốc chủ Nạp Lan Đức
二师兄=Nhị sư huynh
二师兄孟韦=Nhị sư huynh Mạnh Vi
二百二十二种招式=Hai trăm hai mươi hai loại chiêu thức
二级文字=Chữ viết cấp hai
二纪元=Nhị Kỷ Nguyên
二胡=Đàn nhị hồ
二败倾城=Nhị Bại Khuynh Thành
二重至仙剑=Nhị Trọng Chí Tiên Kiếm
二铁则剑圣=Nhị Thiết Tắc Kiếm Thánh
二附马=Nhị Phụ Mã
于家=Vu Gia
于豪雄=Vu Hào Hùng
云之上古符咒=Vân Chi Thượng Cổ Phù Chú
云之元婴=Vân Chi Nguyên Anh
云之剑意=Vân Chi Kiếm Ý
云之天地法则=Vân Chi Thiên Địa Pháp Tắc
云之式=Vân Chi Thức
云之本命元婴=Vân Chi Bản Mệnh Nguyên Anh
云光绣袍=Vân Quang Tú Bào
云家=Vân gia
云无=Vân Vô
云无相=Vân Vô Tướng
云无踪=Vân Vô Tung
云系灵龙=Vân Hệ Linh Long
云袖雪=Vân Tụ Tuyết
云辇=Vân Liễn
云道=Vân Đạo
云隐台=Đài Vân Ẩn
云雨化龙大法=Vân Vũ Hóa Long Đại Pháp
云雾公主=Vân Vụ công chúa
云龙十变=Vân Long Thập Biến
云龙十变心法=Vân Long Thập Biến Tâm Pháp
云龙心法=Vân Long Tâm Pháp
五仙盟=Ngũ Tiên Minh
五十天榜=Ngũ Thập Thiên Bảng
五号=Ngũ Hào
五味之剑=Ngũ Vị Chi Kiếm
五味剑=Ngũ Vị Kiếm
五大剑堂=Ngũ Đại Kiếm Đường
五大古文明=Ngũ Đại Cổ Văn Minh
五岳=Ngũ Nhạc
五岳曲=Ngũ Nhạc Khúc
五峰=Ngũ Phong
五帝五皇轮回剑道=Ngũ Đế Ngũ Hoàng Luân Hồi Kiếm Đạo
五帝剑道=Ngũ Đế Kiếm Đạo
五庄观=Ngũ Trang Quan
五战三胜=Ngũ Chiến Tam Thắng
五月=Tháng Năm
五极归一式=Ngũ Cực Quy Nhất Thức
五舌地狱=Ngũ Thiệt Địa Ngục
五色神石=Ngũ Sắc Thần Thạch
五行=Ngũ hành
五行尸何青干=Ngũ Hành Thi Hà Thanh Can
五行酒=Ngũ Hành Tửu
五零零零大阵=Đại trận ngũ linh linh linh
人之道=Nhân Chi Đạo
人剑=Nhân Kiếm
人剑魂=Nhân Kiếm Hồn
人参果=Nhân Sâm Quả
人参果树=Nhân sâm quả thụ
人和=Nhân Hòa
人杰=Nhân kiệt
人界合一果=Nhân Giới Hợp Nhất Quả
人面兽心我称魔=Nhân Diện Thú Tâm Ngã Xưng Ma
亿万书屋=Ức Vạn Thư Ốc
亿年寒冰之水=Ức Niên Hàn Băng Chi Thủy
亿毒之蛊=Ức Độc Chi Cổ
仇清山=Cừu Thanh Sơn
仇鬼刀傅仇=Trừu Quỷ Đao Phó Cừu
仙之子=Tiên Chi Tử
仙之封神台=Tiên Chi Phong Thần Đài
仙之文明副主=Tiên Chi Văn Minh Phó Chủ
仙之锁链=Tiên Chi Tỏa Liên
仙侠=Tiên Hiệp
仙侠一剑=Tiên Hiệp Nhất Kiếm
仙剑=Tiên Kiếm
仙剑养吾=Tiên Kiếm Dưỡng Ngô
仙剑宗=Tiên Kiếm Tông
仙力=Tiên Lực
仙华=Tiên Hoa
仙华峰=Tiên Hoa Phong
仙古=Tiên Cổ
仙古文明=Tiên Cổ Văn Minh
仙古文明之主=Tiên Cổ Văn Minh Chi Chủ
仙古文明副主=Tiên Cổ Văn Minh Phó Chủ
仙古文明玉皇大帝=Tiên Cổ Văn Minh Ngọc Hoàng Đại Đế
仙古文明的鸿一文明之主=Tiên Cổ Văn Minh Hồng Nhất Văn Minh Chi Chủ
仙字=Tiên tự
仙无踪=Tiên Vô Tung
仙法=Tiên Pháp
仙法百重大地=Tiên Pháp Bách Trọng Đại Địa
仙法荒=Tiên Pháp Hoang
仙炎之火=Tiên Viêm Chi Hỏa
仙王法杖=Tiên Vương Pháp Trượng
仙界三十三天=Tiên Giới Tam Thập Tam Thiên
仙系=Tiên hệ
仙遁五法=Tiên Độn Ngũ Pháp
仙锻=Tiên Đoán
仙门=Tiên Môn
仙风九变=Tiên Phong Cửu Biến
仙风佛联盟=Liên minh Tiên Phong Phật
仙风文明=Tiên Phong Văn Minh
仙风文明副主=Phó chủ Văn minh Tiên Phong
仞利天=Nhận Lợi Thiên
仞利天魔尊=Nhận Lợi Thiên Ma Tôn
仞利天魔尊分身=Nhận Lợi Thiên Ma Tôn Phân Thân
代魄丹=Đại Phách Đan
令灵剑=Lệnh Linh Kiếm
任无星=Nhậm Vô Tinh
任独=Nhậm Độc
任碧凝=Nhậm Bích Ngưng
伏虎汉罗=Phục Hổ Hán La
伞之文明=Văn minh Tán
伞之文明副主=Tán Chi Văn Minh Phó Chủ
伞圣帝子=Tán Thánh Đế Tử
伞锏人尚明白=Tán Kiển Nhân Thượng Minh Bạch
传孟仙书=Truyện Mạnh Tiên Thư
传正仙书=Truyền Chính Tiên Thư
传正神书=Thần Thư Truyền Chính
传送符=Truyền tống phù
伦常心经=Luân Thường Tâm Kinh
伪之冰封空间=Ngụy Chi Băng Phong Không Gian
伪君子凌青天=Ngụy Quân Tử Lăng Thanh Thiên
伪！三字经=Ngụy! Tam tự kinh
何求意=Hà Cầu Ý
何谓浩然正气=Hà vị Hạo nhiên chính khí
何青干=Hà Thanh Can
余师兄=Dư sư huynh
佛之子=Phật Chi Tử
佛力=Phật Lực
佛原=Phật Nguyên
佛原文明=Phật Nguyên Văn Minh
佛原文明之主=Phật Nguyên văn minh chi chủ
佛古=Phật Cổ
佛古文明=Phật Cổ Văn Minh
佛古文明之主=Phật Cổ Văn Minh Chi Chủ
佛古文明的佛宗文明之主=Phật Cổ Văn Minh Phật Tông Văn Minh Chi Chủ
佛宗文明之主=Chủ văn minh Phật Tông
佛巫文明之主=Chủ nhân Văn minh Phật Vu
佛巫文明副主=Phật Vu Văn Minh Phó Chủ
佛心明镜=Phật Tâm Minh Kính
佛心明镜之法=Phật Tâm Minh Kính Chi Pháp
佛心涅磐=Phật Tâm Niết Bàn
佛掌无量=Phật Chưởng Vô Lượng
佛教大能=Phật Giáo Đại Năng
佛气=Phật Khí
佛珠=Phật Châu
佛皇文明之主=Phật Hoàng Văn Minh Chi Chủ
佛祖=Phật Tổ
佛荒仙三古=Phật Hoang Tiên Tam Cổ
佛门=Phật Môn
佛陀剑修=Phật Đà Kiếm Tu
佛陀无极罩=Phật Đà Vô Cực Tráo
信念之剑=Niềm Tin Chi Kiếm
偶起波澜=Ngẫu Khởi Ba Lan
偷之文明=Văn minh Đạo
傀儡门=Khôi Lỗi Môn
傅仇=Phó Cừu
傅冲=Phó Xung
傅冲天龙雕=Phó Xung Thiên Long Điêu
傅家=Phó Gia
傅易=Phó Dịch
傅易师兄=Phó Dịch sư huynh
傅穷天=Phó Cùng Thiên
傅老双=Phó Lão Song
傅老鬼=Phó Lão Quỷ
傅鹰=Phó Ưng
傲之极限=Ngạo Chi Cực Hạn
傲苍生=Ngạo Thương Sinh
僵尸之祖=Cương Thi Chi Tổ
僵尸祖气=Cương Thi Tổ Khí
儒之九式=Nho Chi Cửu Thức
儒之书殿=Nho Chi Thư Điện
儒之大者=Nho Chi Đại Giả
儒之小千世界=Nho Chi Tiểu Thiên Thế Giới
儒之文明=Nho Chi Văn Minh
儒之文明副主=Phó Chủ Văn Minh Nho
儒之文明副主的遗体=di thể Nho Chi Văn Minh Phó Chủ
儒之文胆副主=Nho Chi Văn Đảm Phó Chủ
儒之正殿=Nho Chi Chính Điện
儒之正道=Nho Chi Chính Đạo
儒之神剑=Nho Chi Thần Kiếm
儒剑之屋=Nho Kiếm Chi Ốc
儒力=Nho Lực
儒家=Nho gia
儒道正经=Nho Đạo Chính Kinh
元三国=Tam quốc Nguyên
元元上人=Nguyên Nguyên Thượng Nhân
元凌=Nguyên Lăng
元凌上人=Nguyên Lăng Thượng Nhân
元国=Nguyên Quốc
元始天尊=Nguyên Thủy Thiên Tôn
元始文明副主=Nguyên Thủy Văn Minh Phó Chủ
元始玉清文明副主=Nguyên Thủy Ngọc Thanh Văn Minh Phó Chủ
元婴=Nguyên Anh
元婴控符丹=Viên Anh khống phù đan
元气境=Nguyên Khí Cảnh
元素塔=Nguyên Tố Tháp
元素楼=Nguyên Tố Lâu
元阳上人=Nguyên Dương Thượng Nhân
先天法宝=Tiên Thiên Pháp Bảo
先天灵宝=Tiên Thiên Linh Bảo
先天鸿蒙之气=Tiên thiên Hồng Mông Chi Khí
光之剑意=Quang Chi Kiếm Ý
光奴=Quang Nô
光神=Quang Thần
光脑=Quang Não
克制定理之书=Sách Khắc Chế Định Lý
克字=Khắc tự
克字分身=Khắc Tự Phân Thân
克荒之剑=Khắc Hoang Chi Kiếm
克蛊正道=Khắc Cổ Chính Đạo
克锏剑道=Khắc Giản Kiếm Đạo
兑宫=Đoài Cung
兑泽星=Đoài Trạch Tinh
全真剑门=Toàn Chân Kiếm Môn
八号=Bát Hào
八极炼阴之火=Bát Cực Luyện Âm Chi Hỏa
八极阴炼之火=Bát Cực Âm Luyện Chi Hỏa
八柄神锏=Tám bính thần giản
八棱之锏=Bát Lăng Chi Giản
八棱文明=Bát Lăng văn minh
八棱文明副主=Phó chủ văn minh Bát Lăng
八神剑=Bát Thần Kiếm
八神锏=Bát Thần Giản
八纪元=Bát Kỷ Nguyên
八脉比积分=Bát Mạch Tỷ Tích Phân
八荒大蛇=Bát Hoang Đại Xà
八金刚=Bát Kim Cương
八锏文明流=Bát Giản Văn Minh Lưu
公孙越=Công Tôn Việt
公孙青龙=Công Tôn Thanh Long
公平之剑=Kiếm Công Bằng
公平之尺=Thước Công Bằng
公平文明副主=Phó Chủ Văn Minh Công Bằng
公羊=Công Dương
公羊毫=Công Dương Hào
公羊至尊=Công Dương Chí Tôn
公羊般=Công Dương Bàn
公羊般至尊=Công Dương Bàn Chí Tôn
六号=Lục Hào
六合无敌=Lục Hợp Vô Địch
六大命运铁则=Lục Đại Vận Mệnh Thiết Tắc
六大极限=Lục Đại Cực Hạn
六师弟=Lục sư đệ
六扇门=Lục Phiến Môn
六极归一=Lục Cực Quy Nhất
六极归一式=Lục Cực Quy Nhất Thức
六纪元=Lục Kỷ Nguyên
六艺全能=Lục Nghệ Toàn Năng
兰生酒=Lan Sinh Tửu
其惟冬夏=Kỳ Duy Đông Hạ
养吾=Dưỡng Ngô
养吾仙剑=Dưỡng Ngô Tiên Kiếm
养吾剑=Dưỡng Ngô Kiếm
养吾剑仙=Dưỡng Ngô Kiếm Tiên
养吾剑法=Dưỡng Ngô Kiếm Pháp
养吾剑灵=Dưỡng Ngô Kiếm Linh
养吾浩然正气之剑=Dưỡng Ngô Hạo Nhiên Chính Khí Chi Kiếm
养吾灵剑=Dưỡng Ngô Linh Kiếm
养吾神剑=Dưỡng Ngô Thần Kiếm
兽武百招诀=Thú Võ Bách Chiêu Quyết
兽武门=Thú Võ Môn
兽魂山=Thú Hồn Sơn
军师锏云愁=Quân sư Kiển Vân Sầu
农之一刀=Nông Chi Nhất Đao
冬之剑意=Đông Chi Kiếm Ý
冬季寒寂=Đông Quý Hàn Tịch
冬帝剑道=Đông Đế Kiếm Đạo
冰之=Băng Chi
冰之剑意=Băng Chi Kiếm Ý
冰之文明=Băng Chi Văn Minh
冰之文明副主=Băng Chi Văn Minh Phó Chủ
冰兄=Băng huynh
冰寒帝后=Băng Hàn Đế Hậu
冰心帝妃=Băng Tâm Đế Phi
冰清=Băng Thanh
冰雪之手=Băng Tuyết Chi Thủ
冰魄神刀=Băng Phách Thần Đao
冲霄剑楼=Xung Tiêu Kiếm Lâu
决斗峰=Quyết Đấu Phong
况是青春日将暮，桃花乱落如红雨。劝君终日酩酊醉，酒不到刘伶坟上土=Huống thị thanh xuân nhật tương mộ, đào hoa loạn lạc như hồng vũ. Khuyến quân chung nhật mính đinh túy, tửu bất đáo Lưu Linh phần thượng thổ
冷风=Lãnh Phong
准提=Chuẩn Đề
准提佛祖=Chuẩn Đề Phật Tổ
凌仇=Lăng Cừu
凌玉珠=Lăng Ngọc Châu
凌雄天=Lăng Hùng Thiên
凌青云=Lăng Thanh Vân
凌青云父子=Lăng Thanh Vân phụ tử
凝固星域=Ngưng Cố Tinh Vực
凝炼大荒之兽的魂魄入身=Ngưng luyện Đại Hoang Chi Thú chi hồn phách nhập thân
凝炼真祖之血=Ngưng Luyện Chân Tổ Chi Huyết
凝炼金身真丹=Ngưng Luyện Kim Thân Chân Đan
凤之大陆=Phượng Chi Đại Lục
凤凰=Phượng Hoàng
凤古=Phượng Cổ
凤古三十三天=Ba mươi ba tầng trời Phượng Cổ
凤古文明=Phượng Cổ Văn Minh
凤古文明之主=Phượng Cổ Văn Minh Chi Chủ
凤后=Phượng Hậu
凤后文明之主=Phượng Hậu Văn Minh Chi Chủ
凤求凰=Phượng Cầu Hoàng
凤雀簪链=Phượng Tước Trâm Liên
凤首台=Đài Phượng Thủ
凤首大陆=Đại lục Phượng Thủ
出云国=Xuất Vân quốc
出轨刀=Xuất Quỹ Đao
刀枪剑戟锁=Đao Thương Kiếm Kích Tỏa
刀纵横=Đao Tung Hoành
分景之兵=Binh Khí Phân Cảnh
分纲=Phân cương
分身术=Phân Thân Thuật
分金照=Phân Kim Chiếu
刑之文明之主=Hình Chi Văn Minh Chi Chủ
初代剑主=Sơ Đại Kiếm Chủ
初始文字=Chữ Viễn Thủy
初始文字正字=Chữ Chính Khởi Thủy
初始文字瘟=Chữ khởi nguyên Ôn
初始文正字=Khởi Thủy Văn Chính Tự
制怒诀=Chế Nộ Quyết
刹神枪=Sát Thần Thương
刹那=Sát Na
刹那之城=Sát Na Chi Thành
刹那城池=Thát Na Thành Trì
刹那文明之主=Sát Na Văn Minh Chi Chủ
刹那永恒大法=Sát Na Vĩnh Hằng Đại Pháp
刹那芳华大法=Sát Na Phương Hoa Đại Pháp
刺之剑意=Thích Chi Kiếm Ý
前后左右乾坤石=Đá Càn Khôn trước sau trái phải
前字=Tiền Tự
剑一=Kiếm Nhất
剑七=Kiếm Thất
剑七，小剑界=Kiếm Thất, Tiểu Kiếm Giới
剑三=Kiếm Tam
剑中之魔=Kiếm Trung Chi Ma
剑主=Kiếm chủ
剑主堂=Kiếm Chủ Đường
剑主山=Kiếm Chủ Sơn
剑之世界=Thế giới Kiếm
剑之十八天=Kiếm Chi Thập Bát Thiên
剑之地狱=Kiếm Chi Địa Ngục
剑之子=Kiếm Chi Tử
剑之守护令=Kiếm Chi Thủ Hộ Lệnh
剑之宫=Kiếm Chi Cung
剑之小千世界=Kiếm Chi Tiểu Thiên Thế Giới
剑之文明=Kiếm Chi Văn Minh
剑之文明之主=Kiếm Chi Văn Minh Chi Chủ
剑之文明副主=Kiếm Chi Văn Minh Phó Chủ
剑之星=Kiếm Chi Tinh
剑之滔滔=Kiếm Chi Thao Thao
剑之空间=Không gian kiếm
剑之纪元=Kiếm Chi Kỷ Nguyên
剑之舟=Kiếm Chi Chu
剑九=Kiếm Cửu
剑九长老=Kiếm Cửu trưởng lão
剑九，七情之剑=Kiếm Cửu, Thất Tình Chi Kiếm
剑二=Kiếm Nhị
剑云=Kiếm Vân
剑云一派=Kiếm Vân Nhất Phái
剑云中祖=Kiếm Vân Trung Tổ
剑云城=Kiếm Vân Thành
剑云城池=Kiếm Vân Thành Trì
剑五=Kiếm Ngũ
剑五，唯剑=Kiếm Ngũ, Duy Kiếm
剑人状态=Kiếm nhân trạng thái
剑侠文明副主=Kiếm Hiệp Văn Minh Phó Chủ
剑侯=Kiếm Hầu
剑修=Kiếm tu
剑修星辰=Kiếm Tu Tinh Thần
剑傲群星=Kiếm Ngạo Quần Tinh
剑光=kiếm quang
剑八=Kiếm Bát
剑八，万剑归一=Kiếm Bát, Vạn Kiếm Quy Nhất
剑六=Kiếm Lục
剑六，慑天=Kiếm Lục, Nhiếp Thiên
剑出平平=Kiếm Xuất Bình Bình
剑出淡淡=Kiếm Xuất Đạm Đạm
剑动宇宙=Kiếm Động Vũ Trụ
剑动山河=Kiếm Động Sơn Hà
剑动星辰=Kiếm Động Tinh Thần
剑动风云=Kiếm Động Phong Vân
剑十=Kiếm Thập
剑十一=Kiếm Thập Nhất
剑十五=Kiếm Thập Ngũ
剑南春=Kiếm Nam Xuân
剑卷=Kiếm Quyển
剑古=Kiếm Cổ
剑古文明=Kiếm Cổ Văn Minh
剑古文明之主=Kiếm Cổ Văn Minh Chi Chủ
剑古斗天=Kiếm Cổ Đấu Thiên
剑四=Kiếm Tứ
剑圆=Kiếm Viên
剑圆之道=Kiếm Viên Chi Đạo
剑圆文明=Kiếm Viên Văn Minh
剑圆文明副主=Kiếm Viên Văn Minh Phó Chủ
剑圣=Kiếm Thánh
剑圣之心=Kiếm Thánh Chi Tâm
剑如海=Kiếm Như Hải
剑如钝=Kiếm Như Độn
剑字=Chữ Kiếm
剑宗=Kiếm Tông
剑峰=Kiếm Phong
剑师传承=Kiếm Sư Truyền Thừa
剑式=Kiếm thức
剑形之物=vật hình kiếm
剑忘碑=Kiếm Vong Bi
剑惊四方云起落=Kiếm Kinh Tứ Phương Vân Khởi Lạc
剑惊文明之主=Kiếm Kinh Văn Minh Chi Chủ
剑意=kiếm ý
剑意怪物=Kiếm Ý Quái Vật
剑慧=Kiếm Tuệ
剑慧剑魔=Kiếm Huệ Kiếm Ma
剑技=kiếm kỹ
剑技流=Kiếm Kỹ Lưu
剑招=Kiếm chiêu
剑搅风云=Kiếm Giảo Phong Vân
剑文昌=Kiếm Văn Xương
剑文豪=Kiếm Văn Hào
剑斩至尊=Kiếm Trảm Chí Tôn
剑新世界=Thế giới kiếm mới
剑方方绝=Kiếm Phương Phương Tuyệt
剑星宫=Kiếm Tinh Cung
剑术一条龙=Kiếm thuật Nhất Điều Long
剑术一线天=Kiếm Thuật Nhất Tuyến Thiên
剑术无双=Kiếm Thuật Vô Song
剑极宫=Kiếm Cực Cung
剑极山=Kiếm Cực Sơn
剑柄=Chuôi Kiếm
剑树气运雾=Kiếm Thụ Khí Vận Vụ
剑步=Kiếm Bộ
剑气=Kiếm khí
剑浮神兽=Kiếm Phù Thần Thú
剑浮雕=Kiếm Phù Điêu
剑清幽=Kiếm Thanh U
剑渡星海=Kiếm Độ Tinh Hải
剑潜=Kiếm Tiềm
剑潜剑=Kiếm Tiềm
剑灭老祖=Kiếm Diệt Lão Tổ
剑灭老鬼=Kiếm Diệt Lão Quỷ
剑灵=Kiếm Linh
剑灵宫=Kiếm Linh Cung
剑灵帝姬=Kiếm Linh Đế Cơ
剑灵帝姬云袖雪=Kiếm Linh Đế Cơ Vân Tụ Tuyết
剑烈文明副主=Kiếm Liệt Văn Minh Phó Chủ
剑狂=Kiếm Cuồng
剑狱=Kiếm Ngục
剑王=Kiếm Vương
剑电文明副主=Kiếm Điện Văn Minh Phó Chủ
剑界=Kiếm Giới
剑疯=Kiếm Phong
剑疯真人=Kiếm Phong Chân Nhân
剑皇=Kiếm Hoàng
剑祖=Kiếm Tổ
剑祖城=Kiếm Tổ Thành
剑祖大阵=Kiếm Tổ Đại Trận
剑祖星辰=Kiếm Tổ Tinh Thần
剑祖星辰之主=Kiếm Tổ Tinh Thần Chi Chủ
剑神=Kiếm Thần
剑秀=Kiếm Tú
剑绝=Kiếm Tuyệt
剑绝剑=Kiếm Tuyệt
剑老=Kiếm Lão
剑者=Kiếm Giả
剑者之路=Kiếm Giả Chi Lộ
剑者令=Kiếm Giả Lệnh
剑胜丹=Kiếm Thắng Đan
剑舞=Kiếm vũ
剑苦=Kiếm Khổ
剑苦文明=Văn minh Kiếm Khổ
剑苦文明副主=Kiếm Khổ Văn Minh Phó Chủ
剑虚=Kiếm Hư
剑虚中祖=Kiếm Hư Trung Tổ
剑虚城=Kiếm Hư Thành
剑虚城池=Kiếm Hư Thành Trì
剑败十方=Kiếm Bại Thập Phương
剑贪=Kiếm Tham
剑轮回=Kiếm Luân Hồi
剑轻鸣=Kiếm Khinh Minh
剑遇风云=Kiếm Ngộ Phong Vân
剑道=Kiếm Đạo
剑道世界果=Kiếm Đạo Thế Giới Quả
剑道之树=Kiếm Đạo Chi Thụ
剑道之门=Kiếm Đạo Chi Môn
剑道之门户=Kiếm Đạo Chi Môn Hộ
剑道八极=Kiếm Đạo Bát Cực
剑道八极之剑贪=Kiếm Đạo Bát Cực Chi Kiếm Tham
剑道叶汁=Kiếm Đạo Diệp Trấp
剑道宫=Kiếm Đạo Cung
剑道文字=Kiếm Đạo Văn Tự
剑道智者=Kiếm Đạo Trí Giả
剑道树=Kiếm Đạo Thụ
剑道树果=Kiếm Đạo Thụ Quả
剑道气运七子=Kiếm Đạo Khí Vận Thất Tử
剑道的小神话=Tiểu Thần Thoại Kiếm Đạo
剑道的神话=Thần thoại Kiếm Đạo
剑道研究室=Kiếm Đạo Nghiên Cứu Thất
剑道葫芦=Kiếm Đạo Hồ Lô
剑道集一术=Kiếm Đạo Tập Nhất Thuật
剑锏一体=Kiếm Kiển Nhất Thể
剑锏剑道=Kiếm Giản Kiếm Đạo
剑镇风云=Kiếm Trấn Phong Vân
剑门=Kiếm Môn
剑门初祖=Kiếm Môn Sơ Tổ
剑门十年祭=Kiếm Môn Thập Niên Tế
剑门宝库=Kiếm Môn Bảo Khố
剑门星辰=Kiếm Môn Tinh Thần
剑阁=Kiếm Các
剑阁研究室=Kiếm Các Nghiên Cứu Thất
剑阵=Kiếm trận
剑随波动=Kiếm Tùy Ba Động
剑雄=Kiếm Hùng
剑雄至尊=Kiếm Hùng Chí Tôn
剑雨=Kiếm Vũ
剑雨文明副主=Kiếm Vũ Văn Minh Phó Chủ
剑零=Kiếm Linh
剑零，穿心一剑！=Kiếm Linh, Xuyên Tâm Nhất Kiếm!
剑零，穿心一剑！四连击=Kiếm Linh, Xuyên Tâm Nhất Kiếm! Tứ Liên Kích
剑零，穿心一剑，四连击！=Kiếm Linh, Xuyên Tâm Nhất Kiếm, Tứ Liên Kích!
剑青文明副主=Kiếm Thanh Văn Minh Phó Chủ
剑顶文明=Văn minh Kiếm Đỉnh
剑顶文明之主=Kiếm Đỉnh Văn Minh Chi Chủ
剑风=Kiếm Phong
剑风中=Kiếm Phong Trung
剑风中祖=Kiếm Phong Trung Tổ
剑风城=Kiếm Phong Thành
剑风城池=Kiếm Phong Thành Trì
剑魄=Kiếm Phách
剑魔=Kiếm Ma
剑魔剑贪=Kiếm Ma Kiếm Tham
剑鹰心得=Kiếm Ưng Tâm Đắc
副主=Phó Chủ
副版月光=Phó Bản Nguyệt Quang
割草苗刀=Đao Miêu Cắt Cỏ
力之文明=Văn minh Lực
力之文明副主=Lực Chi Văn Minh Phó Chủ
力之文明力雄帝子=Lực Chi Văn Minh Lực Hùng Đế Tử
力之铁则=Lực Chi Thiết Tắc
力圣文明=Lực Thánh văn minh
力圣文明副主=Phó chủ văn minh Lực Thánh
力悠帝子=Lực Du Đế Tử
力暴文明=Lực Bạo văn minh
力暴文明副主=Phó chủ văn minh Lực Bạo
力雄帝子=Lực Hùng Đế Tử
功法=Công pháp
动字=Chữ Động
劫难天劫图=Thiên kiếp Đồ kiếp nạn
勒刀千古论春秋=Lặc Đao Thiên Cổ Luận Xuân Thu
化剑归锏大法=Hóa Kiếm Quy Kiển Đại Pháp
化小为大=Hóa Nhỏ Thành Lớn
化木生=Hóa Mộc Sinh
化血大法=Hóa Huyết Đại Pháp
化金真君=Hóa Kim Chân Quân
北之剑意=Bắc Chi Kiếm Ý
北仙=Bắc Tiên
北冥=Bắc Minh
北峰之乱=Loạn Bắc Phong
北峰之变=Biến Cố Bắc Phong
北斗七星=Bắc Đẩu Thất Tinh
北斗主杀=Bắc Đẩu Chủ Sát
北斗主杀剑法=Bắc Đẩu Chủ Sát Kiếm Pháp
北极龙宫=Bắc Cực Long Cung
北落师门星=Bắc Lạc Sư Môn Tinh
十七层计划=Kế hoạch Thập Thất Tầng
十万大州=Mười Vạn Đại Châu
十三修=Thập Tam Tu
十三纪元=Thập Tam Kỷ Nguyên
十九重机关=Mười chín Trọng Cơ Quan
十二剑人大阵=Đại trận Mười hai Kiếm Nhân
十二纪元=Thập Nhị Kỷ Nguyên
十二金人大阵=Thập Nhị Kim Nhân Đại Trận
十亿八千万=Mười ức tám ngàn vạn
十八尾猫妖=Thập Bát Vĩ Miêu Yêu
十六纪元=Mười sáu Kỷ Nguyên
十六纵横=Thập Lục Tung Hoành
十号=Thập Hào
十大奇功=Thập Đại Kỳ Công
十大招式极限=Thập Đại Chiêu Thức Cực Hạn
十大最强门派=Thập Đại Tối Cường Môn Phái
十大真传弟子=Thập Đại Chân Truyền Đệ Tử
十大铁则=Thập Đại Thiết Tắc
十字架星=Thập Tự Giá Tinh
十字道人=Thập Tự Đạo Nhân
十强战匣=Thập Cường Chiến Giáp
十强武学=Thập Cường Võ Học
十强武道=Thập Cường Võ Đạo
十方俱灭=Thập Phương Cụ Diệt
十日尘埃弓=Thập Nhật Trần Ai Cung
十月枫叶=Phong Diệp tháng mười
十爪麒麟=Thập Trảo Kỳ Lân
十王峰=Thập Vương Phong
十锤之剑=Thập Chùy Chi Kiếm
十龙合一大法=Thập Long Hợp Nhất Đại Pháp
千万里穿云一箭=Thiên Vạn Lý Xuyên Vân Nhất Tiễn
千丈=Thiên Trượng
千丈剑气=Thiên trượng kiếm khí
千剑剑气=Thiên Kiếm Kiếm Khí
千妃千水晶=Thiên Phi Thiên Thủy Tinh
千字文=Thiên Tự Văn
千山大法=Thiên Sơn Đại Pháp
千山归一=Thiên Sơn Quy Nhất
千山归一大法=Thiên Sơn Quy Nhất Đại Pháp
千山门=Thiên Sơn Môn
千州=Thiên Châu
千度烧=Thiên Độ Thiêu
千手神屠高进=Thiên Thủ Thần Đồ Cao Tiến
千水大法=Thiên Thủy Đại Pháp
千水真经=Thiên Thủy Chân Kinh
千水门=Thiên Thủy Môn
千法酒=Thiên Pháp Tửu
千蛇=Thiên Xà
半个月=Nửa tháng
半步世界境=Bán Bộ Thế Giới Cảnh
半步文明境=Bán Bộ Văn Minh Cảnh
半魔之帝=Bán Ma Chi Đế
华俯首=Hoa Phủ Thủ
华山=Hoa Sơn
华山三剑=Hoa Sơn Tam Kiếm
华山三神话=Hoa Sơn Tam Thần Thoại
华山中人=Hoa Sơn Trung Nhân
华山五大派=Hoa Sơn Ngũ Đại Phái
华山仙门=Hoa Sơn Tiên Môn
华山副掌门=Hoa Sơn Phó Chưởng Môn
华山基础剑法=Hoa Sơn Cơ Sở Kiếm Pháp
华山居=Hoa Sơn Cư
华山掌门=Hoa Sơn Chưởng Môn
华山神话=Hoa Sơn Thần Thoại
华师兄=Hoa sư huynh
华师弟=Hoa sư đệ
华扁医=Hoa Biển Y
华月生=Hoa Nguyệt Sinh
华法回=Hoa Pháp Hồi
华法圣=Hoa Pháp Thánh
华法生=Hoa Pháp Sinh
华法生师叔=Hoa Pháp Sinh sư thúc
华视=Hoa Thị
华鹤=Hoa Hạc
卓凌云=Trác Lăng Vân
卓师叔=Hoa sư thúc
单位禁绝星域位面大阵=Đơn Vị Cấm Tuyệt Tinh Vực Vị Diện Đại Trận
单位禁绝星域位面阵=Đơn vị cấm tuyệt Tinh Vực vị diện trận
南之剑意=Nam Chi Kiếm Ý
南冥=Nam Minh
南华真人=Nam Hoa Chân Nhân
南华经=Nam Hoa Kinh
南华门=Nam Hoa Môn
南域=Nam Vực
南境=Nam Cảnh
南宫=Nam Cung
南宫潜=Nam Cung Tiềm
南宫白=Nam Cung Bạch
南宫至尊=Nam Cung Chí Tôn
南斗七星=Nam Đẩu Thất Tinh
南斗六星=Nam Đẩu Lục Tinh
南方大庸国=Nam Phương Đại Dung Quốc
南无大明佛=Nam Mô Đại Minh Phật
南无大明咒=Nam Vô Đại Minh Chú
南无宿王佛=Nam Vô Túc Vương Phật
南极仙翁=Nam Cực Tiên Ông
南极龙宫=Nam Cực Long Cung
南海仙门=Nam Hải Tiên Môn
南疆=Nam Cương
南越真人=Nam Việt Chân Nhân
南魔=Nam Ma
南魔北仙=Nam Ma Bắc Tiên
卧虎之袍=Ngọa Hổ Chi Bào
卫星雷=Vệ Tinh Lôi
却邪=Khước Tà
却邪神剑=Khước Tà Thần Kiếm
厉如山=Lệ Như Sơn
厉放=Lệ Phóng
厉鬼攻心=Lệ Quỷ Công Tâm
厉鬼无形=Lệ Quỷ Vô Hình
原中央天朝=Nguyên Trung Ương Thiên Triều
原佛文明之主=Chủ nhân Văn minh Nguyên Phật
原绝心=Nguyên Tuyệt Tâm
原绝赤=Nguyên Tuyệt Xích
原赤心=Nguyên Xích Tâm
原赤绝=Nguyên Xích Tuyệt
原野鹰=Nguyên Dã Ưng
去死去死团=Đoàn tan rã
双圣帝子=Song Thánh Đế Tử
双战=Song Chiến
双王=Song Vương
双环门=Song Hoàn Môn
反荒盟=Phản Hoang Minh
反荒组织=Tổ chức Phản Hoang
变之极限=Biến Chi Cực Hạn
口腔=Khoang Miệng
古之剑者=Cổ Chi Kiếm Giả
古之剑者墓=Cổ Chi Kiếm Giả Mộ
古古兽=Cổ Cổ Thú
古古绝地=Cổ Cổ Tuyệt Địa
古始=Cổ Thủy
古怒=Cổ Nộ
古怪剑道=Cổ Quái Kiếm Đạo
古文明=Cổ Văn Minh
古超=Cổ Siêu
只手遮天=Chỉ Thủ Giá Thiên
史书=Sử Thư
右血王=Hữu Huyết Vương
右血王甘道=Hữu Huyết Vương Cam Đạo
叶圆=Diệp Viên
叶姬=Diệp Cơ
叶姬发=Diệp Cơ Phát
叶字=Chữ Diệp
叶寒风=Diệp Hàn Phong
叶方=Diệp Phương
叶杀门=Diệp Sát Môn
叶跳=Diệp Khiêu
叶长老=Diệp trưởng lão
叶阳融=Diệp Dương Dung
司之法术=Tư Chi Pháp Thuật
司之法术总集=Tư Chi Pháp Thuật Tổng Tập
司徒诡秘=Tư Đồ Quỷ Bí
司空赌=Tư Không Đổ
司空锁=Tư Không Tỏa
司马浩=Tư Mã Hạo
司马长白=Tư Mã Trường Bạch
各大无上大教=các đại giáo vô thượng
同心佩=Đồng Tâm Bội
名仙剑=Danh Tiên Kiếm
名剑蝶恋花=Danh Kiếm Điệp Luyến Hoa
后土娘娘=Hậu Thổ Nương Nương
后山=Hậu Sơn
吕家=Lữ Gia
吕洞宾=Lữ Động Tân
君为臣纲=Quân Vi Thần Cương
君子不器=Quân tử bất khí
君子不立在危墙之下=Quân tử không đứng dưới tường nguy
君子浩然=Quân tử Hạo nhiên
君子百击=Quân tử bách kích
君子行正气，小人行邪气。内便於性，外合於义，循理而动，不系於物者，正气也；推於滋味，淫於声色，发於喜怒，不顾后患者，邪气也=Quân tử hành chính khí, tiểu nhân hành tà khí. Nội tiện ư tính, ngoại hợp ư nghĩa, tuần lý nhi động, bất hệ vu vật giả, chính khí dã; thôi vu tư vị, dâm vu thanh sắc, phát vu hỉ nộ, bất cố hậu hoạn giả, tà khí dã
吞之道=Thôn Chi Đạo
吞噬之龙=Thôn Phệ Chi Long
吞噬毒雾=Thôn Phệ Độc Vụ
吞土之龙=Thôn Thổ Chi Long
吞天噬地功=Thôn Thiên Phệ Địa Công
吞字=Thôn tự
吞木之龙=Thôn Mộc Chi Long
吞水之龙=Thôn Thủy Chi Long
吞火之龙=Thôn Hỏa Chi Long
吞金之龙=Thôn Kim Chi Long
吞雷之龙=Thôn Lôi Chi Long
吞风之龙=Thôn Phong Chi Long
听剑室=Thính Kiếm Thất
吸风无影虫=Hấp Phong Vô Ảnh Trùng
周中庸=Chu Trung Dung
周兄=Chu huynh
周回三万里，太皇我称尊=Chu hồi ba vạn dặm, Thái Hoàng ta xưng tôn
周天仙剑=Chu Thiên Tiên Kiếm
周天文字之阵=Chu Thiên Văn Tự Chi Trận
周天文字大阵=Chu Thiên Văn Tự Đại Trận
周子良=Chu Tử Lương
周师兄=Chu sư huynh
周师叔祖=Chu sư thúc tổ
周怒池=Chu Nộ Trì
周易微步=Chu Dịch Vi Bộ
周清玄=Chu Thanh Huyền
周清玄师兄=Chu Thanh Huyền sư huynh
周边文明=Văn minh xung quanh
命理=Mệnh Lý
命理文明=Văn minh Mệnh Lý
命理文明副主=Mệnh Lý Văn Minh Phó Chủ
命运=Vận mệnh
命运通道=Thông đạo Vận Mệnh
命运铁则=Mệnh Vận Thiết Tắc
和！平！=Hòa! Bình!
咕咕=Cổ Cổ
哀之水=Ai Chi Thủy
哀伤肺=Ai thương phế
哀莫大于心死=Ai Mạc Đại Vu Tâm Tử
唐婉儿=Đường Uyển Nhi
唐家=Đường Gia
唐松=Đường Tùng
唯一帝=Duy Nhất Đế
唯一星=Duy Nhất Tinh
唯一门=Duy Nhất Môn
唯剑=Duy Kiếm
唯我生存，众生皆死=Duy Ngã Sinh Tồn, Chúng Sinh Giai Tử
商业城池=Thương Nghiệp Thành Trì
商业岛=Đảo Thương Nghiệp
善之剑意=Thiện Chi Kiếm Ý
善恶=Thiện Ác
喜之剑=Hỷ Chi Kiếm
喜之极=Cực Hỷ
喜伤心=Hỉ thương tâm
喜悲=Hỉ Bi
喜悲大师=Hỉ Bi Đại Sư
器灵=Khí Linh
四号=Tứ Hào
四大天王星=Tứ Đại Thiên Vương Tinh
四大帝子=Tứ Đại Đế Tử
四大文明之主=Tứ Đại Văn Minh Chi Chủ
四妹=Tứ muội
四季绵绵无绝期=Tứ Quý Miên Miên Vô Tuyệt Kỳ
四月=Tháng Tư
四海=Tứ Hải
四狂=Tứ Cuồng
四疆=Tứ Cương
四阶灵脉=Tứ Giai Linh Mạch
四附马=Tứ phò mã
回望阳间路=Hồi Vọng Dương Gian Lộ
回沙郎酒=Hồi Sa Lang Tửu
回风上人=Hồi Phong Thượng Nhân
因果=Nhân Quả
因果大劫=Nhân Quả Đại Kiếp
因果铁则=Thiết Tắc Nhân Quả
困愁城=Khốn Sầu Thành
图之文明=Văn minh Đồ
图之文明副主=Đồ Chi Văn Minh Phó Chủ
图圣帝子=Đồ Thánh Đế Tử
圆之上古剑阵=Viên Thượng Cổ Kiếm Trận
圆之极限=Viên Chi Cực Hạn
圆字=Chữ Viên
圆极神剑=Viên Cực Thần Kiếm
土之剑意=Thổ Chi Kiếm Ý
土之天地法则=Thổ Chi Thiên Địa Pháp Tắc
土母十八层天=Mười tám tầng trời Thổ Mẫu
土母玄冥娘娘=Thổ Mẫu Huyền Minh nương nương
土遁术=Thuật thổ độn
土龙=Thổ Long
圣人境=Thánh Nhân Cảnh
圣光二=Thánh Quang Nhị
圣光文明=Văn minh Thánh Quang
圣光文明副主=Thánh Quang Văn Minh Phó Chủ
圣雪文明=Thánh Tuyết Văn Minh
地之剑意=Địa Chi Kiếm Ý
地之文明之主=Địa Chi Văn Minh Chi Chủ
地书=Địa Thư
地仙之祖=Địa Tiên Chi Tổ
地仙剑=Địa Tiên Kiếm
地冥书生=Địa Minh Thư Sinh
地利=Địa Lợi
地剑=Địa Kiếm
地剑周清玄=Địa Kiếm Chu Thanh Huyền
地剑魂=Địa Kiếm Hồn
地府文明之主=Địa Phủ Văn Minh Chi Chủ
地母之书=Địa Mẫu Chi Thư
地狱门=Địa Ngục Môn
地祖=Địa Tổ
地祖分身=Địa Tổ Phân Thân
地祖宝库=Địa Tổ bảo khố
地级=Cấp Địa
地遁术=Địa Độn Thuật
地阶=Địa Giai
地阶灵石=Địa Giai Linh Thạch
地阶灵脉=Địa Giai Linh Mạch
地龙星=Địa Long Tinh
地龙星球=Địa Long Tinh Cầu
地龙灵剑=Địa Long Linh Kiếm
坎宫=Khảm Cung
坎水星=Khảm Thủy Tinh
坐着打剑堂=Tọa Trứ Đả Kiếm Đường
坤地星=Khôn Địa Tinh
坤宫=Khôn Cung
垦山星=Khẩn Sơn Tinh
域外晋国=Vực ngoại Tấn Quốc
堕马髻=Đọa Mã Kế
墨玉十牙洪荒麒麟=Mặc Ngọc Thập Nha Hồng Hoang Kỳ Lân
墨玉麒麟=Mặc Ngọc Kỳ Lân
墨玉麒麟战甲=Mặc Ngọc Kỳ Lân Chiến Giáp
墨玉麒麟战袍=Chiến bào Kỳ Lân Mặc Ngọc
墨玉麒麟甲=Mặc Ngọc Kỳ Lân Giáp
墨绿战甲=Mặc Lục Chiến Giáp
夏侯=Hạ Hầu
夏侯伤=Hạ Hầu Thương
夏侯伤至尊=Hạ Hầu Thương Chí Tôn
夏侯师叔=Hạ Hầu sư thúc
夏侯忧=Hạ Hầu Ưu
夏侯至尊=Hạ Hầu Chí Tôn
夏帝剑道=Hạ Đế Kiếm Đạo
夏至=Hạ Chí
夏至剑意=Hạ Chí Kiếm Ý
夔牛之鼓=Kỳ Ngưu Chi Cổ
夕阳箫鼓=Tịch Dương Tiêu Cổ
外域=Ngoại Vực
多方位追踪法术大全=Đa Phương Vị Truy Tung Pháp Thuật Toàn Tập
夜之文明=Văn Minh Dạ
夜之酒=Dạ Chi Tửu
夜俱黑=Dạ Cụ Hắc
夜姬雪=Dạ Cơ Tuyết
夜帝=Ngạy Đế
夜帝之法=Dạ Đế Chi Pháp
夜暗文明=Dạ Ám Văn Minh
夜暗文明副主=Dạ Ám Văn Minh Phó Chủ
夜长歌=Dạ Trường Ca
夜雾=Dạ vụ
夜魔=Dạ Ma
大元=Đại Nguyên
大元国=Đại Nguyên Quốc
大关刀=Đại Quan Đao
大力鬼王诀=Đại Lực Quỷ Vương Quyết
大千世界=Đại Thiên Thế Giới
大华国=Đại Hoa Quốc
大原刀法=Đại Nguyên Đao Pháp
大周仙剑=Đại Chu Tiên Kiếm
大国主周中庸=Đại quốc chủ Chu Trung Dung
大国战=Đại Quốc Chiến
大圆满=Đại Viên Mãn
大圣遗音=Đại Thánh Di Âm
大地之精华=Tinh Hoa Đại Địa
大地加速术=Đại Địa Gia Tốc Thuật
大始刀法=Đại Thủy Đao Pháp
大学=Đại Học
大学圣经=Đại Học Thánh Kinh
大师兄=Đại sư huynh
大庸国=Đại Dung Quốc
大庸城=Đại Dung Thành
大庸皇城=Đại Dung Hoàng Thành
大怒明王=Đại Nộ Minh Vương
大悲小恨赋=Đại Bi Tiểu Hận Phú
大晋=Đại Tấn
大晋国=Đại Tấn Quốc
大智大慧之剑=Đại Trí Đại Tuệ Chi Kiếm
大智大慧剑法=Đại Trí Đại Tuệ Kiếm Pháp
大智大慧除魔式=Đại Trí Đại Tuệ Trừ Ma Thức
大暑剑意=Đại Thử Kiếm Ý
大比丘=Đại Tỳ Kheo
大气运=Đại Khí Vận
大法华寺=Đại Pháp Hoa Tự
大洪刀法=Đại Hồng Đao Pháp
大洪神刀=Đại Hồng Thần Đao
大海之精华=Tinh Hoa Đại Hải
大混洞石=Đại Hỗn Động Thạch
大神之光=Đại Thần Chi Quang
大秦=Đại Tần
大秦国=Đại Tần Quốc
大荒刀=Đại Hoang Đao
大荒刀法=Đại Hoang Đao Pháp
大荒剑卷=Đại Hoang Kiếm Quyển
大荒无法=Đại Hoang Vô Pháp
大荒神戟=Đại Hoang Thần Kích
大荒锁空阵=Đại Hoang Tỏa Không Trận
大菩萨地藏真解=Đại Bồ Tát Địa Tạng Chân Giải
大负仙剑=Đại Phụ Tiên Kiếm
大负先生=Đại Phụ tiên sinh
大逆仙剑=Đại Nghịch Tiên Kiếm
大道之戟=Đại Đạo Chi Kích
大道境=Đại Đạo Cảnh
大道法果=Đại Đạo Pháp Quả
大都=Đại Đô
大都城=Đại Đô Thành
大附马=Đại Phụ Mã
大雪=Đại Tuyết
大雪山烂陀寺=Đại Tuyết Sơn Lạn Đà Tự
大霸道拳=Đại Bá Đạo Quyền
大须弥正反七曜九宫剑阵=Đại Tu Di Chính Phản Thất Diệu Cửu Cung Kiếm Trận
大风割裂=Đại Phong Cát Liệt
大风起=Đại Phong Khởi
天一剑法=Thiên Nhất Kiếm Pháp
天一门=Thiên Nhất Môn
天上火=Thiên Thượng Hỏa
天下吾敌=Thiên hạ ngô địch
天丑老人=Thiên Sửu Lão Nhân
天之剑意=Thiên Chi Kiếm Ý
天之子=Thiên Chi Tử
天之文明之主=Thiên Chi Văn Minh Chi Chủ
天之道=Thiên Chi Đạo
天云山=Thiên Vân Sơn
天人灭绝=Thiên Nhân Diệt Tuyệt
天人灭绝朱天人=Thiên Nhân Diệt Tuyệt Chu Thiên Nhân
天佛檀香=Thiên Phật Đàn Hương
天侠肝义胆文明=Văn Minh Thiên Hiệp Can Nghĩa Đảm
天全无缺丹=Thiên Toàn Vô Khuyết Đan
天击文明副主=Thiên Kích Văn Minh Phó Chủ
天剑=Thiên Kiếm
天剑世界=Thiên Kiếm Thế Giới
天剑文明副主=Thiên Kiếm Văn Minh Phó Chủ
天剑燕苍天=Thiên Kiếm Yến Thương Thiên
天剑魂=Thiên Kiếm Hồn
天台峰=Thiên Đài Phong
天同星=Thiên Đồng Tinh
天命=Thiên Mệnh
天命剑道=Thiên Mệnh Kiếm Đạo
天命战轮=Thiên Mệnh Chiến Luân
天命神戟=Thiên Mệnh Thần Kích
天圆地方=Thiên Viên Địa Phương
天圆宗师=Thiên Viên tông sư
天圣帝姬=Thiên Thánh Đế Cơ
天地乾坤=Thiên Địa Càn Khôn
天地圆盘=Thiên Địa Viên Bàn
天地塌陷区=Thiên Địa Tháp Hãm Khu
天地无网=Thiên Địa Vô Võng
天地有儒=Thiên Địa Hữu Nho
天地有正气，杂然赋流形，下则为河岳，上则为日星，于人曰浩然，沛乎塞苍冥=Thiên địa hữu chính khí, tạp nhiên phú lưu hình, hạ tắc vi hà nhạc, thượng tắc vi nhật tinh, vu nhân viết Hạo nhiên, phế hồ tắc thương minh
天地法相=Thiên Địa Pháp Tướng
天地翻覆龙蛇起陆真诀=Thiên Địa Phiên Phúc Long Xà Khởi Lục Chân Quyết
天地间=Thiên Địa Gian
天地阴阳=Thiên Địa Âm Dương
天外晶石=Thiên Ngoại Tinh Thạch
天威=Thiên Uy
天媚狐帝=Thiên Mị Hồ Đế
天尊=Thiên Tôn
天尊丹=Thiên Tôn Đan
天尊境=Cảnh giới Thiên Tôn
天幻之光=Thiên Ảo Chi Quang
天府星=Thiên Phủ Tinh
天恶门=Thiên Ác Môn
天悟石=Thiên Ngộ Thạch
天指点将=Thiên Chỉ Điểm Tướng
天攻=Thiên Công
天攻文明=Thiên Công văn minh
天攻文明副主=Phó chủ Văn minh Thiên Công
天断之峰=Thiên Đoạn Chi Phong
天无绝人之路=Thiên Vô Tuyệt Nhân Chi Lộ
天时=Thiên Thời
天晶魄=Thiên Tinh Phách
天晶鱼=Thiên Tinh Ngư
天曲酿=Thiên Khúc Nương
天有不测风云=Thiên Hữu Bất Trắc Phong Vân
天本无尽=Thiên Bổn Vô Tận
天机因果之盘=Thiên Cơ Nhân Quả Chi Bàn
天机星=Thiên Cơ Tinh
天权=Thiên Quyền
天枢=Thiên Khu
天柱峰=Thiên Trụ Phong
天梁星=Thiên Lương Tinh
天榜=Thiên Bảng
天檀天香药王珠=Thiên Đàn Thiên Hương Dược Vương Châu
天母=Thiên Mẫu
天母帝姬=Thiên Mẫu Đế Cơ
天母文明=Thiên Mẫu Văn Minh
天母文明副主=Thiên Mẫu Văn Minh Phó Chủ
天母纪元=Thiên Mẫu Kỷ Nguyên
天比龙高=Trời cao hơn rồng
天狼=Thiên Lang
天玑=Thiên Cơ
天理=Thiên Lý
天理世界=Thiên Lý thế giới
天理之书=Thiên Lý Chi Thư
天理之宫=Thiên Lý chi cung
天理十八重天=Thiên Lý thập bát trọng thiên
天理文=Thiên Lý Văn
天理文明=Văn minh Thiên Lý
天理文明副主=Thiên Lý Văn Minh Phó Chủ
天琢神鸟=Thiên Trác Thần Điểu
天璇=Thiên Toàn
天生教文明=Văn minh Thiên Sinh Giáo
天相星=Thiên Tướng Tinh
天禅仙剑=Thiên Thiền Tiên Kiếm
天空万灭劫=Thiên Không Vạn Diệt Kiếp
天级妖兽=Yêu thú cấp Thiên
天级灵石=Thiên Cấp Linh Thạch
天级灵脉=Thiên Cấp Linh Mạch
天网大法=Thiên Võng Đại Pháp
天罗地网=Thiên La Địa Võng
天罡地煞穷极剑阵=Thiên Cương Địa Sát Cùng Cực Kiếm Trận
天罡大阵=Thiên Cương Đại Trận
天羽姬=Thiên Vũ Cơ
天花=Thiên Hoa
天荒刀=Thiên Hoang Đao
天荒地老刀=Thiên Hoang Địa Lão Đao
天荒帝子=Thiên Hoang Đế Tử
天药阁=Thiên Dược Các
天蛇八击=Thiên Xà Bát Kích
天诡文明=Văn minh Thiên Quỷ
天诡文明副主=Phó chủ Văn minh Thiên Quỷ
天贪=Thiên Tham
天贪手=Thiên Tham Thủ
天运文明之主=Thiên Vận Văn Minh Chi Chủ
天道拂尘=Thiên Đạo Phất Trần
天防=Thiên Phòng
天防文明=Văn minh Thiên Phòng
天防文明副主=Phó chủ Văn minh Thiên Phòng
天阶灵石=Thiên Giai Linh Thạch
天阶灵脉=Thiên Giai Linh Mạch
天马三角地带=Thiên Mã Tam Giác Địa Đới
天魂星=Thiên Hồn Tinh
天魂法师=Thiên Hồn Pháp Sư
天魔=Thiên Ma
天魔共诛七诛一=Thiên Ma Cộng Tru Thất Tru Nhất
太上伤寒=Thái Thượng Thương Hàn
太上伤寒经=Thái Thượng Thương Hàn Kinh
太上元老=Thái Thượng Nguyên Lão
太上老君=Thái Thượng Lão Quân
太上长老=Thái Thượng Trưởng Lão
太史=Thái Sử
太史一门=Thái Sử nhất môn
太史悲=Thái Sử Bi
太史派=Thái Sử Phái
太史空=Thái Sử Không
太史至尊=Thái Sử Chí Tôn
太史至尊门下=Thái Sử Chí Tôn môn hạ
太史门=Thái Sử Môn
太寒羽雪术=Thái Hàn Vũ Tuyết Thuật
太岁=Thái Tuế
太岁王=Thái Tuế Vương
太极=Thái Cực
太极剑法=Thái Cực Kiếm Pháp
太极图=Thái Cực Đồ
太白仙砂=Thái Bạch Tiên Sa
太白金星=Thái Bạch Kim Tinh
太皇天=Thái Hoàng Thiên
太皇天尊=Thái Hoàng Thiên Tôn
太虚九光龟台金母之君=Thái Hư Cửu Quang Quy Đài Kim Mẫu Chi Quân
太虚苍穹无上真解=Thái Hư Thương Khung Vô Thượng Chân Giải
太虚隐匿令=Thái Hư Ẩn Nặc Lệnh
太阳之精华=Tinh Hoa Thái Dương
太阿仙剑=Thái A Tiên Kiếm
太阿神器=Thái A Thần Khí
太霄神雷门=Thái Tiêu Thần Lôi Môn
夫为妻纲=Phu Vi Thê Cương
头沿响铃=Đầu Duyên Hưởng Linh
夺命之阳=Đoạt Mệnh Chi Dương
夺命枪法=Đoạt Mệnh Thương Pháp
夺爱刀=Đoạt Ái Đao
奇之招式极限=Kỳ chi chiêu thức cực hạn
奇仙剑=Kỳ Tiên Kiếm
女娲=Nữ Oa
女娲娘娘=Nữ Oa Nương Nương
如意=Như Ý
如是我闻=Như thị ngã văn
如来佛祖=Như Lai Phật Tổ
妖之文明=Văn minh Yêu
妖之文明副主=Yêu Chi Văn Minh Phó Chủ
妖之邪道=Yêu Chi Tà Đạo
妖兽=Yêu thú
妖力=Yêu Lực
妖字=Chữ Yêu
妖气=Yêu Khí
妖界=Yêu Giới
妖魔十大长老=Yêu Ma Thập Đại Trưởng Lão
妙仙剑=Diệu Tiên Kiếm
姑苏=Cô Tô
姬千羽=Cơ Thiên Vũ
姬胜雪=Cơ Thắng Tuyết
嫦娥=Hằng Nga
孔圣=Khổng Thánh
孔圣心经=Khổng Thánh Tâm Kinh
孔子=Khổng Tử
孔尚义=Khổng Thượng Nghĩa
孔尼=Khổng Ni
孔尼师兄=Khổng Ni sư huynh
孔师兄=Khổng sư huynh
孔明德=Khổng Minh Đức
孔明德师兄=Khổng Minh Đức sư huynh
孔明扇=Quạt Khổng Minh
孔雀星=Khổng Tước Tinh
存天理灭人欲=Tồn Thiên Lý Diệt Nhân Dục
孙大支=Tôn Đại Chi
孟子=Mạnh Tử
孟子神剑=Mạnh Tử Thần Kiếm
孟师弟=Mạnh sư đệ
孟昭=Mạnh Chiêu
孟浪=Mạnh Lãng
孟韦=Mạnh Vi
季华陀=Quý Hoa Đà
学风二十四=Học Phong Nhị Thập Tứ
宇宙酒=Vũ Trụ Tửu
守护=Thủ Hộ
守护人=người bảo vệ
守护正义=Thủ Hộ Chính Nghĩa
守灭剑法=Thủ Diệt Kiếm Pháp
安之剑意=An Chi Kiếm Ý
宋冲明=Tống Xung Minh
宋地=Tống Địa
宋家=Tống gia
宋帝王=Tống Đế Vương
宋惟一=Tống Duy Nhất
宋清桥=Tống Thanh Kiều
官道=Quan Đạo
定理=Định Lý
定理之书=Sách Định lý
宝一帝子=Bảo Nhất Đế Tử
宝之文明=Văn Minh Bảo
宝亲王=Bảo Thân Vương
宝圣帝子=Bảo Thánh Đế Tử
宝强帝子=Bảo Cường Đế Tử
宝月帝姬=Bảo Nguyệt Đế Cơ
宝树王=Bảo Thụ Vương
宝灵帝姬=Bảo Linh Đế Cơ
宝王帝子=Bảo Vương Đế Tử
宝皇帝子=Bảo Hoàng Đế Tử
宝船=Bảo Thuyền
宝船文明副主=Bảo Thuyền Văn Minh Phó Chủ
宝贝帝姬=Bảo Bối Đế Cơ
宝贝帝姬罗烟贝=Bảo Bối Đế Cơ La Yên Bối
宿月佛=Túc Nguyệt Phật
宿月眠=Túc Nguyệt Miên
宿王佛=Túc Vương Phật
宿王佛祖=Túc Vương Phật Tổ
寂寞读南华=Tịch Mịch Độc Nam Hoa
密宗=Mật Tông
寒之剑意=Hàn Chi Kiếm Ý
寒山剑法=Hàn Sơn Kiếm Pháp
寒蝉悲鸣人流泪=Hàn Thiền Bi Minh Nhân Lưu Lệ
寿光天机镜=Kính Thiên Cơ Thọ Quang
封兽牌=Phong Thú Bài
封剑归隐=Phong Kiếm Quy Ẩn
封宝令=Phong Bảo Lệnh
封建=Phong kiến
封星阵=Phong Tinh trận
封神之劫=Phong Thần Chi Kiếp
封禁=Phong Cấm
射日之箭=Xạ Nhật Chi Tiễn
将进酒=Tương Tiến Tửu
小元国=Tiểu Nguyên Quốc
小元始=Tiểu Nguyên Thủy
小六子陆元=Tiểu Lục Tử Lục Nguyên
小冰棱战车术=Tiểu Băng Lăng Chiến Xa Thuật
小剑=Tiểu Kiếm
小剑界=Tiểu Kiếm Giới
小剑道之树=Tiểu Kiếm Đạo Chi Thụ
小剑道树=Tiểu Kiếm Đạo Thụ
小千世界=Tiểu Thiên Thế Giới
小千世界大荒残破剑卷=Tiểu Thiên Thế Giới Đại Hoang Tàn Phá Kiếm Quyển
小千世界残破剑卷=Tiểu Thiên Thế Giới Tàn Phá Kiếm Quyển
小千世界残破大荒剑卷=Tiểu Thiên Thế Giới tàn phá Đại Hoang Kiếm Quyển
小命运术=Tiểu Mệnh Vận Thuật
小因果命运之法=Tiểu Nhân Quả Mệnh Vận Chi Pháp
小因果铁则=Tiểu Nhân Quả Thiết Tắc
小国战=Tiểu Quốc Chiến
小师=Tiểu Sư
小暑剑意=Tiểu Thử Kiếm Ý
小混洞石=Tiểu Hỗn Động Thạch
小满=Tiểu Mãn
小满剑意=Tiểu Mãn Kiếm Ý
小牙=Tiểu Nha
小白=Tiểu Bạch
小结界丹=Tiểu Kết Giới Đan
小青=Tiểu Thanh
小鱼=Tiểu Ngư
少阳门=Thiếu Dương Môn
尖字=Tiêm Tự
尖字分身=Tiêm tự phân thân
尚书=Thượng Thư
尚明白=Thượng Minh Bạch
尝酒留闲客，行茶使小娃。残杯劝不饮，留醉向谁家=Thường tửu lưu nhàn khách, hành trà sử tiểu oa. Tàn bôi khuyến bất ẩm, lưu túy hướng thùy gia
尸煞=Thi Sát
尾宿星=Vĩ Tú Tinh
尾生=Vĩ Sinh
展白=Triển Bạch
屠刚=Đồ Cương
屠夫高进=Đồ phu Cao Tiến
山剑屠刚=Sơn Kiếm Đồ Cương
山海拳经=Sơn Hải Quyền Kinh
山石崩塌=Sơn Thạch Băng Tháp
岚丽帝妃=Lam Lệ Đế Phi
岩字=Nham tự
岳父=Nhạc phụ
崩天级=Băng Thiên Cấp
左血王=Tả Huyết Vương
左血王罗薇=Tả Huyết Vương La Vi
巨型仙门=Cự Hình Tiên Môn
巨斧帝子=Cự Phủ Đế Tử
巨汉盘动七=Cự Hán Bàn Động Thất
巫之文明=Văn minh Vu
巫之邪道=Tà đạo Vu
巫墓=Vu Mộ
巫界=Vu Giới
巫诅宗师欧阳驼=Vu Tổ Tông Sư Âu Dương Đà
巽宫=Tốn Cung
布衣官道=Bố Y Quan Đạo
师傅=Sư phụ
师兄=Sư huynh
师叔祖=Sư thúc tổ
师妃仙=Sư Phi Tiên
师姐=Sư tỷ
帝之极限=Đế Chi Cực Hạn
帝后真罗仙法=Đế Hậu Chân La Tiên Pháp
帝姬=Đế Cơ
帝姬剑灵帝姬云袖雪=Đế Cơ Kiếm Linh Đế Cơ Vân Tụ Tuyết
帝子=Đế Tử
帝换行宫=Đế Hoán Hành Cung
帝改御驾=Đế Cải Ngự Giá
帝江鸟=Đế Giang Điểu
帝行三十六法=Đế Hành Tam Thập Lục Pháp
帝转御道=Đế Chuyển Ngự Đạo
帝逃=Đế Đào
平天大陆=Bình Thiên Đại Lục
平天棍法=Bình Thiên Côn Pháp
平天高原=Bình Thiên Cao Nguyên
年代文明副主=Phó chủ Văn minh Niên Đại
幻神之蝶=Huyễn Thần Chi Điệp
幽冥之主=U Minh Chi Chủ
幽冥文明=U Minh Văn Minh
幽厉门=U Lệ Môn
幽无求=U Vô Cầu
幽若姬=U Nhược Cơ
幽虚无=U Hư Vô
幽鬼无双=U Quỷ Vô Song
广陵散=Quảng Lăng Tán
庆云=Khánh Vân
应天无求丹=Ứng Thiên Vô Cầu Đan
庭槐寒影疏，邻杵夜声急。佳期旷何许！望望空伫立=Đình hoài hàn ảnh sơ, lân xử dạ thanh cấp. Giai kỳ khoáng hà hứa! Vọng vọng không trụ lập
庭院=đình viện
开天斧法=Khai Thiên Phủ Pháp
开天时之石=Khai Thiên Thời Chi Thạch
开天辟地=Khai Thiên Tích Địa
开天辟地境=Khai Thiên Tích Địa Cảnh
开阳=Khai Dương
异度空间=Dị Độ Không Gian
弑神枪=Thí Thần Thương
张侯张空斩=Trương Hầu Trương Không Trảm
张君可=Trương Quân Khả
张掌柜=Trương chưởng quỹ
张果老=Trương Quả Lão
张良=Trương Lương
张苍厉=Trương Thương Lệ
张虚玄=Trương Hư Huyền
张道生=Trương Đạo Sinh
弱水真解=Nhược Thủy Chân Giải
弱水门=Nhược Thủy Môn
弱相互作用力=Lực Tương Tác Yếu
强相互作用力=Lực Tương Tác Mạnh
归一境=Quy Nhất Cảnh
归剑池=Quy Kiếm Trì
彩礼=Tiền sính
役鬼神灭诀=Dịch Quỷ Thần Diệt Quyết
往生极乐=Vãng Sinh Cực Lạc
御剑=Ngự Kiếm
御火门=Ngự Hỏa Môn
御鸟真诀=Ngự Điểu Chân Quyết
心剑=Tâm Kiếm
心如明镜=Tâm Như Minh Kính
心宿星=Tâm Tú Tinh
心有尘埃=Tâm Hữu Trần Ai
心电剑=Tâm Điện Kiếm
心脏=Tim
心脏山=Tâm Tạng Sơn
心魔=Tâm Ma
忆情=Ức Tình
忘尘=Vong Trần
快剑之门=Khoái Kiếm Chi Môn
快电剑法=Khoái Điện Kiếm Pháp
快绝枪=Khoái Tuyệt Thương
怒之剑=Nộ Chi Kiếm
怒之极=Cực Nộ
怒仙剑=Nộ Tiên Kiếm
怒剑上官鹤=Nộ Kiếm Thượng Quan Hạc
怒金刚=Nộ Kim Cương
怒问天=Nộ Vấn Thiên
怜星=Liên Tinh
怜香仙剑=Liên Hương Tiên Kiếm
思过峰=Tư Quá Phong
急电乱披风剑法=Cấp Điện Loạn Phi Phong Kiếm Pháp
性本是善=Tính Bản Thị Thiện
性本是恶=Tính Bản Thị Ác
怪魔=Quái Ma
总控台=Tổng Khống Đài
总纲=Tổng cương
恐魔=Khủng Ma
恒之层=Hằng Chi Tầng
恒之门=Hằng Chi Môn
恒星派=Hằng Tinh Phái
恶之火=Ác Chi Hỏa
恶之黑气=Ác Chi Hắc Khí
恶伤脾=Ác thương tỳ
恶僧人=Ác Tăng Nhân
恶蛟=Ác Giao
恶锏出涧=Ác Kiển Xuất Giản
悟字=Ngộ Tự
悟混化洞丹=Ngộ Hỗn Hóa Động Đan
悟道丹=Ngộ Đạo Đan
悟道宝阁=Ngộ Đạo Bảo Các
悬剪神剑=Huyền Tiễn Thần Kiếm
悬翦=Huyền Tiễn
悬翦神剑=Huyền Tiễn Thần Kiếm
悲仙剑=Bi Tiên Kiếm
悲剑世界=Thế giới Bi Kiếm
情人节=Lễ tình nhân
惊情七变=Kinh Tình Thất Biến
惊燕神仙一剑=Kinh Yến Thần Tiên Nhất Kiếm
惊燕神剑=Kinh Yến Thần Kiếm
惊神指法=Kinh Thần Chỉ Pháp
惊蛰=Kinh Trập
惊雷神指=Kinh Lôi Thần Chỉ
惊鲵=Kinh Nghê
惊鲵神剑=Kinh Nghê Thần Kiếm
惧之原石=Cụ Chi Nguyên Thạch
惧之黑气=Cụ Chi Hắc Khí
惧伤肾=Cụ thương thận
惨绝人寰扣连环=Thảm Tuyệt Nhân Hoàn Khấu Liên Hoàn
慑天=Nhiếp Thiên
慕容国=Mộ Dung Quốc
慕容暗=Mộ Dung Ám
慕容皇复=Mộ Dung Hoàng Phục
慕容红泪=Mộ Dung Hồng Lệ
慧字=Tuệ Tự
慧心诀=Tuệ Tâm Quyết
慧眼=Tuệ Nhãn
憎恶明王=Tăng Ác Minh Vương
懒剑正我=Lười Kiếm Chính Ngã
我之书，为定理，我之笔，为真理。=Sách của ta, là định lý, bút của ta, là chân lý.
我剑=Ta Kiếm
战兽老祖=Chiến Thú Lão Tổ
战剑门=Chiến Kiếm Môn
战意绝=Chiến Ý Tuyệt
战狂铁=Chiến Cuồng Thiết
战荒之门=Chiến Hoang Chi Môn
战锏之文明=Văn Minh Chiến Kiếm
战！争！=Chiến! Tranh!
戢武侯=Tập Vũ Hầu
扁仲帝子=Biển Trọng Đế Tử
扁医升元丹=Biện Y Thăng Nguyên Đan
手下败将=Thủ Hạ Bại Tướng
打剑堂=Đả Kiếm Đường
打杀棍法=Đả Sát Côn Pháp
执法宗=Chấp Pháp Tông
执法者=Chấp Pháp Giả
扶摇羊角=Phù Diêu Dương Giác
投锏之派=Đầu Kiển Chi Phái
投锏派=Đầu Kiềm Phái
拂柳门=Phất Liễu Môn
拈花一笑=Niêm Hoa Vi Tiếu
招式阁=Chiêu Thức Các
挑战塔=Khiêu Chiến Tháp
掌门=Chưởng Môn
接引=Tiếp Dẫn
接引佛祖=Tiếp Dẫn Phật Tổ
掩日=Yểm Nhật
掩日神剑=Yểm Nhật Thần Kiếm
掩月悲风=Yểm Nguyệt Bi Phong
提壶挂寒柯，远望时复为。无声梦幻间，何事绁尘羁=Đề hồ quải hàn kha, viễn vọng thì phục vi. Vô thanh mộng huyễn gian, hà sự tiết trần ki
插花银雀=Sáp Hoa Ngân Tước
摄天=Nhiếp Thiên
摇光=Diêu Quang
摩迦宗师=Ma-ka Tông Sư
撕风神爪=Tê Phong Thần Trảo
操血十方蛊=Thao Huyết Thập Phương Cổ
改之剑意=Cải Chi Kiếm Ý
放慢术=Phóng Mạn Thuật
敌荒圣帝子=Địch Hoang Thánh Đế Tử
散修强盗罗网=Tổ chức cướp bóc tán tu La Võng
文字之门=Văn Tự Chi Môn
文明=Văn minh
文明之主=Văn Minh Chi Chủ
文明之书=Văn Minh Chi Thư
文明之体=Văn minh chi thể
文明之使=Văn Minh Chi Sứ
文明之卜方舟=Văn Minh Chi Bốc Phương Chu
文明之火=Văn Minh Chi Hỏa
文明之盘=Văn minh chi bàn
文明之龙=Văn Minh Chi Long
文明副主=Văn Minh Phó Chủ
文明圣地=Văn Minh Thánh Địa
文明境=Văn Minh Cảnh
文明境剑法=Văn Minh Cảnh Kiếm Pháp
文明天锁=Văn Minh Thiên Tỏa
文明文字=Văn Minh Văn Tự
文明真火=Văn Minh Chân Hỏa
文明神火=Văn Minh Thần Hỏa
文明神铁=Văn Minh Thần Thiết
文明苗银=Văn minh Miêu Ngân
斗之子=Đấu Chi Tử
斗古文明=Văn minh Đấu Cổ
斗天=Đấu Thiên
斗技=Đấu Kỹ
斗技魔眼=Đấu Kỹ Ma Nhãn
斗气=Đấu Khí
斗炎爆=Đấu Viêm Bạo
斧之文明=Văn minh Phủ
斧之文明副主=Phủ Chi Văn Minh Phó Chủ
斧斩破天式=Phủ Trảm Phá Thiên Thức
斧者=Phủ Giả
斩天掌法=Trảm Thiên Chưởng Pháp
斩妖之剑=Trảm Yêu Chi Kiếm
斩情慧仙剑=Trảm Tình Tuệ Tiên Kiếm
斩情慧剑=Trảm Tình Tuệ Kiếm
断佛忘道=Đoạn Phật Vong Đạo
断水=Đoạn Thủy
断水流=Đoạn Thủy Lưu
断水神剑=Đoạn Thủy Thần Kiếm
断神文明=Đoạn Thần văn minh
断神文明副主=Đoạn Thần Văn Minh Phó Chủ
断肠=Đoạn Tràng
断魂仙人=Đoạn Hồn Tiên Nhân
新剑世界=Tân Kiếm Thế Giới
新酒泉山=Tân Tửu Tuyền Sơn
方圆=Phương Viên
方天戟法=Phương Thiên Kích Pháp
方屠=Phương Đồ
方舟=Phương Chu
方邪=Phương Tà
方食天=Phương Thực Thiên
无上刚柔之身=Vô Thượng Cương Nhu Chi Thân
无上刚柔身=Vô Thượng Cương Nhu Thân
无上剑堂=Vô Thượng Kiếm Đường
无上剑气大法=Vô Thượng Kiếm Khí Đại Pháp
无上剑炉=Vô Thượng Kiếm Lô
无上剑道=Vô Thượng Kiếm Đạo
无上剑门=Vô Thượng Kiếm Môn
无上大教=Vô Thượng Đại Giáo
无上大教无双门=Vô Thượng Đại Giáo Vô Song Môn
无上无天火=Vô Thượng Vô Thiên Hỏa
无上生机诀=Vô Thượng Sinh Cơ Quyết
无上神话燕飞一=Vô Thượng Thần Thoại Yến Phi Nhất
无上藏宝无伤天甲=Vô Thượng Tàng Bảo Vô Thương Thiên Giáp
无上血魄珠=Vô Thượng Huyết Phách Châu
无上金身=Vô Thượng Kim Thân
无上青木佛诀=Vô Thượng Thanh Mộc Phật Quyết
无剑仙门=Vô Kiếm Tiên Môn
无双之箭=Vô Song Chi Tiễn
无双北斗七星阵=Vô Song Bắc Đẩu Thất Tinh Trận
无双正气=Vô Song Chính Khí
无双门=Vô Song Môn
无名火=vô danh hỏa
无回枪法=Vô Hồi Thương Pháp
无境界=Vô Cảnh Giới
无天剑法=Vô Thiên Kiếm Pháp
无天绝剑=Vô Thiên Tuyệt Kiếm
无尽之剑=Vô Tận Chi Kiếm
无尽剑=Vô Tận Kiếm
无尽剑海=Vô Tận Kiếm Hải
无尽树海图=Vô Tận Thụ Hải Đồ
无尽的树海=Vô Tận Thụ Hải
无影无形冰雪天蚕瞬移蛊=Vô Ảnh Vô Hình Băng Tuyết Thiên Tằm Thuấn Di Cổ
无彼无我丹=Vô Bỉ Vô Ngã Đan
无我无网=Vô Ngã Vô Võng
无极=Vô Cực
无极文明=Vô Cực Văn Minh
无极文明之主=Vô Cực Văn Minh Chi Chủ
无求剑法=Vô Cầu Kiếm Pháp
无法力剑堂=Vô Pháp Lực Kiếm Đường
无法叶无天=Vô Pháp Diệp Vô Thiên
无相之龙=Vô Tướng Chi Long
无相吞噬=Vô Tướng Thôn Phệ
无相吞噬之龙=Vô Tướng thôn phệ chi long
无相吞噬功=Vô Tướng Thôn Phệ Công
无相吞噬诀=Vô Tướng Thôn Phệ Quyết
无相吞火诀=Vô Tướng Thôn Hỏa Quyết
无神傀儡=Vô Thần Khôi Lỗi
无赌心经=Vô Đổ Tâm Kinh
无边落木萧萧下=Vô Biên Lạc Mộc Tiêu Tiêu Hạ
无边重力=Vô Biên Trọng Lực
无量佛尊=Vô Lượng Phật Tôn
无量天光玉璧=Vô Lượng Thiên Quang Ngọc Bích
无量天尊=Vô Lượng Thiên Tôn
无阳上人=Vô Dương Thượng Nhân
日月=Nhật Nguyệt
时之剑法=Thời Chi Kiếm Pháp
时之剑道=Thời Chi Kiếm Đạo
时之图=Thời Chi Đồ
时之圆钟=Thời Chi Viên Chung
时之铁则=Thời Chi Thiết Tắc
时间=Thời Gian
时间之河=Hà Thời Gian
时间之门=Thời Gian Chi Môn
时间境=Cảnh Giới Thời Gian
时间铁则=Thời Gian Thiết Tắc
昆仑仙门=Côn Luân Tiên Môn
昆仑觞=Côn Lôn Thương
昊天上帝=Hạo Thiên Thượng Đế
明意帝子=Minh Ý Đế Tử
明月帝姬=Minh Nguyệt Đế Cơ
明王诀=Minh Vương Quyết
易无形=Dịch Vô Hình
易物境=Dịch Vật Cảnh
易经=Kinh Dịch
星之快=Tinh Chi Khoái
星之文明=Văn Minh Tinh
星光=Tinh quang
星动=Tinh Động
星域之门=Tinh Vực Chi Môn
星尘武装=Tinh Trần 武装
星杀文明副主=Phó chủ Văn minh Tinh Sát
星沉直降=Tinh Trầm Trực Giáng
星河剑铁=Tinh Hà Kiếm Thiết
星河文明=Văn minh Ngân Hà
星河文明副主=Tinh Hà Văn Minh Phó Chủ
星河铁剑=Tinh Hà Thiết Kiếm
星箭雷电之一剑=Tinh Tiễn Lôi Điện Chi Nhất Kiếm
星罗仙衣=Tinh La Tiên Y
星罗羽纱=Tinh La Vũ Sa
星耀照世=Tinh Diệu Chiếu Thế
星若河=Tinh Nhược Hà
星若海=Tinh Nhược Hải
星辰=Tinh Thần
星辰之精华=Tinh Hoa Tinh Thần
星辰剑法=Tinh Thần Kiếm Pháp
星辰剑道=Tinh Thần Kiếm Đạo
星辰大阵=Tinh Thần Đại Trận
星辰级=Tinh Thần Cấp
星辰雨=Tinh Thần Vũ
星野=Tinh Dã
星野速=Tinh Dã Tốc
星长河=Tinh Trường Hà
春之法则=Xuân Chi Pháp Tắc
春分=Xuân Phân
春天不是读书天，夏日炎炎正好眠，秋有蚊虫冬有雪，收拾书包好过年=Xuân thiên bất thị độc thư thiên, hạ nhật viêm viêm chính hảo miên, thu hữu văn trùng đông hữu tuyết, thu thập thư bao hảo quá niên
春帝剑道=Xuân Đế Kiếm Đạo
春水哀之琴=Xuân Thủy Ai Chi Cầm
春水门=Xuân Thủy Môn
春秋玄水天劫=Xuân Thu Huyền Thủy Thiên Kiếp
春雷=Xuân Lôi
昭阳=Chiêu Dương
显剑门=Hiển Kiếm Môn
晋元=Tấn Nguyên
晋国=Tấn Quốc
晋国华山=Hoa Sơn, nước Tấn
晋国血剑门=Tấn Quốc Huyết Kiếm Môn
普度之海=Phổ Độ Chi Hải
普渡之海=Phổ Độ Chi Hải
智之快剑=Trí Chi Khoái Kiếm
暗之子=Ám Chi Tử
暗之子李太史=Ám Chi Tử Lý Thái Sử
暗卫=Ám Vệ
暗寂=Ám Tịch
暗风之箭=Ám Phong Chi Tiễn
暴之招式极限=Bạo chi chiêu thức cực hạn
暴雷击星=Bạo Lôi Kích Tinh
暴风酒=Bạo Phong Tửu
曲酒=Khúc Tửu
替天盟=Thay Thiên Minh
最强暗杀小队=Đội ám sát mạnh nhất
最高作战室=Tối Cao Tác Chiến Thất
月之仙剑=Nguyệt Chi Tiên Kiếm
月之文明=Văn minh Nguyệt
月之文明之主=Nguyệt Chi Văn Minh Chi Chủ
月亮=Mặt Trăng
月亮之精华=Tinh Hoa Nguyệt Lượng
月儿高=Nguyệt Nhi Cao
月光佛=Nguyệt Quang Phật
月光小虫虫=Nguyệt Quang Tiểu Trùng Trùng
月光虫=Nguyệt Quang Trùng
月媚帝姬=Nguyệt Mị Đế Cơ
月纵横=Nguyệt Tung Hoành
月芳华=Nguyệt Phương Hoa
服云光绣袍=Phục Vân Quang Tú Bào
望唐仙剑=Vọng Đường Tiên Kiếm
望阳峰=Vọng Dương Phong
朝夕大道花=Triều Tịch Đại Đạo Hoa
朝夕花=Triều Tịch Hoa
朝阳一气剑=Triều Dương Nhất Khí Kiếm
木之使者=Mộc Chi Sử Giả
木圣之道=Mộc Thánh Chi Đạo
木母十八天=Mộc Mẫu Thập Bát Thiên
木母十八层天=Mười tám tầng trời Mộc Mẫu
木病已=Mộc Bệnh Dĩ
木系剑法研究室=Mộc hệ kiếm pháp nghiên cứu thất
木道圣气=Mộc Đạo Thánh Khí
木龙=Mộc Long
未来仪法宝=Vị Lai Nghi Pháp Bảo
本宫=Bản Cung
本草纲经=Bản Thảo Cương Kinh
朱人欲=Chu Nhân Dục
朱天人=Chu Thiên Nhân
朱子之书=Chu Tử Chi Thư
机械万毒鸟=Cơ giới vạn độc điểu
机械文明=Văn minh Cơ Giới
机械界=Giới Cơ Giới
机械界之主=Cơ Giới Giới Chi Chủ
机械螳螂=Cơ giới Đường Lang
杀之剑意=Sát Chi Kiếm Ý
杀之剑法=Sát Chi Kiếm Pháp
杀之弓=Sát Chi Cung
杀剑魔=Sát Kiếm Ma
杀气=Sát khí
杀荒高手=Sát Hoang cao thủ
李三笑=Lý Tam Tiếu
李三药=Lý Tam Dược
李元白=Lý Nguyên Bạch
李太史=Lý Thái Sử
李太名=Lý Thái Danh
李太白=Lý Thái Bạch
李寿=Lý Thọ
李师弟=Lý sư đệ
李求欢=Lý Cầu Hoan
李浩然=Lý Hạo Nhiên
杜云=Đỗ Vân
杨伟=Dương Vĩ
杨顶天=Dương Đỉnh Thiên
极乐剑法=Cực Lạc Kiếm Pháp
极速电腿=Cực Tốc Điện Thối
极速风火轮=Cực Tốc Phong Hỏa Luân
林妙玉=Lâm Diệu Ngọc
林小白=Lâm Tiểu Bạch
林木=Lâm Mộc
柔福帝姬=Nhu Phúc Đế Cơ
柳一刀=Liễu Nhất Đao
柳剑仙门=Liễu Kiếm Tiên Môn
柳叶儿=Liễu Diệp Nhi
柳如眉=Liễu Như Mi
柳随云=Liễu Tùy Vân
树之式=Thụ Chi Thức
树之文明=Văn minh Thụ
树之文明副主=Thụ Chi Văn Minh Phó Chủ
树之文明树圣帝子=Thụ Chi Văn Minh Thụ Thánh Đế Tử
树圣帝子=Thụ Thánh Đế Tử
核心弟子=Hạch Tâm Đệ Tử
核聚变=Hạch Tụ Biến
格斗招式=chiêu thức chiến đấu
桂花=Quế Hoa
桃花剑月芳华=Đào Hoa Kiếm Nguyệt Phương Hoa
梅花三弄=Mai Hoa Tam Lộng
梅花易数=Mai Hoa Dịch Số
梦幻瀑布=Mộng Huyễn Phác Bố
梦湖帝后=Mộng Hồ Đế Hậu
椒图=Tiêu Đồ
楚断=Sở Đoạn
楚断掌门=Sở Đoạn chưởng môn
楚白=Sở Bạch
楚雾=Sở Vụ
横刀门=Hoành Đao Môn
横斩=Hoành Trảm
横眉断=Hoành Mi Đoạn
橙王子=Trình vương tử
欢喜禅=Hoan Hỉ Thiền
欧阳兴=Âu Dương Hưng
欧阳妄=Âu Dương Vọng
欧阳宗师=Âu Dương tông sư
欲之原石=Dục Chi Nguyên Thạch
欲之火=Dục Chi Hỏa
欲伤神=Dục thương thần
正之文明副主=Chính Chi Văn Minh Phó Chủ
正之极限=Chính chi cực hạn
正字=Chữ Chính
正字守护神魂=Chính Tự Thủ Hộ Thần Hồn
正字文明副主=Phó chủ tế Văn minh Chính Tự
正气=Chính Khí
正气云霄散=Chính Khí Vân Tiêu Tán
正气传承=Chính Khí Truyền Thừa
正气剑圣=Chính Khí Kiếm Thánh
正气属性=Thuộc tính chính khí
正气灵霄散=Chính Khí Linh Tiêu Tán
正道=Chính Đạo
步迷=Bộ Mê
武之子=Võ Chi Tử
武动帝子=Võ Động Đế Tử
武博文明=Văn minh Võ Bác
武博文明副主=Võ Bác Văn Minh Phó Chủ
武古=Võ Cổ
武古文明=Võ Cổ Văn Minh
武古文明之主=Võ Cổ Văn Minh Chi Chủ
武命心经=Võ Mệnh Tâm Kinh
武圣=Võ Thánh
武圣帝子=Võ Thánh Đế Tử
武圣文明=Võ Thánh Văn Minh
武圣文明副主=Võ Thánh Văn Minh Phó Chủ
武当=Võ Đang
武当仙门=Võ Đang Tiên Môn
武扬帝子=Võ Dương Đế Tử
武杀文明副主=Võ Sát Văn Minh Phó Chủ
武燕=Võ Yến
武燕姐=Võ Yến tỷ
武燕文明=Văn minh Võ Yến
武燕文明副主=Võ Yến Văn Minh Phó Chủ
武燕荒鹰=Võ Yến Hoang Ưng
武王帝子=Võ Vương Đế Tử
武生=Võ Sinh
武生帝子=Võ Sinh Đế Tử
武皇尊=Võ Hoàng Tôn
武皇帝子=Võ Hoàng Đế Tử
武神文明之主=Chủ văn minh Võ Thần
武神无敌=Võ Thần Vô Địch
武神步=Võ Thần Bộ
武耀文明=Võ Diệu Văn Minh
武耀文明副主=Phó chủ văn minh Võ Diệu
武逍帝子=Võ Tiêu Đế Tử
武道之树=Cây Võ Đạo
死之剑意=Tử Chi Kiếm Ý
死之天地法相=Tử Chi Thiên Địa Pháp Tướng
死无葬身之地=Tử Vô Táng Thân Chi Địa
死魔=Tử Ma
残剑=Tàn Kiếm
段贺=Đoạn Hạ
殷于雷=Ân Vu Lôi
殷无忌=Ân Vô Kỵ
毁灭之初=Khởi Đầu Diệt Vong
毁灭百斩=Diệt Vong Bách Trảm
毒之文明=Văn minh Độc
毒之文明副主=Độc Chi Văn Minh Phó Chủ
毒之文明毒圣帝子=Độc Chi Văn Minh Độc Thánh Đế Tử
毒圣帝子=Độc Thánh Đế Tử
毒我文明=Độc Ngã văn minh
毒我文明副主=Phó Chủ Văn Minh Độc Ngã
毒绝文明=Văn minh Độc Tuyệt
毒绝文明副主=Phó chủ Văn minh Độc Tuyệt
毒艳文明副主=Phó chủ văn minh Độc Diễm
毒龙=Độc Long
比剑大会=Hội Thi Kiếm
比越国=Tỷ Việt Quốc
毕宿星=Tất Tú Tinh
气节=Khí Tiết
气节文明=Khí Tiết văn minh
气节文明副主=Phó Chủ Văn Minh Khí Tiết
气运=Khí Vận
气运七子=Khí Vận Thất Tử
气运之子=Khí Vận Chi Tử
气运之雾=Khí Vận Chi Vụ
气运第八子=Khí Vận Đệ Bát Tử
气运第六子=Khí Vận Đệ Lục Tử
氢之元素=Nguyên tố Hydro
水之剑意=Thủy Chi Kiếm Ý
水之天地法则=Thủy Chi Thiên Địa Pháp Tắc
水之龙=Thủy Long
水圣剑道=Thủy Thánh Kiếm Đạo
水晶棺=Quan tài pha lê
水晶橙汁=Thủy Tinh Chanh
水母云雾公主=Thủy Mẫu Vân Vụ công chúa
水母十八层天=Mười tám tầng trời Thủy Mẫu
水皇剑道=Thủy Hoàng Kiếm Đạo
水镜术=Thủy Kính Thuật
水镜面=Thủy Kính Diện
水雅然=Thủy Nhã Nhiên
水龙=Thủy Long
永世不朽诀=Vĩnh Thế Bất Hủ Quyết
永之层=Vĩnh Chi Tầng
永之秘=Vĩnh Chi Bí
永恒不灭=Vĩnh Hằng Bất Diệt
永恒之主=Vĩnh Hằng Chi Chủ
永恒之乱流=Vĩnh Hằng Chi Lưu
永恒之光圈=Vòng Ánh Sáng Vĩnh Hằng
永恒之刀=Vĩnh Hằng Chi Đao
永恒之劲=Vĩnh Hằng Chi Kính
永恒之地=Vùng Đất Vĩnh Hằng
永恒之天才=Vĩnh Hằng Chi Thiên Tài
永恒之天道堂=Vĩnh Hằng Chi Thiên Đạo Đường
永恒之果=Vĩnh Hằng Chi Quả
永恒之道=Vĩnh Hằng Chi Đạo
永恒之门=Vĩnh Hằng Chi Môn
永恒之门天劫=Thiên kiếp Cánh cửa Vĩnh Hằng
永恒天宫=Vĩnh Hằng Thiên Cung
永恒星域=Vĩnh Hằng Tinh Vực
永恒星火=Vĩnh Hằng Tinh Hỏa
汉宫秋月=Hán Cung Thu Nguyệt
江姓剑客=Kiếm Khách họ Giang
江山书卷=Giang Sơn Thư Quyển
汪血泽=Uông Huyết Trạch
沉星灭世剑法=Trầm Tinh Diệt Thế Kiếm Pháp
沉星陨世剑法=Trầm Tinh Vẫn Thế Kiếm Pháp
沉香宝座=Trầm Hương Bảo Tọa
沙中佛国=Sa Trung Phật Quốc
河之剑意=Hà Chi Kiếm Ý
沸水烧卤=Phí Thủy Thiêu Lỗ
法一帝子=Pháp Nhất Đế Tử
法一文明副主=Pháp Nhất Văn Minh Phó Chủ
法之子=Pháp Chi Tử
法之文明副主=Pháp Chi Văn Minh Phó Chủ
法元天=Pháp Nguyên Thiên
法则空间=Không gian pháp tắc
法刚天=Pháp Cương Thiên
法刚文明副主=Pháp Cương Văn Minh Phó Chủ
法力=Pháp lực
法力大掌=Pháp Lực Đại Chưởng
法变=Pháp Biến
法变文明=Pháp Biến Văn Minh
法变文明之主=Pháp Biến Văn Minh Chi Chủ
法古=Pháp Cổ
法古世界=Pháp Cổ Thế Giới
法古之树=Cây Pháp Cổ
法古之河=Sông Pháp Cổ
法古圣地=Pháp Cổ Thánh Địa
法古圣子=Pháp Cổ Thánh Tử
法古小千世界=Tiểu Thiên Thế Giới Pháp Cổ
法古文明=Pháp Cổ Văn Minh
法古文明之主=Pháp Cổ Văn Minh Chi Chủ
法古文明记妖薄=Pháp Cổ Văn Minh Ký Yêu Bạc
法圣=Pháp Thánh
法圣宫殿=Pháp Thánh Cung Điện
法圣帝子=Pháp Thánh Đế Tử
法妙文明副主=Phó chủ Văn minh Pháp Diệu
法字=Pháp tự
法宝=Pháp bảo
法宝城=Thành Pháp Bảo
法宝大陆=Đại lục Pháp Bảo
法宝文明=Văn minh Pháp Bảo
法宝文明副主=Phó chủ Văn minh Pháp Bảo
法尊霸气诀=Pháp Tôn Bá Khí Quyết
法强帝子=Pháp Cường Đế Tử
法暴帝子=Pháp Bạo Đế Tử
法术=Pháp thuật
法术一线天=Pháp thuật Nhất Tuyến Thiên
法术之宫=Pháp Thuật Chi Cung
法术无双=Pháp Thuật Vô Song
法术玄奥=Pháp Thuật Huyền Áo
法武联盟=Pháp Võ Liên Minh
法灵帝姬=Pháp Linh Đế Cơ
法界三十三天=Pháp Giới Tam Thập Tam Thiên
法皇帝子=Pháp Hoàng Đế Tử
法相池=Pháp Tướng Trì
法空文明=Văn minh Pháp Không
法空文明副主=Phó chủ Văn minh Pháp Không
法网恢恢=Pháp Võng Khôi Khôi
法转千变神通=Pháp Chuyển Thiên Biến Thần Thông
法逍帝子=Pháp Tiêu Đế Tử
法隐文明=Văn minh Pháp Ẩn
法隐文明副主=Pháp Ẩn Văn Minh Phó Chủ
泪枯=Lệ Khô
泰山=Thái Sơn
泰山派=Thái Sơn Phái
洗仙池=Tẩy Tiên Trì
洞阴=Động Âm
洪之刀气=Hồng Chi Đao Khí
洪之招式极限=Hồng chi chiêu thức cực hạn
洪之极限=Hồng Chi Cực Hạn
洪乐王=Hồng Nhạc Vương
洪字真谛=Hồng Tự Chân Đế
洪系文字=Hồng Hệ Văn Tự
洪荒=Hồng Hoang
洪荒之树=Hồng Hoang Chi Thụ
洪荒之气=Hồng Hoang Chi Khí
洪荒大泽=Hồng Hoang Đại Trạch
洪荒始祖龙虎=Hồng Hoang Thủy Tổ Long Hổ
洪荒巨蛋=Hồng Hoang Cự Đản
洪荒巨蛋诀=Hồng Hoang Cự Đản Quyết
洪荒战车=Hồng Hoang Chiến Xa
洪荒斗狼=Hồng Hoang Đấu Lang
洪荒晶石=Hồng Hoang Tinh Thạch
洪荒灵宝=Hồng Hoang Linh Bảo
洪荒石=Hồng Hoang Thạch
洪荒神戟=Hồng Hoang Thần Kích
洪荒神魂聚灵塔=Hồng Hoang Thần Hồn Tụ Linh Tháp
洪荒系=Hồng Hoang Hệ
洪荒级=Cấp Hồng Hoang
洪荒苍狼=Hồng Hoang Thương Lang
洪荒霸刀=Hồng Hoang Bá Đao
洪荒鸿蒙=Hồng Hoang Hồng Mông
流之剑意=Lưu Chi Kiếm Ý
流之天地法则=Lưu Chi Thiên Địa Pháp Tắc
流星=Lưu Tinh
流星仙剑=Lưu Tinh Tiên Kiếm
流星派=Lưu Tinh Phái
流星神剑=Lưu Tinh Thần Kiếm
流水=Lưu Thủy
流水之席=Tửu yến thịnh soạn
测时器=Trắc Thời Khí
浩然剑气=Hạo Nhiên Kiếm Khí
浩然正气=Hạo nhiên chính khí
浩然正气幡=Hạo nhiên chính khí phan
浪秋风=Lãng Thu Phong
浮沉控木法=Phù Trầm Khống Mộc Pháp
浮生若梦=Phù Sinh Nhược Mộng
海底火=Hải Để Hỏa
海贼王=Vua Hải Tặc
涅合金刀=Niết Kim Đao
消弥复元药=Tiêu Di Phục Nguyên Dược
涛之招式极限=Đào chi chiêu thức cực hạn
涡之剑意=Qua Chi Kiếm Ý
深恶痛绝罪凌迟=Thâm Ác Thống Tuyệt Tội Lăng Trì
混之丹=Hỗn Chi Đan
混之气息=Hỗn Chi Khí Tức
混元伞=Hỗn Nguyên Tán
混沌=Hỗn Độn
混沌之晶=Hỗn Độn Chi Tinh
混沌元气=Hỗn Độn Nguyên Khí
混沌境=Hỗn Độn Cảnh
混沌天蛇血=Hỗn Độn Thiên Xà Huyết
混沌心脏之晶=Hỗn Độn Tâm Tạng Chi Tinh
混沌文明=Hỗn Độn Văn Minh
混沌文明兽=Hỗn Độn Văn Minh Thú
混沌文明碎片=Mảnh vỡ Văn minh Hỗn Độn
混沌文明结晶=Kết tinh văn minh hỗn độn
混沌肝晶=Hỗn Độn Can Tinh
混沌肠晶=Hỗn Độn Tràng Tinh
混沌肺晶=Hỗn Độn Phế Tinh
混沌肾晶=Hỗn Độn Thận Tinh
混沌胃晶=Hỗn Độn Vị Tinh
混沌胃酸之主=Chủ nhân của Axit Vị Hỗn Độn
混沌胆晶=Hỗn Độn Đảm Tinh
混沌脑之主=Chủ nhân Não Hỗn Độn
混沌脑晶=Hỗn Độn Não Tinh
混沌脑风暴之主=Hỗn Độn Não Phong Bạo Chi Chủ
混沌脾晶=Hỗn Độn Tỳ Tinh
混沌舌晶=Hỗn Độn Thiệt Tinh
混沌足晶=Hỗn Độn Túc Tinh
混沌魔舌之主=Hỗn Độn Ma Thiệt Chi Chủ
混洞境=Hỗn Động Cảnh
混洞境四重天=Hỗn Động Cảnh Tứ Trọng Thiên
混洞空间=Hỗn Động Không Gian
混雷门=Hỗn Lôi Môn
清心石=Thanh Tâm Thạch
清明=Thanh Minh
清浊石=Thanh Trọc Thạch
清苦一剑=Thanh Khổ Nhất Kiếm
渔家唱晚=Ngư Gia Xướng Vãn
渔舟唱晚=Ngư Chu Xướng Vãn
温玉文明副主=Ôn Ngọc Văn Minh Phó Chủ
温竹酒=Ôn Trúc Tửu
漩涡吞噬=Xoáy Nước Thôn Phệ
潇洒夜雨=Tiêu Sái Dạ Vũ
潇湘夜雨愁断肠=Tiêu Tương Dạ Vũ Sầu Đoạn Trường
潇湘夜雨愁断肠，寒蝉悲鸣人流泪=Tiêu Tương dạ vũ sầu đứt ruột, Hàn thiền bi minh nhân rơi lệ
潜字=Tiềm Tự
潜渊仙剑=Tiềm Uyên Tiên Kiếm
火之文明=Văn minh Hỏa
火之文明副主=Hỏa Chi Văn Minh Phó Chủ
火云帝姬=Hỏa Vân Đế Cơ
火剑司马钟=Hỏa Kiếm Tư Mã Chung
火圣剑道=Hỏa Thánh Kiếm Đạo
火拼六合无敌=Hỏa Tính Lục Hợp Vô Địch
火母十八层天=Mười tám tầng trời Hỏa Mẫu
火母瑶姬圣母=Hỏa Mẫu Dao Cơ Thánh Mẫu
火炎帝后=Hỏa Viêm Đế Hậu
火皇剑道=Hỏa Hoàng Kiếm Đạo
火神七劫火=Hỏa Thần Thất Kiếp Hỏa
火神甲功=Hỏa Thần Giáp Công
火酒=Hỏa Tửu
火麒麟=Hỏa Kỳ Lân
火龙=Hỏa Long
火龙舞星剑法=Hỏa Long Vũ Tinh Kiếm Pháp
灭世=Diệt Thế
灭世级剑法=Diệt Thế Cấp Kiếm Pháp
灭仙剑=Diệt Tiên Kiếm
灭伦天尊=Diệt Luân Thiên Tôn
灭伦文明=Văn minh Diệt Luân
灭伦文明副主=Diệt Luân Văn Minh Phó Chủ
灭情身法=Diệt Tình Thân Pháp
灭星=Diệt Tinh
灭星级法术=Pháp Thuật Diệt Tinh
灭火刹=Diệt Hỏa Sát
灭绝神书=Diệt Tuyệt Thần Thư
灭道仙剑=Diệt Đạo Tiên Kiếm
灭魂=Diệt Hồn
灭魂神剑=Diệt Hồn Thần Kiếm
灭魔大阵=Diệt Ma Đại Trận
灵妙酒=Linh Diệu Tửu
灵字=Linh Tự
灵宝天尊=Linh Bảo Thiên Tôn
灵燕心经=Linh Yến Tâm Kinh
灵猴剑法=Linh Hầu Kiếm Pháp
灵猴摘桃=Linh Hầu Trích Đào
灵猴跃树=Linh Hầu Dược Thụ
灵猴跳=Linh Hầu Khiêu
灵猴酒=Linh Hầu Tửu
灵脉=Linh mạch
灵雨酿=Linh Vũ Nương
灵魂天灯=Linh hồn Thiên Đăng
灾殃=Tai ương
炎斗爆=Viêm Đấu Bạo
炎龙灭世波=Viêm Long Diệt Thế Ba
炼正成魔大法=Luyện Chính Thành Ma Đại Pháp
炼正成魔大阵=Luyện Chính Thành Ma Đại Trận
炼魂魔人=Luyện Hồn Ma Nhân
炼魂魔人何求意=Luyện Hồn Ma Nhân Hà Cầu Ý
烂陀寺=Lạn Đà Tự
烦恼魔=Phiền Não Ma
烦恼魔祖=Phiền Não Ma Tổ
烧刀子=Thiêu Đao Tử
焚书坑儒=Phần Thư Khanh Nho
焦尾=Tiêu Vĩ
燕击鹰沉文明双杀=Yến Kích Ưng Trầm Văn minh Song Sát
燕啄=Yến Chích
燕回闪=Yến Hồi Thiểm
燕师兄=Yến sư huynh
燕师弟=Yến Sư đệ
燕惊剑=Yến Kinh Kiếm
燕惊神剑=Yến Kinh Thần Kiếm
燕春秋=Yến Xuân Thu
燕祖师=Yến Tổ Sư
燕秋月=Yến Thu Nguyệt
燕苍=Yến Thương
燕苍天=Yến Thương Thiên
燕飞一=Yến Phi Nhất
爆雷星辰=Bạo Lôi Tinh Thần
爱伤肠=Ái thương tràng
父为子纲=Phụ Vi Tử Cương
牛郎星=Ngưu Lang Tinh
牵一发而动全身=Khiên Nhất Phát Nhi Động Toàn Thân
特训=Huấn luyện đặc biệt
狂之极限=Cuồng Chi Cực Hạn
狂凶=Cuồng Hung
狂怒之枪=Cuồng Nộ Chi Thương
狂门=Cuồng Môn
狂风快剑=Cuồng Phong Khoái Kiếm
狂风柳林=Cuồng Phong Liễu Lâm
狂风过境=Cuồng Phong Quá Cảnh
狂飙速法=Cuồng Tiêu Tốc Pháp
狂鹰门=Cuồng Ưng Môn
狐之文明=Văn minh Hồ
狐之文明副主=Hồ Chi Văn Minh Phó Chủ
狐圣帝姬=Hồ Thánh Đế Cơ
狐圣帝子=Hồ Thánh Đế Tử
狐姬胡云砚=Hồ Cơ Hồ Vân Nghiên
狐尾文明副主=Phó chủ Văn minh Hồ Vĩ
狐长老=Hồ trưởng lão
独一刀法=Độc Nhất Đao Pháp
独天一帝=Độc Thiên Nhất Đế
独孤昊=Độc Cô Hạo
独孤法=Độc Cô Pháp
独尊仙剑=Độc Tôn Tiên Kiếm
独我为天=Độc Ngã Vi Thiên
独秀峰=Độc Tú Phong
狱之世界=Ngục Chi Thế Giới
狱仙剑=Ngục Tiên Kiếm
狱字=Ngục Tự
狴犴=Bí Ngạn
狻猊=Toan Nghê
猎千秋=Liệp Thiên Thu
猎龙海=Liệp Long Hải
猫之文明=Văn minh Mèo
猫妖=Miêu Yêu
猫妖之族=Miêu Yêu Chi Tộc
猫妖之珠=Miêu Yêu Chi Châu
猫妖之皮=Miêu Yêu Chi Bì
猫妖之骨=Miêu Yêu Chi Cốt
猴儿酒=Hầu Nhi Tửu
猿魔大圣=Viên Ma Đại Thánh
猿魔孙大支=Viên Ma Tôn Đại Chi
玄冥仙门=Huyền Minh Tiên Môn
玄冥妙果=Huyền Minh Diệu Quả
玄冥娘娘=Huyền Minh nương nương
玄冥门=Huyền Minh Môn
玄天山岳化血掌=Huyền Thiên Sơn Nhạc Hóa Huyết Chưởng
玄天甲=Huyền Thiên Giáp
玄画子=Huyền Họa Tử
玄龟=Huyền Quy
玉免钟灵=Ngọc Thỏ Chung Linh
玉兔=Ngọc Thỏ
玉女峰=Ngọc Nữ Phong
玉皇大帝=Ngọc Hoàng Đại Đế
玉真上人=Ngọc Chân Thượng Nhân
玉碑=Ngọc Bi
玉衡=Ngọc Hành
王之极限=Vương Chi Cực Hạn
王师兄=Vương sư huynh
王族=Vương tộc
王杰雄=Vương Kiệt Hùng
王法道=Vương Pháp Đạo
王石头=Vương Thạch Đầu
王超雄=Vương Siêu Hùng
王道法=Vương Đạo Pháp
王霸仙剑=Vương Bá Tiên Kiếm
球之文明=Văn minh Cầu
琉璃金身=Lưu Ly Kim Thân
琴之文明=Cầm Chi Văn Minh
琴之文明副主=Cầm Chi Văn Minh Phó Chủ
琴棋书画四卫=Cầm Kỳ Thư Họa Tứ Vệ
瑶圣池=ao Dao Thánh
瑶姬圣母=Dao Cơ Thánh Mẫu
瑶姬池=Ao Dao Cơ
瓜子脸蛋=khuôn mặt trái xoan
甘道=Cam Đạo
甜之招式极限=Điềm chi chiêu thức cực hạn
生之剑意=Sinh Chi Kiếm Ý
生之天地法相=Sinh Chi Thiên Địa Pháp Tướng
生命圆满境=Sinh Mệnh Viên Mãn Cảnh
生死轮回之盘=Sinh Tử Luân Hồi Chi Bàn
电之剑意=Điện Chi Kiếm Ý
电磁力=Điện Từ Lực
电长老=Điện Trưởng Lão
留白小题诗=Lưu Bạch Tiểu Đề Thi
疠疾=Lệ Tật
疾风乱电风来雨愁剑=Tật Phong Loạn Điện Phong Lai Vũ Sầu Kiếm
痴字=Si Tự
痴断肠=Si Đoạn Tràng
瘟之邪道=Ôn Chi Tà Đạo
瘟系元气=Ôn hệ nguyên khí
瘴气=Chướng Khí
白云=Bạch Vân
白冰船=Bạch Băng Thuyền
白发三千丈=Bạch Phát Tam Thiên Trượng
白发白须=Tóc trắng râu trắng
白发神针扁童一=Bạch Phát Thần Châm Biện Đồng Nhất
白帝剑意=Bạch Đế Kiếm Ý
白帝剑道=Bạch Đế Kiếm Đạo
白狐文明=Văn minh Bạch Hồ
白狐文明副主=Phó chủ Văn minh Bạch Hồ
白玉缠佛带=Bạch Ngọc Triền Phật Đới
白眉之针=Bạch Mi Chi Châm
白眉老人=Bạch Mi Lão Nhân
白色九天羽纱=Bạch Sắc Cửu Thiên Vũ Sa
白芳华=Bạch Phương Hoa
白虹仙剑=Bạch Hồng Tiên Kiếm
白衣银发=Công tử áo trắng tóc bạc
白裘狐衣=Bạch Cừu Hồ Y
白金苹果汁=Bạch Kim Táo
白鹤=Hạc trắng
百万剑坟=Bách Vạn Kiếm Phần
百万剑阵=Bách Vạn Kiếm Trận
百剑坟=Bách Kiếm Phần
百变千幻云雾一千三百剑=Bách Biến Thiên Huyễn Vân Vụ 1300 Kiếm
百国考核=Bách Quốc Khảo Hạch
百指剑=Bách Chỉ Kiếm
百方战棋=Bách Phương Chiến Kỳ
百炼之剑=Bách Luyện Chi Kiếm
百甲子神木天劫=Bách Giáp Tử Thần Mộc Thiên Kiếp
百败真经=Bách Bại Chân Kinh
百贫国=Bách Bần Quốc
百转千回忘忧酒=Bách Chuyển Thiên Hồi Vong Ưu Tửu
百里=Bách Lý
百里冰=Bách Lý Băng
百里月=Bách Lý Nguyệt
百里至尊=Bách Lý Chí Tôn
皇之极限=Hoàng Chi Cực Hạn
皇帝=Hoàng Đế
皇气=Hoàng Khí
皇甫中天=Hoàng Phủ Trung Thiên
盗之文明=Đạo Chi Văn Minh
盘动七=Bàn Động Thất
盘古=Bàn Cổ
盘古幡=Bàn Cổ Phiên
盘古开天=Bàn Cổ Khai Thiên
盘古枪法=Bàn Cổ Thương Pháp
盘古正宗=Chính tông Bàn Cổ
盘古纪元=Bàn Cổ Kỷ Nguyên
盘古酒=Bàn Cổ Tửu
盘古金身=Bàn Cổ Kim Thân
盘天神斧=Bàn Thiên Thần Phủ
盘暴神斧=Bàn Bạo Thần Phủ
盟友=Đồng minh
相思=Tương Tư
相遇森林=Rừng Gặp Gỡ
眉毛剑堂=Mi Mao Kiếm Đường
看守剑卷=người canh giữ Kiếm Quyển
真一境=Chân Nhất Cảnh
真一门=Chân Nhất Môn
真一龙虎大法=Chân Nhất Long Hổ Đại Pháp
真传弟子=Chân Truyền Đệ Tử
真刚=Chân Cương
真刚神剑=Chân Cương Thần Kiếm
真实=Chân Thật
真实之戟=Kích Chân Thật
真实之眼=Chân Thật Chi Nhãn
真武洞天=Chân Võ Động Thiên
真理=Chân Lý
真理之笔=Bút Chân lý
真界境=Chân Giới Cảnh
真级=Cấp Chân
真龙之力=Chân Long Chi Lực
眼之文明=Văn minh Nhãn
眼珠=Nhãn Châu
眼珠子=con ngươi
睚眦=Nha Tí
瞬之剑意=Thuấn Chi Kiếm Ý
瞬移=Thuấn di
石中火=Thạch Trung Hỏa
石义生=Thạch Nghĩa Sinh
石朝阳=Thạch Triều Dương
石猴=Thạch Hầu
石遁术=Thuật thạch độn
破万仙法=Phá Vạn Tiên Pháp
破剑=Phá Kiếm
破惊一袖=Phá Kinh Nhất Tụ
破狐=Phá Hồ
破绽复伤=Phá Trán Phục Thương
破绽迭加=Phá Trán Điệp Gia
破绽追命=Phá Trán Truy Mệnh
破绽追魂=Phá Trán Truy Hồn
硫之元素=Nguyên tố Lưu
碎流星=Toái Lưu Tinh
碧山蛙=Bích Sơn Oa
碧落=Bích Lạc
碧落剑法=Bích Lạc Kiếm Pháp
碧落酒=Bích Lạc Tửu
碧血剑法=Bích Huyết Kiếm Pháp
碧血剑门=Bích Huyết Kiếm Môn
碧血青天=Bích Huyết Thanh Thiên
磁爆天劫=Từ Bạo Thiên Kiếp
磁镜术=Từ Kính Thuật
祖之刀=Tổ Chi Đao
祖龙=Tổ Long
祝天融=Chúc Thiên Dung
祝炎=Chúc Viêm
祝烈风=Chúc Liệt Phong
神亡灭绝佛陨落=Thần Vong Diệt Tuyệt Phật Vẫn Lạc
神力=Thần Lực
神哭鬼愁锏法=Thần Khóc Quỷ Sầu Kiển Pháp
神火炮=Thần Hỏa Pháo
神灵=Thần linh
神灵境=Thần Linh Cảnh
神王=Thần Vương
神秘中年书生剑者=Kiếm giả thư sinh trung niên thần bí
神箭=Thần Tiễn
神级=Cấp Thần
神级兵器=Thần Cấp Binh Khí
神行万变=Thần Hành Vạn Biến
神识=Thần Thức
神魂法宝=Thần Hồn Pháp Bảo
神龙=Thần Long
神龙文明之主=Thần Long Văn Minh Chi Chủ
祭魔真功=Tế Ma Chân Công
离宫=Ly Cung
离火星=Ly Hỏa Tinh
秀峰仙剑=Tú Phong Tiên Kiếm
秀峰剑=Tú Phong Kiếm
秋帝剑道=Thu Đế Kiếm Đạo
科学界=Khoa Học Giới
秘之文明之主=Bí Chi Văn Minh Chi Chủ
秣陵别雪=Mạt Lăng Biệt Tuyết
秦国=Tần Quốc
秦晋两国=Tần Tấn lưỡng quốc
秦晋元=Tần Tấn Nguyên
秦霜城=Tần Sương Thành
秩序=Trật Tự
秩序河流=Hà lưu Trật Tự
秩序铁则=Trật Tự Thiết Tắc
积累境=Cảnh giới Tích Lũy
稀奇古怪剑道=Hi Kì Cổ Quái Kiếm Đạo
究极九头火=Cứu Cực Cửu Đầu Hỏa
穷凶之枪=Cùng Hung Chi Thương
空之山=Không Chi Sơn
空断剑法=Không Đoạn Kiếm Pháp
空间=Không Gian
空间之河=Hà Không Gian
空间之线=Không Gian Chi Tuyến
空间之门=Không Gian Chi Môn
空间变化=Không Gian Biến Hóa
空间封锁=Không Gian Phong Tỏa
空间本身=Không Gian Bản Thân
空间破碎=Không Gian Phá Toái
空间重建=Không Gian Trùng Kiến
空间铁则=Không Gian Thiết Tắc
空间错乱=Không Gian Thác Loạn
穿云光乡袍=Áo bào Vân Quang Hương
穿心=Xuyên Tâm
穿心一剑=Xuyên Tâm Nhất Kiếm
穿梭四季=Xuyên Toa Tứ Quý
立夏=Lập Hạ
立夏剑意=Lập Hạ Kiếm Ý
立春=Lập Xuân
竞技场=Đấu Trường
童百年=Đồng Bách Niên
端午节=Tết Đoan Ngọ
端木=Đoan Mộc
端木丽=Đoan Mộc Lệ
端木从容=Đoan Mộc Tòng Dung
端木响河=Đoan Mộc Hưởng Hà
端木如此=Đoan Mộc Như Thử
端木如虎=Đoan Mộc Như Hổ
端木朱=Đoan Mộc Chu
端木至尊=Đoan Mộc Chí Tôn
端木鹤行=Đoan Mộc Hạc Hành
竹叶青=Trúc Diệp Thanh
竹节门=Trúc Tiết Môn
符咒文明=Văn minh Bùa Chú
符爆文明副主=Phó chủ Văn minh Phù Bạo
第一代祖师=Đệ Nhất Đại Tổ Sư
第一军师=Đệ Nhất Quân Sư
第一剑=Đệ Nhất Kiếm
第一剑主=Đệ Nhất Kiếm Chủ
第一扇时之铁则=Thiết tắc thời gian cửa thứ nhất
第一更=Canh một
第一百零一帝子=Đệ 101 Đế Tử
第七号=Đệ Thất Hào
第七扇门的周易微尘=Châu Dịch Vi Trần cửa thứ bảy
第三千号光奴=Quang Nô thứ 3000
第三扇轮回铁则=Thiết tắc luân hồi cửa thứ ba
第九扇门的无上剑气大法=Vô Thượng Kiếm Khí Đại Pháp cửa thứ chín
第二千九百号光奴=Quang Nô thứ 2900
第二扇门空间铁则=Thiết tắc không gian cửa thứ hai
第五号星辰=Ngôi Sao Số Năm
第八弟子=Đệ Bát Đệ Tử
第八扇门的重剑无双=Trọng Kiếm Vô Song cửa thứ tám
第六号=Đệ Lục Hào
第六扇门=Cửa thứ sáu
第十扇门=Cửa thứ mười
箫之文明=Văn minh Tiêu Chi
箭之快=Tiễn Chi Khoái
箭之文明=Tiễn Chi Văn Minh
箭之文明副主=Phó chủ Văn minh Tiễn
箭之绝招=Tiễn Chi Tuyệt Chiêu
箭舞三十三重天=Tiễn Vũ Tam Thập Tam Trọng Thiên
箭袖船=Tiễn Tụ Thuyền
箭门=Tiễn Môn
精神=tinh thần
精英=Tinh anh
紫光绣袍=Tử Quang Tú Bào
紫色东来果=Tử Sắc Đông Lai Quả
紫袍=Tím bào
紫霞上人=Tử Hà Thượng Nhân
繁星星纱=phồn tinh tinh sa
繁花过眼开一季=Phồn Hoa Quá Nhãn Khai Nhất Quý
繁！荣！=Phồn! Vinh!
红孩儿=Hồng Hài Nhi
纪元=Kỷ Nguyên
纪元之主=Kỷ Nguyên Chi Chủ
纪元之劫=Kiếp Nguyên
纪元之子=Kỷ Nguyên Chi Tử
纪元之树=Cây Kỷ Nguyên
纪元之花=Kỷ Nguyên Chi Hoa
纪元境=Kỷ Nguyên Cảnh
纪元大战=Đại chiến Kỷ Nguyên
纪元气运第一子=Kỷ Nguyên Khí Vận Đệ Nhất Tử
纪元种马=Kỷ Nguyên Chủng Mã
纪元霸主=Kỷ Nguyên bá chủ
纳兰德=Nạp Lan Đức
练仙池=Luyện Tiên Trì
练体期=Luyện Thể Kỳ
练气期=Luyện Khí Kỳ
织云云辇=Chức Vân Vân Niễn
织女=Chức Nữ
终元素=Nguyên tố cuối
终极之图=Chung Cực Chi Đồ
终极兵器=Vũ khí tối thượng
终极劫难天劫图=Chung Cực Kiếp Nạn Thiên Kiếp Đồ
终极生死之树=Chung Cực Sinh Tử Chi Thụ
终极生死之树天劫=Thiên kiếp Cây sinh tử tối thượng
绕指玉剑=Ngọc Kiếm nhiễu chỉ
绛雪宫=Giáng Tuyết Cung
绝世天才培养计划=Kế hoạch bồi dưỡng thiên tài tuyệt thế
绝云气=Tuyệt Vân Khí
绝云气，负青云=Tuyệt Vân Khí, Phụ Thanh Vân
绝云气，负青天=Tuyệt Vân Khí, Phụ Thanh Thiên
绝天仙剑=Tuyệt Thiên Tiên Kiếm
绝天绝地绝千方=Tuyệt Thiên Tuyệt Địa Tuyệt Thiên Phương
绝子绝孙绝生机=Tuyệt Tử Tuyệt Tôn Tuyệt Sinh Cơ
绝杀一剑=Tuyệt Sát Nhất Kiếm
绝神剑法=Tuyệt Thần Kiếm Pháp
继往圣之绝学=Kế vãng thánh chi tuyệt học
绾绾=Oản Oản
绿绮=Lục Khỉ
绿绮十曲=Mười khúc Lục Khởi
绿绮琴=Lục Khởi Cầm
绿蚁新醅酒，红泥小火炉。晚来天欲雪，能饮一杯无？=Lục ngụy tân bôi tửu, hồng nê tiểu hỏa lô. Vãn lai thiên dục tuyết, năng ẩm nhất bôi vô?
缠发银链=Triền Phát Ngân Liên
缥醪酒=Phiêu Lạo Tửu
缩地成尘=Súc Địa Thành Trần
缩地成尘之法=Túc Địa Thành Trần Chi Pháp
网之文明=Võng Chi Văn Minh
网之文明之主=Võng Chi Văn Minh Chi Chủ
罗汉=A-la-hán
罗汉峰=La Hán Phong
罗秀=La Tú
罗织织=La Chức Chức
罗薇=La Vi
罪魔=Tội Ma
美人一笑落一针=Mỹ Nhân Nhất Tiếu Lạc Nhất Châm
翼扬刀=Dực Dương Đao
翼风星=Dực Phong Tinh
老三灵宝天尊=Lão Tam Linh Bảo Thiên Tôn
老丘=Lão Khâu
老白干=Lão Bạch Càn
聆剑室=Linh Kiếm Thất
肉金刚=Nhục Kim Cương
肝之山=Can Chi Sơn
肠之海=Tràng Chi Hải
肺之树=Phế Chi Thụ
肾之山=Thận Chi Sơn
胃之山=Vị Chi Sơn
胃之湖泊=Vị Chi Hồ Bạc
胆之山=Đảm Chi Sơn
胆之精华=Đảm Chi Tinh Hoa
胆之魔神=Đảm Chi Ma Thần
胜仙百步=Thắng Tiên Bách Bộ
胜者组=Thắng Giả Tổ
胡月明=Hồ Nguyệt Minh
脑部=Não Bộ
脑髓=Não Tủy
脾之山=Tỳ Chi Sơn
腾八中祖=Đằng Bát Trung Tổ
自由之翼=Tự Do Chi Dực
至尊=Chí Tôn
至尊仙剑=Chí Tôn Tiên Kiếm
至尊宝=Chí Tôn Bảo
至果罗汉=Chí Quả La Hán
舍卫国祇树给孤独园=Xá Vệ Quốc, Kỳ Thọ, Cấp Cô Độc Viên
舒神酒=Thư Thần Tửu
艮宫=Cấn Cung
色空仙剑=Sắc Không Tiên Kiếm
芒种=Mang Chủng
芒种剑意=Mang Chủng Kiếm Ý
花之文明=Văn minh Hoa
花之文明副主=Phó chủ Văn minh Hoa
花开百山山不动=Hoa Khai Bách Sơn Sơn Bất Động
花间组=Hoa Gian Tổ
花间门=Hoa Gian Môn
芳华门=Phương Hoa Môn
苍云帝妃=Thương Vân Đế Phi
苍冥台=Đài Thương Minh
苍天之精华=Tinh Hoa Thương Thiên
苍天大道石=Đá Đại Đạo Thương Thiên
苍天门=Thương Thiên Môn
苍天霸地拳=Thương Thiên Bá Địa Quyền
苍海阴阳=Thương Hải Âm Dương
苍穹即天=Thương Khung Tức Thiên
苍野鸣=Thương Dã Minh
苏之文明=Tô Chi Văn Minh
苏晴雪=Tô Tình Tuyết
苏盈袖=Tô Doanh Tụ
苏雪宜=Tô Tuyết Nghi
苔痕上阶绿,草色入帘青=Đài Ngân Thượng Giai Lục, Thảo Sắc Nhập Liêm Thanh
苗之文明=Văn minh Miêu
苗之文明副主=Miêu Chi Văn Minh Phó Chủ
苗之文明副主大人=Đại nhân Miêu Chi Văn Minh Phó Chủ
苗刀=Miêu Đao
苗刀千古论春秋=Miêu Đao Thiên Cổ Luận Xuân Thu
苗刀文明=Miêu Đao Văn Minh
苗刀文明副主=Miêu Đao Văn Minh Phó Chủ
苗女=Miêu Nữ
苗女青莲=Miêu nữ Thanh Liên
苗蛊=Miêu Cổ
苗蛊文明=Văn minh Miêu Cổ
苗蛊文明副主=Miêu Cổ Văn Minh Phó Chủ
苗长生=Miêu Trường Sinh
苦之招式极限=Khổ chi chiêu thức cực hạn
苦之极限=Khổ Chi Cực Hạn
苦海无涯=Khổ Hải Vô Nhai
苦海无边=Khổ Hải Vô Biên
茅台烧=Mao Đài Thiêu
荀先书=Tuân Tiên Thư
荀通=Tuân Thông
荆无求=Kinh Vô Cầu
荆还真=Kinh Hoàn Chân
荒之大印=Hoang Chi Đại Ấn
荒之子=Hoang Chi Tử
荒之子大哥=Hoang Chi Tử Đại Ca
荒之气息=Hoang Chi Khí Tức
荒之真印=Hoang Chi Chân Ấn
荒仙佛=Hoang Tiên Phật
荒仙佛文明=Hoang Tiên Phật Văn Minh
荒仙佛联盟=Hoang Tiên Phật Liên Minh
荒仙佛魔=Hoang Tiên Phật Ma
荒令=Hoang Lệnh
荒兽刀=Hoang Thú Đao
荒兽文明刀法=Hoang Thú Văn Minh Đao Pháp
荒兽门=Hoang Thú Môn
荒卫军=Hoang Vệ Quân
荒原帝子=Hoang Nguyên Đế Tử
荒古=Hoang Cổ
荒古仙古佛古=Hoang Cổ Tiên Cổ Phật Cổ
荒古文明=Văn minh Hoang Cổ
荒古文明之主=Hoang Cổ Văn Minh Chi Chủ
荒古永恒之主=Hoang Cổ Vĩnh Hằng Chi Chủ
荒古王朝=Hoang Cổ Vương Triều
荒圣帝子=Hoang Thánh Đế Tử
荒海刀法=Hoang Hải Đao Pháp
荒海文明=Hoang Hải Văn Minh
荒渐于陆=Hoang Tiệm Vu Lục
荒温文明=Hoang Ôn Văn Minh
荒温文明副主=Hoang Ôn Văn Minh Phó Chủ
荒王帝子=Hoang Vương Đế Tử
荒瘟=Hoang Ôn
荒皇帝子=Hoang Hoàng Đế Tử
荒盟=Hoang Minh
荒真文明之主=Hoang Chân Văn Minh Chi Chủ
荒轻公子=Hoang Khinh Công Tử
荒道文明=Văn Minh Hoang Đạo
荒道文明之主=Hoang Đạo Văn Minh Chi Chủ
荒野文明=Văn minh Hoang Dã
荒野金瞳凌云鹰=Hoang Dã Kim Đồng Lăng Vân Ưng
荒霸文明副主=Phó Chủ Văn Minh Hoang Bá
荒风文明=Hoang Phong Văn Minh
荒风文明副主=Phó chủ Văn minh Hoang Phong
荒鹰=Hoang Ưng
荒鹰文明=Hoang Ưng văn minh
荒鹰文明副主=Hoang Ưng Văn Minh Phó Chủ
荣凤娇=Vinh Phượng Kiều
荣华一世=Vinh hoa một đời
药之文明=Dược Chi Văn Minh
药之文明副主=Dược Chi Văn Minh Phó Chủ
药圣帝子=Dược Thánh Đế Tử
药老葛一命=Dược Lão Cát Nhất Mệnh
莫仙剑=Mạc Tiên Kiếm
莫子王=Mạc Tử Vương
莫子言=Mạc Tử Ngôn
莫子鹤=Mạc Tử Hạc
莫氏父子=Mạc thị phụ tử
莫辰子=Mạc Thần Tử
莫野王=Mạc Dã Vương
菩提佛祖=Bồ Đề Phật Tổ
菩萨=Bồ Tát
菩萨尊神=Bồ Tát Tôn Thần
萧峰雄=Tiêu Phong Hùng
葛无伤=Cát Vô Thương
葛无灾=Cát Vô Tai
葛无病=Cát Vô Bệnh
葛无痛=Cát Vô Thống
葛氏四兄弟=Tứ huynh đệ Cát thị
葬心剑法=Táng Tâm Kiếm Pháp
蒙脱脱上师=Mông Thoát Thoát Thượng Sư
蒲牢=Bồ Lao
蕉窗夜雨=Tiêu Song Dạ Vũ
藏之剑意=Tàng Chi Kiếm Ý
藏之极限=Tàng chi cực hạn
藏书城池=Tàng Thư Thành Trì
虎翼=Hổ Dực
虎长老=Hổ Trưởng Lão
虚无=Hư Vô
虚空=Hư không
虚空兽魂山=Hư Không Thú Hồn Sơn
虚空火焰=Hư Không Hỏa Diễm
虚空通道=Hư Không Thông Đạo
虚空通道竞技场=Hư Không Thông Đạo Cạnh Kỹ Trường
虚行风=Hư Hành Phong
蛊之邪道=Cổ Chi Tà Đạo
蛊虫=Cổ trùng
蛊虫防御之甲=Cổ Trùng Phòng Ngự Chi Giáp
蛮之文明=Văn Minh Man
蝶恋花=Điệp Luyến Hoa
螓首=Thân thủ
螭吻=Ly Vẫn
螭虎=Li Hổ
血之世界=Huyết Chi Thế Giới
血之茧=Huyết Chi Kiển
血光=Huyết quang
血刀众=Huyết Đao chúng
血剑老祖=Huyết Kiếm Lão Tổ
血变剑仙=Huyết Biến Kiếm Tiên
血奴=Huyết Nô
血影=Huyết Ảnh
血月谛命经=Huyết Nguyệt Đế Mệnh Kinh
血枯=Huyết Khô
血浪滔天=Huyết Lãng Thao Thiên
血海=Huyết hải
血猎人方屠=Huyết Liệp Nhân Phương Đồ
血神之鼓=Huyết Thần Chi Cổ
血神王=Huyết Thần Vương
血神经=Huyết Thần Kinh
血神鼓=Huyết Thần Cổ
血药胖子李三笑=Huyết Dược Bàn Tử Lý Tam Tiếu
血门=Huyết Môn
血龙大法=Huyết Long Đại Pháp
行之剑意=Hành Chi Kiếm Ý
行之天地法则=Hành Chi Thiên Địa Pháp Tắc
行云=Hành Vân
行云流水=Hành Vân Lưu Thủy
行魔=Hành Ma
衡山=Hành Sơn
衰！落！=Suy! Lạc!
袁金蛇=Viên Kim Xà
袖箭船=Tụ Tiễn Thuyền
袖雪=Tụ Tuyết
袖雪姐姐=Tú Tuyết tỷ tỷ
裂土破=Liệt Thổ Phá
西之剑意=Tây Chi Kiếm Ý
西凤酒=Tây Phượng Tửu
西华=Tây Hoa
西方大瑞国=Tây Phương Đại Thụy Quốc
西极仙翁=Tây Cực Tiên Ông
西极龙宫=Tây Cực Long Cung
西毒=Tây Độc
西王母=Tây Vương Mẫu
西穷窅冥之党=Tây Cùng Yểu Minh Chi Đảng
观察文明副主=Quan Sát Văn Minh Phó Chủ
观音贵子=Quan Âm Quý Tử
解兵一剑=Giải Binh Nhất Kiếm
解脱之崖=Giải Thoát Chi Nhai
言苍山=Ngôn Thương Sơn
论语圣经=Luận Ngữ Thánh Kinh
识海=thức hải
诈之招式极限=Trá chi chiêu thức cực hạn
诛天至邪=Tru Thiên Chí Tà
诡之招式极限=Quỷ chi chiêu thức cực hạn
诡秘无极司徒诡秘=Quỷ Bí Vô Cực Tư Đồ Quỷ Bí
诡秘星=Quỷ Bí Tinh
诡秘盟=Quỷ Bí Minh
诡虚剑法=Quỷ Hư Kiếm Pháp
诸剑大阵=Chư Kiếm Đại Trận
诸天=Chư Thiên
诸天人头大法=Chư Thiên Nhân Đầu Đại Pháp
诸天封神指=Chư Thiên Phong Thần Chỉ
诸天文明=Chư Thiên Văn Minh
诸天神物=Thần Vật Chư Thiên
诸葛=Gia Cát
诸葛智=Gia Cát Trí
诸葛智伤=Gia Cát Trí Thương
诸邪退避甲=Chư Tà Thoái Tị Giáp
谍谍=Tiếp tiếp
谍谍谍谍谍=Điệp điệp điệp điệp điệp
谷雨=Cốc Vũ
贝双帝子=Bối Song Đế Tử
负青天=Phụ Thanh Thiên
败者组=Bại Giả Tổ
贪之法则空间=Không gian pháp tắc Tham
贪字=chữ Tham
贪欲剑法=Tham Dục Kiếm Pháp
贪狼=Tham Lang
贪狼仙剑=Tham Lang Tiên Kiếm
贵公子=quý công tử
赌仙岛=Đổ Tiên Đảo
赌仙岛主=Đổ Tiên Đảo Chủ
赌字=Đổ Tự
赌字分身=Đổ Tự Phân Thân
赌神=Đổ Thần
赌神之战=Đổ Thần Chi Chiến
赌鬼心法=Đổ Quỷ Tâm Pháp
赌鬼心经=Đổ Quỷ Tâm Kinh
赑屃=Bệ Ngạn
赔礼=Bồi thường
赢字分身=Phân thân chữ Thắng
赤帝=Xích Đế
赤帝火龙啸=Xích Đế Hỏa Long Khiếu
赤帝终极九式=Xích Đế Chung Cực Cửu Thức
赤翼妖王=Xích Dực Yêu Vương
赤龙仙门=Xích Long Tiên Môn
赵哲=Triệu Triết
赵图=Triệu Đồ
赵天雷=Triệu Thiên Lôi
赵混雷=Triệu Hỗn Lôi
超水亿弱千水劫=Siêu Thủy Ức Nhược Thiên Thủy Kiếp
越女剑宗=Việt Nữ Kiếm Tông
越女剑门=Việt Nữ Kiếm Môn
越女小青=Việt Nữ Tiểu Thanh
越女阿青=Việt Nữ A Thanh
越鹿山=Việt Lộc Sơn
足之深渊=Túc Chi Thâm Uyên
趴蝮=Bá Phục
跃火舞=Dược Hỏa Vũ
踏步微尘=Đạp Bộ Vi Trần
踏风神刀=Đạp Phong Thần Đao
身形如电=Thân Hình Như Điện
躺尸剑法=Thảng Thi Kiếm Pháp
躺着打剑堂=Thảng Trứ Đả Kiếm Đường
轩辕=Hiên Viên
轩辕五败=Hiên Viên Ngũ Bại
轩辕令=Hiên Viên Lệnh
轩辕十二=Hiên Viên Thập Nhị
轩辕十四星=Hiên Viên Thập Tứ Tinh
轩辕司龙=Hiên Viên Tư Long
轩辕小号=Hiên Viên Tiểu Hiệu
轩辕师兄=Hiên Viên sư huynh
轩辕强=Hiên Viên Cường
轩辕日月=Hiên Viên Nhật Nguyệt
轩辕望=Hiên Viên Vọng
轩辕望至尊=Hiên Viên Vọng Chí Tôn
轩辕派=Hiên Viên Phái
轩辕淡=Hiên Viên Đạm
轩辕至尊=Hiên Viên Chí Tôn
轩辕骨龙=Hiên Viên Cốt Long
转魄=Chuyển Phách
转魄神剑=Chuyển Phách Thần Kiếm
轮回=Luân Hồi
轮回之力=Luân Hồi Chi Lực
轮回之盘=Luân Hồi Chi Bàn
轮回之门=Luân Hồi Chi Môn
轮回剑气=Luân Hồi Kiếm Khí
轮回剑道=Luân Hồi Kiếm Đạo
轮回铁则=Luân Hồi Thiết Tắc
轻之文明=Văn minh Khinh
轻风酒=Khinh Phong Tửu
辛姓贤人=Hiền nhân họ Tân
过门更相呼，有酒斟酌之=Quá môn canh tương hô, hữu tửu châm chước chi
近海之域=Vùng gần biển
远古温瘟亿毒洪水=Viễn Cổ Ôn Ôn Ức Độc Hồng Thủy
迷路之枭=Mê Lộ Chi Kiêu
追踪术=Thuật Truy Tung
适应=Thích Ứng
适应铁则=Thích Ứng Thiết Tắc
逃门=Đào Môn
逆五行剑法=Nghịch Ngũ Hành Kiếm Pháp
逍遥仙门=Tiêu Dao Tiên Môn
逍遥子=Tiêu Dao Tử
通晓真人=Thông Hiểu Chân Nhân
速一=Tốc Nhất
速之文明之主=Tốc Chi Văn Minh Chi Chủ
速神境=Cảnh giới Tốc Thần
速神步=Tốc Thần Bộ
造物境=Tạo Vật Cảnh
道字=Đạo Tự
道字分身=Đạo Tự Phân Thân
道字天劫=Thiên kiếp chữ Đạo
道字真身=Đạo Tự Chân Thân
道门=Đạo Môn
遗失=Di Thất
遗失之刃=Di Thất Chi Nhận
遗失之地=Di Thất Chi Địa
遗失之层=Di Thất Chi Tầng
遗失文明之主=Di Thất Văn Minh Chi Chủ
邀月=Yêu Nguyệt
邪乱乾坤=Tà Loạn Càn Khôn
邪乱天地=Tà Loạn Thiên Địa
邪剑=Tà Kiếm
邪剑文明=Văn minh Tà Kiếm
邪剑文明副主=Tà Kiếm Văn Minh Phó Chủ
邪吞天地=Tà Thôn Thiên Địa
邪本无道=Tà Bổn Vô Đạo
邪极天尊=Tà Cực Thiên Tôn
邪极空仙剑=Tà Cực Không Tiên Kiếm
邪极至尊=Tà Cực Chí Tôn
邪火心经=Tà Hỏa Tâm Kinh
邪王第一剑=Tà Vương Đệ Nhất Kiếm
邪翻乱=Tà Phiên Loạn
邪翻云=Tà Phiên Vân
邪翻天=Tà Phiên Thiên
邪诡剑=Tà Quỷ Kiếm
邪道为天剑法=Tà Đạo Vi Thiên Kiếm Pháp
郭侃=Quách Khản
都市全能霸主=Đô Thị Toàn Năng Bá Chủ
酒之五味剑=Tửu Chi Ngũ Vị Kiếm
酒之至尊=Tửu Chi Chí Tôn
酒仙人=Tửu Tiên Nhân
酒剑懒=Tửu Kiếm Lại
酒垆=Tửu Lư
酒椰果=Tửu Da Quả
酒泉山=Tửu Tuyền Sơn
酒火=Tửu Hỏa
酒葫芦=Bầu rượu
酒门=Tửu Môn
醉之子=Túy Chi Tử
醉剑=Túy Kiếm
醉逍遥居=Tuý Tiêu Dao Cư
释迦佛祖=Thích Ca Phật Tổ
重伤=Trọng thương
重剑无双=Trọng Kiếm Vô Song
重斧文明副主=Trọng Phủ Văn Minh Phó Chủ
野人=dã nhân
野行之法=Dã Hành Chi Pháp
金光太玄之冠=Kim Quang Thái Huyền chi quan
金刚明王=Kim Cương Minh Vương
金刚经=Kim Cương Kinh
金刚门=Kim Cương Môn
金母十八层天=Mười tám tầng trời Kim Mẫu
金母西王母=Kim Mẫu Tây Vương Mẫu
金球术=Kim Cầu Thuật
金童玉女=Kim Đồng Ngọc Nữ
金系剑法研究室=Kim hệ kiếm pháp nghiên cứu thất
金身=Kim Thân
金针渡穴法=Kim Châm Độ Huyệt Pháp
金龙=Kim Long
金龙巢穴=Kim Long Sào Huyệt
金龙魄=Kim Long Phách
鉴动明静果=Giám Động Minh Tĩnh Quả
钆元素=Nguyên tố Gadolini
钇元素=Nguyên tố Ytri
针之文明=Châm Chi Văn Minh
针之文明之主=Châm Chi Văn Minh Chi Chủ
针之文明副主=Châm Chi Văn Minh Phó Chủ
钔元素=Nguyên tố Men
钟大小姐=Chung Đại tiểu thư
钟大小姐钟灵=Chung Đại Tiểu Thư Chung Linh
钟灵=Chung Linh
钟誉庆=Chung Dự Khánh
钟鼓馔玉不足贵，但原长醉不复醒。古来圣贤皆寂寞，唯有饮者留其名。陈王昔时宴平乐，斗酒十千恣欢谑。主人何为言少钱，径须沽取对君酌。五花马，千金裘，呼儿将出换美酒，与尔同销万古愁=Chung cổ soạn ngọc bất túc quý, đãn nguyện trường túy bất phục tỉnh. Cổ lai thánh hiền giai tịch mịch, duy hữu ẩm giả lưu kỳ danh. Trần Vương tích thì yến bình lạc, đấu tửu thập thiên tứ hoan hước. Chủ nhân hà vi ngôn thiểu tiền, kính tu cô thủ đối quân chước. Ngũ hoa mã, thiên kim cầu, hô nhi tương xuất hoán mỹ tửu, dữ nhĩ đồng tiêu vạn cổ sầu
钨元素=Nguyên tố Vonfram
钱之文明=Tiền Chi Văn Minh
钱生钱=Tiền Sinh Tiền
钼元素=Nguyên tố Molypden
铁字世家=Thiết Tự Thế Gia
铁甲文明蛊=Thiết Giáp Văn Minh Cổ
铅元素=Nguyên tố Chì
铈元素=Nguyên tố Ceri
铊元素=Nguyên tố Thallium
铌元素=Nguyên tố Niobi
铕元素=Nguyên tố Europi
铜鼎=Đỉnh đồng
银元素=Nguyên tố bạc
银发白袍年轻男子=Thiếu niên áo bào trắng tóc bạc
银河图=Ngân Hà Đồ
银簪抹额=Ngân Trâm Mạt Ngạch
银角银梳=Ngân Giác Ngân Sơ
银雀凤冠=Ngân Tước Phượng Quan
银马罗汉=Ngân Mã La Hán
铷元素=Nguyên tố Rubidi
铹元素=Nguyên tố Lawrenci
锁之道=Tỏa Chi Đạo
锆元素=Nguyên tố Zirconi
锋字=Phong Tự
锏之天罡大阵=Kiển Thiên Cương Đại Trận
锏之天罡阵=Kiển Chi Thiên Cương Trận
锏之文字=Chữ Kiển
锏之文明=Văn minh Kiển
锏之文明副主=Điển Chi Văn Minh Phó Chủ
锏之文明锏圣帝子=Kiển Chi Văn Minh Kiển Thánh Đế Tử
锏之法力=Kiển Chi Pháp Lực
锏之真元=Kiển Chi Chân Nguyên
锏之网=Kiển Chi Võng
锏云愁=Kiển Vân Sầu
锏伤心=Giản Thương Tâm
锏何求=Kiển Hà Cầu
锏噬剑流=Kiển Phệ Kiếm Lưu
锏圣帝子=Giản Thánh Đế Tử
锏心帝子=Kiển Tâm Đế Tử
锏月帝子=Kiển Nguyệt Đế Tử
锏月白=Kiển Nguyệt Bạch
锏气=Kiển Khí
锏流泪=Giản Lưu Lệ
锏独心=Kiển Độc Tâm
锏玄纲=Kiển Huyền Cương
锏玄衣=Kiển Huyền Y
锏白=Kiển Bạch
锏自毒=Kiển Tự Độc
锏自行=Kiển Tự Hành
锏长空=Kiển Trường Không
锏龙升天=Kiển Long Thăng Thiên
锐字=Chữ Duệ
锘元素=Nguyên tố Nobel
锶元素=Nguyên tố Stronti
镇元子=Trấn Nguyên Tử
镇天塔=Trấn Thiên Tháp
镇岳灵剑=Trấn Nhạc Linh Kiếm
镜朱尘之照烂，袭青气之烟=Kính Chu Trần Chi Chiếu Lạn, Tập Thanh Khí Chi Yên
镨元素=Nguyên tố Praseodymium
长刀天王罗森=Trường Đao Thiên Vương La Sâm
长叹=Trường Thán
长叹神剑=Trường Thán Thần Kiếm
长春居=Trường Xuân Cư
长枪门=Trường Thương Môn
长毛巨象=Trường Mao Cự Tượng
长江大河=Trường Giang Đại Hà
长生境=Trường Sinh Cảnh
长眉老人=Trường Mi Lão Nhân
长锏=Trường Kiếm
门主=Môn chủ
门之台=Môn Chi Đài
门派排名战=Trận chiến xếp hạng môn phái
闪电门=Thiểm Điện Môn
闭眼打剑堂=Bế Nhãn Đả Kiếm Đường
闭着眼打剑堂=Bế Nhãn Đả Kiếm Đường
问仙宫=Vấn Tiên Cung
问君安=Vấn Quân An
问天枪诀=Vấn Thiên Thương Quyết
问情=Vấn Tình
问情之剑=Vấn Tình Chi Kiếm
问钝仙剑=Vấn Độn Tiên Kiếm
闻香散=Văn Hương Tán
防御结晶=Phòng ngự kết tinh
阳之剑者令=Dương Chi Kiếm Giả Lệnh
阳仙锁链=Dương Tiên Tỏa Liên
阳关三迭=Dương Quan Tam Điệp
阳关三迭琴曲=Dương Quan Tam Điệp Cầm Khúc
阳干星=Dương Can Tinh
阴世五绝剑=Âm Thế Ngũ Tuyệt Kiếm
阴世奇=Âm Thế Kỳ
阴之春雷=Âm Chi Xuân Lôi
阴仙锁链=Âm Tiên Tỏa Liên
阴冷之冬=Âm Lãnh Chi Đông
阴凉之秋=Âm Lương Chi Thu
阴凝四季剑法=Âm Ngưng Tứ Quý Kiếm Pháp
阴惨须=Âm Thảm Tu
阴暗之夏=Âm Ám Chi Hạ
阴阳=Âm Dương
阴阳之盘=Âm Dương Chi Bàn
阴阳二气瓶=Âm Dương Nhị Khí Bình
阴阳铁则=Âm Dương Thiết Tắc
阴阳门=Âm Dương Môn
阴雷之春=Âm Lôi Chi Xuân
阴魔=Âm Ma
阵之文明=Văn minh Trận
阵之文明副主=Trận Văn Minh Phó Chủ
阵绝文明副主=Phó chủ Văn minh Trận Tuyệt
阿修罗蛇颈龙=A Tu La Xà Cảnh Long
阿弥陀佛=A Di Đà Phật
阿青=A Thanh
陀背=lưng còng
陆云=Lục Vân
陆元=Lục Nguyên
陆元道友=Lục Nguyên đạo hữu
陆家二老=Lục gia nhị lão
陆家庄=Lục Gia Trang
陆小友=Lục tiểu hữu
陆师兄=Lục sư huynh
陆师弟=Lục sư đệ
陆掌门=Chưởng môn Lục
陆施主=Lục thí chủ
陆氏二老=Nhị lão nhà họ Lục
陆芷苡=Lục Chỉ Ỷ
除魔之剑=Trừ Ma Chi Kiếm
险之招式极限=Hiểm chi chiêu thức cực hạn
险字=Chữ Hiểm
隐之剑术=Ẩn Chi Kiếm Thuật
隐剑宗=Ẩn Kiếm Tông
隐剑宗宗主剑如海=Ẩn Kiếm Tông Tông Chủ Kiếm Như Hải
隐匿=Ẩn nấp
隔代传人=truyền nhân cách đời
难言也。其为气也，至大至刚，以直养而无害，则塞于天地之间=Nan ngôn dã. Kỳ vi khí dã, chí đại chí cương, dĩ trực dưỡng nhi vô hại, tắc tắc vu thiên địa chi gian
雄之招式极限=Hùng chi chiêu thức cực hạn
雄之至尊=Hùng Chi Chí Tôn
雄字=Hùng Tự
雄战=Hùng Chiến
雄百里=Hùng Bách Lý
雄霸刀法=Hùng Bá Đao Pháp
雨水=Vũ Thủy
雨水剑意=Vũ Thủy Kiếm Ý
雪之剑意=Tuyết Chi Kiếm Ý
雪山=Tuyết Sơn
雪蛇术=Tuyết Xà Thuật
雷七=Lôi Thất
雷之天地法相=Lôi Chi Thiên Địa Pháp Tướng
雷之文明=Văn minh Lôi
雷傲公主=Lôi Ngạo công chúa
雷傲台=Đài Lôi Ngạo
雷公=Lôi Công
雷凤凰=Lôi Phượng Hoàng
雷击九地=Lôi Kích Cửu Địa
雷力双暴=Lôi Lực song bạo
雷动天=Lôi Động Thiên
雷声入耳=Lôi Thanh Nhập Nhĩ
雷帝天罚法=Lôi Đế Thiên Phạt Pháp
雷斯文=Lôi Tư Văn
雷星剑法=Lôi Tinh Kiếm Pháp
雷暴文明=Lôi Bạo văn minh
雷暴文明副主=Phó Chủ Văn Minh Lôi Bạo
雷母十八层天=Mười tám tầng trời Lôi Mẫu
雷母雷傲公主=Lôi Mẫu Lôi Ngạo công chúa
雷王文明副主=Phó chủ Văn minh Lôi Vương
雷电之快=Lôi Điện Chi Khoái
雷系剑法研究室=Lôi hệ kiếm pháp nghiên cứu thất
雷系法术=Pháp thuật hệ Lôi
雷蛇追踪=Lôi Xà Truy Tung
雷霆帝子=Lôi Đình Đế Tử
雷音剑法=Lôi Âm Kiếm Pháp
雷龙=Lôi Long
雷龙入地=Lôi Long Nhập Địa
雷龙降世神通=Lôi Long Giáng Thế Thần Thông
雾外江山=Vụ Ngoại Giang Sơn
霆之剑意=Ý Kiếm của Đình
震天之箭=Chấn Thiên Chi Tiễn
震宇之吼=Chấn Vũ Chi Hống
震宫=Chấn Cung
震雷星=Chấn Lôi Tinh
霍一步=Hoắc Nhất Bộ
霜之剑意=Sương Chi Kiếm Ý
霸之极限=Bá Chi Cực Hạn
霸仙剑=Bá Tiên Kiếm
霸兽老祖=Bá Thú Lão Tổ
霸刀门=Bá Đao Môn
霸剑=Bá Kiếm
霸剑无双=Bá Kiếm Vô Song
霸气=Bá Khí
霸王拳=Bá Vương Quyền
青之一剑=Thanh Chi Nhất Kiếm
青之文明=Văn minh Thanh
青之文明剑道=Thanh Chi Văn Minh Kiếm Đạo
青之神女=Thần Nữ Màu Xanh
青冥=Thanh Minh
青圣剑道=Thanh Thánh Kiếm Đạo
青圣帝道=Thanh Thánh Đế Đạo
青城仙门=Thanh Thành Tiên Môn
青城山=Thanh Thành Sơn
青城派=Thanh Thành Phái
青女=Thanh Nữ
青女之争=Tranh đoạt Thanh Nữ
青山不改，绿水长流=Thanh Sơn bất cải, Lục Thủy trường lưu
青帝剑道=Thanh Đế Kiếm Đạo
青景公主=Thanh Cảnh Công Chúa
青极钟=Chuông Thanh Cực
青树翠蔓=Thanh Thụ Thúy Mạn
青檀台=Thanh Đàn Đài
青碧色的龙=Thanh Bích sắc Long
青箬笠=Thanh Nhược Lạp
青翠十里钗=Thanh Thúy Thập Lý Xoa
青色照纹宫=Thanh Sắc Chiếu Văn Cung
青色裘衣=Áo lông xanh
青草池塘处处蛙=Thanh Thảo Trì Đường Xứ Xứ Oa
青莲=Thanh Liên
青萝=Thanh La
青衣=Áo xanh
青衣年轻人=Thanh Y Niên Khinh Nhân
青衣清丽少女=Thiếu nữ áo xanh thanh lệ
青越仙剑=Thanh Việt Tiên Kiếm
青酒=Thanh Tửu
青音钟=Chuông Thanh Âm
青鸟=Thanh Điểu
青鸾=Thanh Loan
青鸾仙剑=Thanh Loan Tiên Kiếm
静字=Chữ Tĩnh
静惊心=Tĩnh Kinh Tâm
非剑者之路=Phi Kiếm Giả Chi Lộ
非时之铁则=Phi Thời Chi Thiết Tắc
韩非子=Hàn Phi Tử
顶天=Đỉnh Thiên
顶天公子=Đỉnh Thiên Công Tử
顶级步法=Đỉnh Cấp Bộ Pháp
顾秋水=Cố Thu Thủy
颜清寒=Nhan Thanh Hàn
颠魔丹=Điên Ma Đan
风三十=Phong Tam Thập
风中秋=Phong Trung Thu
风之仙剑=Phong Chi Tiên Kiếm
风之咸剑=Phong Chi Hàm Kiếm
风之咸轮=Phong Chi Hàm Luân
风之天地法则=Phong Chi Thiên Địa Pháp Tắc
风之扇=Phong Chi Phiến
风之文明=Văn minh Phong
风之文明副主=Phong Chi Văn Minh Phó Chủ
风之甜剑=Phong Chi Điềm Kiếm
风之甜轮=Phong Chi Điềm Luân
风之精灵=Phong Chi Tinh Linh
风之精灵咕咕=Phong Chi Tinh Linh Cổ Cổ
风之苦剑=Phong Chi Khổ Kiếm
风之苦轮=Phong Chi Khổ Luân
风之辣剑=Phong Chi Lạt Kiếm
风之辣轮=Phong Chi Lạt Luân
风之道=Phong Chi Đạo
风之酸剑=Phong Chi Toan Kiếm
风之飘渺=Phong Chi Phiêu Miểu
风二十=Phong Nhị Thập
风二十四=Phong Nhị Thập Tứ
风云一百零八剑=Phong Vân 108 Kiếm
风云再起=Phong Vân Tái Khởi
风云急变=Phong Vân Cấp Biến
风伤文明=Văn minh Phong Thương
风伤文明副主=Phong Thương Văn Minh Phó Chủ
风冉帝姬=Phong Nhiễm Đế Cơ
风吹人=Phong Xuy Nhân
风吹风=Phong Xuy Phong
风啸天=Phong Khiếu Thiên
风回旋=Phong Hồi Toàn
风天音=Phong Thiên Âm
风师姐=Phong sư tỷ
风师弟=Phong sư đệ
风怒潮=Phong Nộ Triều
风扬牧=Phong Dương Mục
风无形=Phong Vô Hình
风明意=Phong Minh Ý
风明月=Phong Minh Nguyệt
风星星=Phong Tinh Tinh
风母九天玄女=Phong Mẫu Cửu Thiên Huyền Nữ
风母十八层天=Mười tám tầng trời Phong Mẫu
风水=Phong Thủy
风水大劫=Phong Thủy Đại Kiếp
风神百步=Phong Thần Bách Bộ
风系剑法研究室=Phong hệ kiếm pháp nghiên cứu thất
风裂百式=Phong Liệt Bách Thức
风速绝伦=Phong Tốc Tuyệt Luân
风魔王=Phong Ma Vương
风龙=Phong Long
风龙怒天剑=Phong Long Nộ Thiên Kiếm
飞剑客=Phi Kiếm Khách
飞卫=Phi Vệ
飞燕仙剑=Phi Yến Tiên Kiếm
飞雪剑法=Phi Tuyết Kiếm Pháp
食道=Thực Đạo
饕餮=Tao Thiết
饶生明=Nhiêu Sinh Minh
首功=Công đầu
马王爷=Mã Vương Gia
骨之神魔战法=Cốt Chi Thần Ma Chiến Pháp
高天阶=Cao Thiên Giai
高山流水=Cao Sơn Lưu Thủy
高德天尊=Cao Đức Thiên Tôn
高进=Cao Tiến
鬼之招式极限=Quỷ chi chiêu thức cực hạn
鬼之船=Quỷ Chi Thuyền
鬼哭神号第一军师=Quỷ Khốc Thần Hào đệ nhất quân sư
鬼哭神愁=Quỷ Khốc Thần Sầu
鬼王何求道=Quỷ Vương Hà Cầu Đạo
鬼王惧之旗=Quỷ Vương Cụ Chi Kỳ
鬼王门=Quỷ Vương Môn
鬼神指=Quỷ Thần Chỉ
鬼秘仙锏=Quỷ Bí Tiên Kiển
鬼纵横=Quỷ Tung Hoành
鬼门=Quỷ Môn
鬼陌刀=Quỷ Mạch Đao
鬼龙马=Quỷ Long Mã
魂魄=Hồn phách
魔之大神=Ma Chi Đại Thần
魔之子=Ma Chi Tử
魔之文明=Văn minh Ma Cổ
魔之文明之主=Ma Chi Văn Minh Chi Chủ
魔之邪道=Ma Chi Tà Đạo
魔剑三式=Ma Kiếm Tam Thức
魔剑宗=Ma Kiếm Tông
魔剑文明=Ma Kiếm Văn Minh
魔剑文明副主=Ma Kiếm Văn Minh Phó Chủ
魔力=Ma Lực
魔古文明=Ma Cổ Văn Minh
魔字=Chữ Ma
魔宝楼=Ma Bảo Lâu
魔念仙剑=Ma Niệm Tiên Kiếm
魔念剑=Ma Niệm Kiếm
魔木崖=Ma Mộc Nhai
魔本无心=Ma Bổn Vô Tâm
魔杀快剑=Ma Sát Khoái Kiếm
魔梵般若=Ma Phạn Bát Nhã
魔气=Ma Khí
魔气山=Ma Khí Sơn
魔界=Ma Giới
魔罗=Ma La
魔罗天=Ma La Thiên
魔舌之主=Ma Thiệt Chi Chủ
魔路剑法=Ma Lộ Kiếm Pháp
魔速文明副主=Ma Tốc Văn Minh Phó Chủ
魔道=Ma Đạo
鲲鹏=Côn Bằng
鲲鹏世界=Thế giới Côn Bằng
鲲鹏王=Côn Bằng Vương
鸟之文明=Văn minh Điểu
鸟之文明副主=Điểu Chi Văn Minh Phó Chủ
鸟头=Đầu chim
鸟尾=Đuôi chim
鸟翼=Cánh chim
鸟身=Thân chim
鸾鸟=Loan Điểu
鸿一文明之主=Hồng Nhất Văn Minh Chi Chủ
鸿均=Hồng Quân
鸿均文明之主=Chủ văn minh Hồng Quân
鸿老儿=Ông già Hồng
鸿蒙=Hồng Mông
鸿蒙之书=Hồng Mông Chi Thư
鸿蒙文明=Hồng Mông Văn Minh
鸿蒙文明之主=Hồng Mông Văn Minh Chi Chủ
鸿蒙道尊=Hồng Mông Đạo Tôn
鸿钧=Hồng Quân
鹤一星=Hạc Nhất Tinh
鹤阳楼=Hạc Dương Lâu
鹰杀神羽=Ưng Sát Thần Vũ
鹰燕文明双杀=Ưng Yến Văn minh Song Sát
鹰魔神=Ưng Ma Thần
麻八=Ma Bát
黄巾剑客=Hoàng Cân Kiếm Khách
黄巾力士=Hoàng Cân Lực Sĩ
黄强=Hoàng Cường
黄面老者=Lão giả mặt vàng
黑暗之翼=Hắc Ám Chi Dực
黑死=Hắc Tử
黑衣人=Hắc Y Nhân
黑风=Hắc Phong
黑风老妖=Hắc Phong Lão Yêu
黑马陆元=Hắc mã Lục Nguyên
齐天之剑=Tề Thiên Kiếm
龙之文明=Văn minh Long
龙之文明副主=Long Chi Văn Minh Phó Chủ
龙尊=Long Tôn
龙族=Long Tộc
龙望图=Long Vọng Đồ
龙眼=long nhãn
龙系=Long hệ
龙蛇起陆=Long Xà Khởi Lục
龙首山=Long Thủ Sơn
龟息剑缩大法=Quy Tức Kiếm Súc Đại Pháp